Estado	Municipio	Parroquia	Centro	Número de Electores escrutados.	Número de Actas Procesadas.	Número total de Votos Nulos.	Número Total de Votantes que votaron realmente.	HUGO CHAVEZ	Número total de Votos Válidos.	ORLANDO CHIRINO	REINA SEQUERA	LUIS REYES	MARIA BOLIVAR	HENRIQUE CAPRILES RADONSKI	Número de Votos Escrutados.
EDO. PORTUGUESA	MP. GUANARITO	PQ. DIVINA PASTORA	ESCUELA CONCENTRADA MIXTA NUMERO 133	559	1	26	440	290	414	0	2	0	0	122	440
EDO. PORTUGUESA	MP. GUANARITO	PQ. DIVINA PASTORA	ESCUELA CONCENTRADA NUMERO 5	185	1	1	149	116	148	0	0	0	0	32	149
EDO. PORTUGUESA	MP. GUANARITO	PQ. DIVINA PASTORA	ESCUELA ESTADAL CONCENTRADA NUMERO 108	514	1	24	407	243	383	0	5	0	0	135	407
EDO. PORTUGUESA	MP. GUANARITO	PQ. DIVINA PASTORA	ESCUELA CONCENTRADA NACIONAL MIXTA Y ANEXA ESTADAL NUMERO 132	852	2	23	699	498	676	0	4	0	0	174	699
EDO. PORTUGUESA	MP. GUANARITO	PQ. DIVINA PASTORA	ESCUELA CONCENTRADA NUMERO 109	376	1	2	307	237	305	0	1	0	0	67	307
EDO. PORTUGUESA	MP. GUANARITO	PQ. DIVINA PASTORA	UNIDAD ESTADAL CONCENTRADA NUMERO 537	175	1	7	158	107	151	0	0	1	0	43	158
EDO. PORTUGUESA	MP. GUANARITO	PQ. DIVINA PASTORA	ESCUELA BASICA ESTADAL UNITARIA SIN NUMERO NER 166	100	1	3	87	60	84	0	3	0	0	21	87
EDO. PORTUGUESA	MP. GUANARITO	PQ. DIVINA PASTORA	ESCUELA ESTADAL CONCENTRADA NUMERO 121	319	1	11	264	200	253	0	5	0	0	48	264
EDO. PORTUGUESA	MP. GUANARITO	PQ. DIVINA PASTORA	ESCUELA NACIONAL CONCENTRADA LA CEBEREÑA	520	1	10	430	278	420	2	5	0	0	135	430
EDO. PORTUGUESA	MP. GUANARITO	PQ. DIVINA PASTORA	ESCUELA ESTADAL UNITARIA NUMERO 51
EDO. PORTUGUESA	MP. GUANARITO	CM. GUANARITO	ESCUELA ESTADAL UNITARIA NUMERO 129	775	2	8	654	304	646	0	0	0	0	342	654
EDO. PORTUGUESA	MP. GUANARITO	CM. GUANARITO	ESCUELA ESTADAL CONCENTRADA LA HOYADA NUMERO 107	764	2	10	586	493	576	0	1	3	0	79	586
EDO. PORTUGUESA	MP. GUANARITO	CM. GUANARITO	ESCUELA BASICA UNITARIA 536 COROZAL	585	1	6	484	246	478	0	1	0	0	231	484
EDO. PORTUGUESA	MP. GUANARITO	CM. GUANARITO	ESCUELA BASICA PORTUGUESA	2674	5	38	2207	1612	2169	2	11	4	1	539	2207
EDO. PORTUGUESA	MP. GUANARITO	CM. GUANARITO	ESCUELA ESTADAL UNITARIA NUMERO 131	268	1	0	148	136	148	1	0	0	0	11	148
EDO. PORTUGUESA	MP. GUANARITO	CM. GUANARITO	ESCUELA ESTADAL UNITARIA NUMERO 12	362	1	5	277	234	272	0	0	1	0	37	277
EDO. PORTUGUESA	MP. GUANARITO	CM. GUANARITO	ESCUELA ESTADAL CONCENTRADA NUMERO 134	110	1	2	92	71	90	0	0	0	0	19	92
EDO. PORTUGUESA	MP. GUANARITO	CM. GUANARITO	ESCUELA ESTADAL UNITARIA NUMERO 126	232	1	5	177	103	172	0	1	0	0	68	177
EDO. PORTUGUESA	MP. GUANARITO	CM. GUANARITO	ESCUELA ESTADAL UNITARIA NUMERO 125	343	1	4	284	223	280	0	5	0	0	52	284
EDO. PORTUGUESA	MP. GUANARITO	CM. GUANARITO	ESCUELA BASICA UNITARIA NUMERO 117	491	1	11	433	301	422	1	1	2	0	117	433
EDO. PORTUGUESA	MP. GUANARITO	CM. GUANARITO	ESCUELA MUNICIPAL GUANARITO	3105	6	68	2592	1705	2524	0	6	2	0	811	2592
EDO. PORTUGUESA	MP. GUANARITO	CM. GUANARITO	ESCUELA BASICA FRAY ANDRES GRAZALEMA	1462	3	58	1254	784	1196	1	5	3	0	403	1254
EDO. PORTUGUESA	MP. GUANARITO	CM. GUANARITO	ESCUELA BASICA MONSEÑOR UNDA	2895	6	50	2285	1333	2235	0	10	5	0	887	2285
EDO. PORTUGUESA	MP. GUANARITO	CM. GUANARITO	ESCC.BOLIVARIANA SIMON RODRIGUEZ	450	1	13	388	320	375	0	4	0	0	51	388
EDO. PORTUGUESA	MP. GUANARITO	CM. GUANARITO	ESCUELA BASICA UNITARIA NUMERO 512	392	1	3	329	292	326	0	3	1	0	30	329
EDO. PORTUGUESA	MP. GUANARITO	CM. GUANARITO	ESCUELA ESTADAL CONCENTRADA 124	447	1	8	346	209	338	0	0	0	0	129	346
EDO. PORTUGUESA	MP. GUANARITO	CM. GUANARITO	CICLO COMBINADO ARTURO CELESTINO ALVAREZ	2432	5	55	1951	1259	1896	1	4	5	0	627	1951
EDO. PORTUGUESA	MP. GUANARITO	CM. GUANARITO	PARQUE DE RECREACION DIRIGIDA CONSEJO VENEZOLANO DEL NIÑO	1347	3	26	1051	649	1025	0	4	3	0	369	1051
EDO. PORTUGUESA	MP. GUANARITO	PQ.TRINIDAD DE LA CAPILLA	ESCUELA ESTADAL BASICA NUMERO 110	736	2	10	554	432	544	1	1	3	1	106	554
EDO. PORTUGUESA	MP. GUANARITO	PQ.TRINIDAD DE LA CAPILLA	ESCUELA ESTADAL BASICA UNITARIA NUMERO 122	296	1	2	208	186	206	0	0	0	0	20	208
EDO. PORTUGUESA	MP. GUANARITO	PQ.TRINIDAD DE LA CAPILLA	ESCUELA ESTADAL CONCENTRADA NUMERO 112	504	1	5	368	315	363	0	1	1	1	45	368
EDO. PORTUGUESA	MP. GUANARITO	PQ.TRINIDAD DE LA CAPILLA	ESCUELA ESTADAL CONCENTRADA NUMERO 113
EDO. PORTUGUESA	MP. GUANARITO	PQ.TRINIDAD DE LA CAPILLA	E.B.E. CONCENTRADA N° 111 LA ARENOSA NER 7	181	1	5	157	142	152	0	1	0	0	9	157
EDO. PORTUGUESA	MP. GUANARITO	PQ.TRINIDAD DE LA CAPILLA	ESCUELA ESTADAL CONCENTRADA NUMERO 204
EDO. PORTUGUESA	MP. GUANARITO	PQ.TRINIDAD DE LA CAPILLA	ESCUELA ESTADAL CONCENTRADA NUMERO 36	196	1	1	164	154	163	0	1	0	0	8	164
EDO. PORTUGUESA	MP. OSPINO	PQ. APARICION	ESCUELA ESTADAL EL TIGRE NUMERO 156	109	1	2	106	104	104	0	0	0	0	0	106
EDO. PORTUGUESA	MP. OSPINO	PQ. APARICION	ESCUELA CONCENTRADA NACIONAL SIN NUMERO	518	1	2	332	287	330	1	4	2	1	35	332
EDO. PORTUGUESA	MP. OSPINO	PQ. APARICION	ESCUELA ESTADAL UNITARIA NUMERO 328	607	2	9	488	331	479	0	2	0	0	146	488
EDO. PORTUGUESA	MP. OSPINO	PQ. APARICION	ESCUELA ESTADAL SIN NUMERO BELLA TOVAR	129	1	3	119	77	116	0	1	0	0	38	119
EDO. PORTUGUESA	MP. OSPINO	PQ. APARICION	ESCUELA MAMARIA	324	1	11	283	247	272	0	0	0	0	25	283
EDO. PORTUGUESA	MP. OSPINO	PQ. APARICION	ESCUELA GRADUADA LA CORTEZA	1897	4	37	1509	1087	1472	1	15	4	0	365	1509
EDO. PORTUGUESA	MP. OSPINO	PQ. APARICION	ESCUELA BOLIVARIANA FRAY FELIPE DE PALMA	378	1	5	332	266	327	0	0	0	0	61	332
EDO. PORTUGUESA	MP. OSPINO	PQ. APARICION	ESCUELA BOLIVARIANA PARAPARITO	264	1	3	210	198	207	0	1	0	0	8	210
EDO. PORTUGUESA	MP. OSPINO	PQ. APARICION	UNIDAD EDUCATIVA NACIONAL LA CORTEZA	1042	2	15	875	645	860	0	4	0	0	211	875
EDO. PORTUGUESA	MP. OSPINO	PQ. APARICION	ESCUELA ESTADAL NUMERO 482 NUCLEO 09.	327	1	1	241	232	240	0	0	0	0	8	241
EDO. PORTUGUESA	MP. OSPINO	PQ. APARICION	ESCUELA CONCENTRADA TIPO NUMERO 327	614	2	18	517	407	499	0	2	0	0	90	517
EDO. PORTUGUESA	MP. OSPINO	PQ. APARICION	ESCUELA BASICA CONCENTRADA SIN NUMERO	215	1	6	167	126	161	0	0	0	0	35	167
EDO. PORTUGUESA	MP. OSPINO	CM. OSPINO	UNIDAD EDUCATIVA GABRIEL PEREZ DE PAGOLA	1168	2	15	996	474	981	0	7	0	0	500	996
EDO. PORTUGUESA	MP. OSPINO	CM. OSPINO	ESCUELA TECNICA AGROPECUARIA OSPINO	1214	3	19	934	444	915	2	7	0	0	462	934
EDO. PORTUGUESA	MP. OSPINO	CM. OSPINO	ESCUELA CONCENTRADA EL JOBAL NUMERO 333	199	1	2	159	139	157	0	1	0	0	17	159
EDO. PORTUGUESA	MP. OSPINO	CM. OSPINO	ESCUELA UNITARIA NUMERO 339	103	1	0	96	96	96	0	0	0	0	0	96
EDO. PORTUGUESA	MP. OSPINO	CM. OSPINO	ESCUELA CONCENTRADA NUMERO 485	622	2	7	528	374	521	0	1	0	0	146	528
EDO. PORTUGUESA	MP. OSPINO	CM. OSPINO	ESCUELA CONCENTRADA NUMERO 483	338	1	1	257	211	256	0	3	0	1	41	257
EDO. PORTUGUESA	MP. OSPINO	CM. OSPINO	CENTRO DE EDUCACION INICIAL NEGRA HIPOLITA	209	1	5	191	167	186	0	0	0	0	19	191
EDO. PORTUGUESA	MP. OSPINO	CM. OSPINO	ESCUELA UNITARIA LAS QUESERAS NUMERO 341	140	1	2	128	69	126	0	0	0	0	57	128
EDO. PORTUGUESA	MP. OSPINO	CM. OSPINO	ESCUELA ESTADAL CONCENTRADA MIXTA NUMERO 330	512	1	2	425	361	423	2	2	0	0	58	425
EDO. PORTUGUESA	MP. OSPINO	CM. OSPINO	ESCUELA BASICA BATALLA DE OSPINO	976	2	21	827	599	806	0	6	0	0	201	827
EDO. PORTUGUESA	MP. OSPINO	CM. OSPINO	ESCUELA ESTADAL UNITARIA NUMERO 148	77	1	1	69	60	68	0	1	0	0	7	69
EDO. PORTUGUESA	MP. OSPINO	CM. OSPINO	ESCUELA ESTADAL CONCENTRADA NUMERO 152	859	2	13	668	494	655	0	3	0	0	158	668
EDO. PORTUGUESA	MP. OSPINO	CM. OSPINO	ESCUELA ESPECIAL CONCENTRADA NUMERO 153	304	1	7	209	144	202	0	1	2	0	55	209
EDO. PORTUGUESA	MP. OSPINO	CM. OSPINO	ESCUELA NACIONAL GRADUADA OSPINO	1393	3	38	1107	827	1069	0	12	3	0	227	1107
EDO. PORTUGUESA	MP. OSPINO	CM. OSPINO	ESCUELA GRADUADA BARRIO ARRIBA	1795	3	16	1485	995	1469	1	7	1	1	464	1485
EDO. PORTUGUESA	MP. OSPINO	CM. OSPINO	ESCUELA ESTADAL UNITARIA SIN NUMERO	272	1	4	220	167	216	0	3	1	0	45	220
EDO. PORTUGUESA	MP. OSPINO	CM. OSPINO	ESCUELA CONCENTRADA MIXTA NUMERO 334	357	1	8	274	238	266	0	2	0	0	26	274
EDO. PORTUGUESA	MP. OSPINO	CM. OSPINO	ESCUELA BASICA NACIONAL CIUDAD TRUJILLO	1522	3	26	1233	540	1207	0	10	0	1	656	1233
EDO. PORTUGUESA	MP. OSPINO	CM. OSPINO	ESCUELA ESTADAL CONCENTRADA NUMERO 331	493	1	6	412	339	406	0	6	0	0	61	412
EDO. PORTUGUESA	MP. OSPINO	CM. OSPINO	ESCUELA ESTADAL CONCENTRADA NUMERO 332	413	1	5	330	285	325	0	1	0	0	39	330
EDO. PORTUGUESA	MP. OSPINO	CM. OSPINO	ESCUELA NERIA DE QUINTERO	2235	4	48	1791	1247	1743	1	12	1	0	482	1791
EDO. PORTUGUESA	MP. OSPINO	CM. OSPINO	ESCUELA UNITARIA 488	138	1	0	130	127	130	0	0	0	0	3	130
EDO. PORTUGUESA	MP. OSPINO	CM. OSPINO	ESCUELA ESTADAL NUMERO 369	408	1	5	316	227	311	0	8	0	1	75	316
EDO. PORTUGUESA	MP. OSPINO	CM. OSPINO	ESCUELA ESTADAL CONCENTRADA NUMERO 157 LIBERTADOR	1127	2	37	892	733	855	0	6	2	1	113	892
EDO. PORTUGUESA	MP. OSPINO	CM. OSPINO	ESCUELA PRIMARIA OSPINO REAL	230	1	5	209	142	204	0	1	0	0	61	209
EDO. PORTUGUESA	MP. OSPINO	CM. OSPINO	ESCUELA ESTADAL UNITARIA NUMERO 340 MATAPELADA	210	1	4	157	111	153	0	1	1	0	40	157
EDO. PORTUGUESA	MP. OSPINO	CM. OSPINO	ESCUELA BASICA DANIEL CAMEJO ACOSTA	931	2	23	806	490	783	0	3	2	0	288	806
EDO. PORTUGUESA	MP. OSPINO	PQ. LA ESTACION	ESCUELA CONCENTRADA MIXTA 351	358	1	6	216	166	210	0	0	2	0	42	216
EDO. PORTUGUESA	MP. OSPINO	PQ. LA ESTACION	ESCUELA ESTADAL UNITARIA NUMERO 329	165	1	6	122	95	116	0	0	0	0	21	122
EDO. PORTUGUESA	MP. OSPINO	PQ. LA ESTACION	ESCUELA BOLIVARIANA JOBILLAL	57	1	1	41	39	40	1	0	0	0	0	41
EDO. PORTUGUESA	MP. OSPINO	PQ. LA ESTACION	ESCUELA ESTADAL CONCENTRADA NUMERO 361	528	1	8	376	307	368	0	5	1	0	55	376
EDO. PORTUGUESA	MP. OSPINO	PQ. LA ESTACION	ESCUELA ESTADAL UNITARIA NUMERO 344	392	1	3	242	179	239	0	2	1	0	57	242
EDO. PORTUGUESA	MP. OSPINO	PQ. LA ESTACION	ESCUELA ESTADAL CONCENTRADA NUMERO 323	814	2	21	513	433	492	0	2	0	0	57	513
EDO. PORTUGUESA	MP. OSPINO	PQ. LA ESTACION	ESCUELA ESTADAL UNITARIA NUMERO 349	109	1	1	94	80	93	0	1	1	0	11	94
EDO. PORTUGUESA	MP. OSPINO	PQ. LA ESTACION	ESCUELA ESTADAL CONCENTRADA NUMERO 324	256	1	4	202	183	198	0	1	0	0	14	202
EDO. PORTUGUESA	MP. OSPINO	PQ. LA ESTACION	ESCUELA ESTADAL CONCENTRADA NUMERO 359	493	1	6	352	309	346	1	4	0	0	32	352
EDO. PORTUGUESA	MP. OSPINO	PQ. LA ESTACION	ESCUELA ESTADAL CONCENTRADA NUMERO 93	74	1	0	57	54	57	0	0	0	0	3	57
EDO. PORTUGUESA	MP. OSPINO	PQ. LA ESTACION	ESCUELA ESTADAL NUMERO 355	186	1	3	158	141	155	0	1	0	0	13	158
EDO. PORTUGUESA	MP. OSPINO	PQ. LA ESTACION	ESCUELA ESTADAL CONCENTRADA NUMERO 353	108	1	3	71	57	68	0	3	0	0	8	71
EDO. PORTUGUESA	MP. OSPINO	PQ. LA ESTACION	ESCUELA CONCENTRADA NUMERO 345	174	1	4	134	96	130	0	1	0	0	33	134
EDO. PORTUGUESA	MP. OSPINO	PQ. LA ESTACION	ESCUELA CONCENTRADA NUMERO 346	52	1	0	41	41	41	0	0	0	0	0	41
EDO. PORTUGUESA	MP. OSPINO	PQ. LA ESTACION	ESCUELA BOLIVARIANA EL RODEO	148	1	6	124	76	118	0	1	0	0	41	124
EDO. PORTUGUESA	MP. OSPINO	PQ. LA ESTACION	ESCUELA ESTADAL UNITARIA NUMERO 146	117	1	3	62	46	59	0	0	0	0	13	62
EDO. PORTUGUESA	MP. OSPINO	PQ. LA ESTACION	ESCUELA ESTADAL UNITARIA SIN NUMERO	63	1	1	50	44	49	0	0	1	0	4	50
EDO. PORTUGUESA	MP. OSPINO	PQ. LA ESTACION	ESCUELA ESTADAL UNITARIA NUMERO 354	81	1	0	68	57	68	0	3	0	0	8	68
EDO. PORTUGUESA	MP. OSPINO	PQ. LA ESTACION	ESCUELA ESTADAL UNITARIA NUMERO 358	169	1	1	121	118	120	0	0	0	0	2	121
EDO. PORTUGUESA	MP. OSPINO	PQ. LA ESTACION	ESCUELA CONCENTRADA MIXTA SIN NUMERO	338	1	4	261	245	257	0	2	0	0	10	261
EDO. PORTUGUESA	MP. OSPINO	PQ. LA ESTACION	ESCUELA ESTADAL CONCENTRADA NUMERO 348	132	1	3	113	101	110	0	1	0	0	8	113
EDO. PORTUGUESA	MP. OSPINO	PQ. LA ESTACION	ESCUELA ESTADAL CONCENTRADA NUMERO 84	130	1	2	98	89	96	0	1	0	0	6	98
EDO. PORTUGUESA	MP. OSPINO	PQ. LA ESTACION	ESCUELA ESTADAL NUMERO 343	424	1	7	313	234	306	0	4	0	0	68	313
EDO. PORTUGUESA	MP. OSPINO	PQ. LA ESTACION	ESCUELA BASICA COSPES	1245	3	24	1011	752	987	0	5	1	0	229	1011
EDO. PORTUGUESA	MP. OSPINO	PQ. LA ESTACION	ESCUELA NACIONAL UNITARIA GUACHE DE GARABOTE	437	1	1	295	276	294	0	2	0	0	16	295
EDO. PORTUGUESA	MP.GENARO BOCONOITO	PQ. ANTOLIN TOVAR AQUINO	ESCUELA ESTADAL CONCENTRADA NUMERO 01	540	1	6	453	371	447	1	2	0	0	73	453
EDO. PORTUGUESA	MP.GENARO BOCONOITO	PQ. ANTOLIN TOVAR AQUINO	ESCUELA ESTADAL CONCENTRADA NUMERO 10	296	1	3	233	180	230	1	3	0	0	46	233
EDO. PORTUGUESA	MP.GENARO BOCONOITO	PQ. ANTOLIN TOVAR AQUINO	ESCUELA NACIONAL CONCENTRADA NUMERO 3872 BARRIALITO	355	1	3	282	253	279	0	3	2	0	21	282
EDO. PORTUGUESA	MP.GENARO BOCONOITO	PQ. ANTOLIN TOVAR AQUINO	ESCUELA ESTADAL CONCENTRADA NUMERO 04	287	1	7	264	242	257	0	0	0	0	15	264
EDO. PORTUGUESA	MP.GENARO BOCONOITO	PQ. ANTOLIN TOVAR AQUINO	ESCUELA NACIONAL CONCENTRADA NUMERO 229 Y 105 ANEXA	781	2	14	650	536	636	0	3	1	0	96	650
EDO. PORTUGUESA	MP.GENARO BOCONOITO	PQ. ANTOLIN TOVAR AQUINO	ESCUELA ESTADAL UNITARIA NUMERO 504	135	1	0	121	119	121	0	0	1	0	1	121
EDO. PORTUGUESA	MP.GENARO BOCONOITO	PQ. ANTOLIN TOVAR AQUINO	ESCUELA  ESTADAL CONCENTRADA NUMERO 02	611	2	16	521	455	505	0	1	0	0	49	521
EDO. PORTUGUESA	MP.GENARO BOCONOITO	PQ. ANTOLIN TOVAR AQUINO	ESCUELA ESTADAL CONCENTRADA NUMERO 69	632	2	8	558	501	550	0	3	0	0	46	558
EDO. PORTUGUESA	MP.GENARO BOCONOITO	PQ. ANTOLIN TOVAR AQUINO	ESCUELA BASICA SAN NICOLAS	1728	3	39	1407	1047	1368	1	6	0	0	314	1407
EDO. PORTUGUESA	MP.GENARO BOCONOITO	PQ. ANTOLIN TOVAR AQUINO	ESCUELA ESTADAL CONCENTRADA NUMERO 40	344	1	14	289	242	275	0	0	1	0	32	289
EDO. PORTUGUESA	MP.GENARO BOCONOITO	PQ. ANTOLIN TOVAR AQUINO	ESCUELA NACIONAL UNITARIA NUMERO 3573	255	1	5	215	188	210	0	1	0	0	21	215
EDO. PORTUGUESA	MP.GENARO BOCONOITO	CM. BOCONOITO	ESCUELA BASICA CARLOS QUINTERO ALEGRIA	2918	5	39	2306	1786	2267	0	17	2	0	462	2306
EDO. PORTUGUESA	MP.GENARO BOCONOITO	CM. BOCONOITO	ESCUELA ESTADAL CONCENTRADA NUMERO 465	207	1	5	180	132	175	0	6	0	0	37	180
EDO. PORTUGUESA	MP.GENARO BOCONOITO	CM. BOCONOITO	ESCUELA CONCENTRADA NACIONAL SIPORORO NUMERO 1629S N ANEXA 83	1093	2	20	903	807	883	0	4	1	0	71	903
EDO. PORTUGUESA	MP.GENARO BOCONOITO	CM. BOCONOITO	ESCUELA ESTADAL CONCENTRADA NUMERO 21	419	1	6	355	285	349	0	2	1	0	61	355
EDO. PORTUGUESA	MP.GENARO BOCONOITO	CM. BOCONOITO	ESCUELA ESTADAL NUMERO 464	1030	2	18	879	662	861	1	6	0	0	192	879
EDO. PORTUGUESA	MP.GENARO BOCONOITO	CM. BOCONOITO	ESCUELA ESTADAL CONCENTRADA NUMERO 3	501	1	5	415	382	410	0	2	0	0	26	415
EDO. PORTUGUESA	MP.GENARO BOCONOITO	CM. BOCONOITO	ESCUELA NACIONAL CONCENTRADA NUMERO 2882 Y ANEXA 85	1708	3	40	1411	1055	1371	0	8	0	0	308	1411
EDO. PORTUGUESA	MP.GENARO BOCONOITO	CM. BOCONOITO	ESCUELA ESTADAL CONCENTRADA NUMERO 24 PUENTE PAEZ	550	1	8	425	379	417	0	3	0	0	35	425
EDO. PORTUGUESA	MP.GENARO BOCONOITO	CM. BOCONOITO	UNIDAD EDUCATIVA NACIONAL BOCONOITO	1940	4	31	1630	1317	1599	0	5	0	1	276	1630
EDO. PORTUGUESA	MP.S RAFAEL DE ONOTO	CM. SAN RAFAEL DE ONOTO	ESCUELA BASICA TRINA DE MORENO	1003	2	14	840	644	826	0	3	0	1	178	840
EDO. PORTUGUESA	MP.S RAFAEL DE ONOTO	CM. SAN RAFAEL DE ONOTO	INSTITUTO DE EDUCACION ESPECIAL  MARIA BELEN DE SIVIRA	678	2	12	591	391	579	0	2	0	0	186	591
EDO. PORTUGUESA	MP.S RAFAEL DE ONOTO	CM. SAN RAFAEL DE ONOTO	ESCUELA ESTADAL EL HIJITO NUMERO 182	462	1	7	388	345	381	0	3	1	0	32	388
EDO. PORTUGUESA	MP.S RAFAEL DE ONOTO	CM. SAN RAFAEL DE ONOTO	ESCUELA NACIONAL CONCENTRADA MANGO MOCHO	1172	2	22	1008	722	986	0	10	0	0	254	1008
EDO. PORTUGUESA	MP.S RAFAEL DE ONOTO	CM. SAN RAFAEL DE ONOTO	ESCUELA ESTADAL CONCENTRADA NUMERO 185 MARINA DE CONTRERAS	546	1	7	485	408	478	0	3	1	0	66	485
EDO. PORTUGUESA	MP.S RAFAEL DE ONOTO	CM. SAN RAFAEL DE ONOTO	UNIDAD EDUCATIVA MENCA DE LEONI	3155	6	80	2518	1596	2438	1	21	0	0	820	2518
EDO. PORTUGUESA	MP.S RAFAEL DE ONOTO	CM. SAN RAFAEL DE ONOTO	ESCUELA BASICA ESTADAL CONCENTRADA PASO COJEDES	178	1	4	149	130	145	0	1	0	0	14	149
EDO. PORTUGUESA	MP.S RAFAEL DE ONOTO	CM. SAN RAFAEL DE ONOTO	CICLO COMBINADO JOSE DE LA CRUZ PAREDES	1218	3	13	1037	618	1024	0	9	1	0	396	1037
EDO. PORTUGUESA	MP.S RAFAEL DE ONOTO	CM. SAN RAFAEL DE ONOTO	ESCUELA ESTADAL CONCENTRADA NUMERO 166 TEJERIAS	1267	3	26	1051	773	1025	0	4	0	1	247	1051
EDO. PORTUGUESA	MP.S RAFAEL DE ONOTO	PQ. SANTA FE	ESCUELA CONCENTRADA SANTA FE	966	2	12	849	652	837	1	1	2	0	181	849
EDO. PORTUGUESA	MP.S RAFAEL DE ONOTO	PQ. THERMO MORLES	ESCUELA NACIONAL CONCENTRADA EL MORRO	357	1	4	296	261	292	0	1	0	0	30	296
EDO. PORTUGUESA	MP.S RAFAEL DE ONOTO	PQ. THERMO MORLES	ESCUELA BASICA ALGARROBITO NUMERO 6	1267	3	22	1000	714	978	0	11	0	0	253	1000
EDO. PORTUGUESA	CE. GUANARE	CM. GUANARE	ESCUELA BASICA ESTADAL GUILLERMO GAMARRA MARRERO	2005	4	47	1687	1094	1640	0	11	1	1	533	1687
EDO. PORTUGUESA	CE. GUANARE	CM. GUANARE	ESCUELA CONCENTRADA NUMERO 44	100	1	2	84	73	82	0	0	0	0	9	84
EDO. PORTUGUESA	CE. GUANARE	CM. GUANARE	CENTRO EDUCATIVO RECREACIONAL  GRISELDA DE LA RIVA	223	1	5	191	143	186	0	0	0	0	43	191
EDO. PORTUGUESA	CE. GUANARE	CM. GUANARE	ESCUELA MULTIGRADO NACIONAL SIN NUMERO	309	1	2	115	88	113	0	0	0	0	25	115
EDO. PORTUGUESA	CE. GUANARE	CM. GUANARE	ESCUELA ESTADAL MULTIGRADO NUMERO 222	218	1	1	151	112	150	0	0	0	0	38	151
EDO. PORTUGUESA	CE. GUANARE	CM. GUANARE	CICLO DIVERCIFICADO CARLOS EMILIO MUÑOZ ORAA	2379	4	31	1982	1131	1951	0	14	0	2	804	1982
EDO. PORTUGUESA	CE. GUANARE	CM. GUANARE	ESCUELA CONCENTRADA MIXTA NUMERO 1810 82
EDO. PORTUGUESA	CE. GUANARE	CM. GUANARE	ESCUELA BASICA ORLANDO GIL CASA DIEGO	3562	7	65	3109	1629	3044	1	15	3	0	1396	3109
EDO. PORTUGUESA	CE. GUANARE	CM. GUANARE	JARDIN DE INFANCIA GUANARE INAN	821	2	17	684	275	667	0	1	0	0	391	684
EDO. PORTUGUESA	CE. GUANARE	CM. GUANARE	ESC. BOLIVARIANA  SOL DE JUSTICIA	592	1	13	517	467	504	3	1	2	0	31	517
EDO. PORTUGUESA	CE. GUANARE	CM. GUANARE	ESCUELA BASICA LIBERTADOR	1435	3	31	1200	987	1169	0	5	1	0	176	1200
EDO. PORTUGUESA	CE. GUANARE	CM. GUANARE	ESCUELA CONCENTRADA MIXTA NUMERO 1808 Y 90	734	2	13	575	455	562	1	2	1	0	103	575
EDO. PORTUGUESA	CE. GUANARE	CM. GUANARE	ESCUELA ESTADAL CONCENTRADA SIN NUMERO OJO DE AGUA LA CAMPIÑA NER NUMERO 34	101	1	3	94	76	91	0	0	0	0	15	94
EDO. PORTUGUESA	CE. GUANARE	CM. GUANARE	BIBLIOTECA PUBLICA DOCTOR ALIRIO UGARTE PELAYO	1489	3	26	1221	534	1195	0	7	1	1	652	1221
EDO. PORTUGUESA	CE. GUANARE	CM. GUANARE	ESCUELA BASICA NACIONAL DOCTOR MELITON VARGAS	2890	5	52	2226	1280	2174	3	17	3	0	871	2226
EDO. PORTUGUESA	CE. GUANARE	CM. GUANARE	ESCUELA BASICA DOCTOR CARLOS RODRIGUEZ ORTIZ	1314	3	30	1149	769	1119	0	8	0	0	342	1149
EDO. PORTUGUESA	CE. GUANARE	CM. GUANARE	ESCUELA BASICA MARIA CONCEPCION PALACIOS	2948	6	42	2469	1608	2427	2	17	2	0	798	2469
EDO. PORTUGUESA	CE. GUANARE	CM. GUANARE	ESCUELA TECNICA INDUSTRIAL GUANARE	1567	3	37	1292	861	1255	1	9	2	1	381	1292
EDO. PORTUGUESA	CE. GUANARE	CM. GUANARE	ESCUELA BASICA MIGUEL ANTONIO VASQUEZ	2984	6	99	2440	2072	2341	1	11	3	1	253	2440
EDO. PORTUGUESA	CE. GUANARE	CM. GUANARE	ESCUELA BASICA LUIS FAJARDO GALENO	1265	3	46	1083	730	1037	0	7	3	0	297	1083
EDO. PORTUGUESA	CE. GUANARE	CM. GUANARE	ESCUELA ESTADAL UNITARIA NUMERO 81	322	1	1	233	215	232	0	2	1	0	14	233
EDO. PORTUGUESA	CE. GUANARE	CM. GUANARE	ESCUELA ESTADAL CONCENTRADA NUMERO 48	544	1	7	439	367	432	0	3	0	0	62	439
EDO. PORTUGUESA	CE. GUANARE	CM. GUANARE	COLEGIO ADVENTISTA ANDRES BELLO	778	2	10	689	281	679	0	8	1	1	388	689
EDO. PORTUGUESA	CE. GUANARE	CM. GUANARE	ESCUELA BASICA NACIONAL CONCENTRADA SIN NUMERO	439	1	8	366	329	358	0	0	0	0	29	366
EDO. PORTUGUESA	CE. GUANARE	CM. GUANARE	COLEGIO PRIVADO NUESTRA SEÑORA DE LOURDES	173	1	1	163	47	162	0	0	0	0	115	163
EDO. PORTUGUESA	CE. GUANARE	CM. GUANARE	ESCUELA BASICA ESTADAL CONCENTRADA NUMERO 543	112	1	0	110	108	110	0	0	1	0	1	110
EDO. PORTUGUESA	CE. GUANARE	CM. GUANARE	ESCUELA BASICA AMADIO MARQUEZ	3834	7	74	3093	2448	3019	0	21	2	0	548	3093
EDO. PORTUGUESA	CE. GUANARE	CM. GUANARE	ESCUELA GENERAL CARLOS SOUBLETTE	555	1	10	500	414	490	0	3	0	0	73	500
EDO. PORTUGUESA	CE. GUANARE	CM. GUANARE	ESCUELA POPULAR CATOLICA FE Y ALEGRIA	1844	4	40	1636	754	1596	0	8	0	0	834	1636
EDO. PORTUGUESA	CE. GUANARE	CM. GUANARE	ESCUELA BASICA VIRGINIA DE RAMOS	2784	5	43	2326	1451	2283	1	11	0	0	820	2326
EDO. PORTUGUESA	CE. GUANARE	CM. GUANARE	ESCUELA CONCENTRADA 19 DE ABRIL	2258	4	39	1797	1422	1758	1	9	1	0	325	1797
EDO. PORTUGUESA	CE. GUANARE	CM. GUANARE	CASA DE SALUD	371	1	14	258	170	244	0	2	0	1	71	258
EDO. PORTUGUESA	CE. GUANARE	CM. GUANARE	CICLO COMBINADO JOSE VICENTE DE UNDA	2380	5	44	1912	826	1868	1	11	1	3	1026	1912
EDO. PORTUGUESA	CE. GUANARE	CM. GUANARE	ESCUELA BASICA SAN RAFAEL NUMERO 467	663	2	10	558	501	548	0	7	0	0	40	558
EDO. PORTUGUESA	CE. GUANARE	CM. GUANARE	CENTRO DE ATENCION AL NIÑO  DOÑA BOLIVIA RIERA DE MARTINEZ	379	1	6	332	266	326	0	2	0	0	58	332
EDO. PORTUGUESA	CE. GUANARE	CM. GUANARE	CENTRO DE BELLAS ARTES AMANDA MUÑOZ	108	1	0	104	45	104	0	0	0	0	59	104
EDO. PORTUGUESA	CE. GUANARE	CM. GUANARE	ESCUELA BASICA JUAN FERNANDEZ DE LEON	3649	7	89	3075	1227	2986	1	30	1	2	1725	3075
EDO. PORTUGUESA	CE. GUANARE	CM. GUANARE	ESCUELA ESTADAL MULTIGRADO NUMERO 55 EL PUENTE	367	1	4	291	262	287	0	0	2	0	23	291
EDO. PORTUGUESA	CE. GUANARE	CM. GUANARE	ESCUELA BASICA GIRALUNA	2498	5	52	2127	691	2075	0	11	0	0	1373	2127
EDO. PORTUGUESA	CE. GUANARE	CM. GUANARE	ESCUELA BASICA ESTADAL HORTENCIA PERAZA	2241	4	45	1712	1105	1667	0	13	0	1	548	1712
EDO. PORTUGUESA	CE. GUANARE	CM. GUANARE	ESCUELA BOLIVARIANA SAN RAFAEL DE LAS GUASDUAS NUMERO 51	375	1	10	312	257	302	0	2	1	0	42	312
EDO. PORTUGUESA	CE. GUANARE	CM. GUANARE	UNIDAD EDUCATIVA PRIVADA COLEGIO CATOLICO SAN JOSE	335	1	9	305	187	296	0	1	1	0	107	305
EDO. PORTUGUESA	CE. GUANARE	CM. GUANARE	FACULTAD DE MEDICINA EXTENCION GUANARE	571	1	22	525	240	503	0	2	1	1	259	525
EDO. PORTUGUESA	CE. GUANARE	CM. GUANARE	ESCUELA BASICA DON SIMON RODRIGUEZ	890	2	25	728	507	703	0	8	1	0	187	728
EDO. PORTUGUESA	CE. GUANARE	CM. GUANARE	CENTRO DE ATENCION INTEGRAL	1706	3	35	1571	836	1536	0	9	1	0	690	1571
EDO. PORTUGUESA	CE. GUANARE	CM. GUANARE	ESCUELA BASICA ARNOLDO JOSE PERAZA	2378	4	59	2016	1550	1957	1	11	3	0	392	2016
EDO. PORTUGUESA	CE. GUANARE	CM. GUANARE	ESCUELA BASICA ESTADAL 530	1237	3	30	1039	809	1009	1	11	1	0	187	1039
EDO. PORTUGUESA	CE. GUANARE	CM. GUANARE	UNIDAD EDUCATIVA CESAR LIZARDO	191	1	5	171	75	166	0	1	0	0	90	171
EDO. PORTUGUESA	CE. GUANARE	CM. GUANARE	ESCUELA BASICA DON ANTONIO TORREALBA	1762	3	28	1468	1082	1440	1	4	0	0	353	1468
EDO. PORTUGUESA	CE. GUANARE	CM. GUANARE	ESCUELA BASICA GILBERTO OROPEZA	1487	3	22	1225	1021	1203	1	8	0	0	173	1225
EDO. PORTUGUESA	CE. GUANARE	CM. GUANARE	ESCUELA BASICA JOSE MARIA VARGAS	2944	6	64	2410	1036	2346	0	20	1	0	1289	2410
EDO. PORTUGUESA	CE. GUANARE	CM. GUANARE	ESCUELA BASICA ESTADAL RAFAEL ROBERTO GAVIDIA	893	2	43	773	538	730	0	5	1	0	186	773
EDO. PORTUGUESA	CE. GUANARE	CM. GUANARE	ESCUELA BASICA NACIONAL DOCTOR MIGUEL ORAA	2292	4	35	1851	1046	1816	2	17	2	0	749	1851
EDO. PORTUGUESA	CE. GUANARE	CM. GUANARE	ESCUELA BASICA CIUDAD DE GUANARE	3318	6	79	2636	1327	2557	3	21	4	2	1200	2636
EDO. PORTUGUESA	CE. GUANARE	CM. GUANARE	JARDIN DE INFANCIA JOSE VICENTE DE UNDA	762	2	20	673	558	653	0	4	1	1	89	673
EDO. PORTUGUESA	CE. GUANARE	CM. GUANARE	PRE ESCOLAR JUAN PABLO SEGUNDO	2398	5	43	2041	1680	1998	0	13	0	0	305	2041
EDO. PORTUGUESA	CE. GUANARE	CM. GUANARE	GRUPO ESCOLAR NACIONAL DIEGO ANTONIO BRICEÑO	3076	6	62	2528	1722	2466	3	18	2	1	720	2528
EDO. PORTUGUESA	CE. GUANARE	CM. GUANARE	CICLO BASICO COMBINADO DOCTOR FELIX SATURNINO ARISA	1535	3	32	1247	759	1215	1	12	1	0	442	1247
EDO. PORTUGUESA	CE. GUANARE	CM. GUANARE	NUCLEO RURAL NUMERO 289 ESCUELA ESTADAL NUMERO 49.	186	1	5	162	143	157	0	2	0	0	12	162
EDO. PORTUGUESA	CE. GUANARE	CM. GUANARE	COLEGIO UNIVERSITARIO FERMIN TORO	2831	5	38	2465	1315	2427	0	19	0	2	1091	2465
EDO. PORTUGUESA	CE. GUANARE	CM. GUANARE	ESCUELA CONCENTRADA MIXTA NUMERO 14	158	1	7	121	83	114	0	0	0	0	31	121
EDO. PORTUGUESA	CE. GUANARE	CM. GUANARE	ESCUELA ANDRES ELOY BLANCO	1397	3	29	1168	739	1139	1	9	1	0	389	1168
EDO. PORTUGUESA	CE. GUANARE	CM. GUANARE	ESCUELA BASICA ANA DE ZAMBRANO ROA	1402	3	20	1245	579	1225	1	8	0	1	636	1245
EDO. PORTUGUESA	CE. GUANARE	CM. GUANARE	ESCUELA BASICA UNITARIA NUMERO 56	77	1	0	62	59	62	0	0	1	0	2	62
EDO. PORTUGUESA	CE. GUANARE	CM. GUANARE	PRE ESCOLAR LOS LLANERITOS	442	1	11	397	242	386	0	0	1	0	143	397
EDO. PORTUGUESA	CE. GUANARE	CM. GUANARE	ESCUELA ESTADAL CONCENTRADA NUMERO 76 BUENA VISTA EL COCO
EDO. PORTUGUESA	CE. GUANARE	CM. GUANARE	JARDIN DE INFANCIA	934	2	18	865	463	847	0	10	1	0	373	865
EDO. PORTUGUESA	CE. GUANARE	CM. GUANARE	ESCUELA BASICA CONCENTRADA SIN NUMERO 5 DE JULIO	193	1	6	181	158	175	0	3	1	0	13	181
EDO. PORTUGUESA	CE. GUANARE	CM. GUANARE	ESCUELA ESTADAL BASICA NICOMEDES CASTILLO	1703	3	33	1393	859	1360	2	8	2	0	489	1393
EDO. PORTUGUESA	CE. GUANARE	CM. GUANARE	ESCUELA ESTADAL CONCENTRADA BASICA NUMERO 33	1146	2	15	908	706	893	0	4	0	0	183	908
EDO. PORTUGUESA	CE. GUANARE	CM. GUANARE	ESCUELA ESTADAL CONCENTRADA NUMERO 9	295	1	6	201	162	195	2	2	0	0	29	201
EDO. PORTUGUESA	CE. GUANARE	CM. GUANARE	ESCUELA GRADUADA BASICA TIERRA BUENA	996	2	16	851	747	835	2	2	0	0	84	851
EDO. PORTUGUESA	CE. GUANARE	CM. GUANARE	JARDIN DE INFANCIA LOS CACHORRITOS	1383	3	20	1199	865	1179	2	13	0	1	298	1199
EDO. PORTUGUESA	CE. GUANARE	CM. GUANARE	LICEO LA COMUNIDAD NUEVA	2354	4	44	2046	992	2002	0	11	0	0	999	2046
EDO. PORTUGUESA	CE. GUANARE	CM. GUANARE	INTERNADO JUDICIAL	373	1	1	131	118	130	0	0	0	0	12	131
EDO. PORTUGUESA	CE. GUANARE	CM. GUANARE	PRE ESCOLAR MATILDE DE PIERLUISSI	954	2	16	857	331	841	0	3	0	1	506	857
EDO. PORTUGUESA	CE. GUANARE	CM. GUANARE	CENTRO MATERNAL BLANCA R. PEREZ	880	2	12	816	225	804	0	2	0	2	575	816
EDO. PORTUGUESA	CE. GUANARE	CM. GUANARE	ESCUELA CONCENTRADA MIXTA NUMERO 53
EDO. PORTUGUESA	CE. GUANARE	CM. GUANARE	ESCUELA BASICA PROFESORA CELINDA ADAMS	1221	3	25	1016	772	991	1	3	1	0	214	1016
EDO. PORTUGUESA	CE. GUANARE	CM. GUANARE	ESCUELA ESTADAL CONCENTRADA NUMERO 15 NUCLEO ESCOLAR RURAL NUMERO 289	154	1	6	123	104	117	0	0	0	0	13	123
EDO. PORTUGUESA	CE. GUANARE	CM. GUANARE	ESCUELA BASICA CONCENTRADA JOSE FELIX RIVAS	310	1	3	268	231	265	0	0	0	0	34	268
EDO. PORTUGUESA	CE. GUANARE	CM. GUANARE	UNIDAD EDUCATIVA JOSE DE LOS SANTOS URRIOLA	409	1	6	334	263	328	0	3	0	0	62	334
EDO. PORTUGUESA	CE. GUANARE	CM. GUANARE	ESCUELA ESTADAL GRADUADA NUMERO 16 LA CURVA TERESA DE LA PARRA	762	2	15	602	539	587	0	3	0	0	45	602
EDO. PORTUGUESA	CE. GUANARE	CM. GUANARE	ESCUELA BASICA TRADICIONAL NUMERO 469 ANTONIO JOSE DE SUCRE	814	2	31	676	510	645	0	7	0	0	128	676
EDO. PORTUGUESA	CE. GUANARE	PQ. CORDOBA	ESCUELA BASICA CORDOBA
EDO. PORTUGUESA	CE. GUANARE	PQ. CORDOBA	ESCUELA NACIONAL UNITARIA NUMERO 118 ANEXA CON MIXTA NUMERO 73	300	1	3	236	211	233	0	1	0	0	21	236
EDO. PORTUGUESA	CE. GUANARE	PQ. CORDOBA	ESCUELA ESTADAL CONCENTRADA NUMERO 78
EDO. PORTUGUESA	CE. GUANARE	PQ. CORDOBA	ESCUELA ESTADAL CONCENTRADA NUMERO 79
EDO. PORTUGUESA	CE. GUANARE	PQ. CORDOBA	ESCUELA NACIONAL UNITARIA NUMERO 211
EDO. PORTUGUESA	CE. GUANARE	PQ. CORDOBA	ESCUELA ESTADAL UNITARIA NUMERO 260	87	1	1	56	51	55	0	1	0	0	3	56
EDO. PORTUGUESA	CE. GUANARE	PQ. VIRGEN DE LA COROMOTO	UNIDAD EDUCATIVA NACIONAL TUCUPIDO	1508	3	45	1263	940	1218	0	6	0	1	271	1263
EDO. PORTUGUESA	CE. GUANARE	PQ. VIRGEN DE LA COROMOTO	ESCUELA ESTADAL CONCENTRADA NUMERO 23	296	1	9	238	185	229	0	1	0	0	43	238
EDO. PORTUGUESA	CE. GUANARE	PQ. VIRGEN DE LA COROMOTO	ESCUELA ESTADAL UNITARIA NUMERO 529 NER 30
EDO. PORTUGUESA	CE. GUANARE	PQ. VIRGEN DE LA COROMOTO	ESCUELA ESTATAL CONCENTRADA  546 LOS HIERROS	157	1	4	144	109	140	0	1	0	0	30	144
EDO. PORTUGUESA	CE. GUANARE	PQ. VIRGEN DE LA COROMOTO	E.T.C QUEBRADA DE LA VIRGEN	2236	4	60	1748	1307	1688	1	16	2	0	362	1748
EDO. PORTUGUESA	CE. GUANARE	PQ. VIRGEN DE LA COROMOTO	ESCUELA ESTADAL NUMERO 07 Y ANEXA NACIONAL	470	1	4	403	296	399	0	2	0	0	101	403
EDO. PORTUGUESA	CE. GUANARE	PQ. VIRGEN DE LA COROMOTO	ESCUELA ESTADAL CONCENTRADA NUMERO 11 NUCLEO 30	326	1	8	277	177	269	0	6	0	0	86	277
EDO. PORTUGUESA	CE. GUANARE	PQ. VIRGEN DE LA COROMOTO	ESCUELA ESTADAL CONCENTRADA NUMERO 12 Y ANEXA NACIONAL	806	2	32	685	561	653	0	4	3	0	85	685
EDO. PORTUGUESA	CE. GUANARE	PQ. VIRGEN DE LA COROMOTO	ESCUELA ESTADAL UNITARIA NUMERO 64	324	1	4	292	270	288	0	0	0	0	18	292
EDO. PORTUGUESA	CE. GUANARE	PQ. VIRGEN DE LA COROMOTO	ESCUELA BOLIVARIANA NEGRO PRIMERO NER 030	206	1	2	190	160	188	0	3	0	0	25	190
EDO. PORTUGUESA	CE. GUANARE	PQ.SAN JOSE DE LA MONTA#A	ESCUELA ESTADAL CONCENTRADA NUMERO 208	371	1	4	237	182	233	0	1	0	0	50	237
EDO. PORTUGUESA	CE. GUANARE	PQ.SAN JOSE DE LA MONTA#A	ESCUELA BASICA NUMERO 216 NUCLEO RURAL NUMERO 223
EDO. PORTUGUESA	CE. GUANARE	PQ.SAN JOSE DE LA MONTA#A	ESCUELA ESTADAL CONCENTRADA NUMERO 205
EDO. PORTUGUESA	CE. GUANARE	PQ.SAN JUAN GUANAGUANARE	ESCUELA BASICA ESTADAL CONCENTRADA LAS PLAYITAS NUMERO 5NER 11	213	1	3	189	185	186	0	0	0	0	1	189
EDO. PORTUGUESA	CE. GUANARE	PQ.SAN JUAN GUANAGUANARE	ESCUELA BASICA 3 DE NOVIEMBRE	2540	5	46	2096	1354	2050	2	15	4	2	673	2096
EDO. PORTUGUESA	CE. GUANARE	PQ.SAN JUAN GUANAGUANARE	ESCUELA ESTADAL NUMERO 10 Y ANEXA NACIONAL	644	2	9	512	408	503	1	1	3	0	90	512
EDO. PORTUGUESA	CE. GUANARE	PQ.SAN JUAN GUANAGUANARE	ESCUELA ESTADAL CONCENTRADA LOLA DE PACHECO	238	1	6	213	153	207	0	2	0	0	52	213
EDO. PORTUGUESA	CE. GUANARE	PQ.SAN JUAN GUANAGUANARE	CENTRO CULTURAL DON ANTONIO TORREALBA MESA DE CAVACA	264	1	3	236	171	233	0	0	0	0	62	236
EDO. PORTUGUESA	CE. GUANARE	PQ.SAN JUAN GUANAGUANARE	UNIDAD EDUCATIVA NACIONAL SAN JUAN DE GUANAGUANARE	1491	3	15	1290	832	1275	0	10	2	1	430	1290
EDO. PORTUGUESA	CE. GUANARE	PQ.SAN JUAN GUANAGUANARE	ESCUELA BASICA CONCENTRADA NUMERO 490	337	1	9	298	237	289	0	3	0	0	49	298
EDO. PORTUGUESA	CE. GUANARE	PQ.SAN JUAN GUANAGUANARE	UNIDAD CONCENTRADA NUMERO 277	267	1	2	207	188	205	0	2	2	0	13	207
EDO. PORTUGUESA	CE. GUANARE	PQ.SAN JUAN GUANAGUANARE	ESCUELA BASICA ESTADAL SIMON BOLIVAR	1231	3	26	969	672	943	0	11	0	0	260	969
EDO. PORTUGUESA	CE. GUANARE	PQ.SAN JUAN GUANAGUANARE	ESCUELA BASICA CONCENTRADA NUMERO 42	177	1	6	152	129	146	0	1	0	0	16	152
EDO. PORTUGUESA	CE. GUANARE	PQ.SAN JUAN GUANAGUANARE	ESCUELA UNITARIA SIN NUMERO EL BUEY	258	1	13	207	169	194	0	0	0	0	25	207
EDO. PORTUGUESA	CE. GUANARE	PQ.SAN JUAN GUANAGUANARE	ESCUELA ESTADAL CONCENTRADA NUMERO 47	510	1	11	445	279	434	0	2	0	0	153	445
EDO. PORTUGUESA	CE. GUANARE	PQ.SAN JUAN GUANAGUANARE	ESCUELA GRANJA OSCAR VILLANUEVA ANEXA NUMERO 390	1160	2	13	958	497	945	0	4	0	0	444	958
EDO. PORTUGUESA	MP. ESTELLER	PQ. UVERAL	ESCUELA UNITARIA 405
EDO. PORTUGUESA	MP. ESTELLER	PQ. UVERAL	ESCUELA CONCENTRADA 382	378	1	3	303	246	300	3	5	0	0	46	303
EDO. PORTUGUESA	MP. ESTELLER	PQ. UVERAL	ESCUELA UNITARIA NUMERO 398	166	1	3	135	122	132	0	0	0	0	10	135
EDO. PORTUGUESA	MP. ESTELLER	PQ. UVERAL	CICLO BASICO UVERAL	1021	2	21	768	616	747	1	9	4	0	117	768
EDO. PORTUGUESA	MP. ESTELLER	PQ. UVERAL	ESCUELA ESTADAL CONCENTRADA NUMERO 370	190	1	3	161	115	158	0	3	0	0	40	161
EDO. PORTUGUESA	MP. ESTELLER	PQ. UVERAL	ESCUELA ESTADAL 1912 402	606	2	13	490	406	477	0	1	1	0	69	490
EDO. PORTUGUESA	MP. ESTELLER	PQ. UVERAL	ESCUELA ESTADAL CONCENTRADA NUMERO 381 MANTECAL	434	1	9	355	325	346	0	2	0	0	19	355
EDO. PORTUGUESA	MP. ESTELLER	PQ. UVERAL	ESCUELA ESTADAL CONCENTRADA NUMERO 383 SAN JORGE	185	1	1	170	169	169	0	0	0	0	0	170
EDO. PORTUGUESA	MP. ESTELLER	PQ. UVERAL	ESCUELA BASICA ESTADAL CONCENTRADA NUMERO 401	183	1	3	169	145	166	0	1	0	0	20	169
EDO. PORTUGUESA	MP. ESTELLER	PQ. UVERAL	ESCUELA CONCENTRADA NUMERO 1890	246	1	3	210	181	207	0	0	0	1	25	210
EDO. PORTUGUESA	MP. ESTELLER	PQ. UVERAL	ESCUELA ESTADAL UNITARIA 404	100	1	2	92	78	90	0	0	0	0	12	92
EDO. PORTUGUESA	MP. ESTELLER	PQ. UVERAL	ESCUELA BASICA PAUJICITO	465	1	5	371	283	366	0	5	1	0	77	371
EDO. PORTUGUESA	MP. ESTELLER	PQ. UVERAL	ESCUELA ESTADAL UNITARIA NUMERO 389	255	1	3	171	142	168	0	2	0	0	24	171
EDO. PORTUGUESA	MP. ESTELLER	PQ. UVERAL	ESCUELA ESTADAL CONCENTRADA EL PAJON NUMERO 388	265	1	4	217	177	213	0	1	0	0	35	217
EDO. PORTUGUESA	MP. ESTELLER	CM. PIRITU	ESCUELA ESTADAL UNITARIA NUMERO 489	336	1	5	294	272	289	0	1	0	0	16	294
EDO. PORTUGUESA	MP. ESTELLER	CM. PIRITU	ESCUELA ESTADAL CONCENTRADA NUMERO 395 LA PAVA	233	1	0	209	197	209	0	1	0	0	11	209
EDO. PORTUGUESA	MP. ESTELLER	CM. PIRITU	ESCUELA  ESTADAL CONCENTRADA  NUMERO 394	244	1	2	202	183	200	0	1	1	0	15	202
EDO. PORTUGUESA	MP. ESTELLER	CM. PIRITU	ESCUELA BASICA NACIONAL CONCENTRADA NUMERO 1892	218	1	0	192	183	192	0	0	0	0	9	192
EDO. PORTUGUESA	MP. ESTELLER	CM. PIRITU	ESCUELA ESTADAL UNITARIA NUMERO 393 EL DANTO	224	1	2	173	148	171	0	1	0	1	21	173
EDO. PORTUGUESA	MP. ESTELLER	CM. PIRITU	ESCUELA BASICA JESUS ALVARADO NUÑEZ	2396	5	33	1885	1232	1852	1	5	1	0	613	1885
EDO. PORTUGUESA	MP. ESTELLER	CM. PIRITU	CENTRO DE EDUCACION INICIAL LAS GUAFITAS	257	1	3	232	208	229	0	0	0	0	21	232
EDO. PORTUGUESA	MP. ESTELLER	CM. PIRITU	ESCUELA NACIONAL CONCENTRADA MIXTA NUMERO 2360	352	1	2	277	254	275	0	1	0	0	20	277
EDO. PORTUGUESA	MP. ESTELLER	CM. PIRITU	ESCUELA ESTADAL NUMERO 374	236	1	2	198	166	196	0	1	2	0	27	198
EDO. PORTUGUESA	MP. ESTELLER	CM. PIRITU	ESCUELA BASICA  ANTONIO RODRIGUEZ PICON	2637	5	55	2038	1434	1983	2	21	1	0	525	2038
EDO. PORTUGUESA	MP. ESTELLER	CM. PIRITU	ESCUELA ESTADAL CONCENTRADA NUMERO 371	338	1	7	295	240	288	0	1	0	0	47	295
EDO. PORTUGUESA	MP. ESTELLER	CM. PIRITU	ESCUELA ESTADAL CONCENTRADA NUMERO 375	333	1	10	273	229	263	2	2	1	0	29	273
EDO. PORTUGUESA	MP. ESTELLER	CM. PIRITU	ESCUELA ESTADAL CONCENTRADA NUMERO 377	346	1	1	303	295	302	1	0	0	0	6	303
EDO. PORTUGUESA	MP. ESTELLER	CM. PIRITU	ESCUELA BASICA LA GUTIERREÑA	449	1	10	378	305	368	0	7	2	0	54	378
EDO. PORTUGUESA	MP. ESTELLER	CM. PIRITU	ESCUELA ESTADAL UNITARIA NUMERO175	113	1	1	111	101	110	0	0	0	0	9	111
EDO. PORTUGUESA	MP. ESTELLER	CM. PIRITU	ESCUELA  ESTADAL CONCENTRADA  NUMERO 386	558	1	15	451	361	436	1	5	0	0	69	451
EDO. PORTUGUESA	MP. ESTELLER	CM. PIRITU	PARQUE DE RECREACION DIRIGIDA	1533	3	34	1338	765	1304	0	9	2	0	528	1338
EDO. PORTUGUESA	MP. ESTELLER	CM. PIRITU	ESCUELA ESTADAL CONCENTRADA NUMERO 2938	203	1	1	183	172	182	0	1	1	0	8	183
EDO. PORTUGUESA	MP. ESTELLER	CM. PIRITU	ESCUELA CONCENTRADA MIXTA NUMERO 384	462	1	4	388	340	384	0	0	0	1	43	388
EDO. PORTUGUESA	MP. ESTELLER	CM. PIRITU	UNIDAD CONCENTRADA JUAN ZABARCE	1586	3	22	1346	1062	1324	0	8	1	1	252	1346
EDO. PORTUGUESA	MP. ESTELLER	CM. PIRITU	ESCUELA BASICA PIRITU	2769	5	45	2317	1821	2272	1	13	0	2	435	2317
EDO. PORTUGUESA	MP. ESTELLER	CM. PIRITU	ESCUELA BASICA LOS CORRALES	807	2	3	641	576	638	0	3	2	0	57	641
EDO. PORTUGUESA	MP. ESTELLER	CM. PIRITU	ESCUELA BASICA MATIAS SALAZAR	1539	3	30	1313	1117	1283	1	6	0	0	159	1313
EDO. PORTUGUESA	MP. ESTELLER	CM. PIRITU	ESCUELA NACIONAL CONCENTRADA NUMERO 2935	429	1	7	325	286	318	0	2	1	0	29	325
EDO. PORTUGUESA	MP. ESTELLER	CM. PIRITU	ESCUELA ESTADAL UNITARIA LAS TRINCHERAS	410	1	7	332	273	325	0	2	0	0	50	332
EDO. PORTUGUESA	MP. ESTELLER	CM. PIRITU	INSTITUTO COMERCIAL PADRE ESTELLER	1356	3	41	1142	697	1101	0	14	1	0	389	1142
EDO. PORTUGUESA	MP. ESTELLER	CM. PIRITU	ESCUELA BASICA NACIONAL BANCO DEL PUEBLO	501	1	15	428	348	413	0	4	0	0	61	428
EDO. PORTUGUESA	MP. ESTELLER	CM. PIRITU	ESCUELA ESTADAL CONCENTRADA NUMERO 380	301	1	5	254	215	249	0	3	0	0	31	254
EDO. PORTUGUESA	MP. ESTELLER	CM. PIRITU	CICLO COMBINADO PABLO HERRERA CAMPINS	2917	5	70	2400	1481	2330	1	23	0	1	824	2400
EDO. PORTUGUESA	MP. ESTELLER	CM. PIRITU	ESCUELA ESTADAL CONCENTRADA NUMERO 385	271	1	3	239	209	236	0	3	0	0	24	239
EDO. PORTUGUESA	MP. SANTA ROSALIA	PQ. FLORIDA	ESCUELA BASICA NUEVA FLORIDA NUMERO 419
EDO. PORTUGUESA	MP. SANTA ROSALIA	PQ. FLORIDA	ESCUELA BASICA TUREN	1413	3	19	1088	888	1069	1	9	0	0	171	1088
EDO. PORTUGUESA	MP. SANTA ROSALIA	PQ. FLORIDA	ESCUELA BASICA ESTADAL CONCENTRADA NUMERO 162 LA REDOMA
EDO. PORTUGUESA	MP. SANTA ROSALIA	PQ. FLORIDA	ESCUELA UNITARIA EL TORO
EDO. PORTUGUESA	MP. SANTA ROSALIA	PQ. FLORIDA	ESCUELA BASICA ESTADAL UNITARIA LA 23
EDO. PORTUGUESA	MP. SANTA ROSALIA	CM. EL PLAYON	UNIDAD EDUCATIVA NACIONAL EL PLAYON	1007	2	13	858	621	845	1	6	0	0	217	858
EDO. PORTUGUESA	MP. SANTA ROSALIA	CM. EL PLAYON	ESCUELA BOLIVARIANA PUNTO FIJO
EDO. PORTUGUESA	MP. SANTA ROSALIA	CM. EL PLAYON	ESCUELA BASICA EL PLAYON	2249	4	36	1705	1196	1669	3	11	0	0	459	1705
EDO. PORTUGUESA	MP. SANTA ROSALIA	CM. EL PLAYON	ESCUELA BOLIVARIANA BARRIO UNIDO NUMERO 418	191	1	2	152	128	150	0	0	0	0	22	152
EDO. PORTUGUESA	MP. SANTA ROSALIA	CM. EL PLAYON	ESCUELA  BOLIVARIANA SAN PABLO	717	2	1	623	554	622	0	1	0	0	67	623
EDO. PORTUGUESA	MP. SANTA ROSALIA	CM. EL PLAYON	ESCUELA CONCENTRADA BOLIVARIANA POBLADO I
EDO. PORTUGUESA	MP. SANTA ROSALIA	CM. EL PLAYON	ESCUELA BASICA RAYITO DE LUZ	529	1	10	459	338	449	0	1	0	0	110	459
EDO. PORTUGUESA	MP. SANTA ROSALIA	CM. EL PLAYON	ESCUELA BOLIVARIANA LA FELICIDAD	283	1	4	260	248	256	0	1	0	0	7	260
EDO. PORTUGUESA	MP. SANTA ROSALIA	CM. EL PLAYON	ESCUELA BOLIVARIANA POBLADO II
EDO. PORTUGUESA	MP. SANTA ROSALIA	CM. EL PLAYON	ESCUELA BOLIVARIANA  MICRO SUR III	193	1	1	158	144	157	0	0	0	0	13	158
EDO. PORTUGUESA	MP. SANTA ROSALIA	CM. EL PLAYON	ESCUELA ESTADAL CONCENTRADA NUMERO 416 COGOTE
EDO. PORTUGUESA	MP. SANTA ROSALIA	CM. EL PLAYON	ESCUELA BASICA ESTADAL  NUMERO 417 EL GATEADO	965	2	11	777	664	766	0	2	1	0	99	777
EDO. PORTUGUESA	MP. SANTA ROSALIA	CM. EL PLAYON	ESCUELA CONCENTRADA NACIONAL MICRO SUR II	475	1	5	412	381	407	0	1	1	0	24	412
EDO. PORTUGUESA	MP. SANTA ROSALIA	CM. EL PLAYON	ESCUELA BOLIVARIANA NER 31	128	1	1	114	79	113	0	0	0	0	34	114
EDO. PORTUGUESA	MP. SANTA ROSALIA	CM. EL PLAYON	ESCUELA ESTADAL BOLIVARIANA NUMERO 429 COROZAL	182	1	9	154	106	145	0	3	0	0	36	154
EDO. PORTUGUESA	MP. TUREN	PQ. SAN ISIDRO LABRADOR	ESCUELA BASICA CHINGALI NUCLEO ESCOLAR RURAL 23	140	1	2	122	104	120	0	3	0	0	13	122
EDO. PORTUGUESA	MP. TUREN	PQ. SAN ISIDRO LABRADOR	ESCUELA BOLIVARIANA EL PALMAR	827	2	7	605	552	598	0	2	0	1	43	605
EDO. PORTUGUESA	MP. TUREN	PQ. SAN ISIDRO LABRADOR	ESCUELA ESTADAL CONCENTRADA LA ROGEÑA	231	1	0	201	189	201	0	1	2	0	9	201
EDO. PORTUGUESA	MP. TUREN	PQ. SAN ISIDRO LABRADOR	ESCUELA BOLIVARIANA MARIA ISABEL COLMENAREZ	1174	2	11	878	643	867	0	5	0	0	219	878
EDO. PORTUGUESA	MP. TUREN	PQ. SAN ISIDRO LABRADOR	ESCUELA TECNICA AGROPECUARIA LA COLONIA	1160	2	11	962	492	951	0	6	0	1	452	962
EDO. PORTUGUESA	MP. TUREN	PQ. SAN ISIDRO LABRADOR	ESCUELA BOLIVARIANA MICRO ESTE	203	1	4	180	163	176	0	1	0	0	12	180
EDO. PORTUGUESA	MP. TUREN	CM. VILLA BRUZUAL	ESCUELA BOLIVARIANA CIUDAD DE MERIDA	3354	6	53	2586	1652	2533	1	20	5	1	854	2586
EDO. PORTUGUESA	MP. TUREN	CM. VILLA BRUZUAL	ESCUELA BOLIVARIANA CANOITA NUMERO 1781	445	1	6	365	331	359	0	3	1	0	24	365
EDO. PORTUGUESA	MP. TUREN	CM. VILLA BRUZUAL	UNIDAD EDUCATIVA COLEGIO JOSE ANTONIO PAEZ	1084	2	15	923	539	908	0	6	0	0	363	923
EDO. PORTUGUESA	MP. TUREN	CM. VILLA BRUZUAL	CENTRO DE CAPACITACION EN ARTES Y OFICIO AMALIA MORANDI	1244	3	26	1095	626	1069	1	12	0	0	430	1095
EDO. PORTUGUESA	MP. TUREN	CM. VILLA BRUZUAL	ESCUELA BOLIVARIANA TUREN	1101	2	11	943	569	932	0	6	0	1	356	943
EDO. PORTUGUESA	MP. TUREN	CM. VILLA BRUZUAL	ESCUELA BOLIVARIANA PARICUA	562	1	8	457	399	449	0	2	2	0	46	457
EDO. PORTUGUESA	MP. TUREN	CM. VILLA BRUZUAL	ESCUELA BOLIVARIANA JOSE BENIGNO DORANTE	952	2	16	793	653	777	0	8	0	0	116	793
EDO. PORTUGUESA	MP. TUREN	CM. VILLA BRUZUAL	JARDIN DE INFANCIA ARCOIRIS	311	1	9	244	159	235	0	4	0	0	72	244
EDO. PORTUGUESA	MP. TUREN	CM. VILLA BRUZUAL	ESCUELA BOLIVARIANA LAS CARAMAS NUMERO 422	534	1	6	410	368	404	0	1	0	0	35	410
EDO. PORTUGUESA	MP. TUREN	CM. VILLA BRUZUAL	UNIDAD EDUCATIVA NACIONAL 27 DE JUNIO	2078	4	26	1792	1092	1766	0	8	1	1	664	1792
EDO. PORTUGUESA	MP. TUREN	CM. VILLA BRUZUAL	ESCUELA BASICA BOLIVARIANA ROMULO GALLEGOS	1605	3	32	1334	1134	1302	0	6	0	0	162	1334
EDO. PORTUGUESA	MP. TUREN	CM. VILLA BRUZUAL	ESCUELA BASICA TIBERIO GRATEROL	2318	4	29	1870	1540	1841	0	8	2	0	291	1870
EDO. PORTUGUESA	MP. TUREN	CM. VILLA BRUZUAL	ESCUELA NACIONAL BOLIVARIANA LA VEGA QUINTEREÑA	83	1	3	76	59	73	0	2	0	1	11	76
EDO. PORTUGUESA	MP. TUREN	CM. VILLA BRUZUAL	ESCUELA BASICA PATIO GRANDE	1495	3	18	1272	873	1254	0	7	0	0	374	1272
EDO. PORTUGUESA	MP. TUREN	CM. VILLA BRUZUAL	ESCUELA BASICA ESTADAL  NUMERO 409 TUREN VIEJO
EDO. PORTUGUESA	MP. TUREN	CM. VILLA BRUZUAL	INSTITUTO DE EDUCACION ESPECIAL BOLIVARIANO TUREN	1577	3	24	1167	766	1143	0	15	1	0	361	1167
EDO. PORTUGUESA	MP. TUREN	CM. VILLA BRUZUAL	JARDIN DE INFANCIA VILLA BRUZUAL	570	1	5	444	344	439	0	2	0	0	93	444
EDO. PORTUGUESA	MP. TUREN	CM. VILLA BRUZUAL	ESCUELA ESTADAL CONCENTRADA BASICA ASEQUIONCITO 415	132	1	1	121	115	120	0	0	0	0	5	121
EDO. PORTUGUESA	MP. TUREN	CM. VILLA BRUZUAL	ESCUELA BASICA CONCENTRADA NUMERO 410	567	1	5	463	416	458	0	3	0	0	39	463
EDO. PORTUGUESA	MP. TUREN	CM. VILLA BRUZUAL	CICLO BASICO TUREN	2368	5	40	1948	1316	1908	2	13	1	0	576	1948
EDO. PORTUGUESA	MP. TUREN	CM. VILLA BRUZUAL	ESCUELA BASICA ESTADAL NUMERO 435 LA ADUANA	464	1	9	404	317	395	0	5	0	0	73	404
EDO. PORTUGUESA	MP. TUREN	CM. VILLA BRUZUAL	ESCUELA BOLIVARIANA DOCTOR ANGEL RIVAS BALDWIN	2408	5	27	1813	1230	1786	1	13	0	1	541	1813
EDO. PORTUGUESA	MP. TUREN	CM. VILLA BRUZUAL	ESCUELA BASICA CARLOS GAUNA	627	2	12	553	390	541	0	3	0	0	148	553
EDO. PORTUGUESA	MP. TUREN	CM. VILLA BRUZUAL	ESCUELA BOLIVARIANA EL JOBAL	373	1	4	280	186	276	0	0	0	1	89	280
EDO. PORTUGUESA	MP. TUREN	CM. VILLA BRUZUAL	CENTRO EDUCACION INICIAL SIMONCITO CIUDAD DE MERIDA	832	2	13	712	501	699	0	2	0	0	196	712
EDO. PORTUGUESA	MP. TUREN	CM. VILLA BRUZUAL	UNIDAD EDUCATIVA EL ASEQUION	436	1	4	341	311	337	0	1	0	2	23	341
EDO. PORTUGUESA	MP. TUREN	CM. VILLA BRUZUAL	UNIDAD EDUCATIVA INSTITUTO ANDRES BELLO	1563	3	20	1338	621	1318	0	7	0	0	690	1338
EDO. PORTUGUESA	MP. TUREN	PQ. CANELONES	ESCUELA BOLIVARIANA LA CEIBA	704	2	13	603	461	590	0	2	0	0	127	603
EDO. PORTUGUESA	MP. TUREN	PQ. CANELONES	ESCUELA BASICA LA MISION	2927	5	41	2400	2040	2359	1	13	1	0	304	2400
EDO. PORTUGUESA	MP. TUREN	PQ. CANELONES	UNIDAD EDUCATIVA ESTADAL ANTONIO JOSE DE SUCRE	868	2	23	729	550	706	0	4	4	0	148	729
EDO. PORTUGUESA	MP. TUREN	PQ. CANELONES	ESCUELA BASICA ESTADAL NUMERO 514	120	1	1	114	107	113	0	2	0	0	4	114
EDO. PORTUGUESA	MP. TUREN	PQ. CANELONES	ESCUELA ESTADAL CONCENTRADA NUMERO 146	392	1	2	334	296	332	0	1	0	0	35	334
EDO. PORTUGUESA	MP. TUREN	PQ. CANELONES	ESCUELA ESTADAL NUMERO 145	176	1	4	163	151	159	0	0	0	0	8	163
EDO. PORTUGUESA	MP. TUREN	PQ. CANELONES	ESCUELA BASICA ESTADAL NUMERO 411	481	1	13	430	337	417	0	4	0	0	76	430
EDO. PORTUGUESA	MP. TUREN	PQ. SANTA CRUZ	ESCUELA BASICA ESTADAL CONCENTRADA NUMERO 496 LOS CABALLOS	130	1	0	107	86	107	0	1	1	0	19	107
EDO. PORTUGUESA	MP. TUREN	PQ. SANTA CRUZ	ESCUELA ESTADAL CONCENTRADA SANTA ROSA NUMERO 420	505	1	7	391	353	384	0	1	1	0	29	391
EDO. PORTUGUESA	MP. TUREN	PQ. SANTA CRUZ	ESCUELA BOLIVARIANA LA REFORMA	297	1	2	228	186	226	0	4	1	0	35	228
EDO. PORTUGUESA	MP. TUREN	PQ. SANTA CRUZ	ESCUELA BASICA CONCENTRADA MERECURE	192	1	4	142	120	138	0	1	0	0	17	142
EDO. PORTUGUESA	MP. TUREN	PQ. SANTA CRUZ	ESCUELA BASICA ESTADAL ALIDA AGUILERA DE NOGUERA	2001	4	45	1510	1194	1465	2	12	5	1	251	1510
EDO. PORTUGUESA	MP. TUREN	PQ. SANTA CRUZ	ESCUELA ESTADAL CONCENTRADA NUMERO 141	226	1	11	184	161	173	0	0	2	0	10	184
EDO. PORTUGUESA	MP. PAPELON	CM. PAPELON	ESCUELA ESTADAL BASICA CONCENTRADA NUMERO 26	874	2	9	712	425	703	0	5	0	0	273	712
EDO. PORTUGUESA	MP. PAPELON	CM. PAPELON	ESCUELA BASICA CIUDAD DE SAN FELIPE	1713	3	35	1375	643	1340	1	9	1	0	686	1375
EDO. PORTUGUESA	MP. PAPELON	CM. PAPELON	ESCUELA CONCENTRADA NUMERO 497	428	1	11	328	244	317	0	2	1	0	70	328
EDO. PORTUGUESA	MP. PAPELON	CM. PAPELON	UNIDAD EDUCATIVA LUIS ANTONIO CASTILLO	1527	3	28	1272	646	1244	1	5	1	0	591	1272
EDO. PORTUGUESA	MP. PAPELON	CM. PAPELON	ESCUELA ESTADAL UNITARIA NUMERO 70
EDO. PORTUGUESA	MP. PAPELON	PQ. CA#O DELGADITO	ESCUELA BASICA CONCENTRADA NUMERO 20	644	2	5	522	420	517	2	3	0	0	92	522
EDO. PORTUGUESA	MP. PAPELON	PQ. CA#O DELGADITO	ESCUELA MIXTA COROZAL NUMERO 30 40	249	1	1	210	189	209	0	0	3	1	16	210
EDO. PORTUGUESA	MP. PAPELON	PQ. CA#O DELGADITO	ESCUELA ESTADAL CONCENTRADA NUMERO 17
EDO. PORTUGUESA	MP. PAPELON	PQ. CA#O DELGADITO	ESCUELA ESTADAL CONCENTRADA NUMERO 30	361	1	4	277	180	273	0	0	1	0	92	277
EDO. PORTUGUESA	MP. PAPELON	PQ. CA#O DELGADITO	ESCUELA BASICA CONCENTRADA NUMERO 119
EDO. PORTUGUESA	MP. PAPELON	PQ. CA#O DELGADITO	ESCUELA BASICA JOSE ANTONIO PAEZ	850	2	15	660	592	645	0	2	2	0	49	660
EDO. PORTUGUESA	MP. PAPELON	PQ. CA#O DELGADITO	ESCUELA ESTADAL UNITARIA NUMERO 57 SABANA DULCE
EDO. PORTUGUESA	MP. PAPELON	PQ. CA#O DELGADITO	ESCUELA ESTADAL BASICA NUMERO 28 CAÑO DELGADITO	409	1	5	311	270	306	1	4	0	0	31	311
EDO. PORTUGUESA	MP. PAPELON	PQ. CA#O DELGADITO	ESCUELA ESTADAL BASICA NUMERO 29	787	2	20	657	504	637	0	7	1	0	125	657
EDO. PORTUGUESA	MP. PAPELON	PQ. CA#O DELGADITO	ESCUELA BASICA UNITARIA NUMERO 60	161	1	3	121	99	118	1	0	0	0	18	121
EDO. PORTUGUESA	MP. PAPELON	PQ. CA#O DELGADITO	ESCUELA BASICA CONCENTRADA NUMERO 19 SAN ANDRES	220	1	4	195	159	191	0	1	0	0	31	195
EDO. PORTUGUESA	MP. PAPELON	PQ. CA#O DELGADITO	ESCUELA ESTADAL UNITARIA NUMERO 61	198	1	2	160	145	158	0	1	0	0	12	160
EDO. PORTUGUESA	MP. PAPELON	PQ. CA#O DELGADITO	ESCUELA BASICA DOCTOR RAFAEL QUINTERO SERRA	1256	3	32	972	768	940	0	4	0	0	168	972
EDO. PORTUGUESA	MP. PAPELON	PQ. CA#O DELGADITO	ESCUELA FE Y ESPERANZA	131	1	6	125	109	119	0	1	0	0	9	125
EDO. PORTUGUESA	MP. AGUA BLANCA	CM. AGUA BLANCA	ESCUELA BOLIVARIANA MAZATO	123	1	2	112	108	110	0	0	0	0	2	112
EDO. PORTUGUESA	MP. AGUA BLANCA	CM. AGUA BLANCA	ESCUELA CONCENTRADA NUMERO 180	231	1	5	219	198	214	0	1	0	0	15	219
EDO. PORTUGUESA	MP. AGUA BLANCA	CM. AGUA BLANCA	ESCUELA ESTADAL CONCENTRADA NUMERO 2474	1369	3	34	1212	990	1178	0	8	1	2	177	1212
EDO. PORTUGUESA	MP. AGUA BLANCA	CM. AGUA BLANCA	CENTRO EDUCACION INICIAL PARAISO INFANTIL	236	1	7	211	163	204	0	3	0	0	38	211
EDO. PORTUGUESA	MP. AGUA BLANCA	CM. AGUA BLANCA	CENTRO EDUCACION INICIAL BOLIVARIANO COLINAS DE SANTA CLARA	413	1	5	376	302	371	0	3	0	0	66	376
EDO. PORTUGUESA	MP. AGUA BLANCA	CM. AGUA BLANCA	ESCUELA NACIONAL CONCENTRADA QUEBRADA HONDA	508	1	7	457	409	450	0	1	0	0	40	457
EDO. PORTUGUESA	MP. AGUA BLANCA	CM. AGUA BLANCA	ESCUELA BASICA ATAPAIMA	3082	6	48	2467	1568	2419	3	19	2	2	825	2467
EDO. PORTUGUESA	MP. AGUA BLANCA	CM. AGUA BLANCA	ESCUELA ESTADAL UNITARIA NUMERO 178	304	1	6	269	192	263	0	1	1	0	69	269
EDO. PORTUGUESA	MP. AGUA BLANCA	CM. AGUA BLANCA	LICEO OSCAR PICON GIACOPPINI	1608	3	44	1401	980	1357	2	7	0	0	368	1401
EDO. PORTUGUESA	MP. AGUA BLANCA	CM. AGUA BLANCA	ESCUELA NACIONAL CONCENTRADA LA ESPERANZA	565	1	6	475	424	469	0	2	0	1	42	475
EDO. PORTUGUESA	MP. AGUA BLANCA	CM. AGUA BLANCA	CENTRO EDUCACION INICIAL LOS RETOÑITOS	349	1	8	327	257	319	0	0	1	0	61	327
EDO. PORTUGUESA	MP. AGUA BLANCA	CM. AGUA BLANCA	ESCUELA ESTADAL UNITARIA NUMERO 169	305	1	3	265	222	262	0	0	0	0	40	265
EDO. PORTUGUESA	MP. AGUA BLANCA	CM. AGUA BLANCA	ESCUELA ESTADAL 250 AÑOS DE AGUA BLANCA	1651	3	42	1430	1147	1388	0	3	3	0	235	1430
EDO. PORTUGUESA	MP. AGUA BLANCA	CM. AGUA BLANCA	ESCUELA BOLIVARIANA EL HATICO	131	1	6	120	108	114	0	0	0	0	6	120
EDO. PORTUGUESA	MP. AGUA BLANCA	CM. AGUA BLANCA	ESCUELA CONCENTRADA NUMERO 768	512	1	11	438	389	427	0	1	0	0	37	438
EDO. PORTUGUESA	MP. AGUA BLANCA	CM. AGUA BLANCA	ESCUELA NACIONAL EL TOCUYANO	879	2	9	768	735	759	0	2	1	0	21	768
EDO. PORTUGUESA	MP. AGUA BLANCA	CM. AGUA BLANCA	UNIDAD EDUCATIVA ESTADAL GUMERSINDO MARTINEZ	1115	2	38	945	705	907	1	1	2	0	198	945
EDO. PORTUGUESA	MP. AGUA BLANCA	CM. AGUA BLANCA	ESCUELA LA APISA	340	1	1	293	287	292	0	0	0	0	5	293
EDO. PORTUGUESA	MP. AGUA BLANCA	CM. AGUA BLANCA	ESCUELA NACIONAL CONCENTRADA PIRITAL	493	1	3	420	394	417	0	1	0	0	22	420
EDO. PORTUGUESA	MP. ARAURE	CM. ARAURE	ESCUELA NACIONAL NUMERO 3765	459	1	16	376	295	360	0	2	1	0	62	376
EDO. PORTUGUESA	MP. ARAURE	CM. ARAURE	UNIVERSIDAD NACIONAL YACAMBU	1451	3	16	1357	388	1341	0	6	0	0	947	1357
EDO. PORTUGUESA	MP. ARAURE	CM. ARAURE	UNIDAD EDUCATIVA BOLIVARIANA NACIONAL VILLAS DEL PILAR	2974	6	45	2652	1284	2607	2	12	1	2	1306	2652
EDO. PORTUGUESA	MP. ARAURE	CM. ARAURE	MODULO INTEGRAL DE BIENESTAR ESTUDIANTIL NIBE	1189	2	18	1018	792	1000	0	5	1	0	202	1018
EDO. PORTUGUESA	MP. ARAURE	CM. ARAURE	PRE ESCOLAR LAS PALMITAS	1097	2	23	863	649	840	0	5	0	0	186	863
EDO. PORTUGUESA	MP. ARAURE	CM. ARAURE	ESCUELA BASICA MONSEÑOR OMAR RAMOS CORDERO	3480	7	71	2834	2202	2763	1	17	2	3	538	2834
EDO. PORTUGUESA	MP. ARAURE	CM. ARAURE	ESCUELA BASICA 13 DE JUNIO	1037	2	14	837	612	823	1	2	2	0	206	837
EDO. PORTUGUESA	MP. ARAURE	CM. ARAURE	ESCUELA BASICA OMAR RAMOS CORDERO 3	2390	5	37	1954	1578	1917	0	12	0	0	327	1954
EDO. PORTUGUESA	MP. ARAURE	CM. ARAURE	ESCUELA BASICA GENERAL PAEZ	2498	5	21	2061	1208	2040	2	11	1	0	818	2061
EDO. PORTUGUESA	MP. ARAURE	CM. ARAURE	ESCUELA NACIONAL NUMERO 3332 Y 202	623	2	12	506	417	494	0	3	0	0	74	506
EDO. PORTUGUESA	MP. ARAURE	CM. ARAURE	ESCUELA BASICA YOLANDA RIVERA DE PIERUZZINI	3657	7	53	3189	2307	3136	0	21	1	2	805	3189
EDO. PORTUGUESA	MP. ARAURE	CM. ARAURE	UNIDAD EDUCATIVA NACIONAL SAMUEL ROBINSON	1686	3	39	1506	1083	1467	1	3	1	1	378	1506
EDO. PORTUGUESA	MP. ARAURE	CM. ARAURE	UNIVERSIDAD NACIONAL ABIERTA NUCLEO ARAURE	771	2	23	715	302	692	0	0	0	2	388	715
EDO. PORTUGUESA	MP. ARAURE	CM. ARAURE	ESC. BASC. ANTONIO JOSE DE SUCRE	121	1	4	109	102	105	0	0	0	0	3	109
EDO. PORTUGUESA	MP. ARAURE	CM. ARAURE	ESCUELA BASICA OSCAR MENDOZA	1529	3	48	1344	1161	1296	0	4	1	0	130	1344
EDO. PORTUGUESA	MP. ARAURE	CM. ARAURE	ESCUELA BASICA BOLIVARIANA DESARROLLO CAMBURITO	1678	3	22	1483	763	1461	0	6	1	2	689	1483
EDO. PORTUGUESA	MP. ARAURE	CM. ARAURE	ESCUELA BASICA BOLIVARIANA NUESTRA SEÑORA DEL PILAR	1274	3	11	1110	388	1099	0	4	0	0	707	1110
EDO. PORTUGUESA	MP. ARAURE	CM. ARAURE	ESCUELA ESTADAL CONCENTRADA NUMERO 179 QUEBRADA DE ARMO	1140	2	21	1020	834	999	0	4	1	0	160	1020
EDO. PORTUGUESA	MP. ARAURE	CM. ARAURE	ESCUELA BASICA CARLOS ALBERTO PELAYO	1729	3	33	1390	829	1357	1	4	0	1	522	1390
EDO. PORTUGUESA	MP. ARAURE	CM. ARAURE	UNIDAD EDUCATIVA ESTADAL LOS BOTALONES	399	1	3	281	208	278	1	0	0	1	68	281
EDO. PORTUGUESA	MP. ARAURE	CM. ARAURE	EDIFICIO BANCO DE DESARROLLO AGROPECUARIO (BANDAGRO)	263	1	1	214	132	213	0	1	0	0	80	214
EDO. PORTUGUESA	MP. ARAURE	CM. ARAURE	PRE   ESCOLAR SIMONCITO	1405	3	40	1280	907	1240	1	5	1	0	326	1280
EDO. PORTUGUESA	MP. ARAURE	CM. ARAURE	GRUPO ESCOLAR BATALLA DE ARAURE	2436	5	61	2141	1145	2080	2	12	0	1	920	2141
EDO. PORTUGUESA	MP. ARAURE	CM. ARAURE	ESCUELA BASICA TRICENTENARIA DE ARAURE	2779	5	27	2299	2032	2272	0	9	0	0	231	2299
EDO. PORTUGUESA	MP. ARAURE	CM. ARAURE	ESCUELA BASICA NEREIDA MORENO DE DUGARTE	1507	3	19	1330	796	1311	0	12	2	1	500	1330
EDO. PORTUGUESA	MP. ARAURE	CM. ARAURE	ESCUELA BASICA GENERAL JUAN GUILLERMO IRIBARREN	2766	5	52	2392	1815	2340	1	15	2	3	504	2392
EDO. PORTUGUESA	MP. ARAURE	CM. ARAURE	ESCUELA ESTADAL NUMERO 175	812	2	7	666	553	659	1	5	2	0	98	666
EDO. PORTUGUESA	MP. ARAURE	CM. ARAURE	ESCUELA BASICA CIUDAD DE ARAURE	1836	4	10	1574	292	1564	0	7	0	0	1265	1574
EDO. PORTUGUESA	MP. ARAURE	CM. ARAURE	ESCUELA BASICA FRANCISCO DE MIRANDA	2548	5	53	2103	1246	2050	2	3	3	0	796	2103
EDO. PORTUGUESA	MP. ARAURE	CM. ARAURE	ESCUELA ESTADAL NUMERO 194	387	1	2	290	279	288	0	1	0	0	8	290
EDO. PORTUGUESA	MP. ARAURE	CM. ARAURE	CENTRO PRE ESCOLAR AÑO INTERNACIONAL DEL NIÑO	1825	4	58	1621	860	1563	0	12	0	5	686	1621
EDO. PORTUGUESA	MP. ARAURE	CM. ARAURE	CENTRO PRE ESCOLAR ANDRES BELLO	449	1	5	401	320	396	0	2	0	0	74	401
EDO. PORTUGUESA	MP. ARAURE	CM. ARAURE	CICLO COMBINADO JUAN PABLO PEREZ GRATEROL	764	2	17	666	476	649	0	5	1	0	167	666
EDO. PORTUGUESA	MP. ARAURE	CM. ARAURE	CICLO COMBINADO HILARION LOPEZ	1831	4	29	1423	530	1394	0	9	0	1	854	1423
EDO. PORTUGUESA	MP. ARAURE	CM. ARAURE	INSTITUTO MUNICIPAL DE RECREACIÓN DEPORTIVA ARAURE	1482	3	31	1248	626	1217	1	10	1	0	579	1248
EDO. PORTUGUESA	MP. ARAURE	CM. ARAURE	ESCUELA GRADUADA TAPA DE PIEDRA	2643	5	45	2313	1981	2268	1	12	3	0	271	2313
EDO. PORTUGUESA	MP. ARAURE	CM. ARAURE	JARDIN DE INFANCIA LA LAGUNITA	2203	4	21	1919	1579	1898	2	13	1	3	300	1919
EDO. PORTUGUESA	MP. ARAURE	CM. ARAURE	ESCUELA ESTADAL BETTY URDANETA DE HERRERA	845	2	12	748	670	736	0	1	0	1	64	748
EDO. PORTUGUESA	MP. ARAURE	CM. ARAURE	INSTITUTO EDUCATIVO INICIAL SIMÓN BOLÍVAR	570	1	3	463	243	460	0	1	0	0	216	463
EDO. PORTUGUESA	MP. ARAURE	CM. ARAURE	ESCUELA BASICA UNITARIA NUMERO 173	206	1	3	139	132	136	1	0	1	0	2	139
EDO. PORTUGUESA	MP. ARAURE	CM. ARAURE	COLEGIO UNIVERSITARIO FERMÍN TORO	1873	4	20	1560	737	1540	1	10	1	1	790	1560
EDO. PORTUGUESA	MP. ARAURE	CM. ARAURE	UNIDAD EDUCATIVA NACIONAL LA LUCIA	1133	2	25	914	717	889	0	5	0	0	167	914
EDO. PORTUGUESA	MP. ARAURE	CM. ARAURE	ESCUELA NACIONAL UNITARIA NUMERO 76	349	1	4	309	278	305	0	0	0	0	27	309
EDO. PORTUGUESA	MP. ARAURE	CM. ARAURE	ESCUELA CONCENTRADA MIXTA MIRAFLORES	1019	2	18	873	701	855	0	3	2	1	148	873
EDO. PORTUGUESA	MP. ARAURE	CM. ARAURE	ESCUELA ESTADAL CONCENTRADA NUMERO 164 EL JOBITO	623	2	15	546	393	531	1	4	1	0	132	546
EDO. PORTUGUESA	MP. ARAURE	CM. ARAURE	ASILO DE ANCIANOS	477	1	4	372	188	368	0	1	0	1	178	372
EDO. PORTUGUESA	MP. ARAURE	CM. ARAURE	ESCUELA BASICA ALI PRIMERA	3361	6	85	2753	2278	2668	0	7	2	1	380	2753
EDO. PORTUGUESA	MP. ARAURE	CM. ARAURE	ESCUELA ESTADAL NUMERO 1	473	1	1	361	349	360	0	3	0	0	8	361
EDO. PORTUGUESA	MP. ARAURE	CM. ARAURE	CENTRO PREESCOLAR EL PERIQUITO	168	1	0	153	130	153	0	0	0	0	23	153
EDO. PORTUGUESA	MP. ARAURE	CM. ARAURE	ESCUELA BOLIVARIANA GUACUY II	212	1	2	203	179	201	0	0	0	0	22	203
EDO. PORTUGUESA	MP. ARAURE	CM. ARAURE	CENTRO PRE ESCOLAR BARAURE III	1283	3	17	1045	826	1028	0	11	0	1	190	1045
EDO. PORTUGUESA	MP. ARAURE	CM. ARAURE	PREESCOLAR SIMON BOLIVAR	287	1	9	264	236	255	0	0	0	0	19	264
EDO. PORTUGUESA	MP. ARAURE	CM. ARAURE	JARDIN ESCOLAR ARAURE, (INAM)	1376	3	25	1198	899	1173	0	3	1	1	269	1198
EDO. PORTUGUESA	MP. ARAURE	CM. ARAURE	ESCUELA NACIONAL CONCENTRADA NUMERO 3348 1880	984	2	19	797	644	778	0	8	1	0	125	797
EDO. PORTUGUESA	MP. ARAURE	CM. ARAURE	ESCUELA CONCENTRADA NACIONAL NUMERO 3751 POTRERO DE ARMO	528	1	11	475	419	464	0	0	0	0	45	475
EDO. PORTUGUESA	MP. ARAURE	CM. ARAURE	COLEGIO GRAN MARISCAL DE AYACUCHO	904	2	11	805	317	794	1	2	0	0	474	805
EDO. PORTUGUESA	MP. ARAURE	CM. ARAURE	ESCUELA ESTADAL CONCENTRADA NUMERO 161	1337	3	9	1069	685	1060	3	7	0	1	364	1069
EDO. PORTUGUESA	MP. ARAURE	CM. ARAURE	ESCUELA ESTADAL CONCENTRADA NUMERO 160	1028	2	6	918	172	912	0	2	0	1	737	918
EDO. PORTUGUESA	MP. ARAURE	CM. ARAURE	ESCUELA ESTADAL CONCENTRADA NUMERO 163	709	2	13	648	543	635	1	4	1	0	86	648
EDO. PORTUGUESA	MP. ARAURE	CM. ARAURE	ESCUELA ESTADAL NUMERO 176 GUAIMARAL	381	1	15	325	255	310	0	2	0	0	53	325
EDO. PORTUGUESA	MP. ARAURE	CM. ARAURE	ESCUELA BASICA NUMERO 440	87	1	0	73	72	73	0	0	1	0	0	73
EDO. PORTUGUESA	MP. ARAURE	CM. ARAURE	ESCUELA BASICA CONCENTRADA NUMERO 190	239	1	0	182	175	182	0	2	0	0	5	182
EDO. PORTUGUESA	MP. ARAURE	PQ. RIO ACARIGUA	ESCUELA BOLIVARIANA 22403	173	1	2	150	144	148	0	0	0	0	4	150
EDO. PORTUGUESA	MP. ARAURE	PQ. RIO ACARIGUA	ESCUELA ESTADAL UNITARIA NUMERO 321	797	2	6	593	555	587	0	2	2	0	28	593
EDO. PORTUGUESA	MP. ARAURE	PQ. RIO ACARIGUA	ESCUELA ESTADAL UNITARIA 184 LAS MESAS	164	1	3	155	147	152	0	1	1	0	3	155
EDO. PORTUGUESA	MP. ARAURE	PQ. RIO ACARIGUA	ESCUELA BASICA LISANDRO ALVARADO	2690	5	28	2196	1712	2168	1	10	3	0	442	2196
EDO. PORTUGUESA	MP. ARAURE	PQ. RIO ACARIGUA	ESCUELA NACIONAL CONCENTRADA NUMERO 170 LA ROGEÑA	424	1	7	352	320	345	1	0	0	0	24	352
EDO. PORTUGUESA	MP. ARAURE	PQ. RIO ACARIGUA	ESCUELA ESTADAL UNITARIA NUMERO 185	662	2	3	558	524	555	1	6	1	0	23	558
EDO. PORTUGUESA	MP. ARAURE	PQ. RIO ACARIGUA	ESCUELA ESTADAL UNITARIA NUMERO 184	578	1	6	409	374	403	0	1	1	1	26	409
EDO. PORTUGUESA	MP. ARAURE	PQ. RIO ACARIGUA	ESCUELA ESTADAL CONCENTRADA MIXTA NUMERO 171	463	1	6	369	338	363	1	3	0	0	21	369
EDO. PORTUGUESA	MP. ARAURE	PQ. RIO ACARIGUA	UNIDAD EDUCATIVA NACIONAL MANUEL BARRIOS FREITEZ	1728	3	43	1449	1156	1406	0	5	2	0	243	1449
EDO. PORTUGUESA	MP. SUCRE	PQ. SAN JOSE DE SAGUAZ	ESCUELA ESTADAL UNITARIA N° 254 EL ALTO DE SAGUAZ	104	1	0	92	67	92	0	1	0	0	24	92
EDO. PORTUGUESA	MP. SUCRE	PQ. SAN JOSE DE SAGUAZ	ESCUELA BASICA UNITARIA NUMERO 256	123	1	2	113	84	111	0	1	0	0	26	113
EDO. PORTUGUESA	MP. SUCRE	PQ. SAN JOSE DE SAGUAZ	ESCUELA CONCENTRADA MIXTA NUMERO 217 105 2174	817	2	18	626	440	608	0	5	2	0	161	626
EDO. PORTUGUESA	MP. SUCRE	PQ. SAN JOSE DE SAGUAZ	ESCUELA ESTADAL CONCENTRADA	397	1	9	344	274	335	0	0	0	0	61	344
EDO. PORTUGUESA	MP. SUCRE	PQ.SAN RAFAEL PALO ALZADO	ESCUELA BASICA UNITARIA SIN NUMERO	316	1	9	265	230	256	0	1	0	0	25	265
EDO. PORTUGUESA	MP. SUCRE	PQ.SAN RAFAEL PALO ALZADO	ESCUELA BASICA PALO ALSADO	923	2	9	703	437	694	0	3	0	0	254	703
EDO. PORTUGUESA	MP. SUCRE	PQ.SAN RAFAEL PALO ALZADO	ESCUELA ESTADAL CONCENTRADA NUMERO 213	256	1	5	204	111	199	0	0	2	0	86	204
EDO. PORTUGUESA	MP. SUCRE	PQ.SAN RAFAEL PALO ALZADO	ESCUELA NACIONAL CONCENTRADA NUMERO 203	300	1	5	246	189	241	0	1	0	0	51	246
EDO. PORTUGUESA	MP. SUCRE	PQ.SAN RAFAEL PALO ALZADO	ESCUELA NACIONAL CONCENTRADA NUMERO 1788	661	2	12	531	407	519	0	1	0	0	111	531
EDO. PORTUGUESA	MP. SUCRE	CM. BISCUCUY	ESCUELA ESTADAL CIUDAD DE BISCUCUY	663	2	13	595	331	582	1	3	0	0	247	595
EDO. PORTUGUESA	MP. SUCRE	CM. BISCUCUY	ESCUELA ESTADAL UNITARIA NUMERO 234 SANTO CRISTO	1099	2	39	911	712	872	1	1	1	1	156	911
EDO. PORTUGUESA	MP. SUCRE	CM. BISCUCUY	ESCUELA BASICA MESA DE LAS PIÑAS	621	2	35	546	372	511	0	2	0	0	137	546
EDO. PORTUGUESA	MP. SUCRE	CM. BISCUCUY	ESCUELA BASICA JAIME CAZORLA	3133	6	67	2423	1127	2356	1	10	1	2	1215	2423
EDO. PORTUGUESA	MP. SUCRE	CM. BISCUCUY	UNIDAD EDUCATIVA SALUDABLE ARGIMIRO GABALDON	845	2	27	739	368	712	0	2	0	0	342	739
EDO. PORTUGUESA	MP. SUCRE	CM. BISCUCUY	ESCUELA ESTADAL CONCENTRADA NUMERO 223	531	1	9	448	345	439	0	2	1	0	91	448
EDO. PORTUGUESA	MP. SUCRE	CM. BISCUCUY	ESCUELA BASICA GUILLERMO GAMARRA MARRERO	2242	4	59	1827	1039	1768	1	12	1	0	715	1827
EDO. PORTUGUESA	MP. SUCRE	CM. BISCUCUY	ESCUELA BASICA ESTADAL UNITARIA NUMERO 236 EL CACHO	131	1	5	118	88	113	0	1	0	0	24	118
EDO. PORTUGUESA	MP. SUCRE	CM. BISCUCUY	PRE ESCOLAR LAS MONTAÑITAS	904	2	22	815	431	793	0	7	0	0	355	815
EDO. PORTUGUESA	MP. SUCRE	CM. BISCUCUY	LICEO FERNANDO DELGADO LOZANO	1031	2	27	865	402	838	0	10	0	0	426	865
EDO. PORTUGUESA	MP. SUCRE	CM. BISCUCUY	ESCUELA CONCENTRADA MIXTA NUMERO 226 JOSE DE CRUZ MANZANILLA	476	1	10	348	214	338	0	1	1	0	122	348
EDO. PORTUGUESA	MP. SUCRE	CM. BISCUCUY	ESCUELA ESTADAL CONCENTRADA NUMERO 210	379	1	7	307	226	300	0	6	1	0	67	307
EDO. PORTUGUESA	MP. SUCRE	CM. BISCUCUY	ESCUELA ESTADAL UNITARIA NUMERO 237	289	1	1	222	182	221	0	2	0	0	37	222
EDO. PORTUGUESA	MP. SUCRE	CM. BISCUCUY	ESCUELA ROMULO GALLEGOS	1062	2	15	897	471	882	0	3	0	0	408	897
EDO. PORTUGUESA	MP. SUCRE	CM. BISCUCUY	CENTRO EDUCACION INICIAL ARGEMIRO GABALDON	321	1	4	293	229	289	0	0	0	0	60	293
EDO. PORTUGUESA	MP. SUCRE	CM. BISCUCUY	ESCUELA BASICA CONCENTRADA NUMERO 225	300	1	5	262	194	257	0	2	0	0	61	262
EDO. PORTUGUESA	MP. SUCRE	PQ. UVENCIO A VELASQUEZ	E.B.E. CONCENTRADA N° 238 EL NUEZAL II	96	1	0	82	70	82	0	1	0	0	11	82
EDO. PORTUGUESA	MP. SUCRE	PQ. UVENCIO A VELASQUEZ	ESCUELA BASICA CONCENTRADA NUMERO 043 PECHO DE SALVAJE	140	1	7	120	98	113	0	3	0	0	12	120
EDO. PORTUGUESA	MP. SUCRE	PQ. UVENCIO A VELASQUEZ	ESCUELA ESTADAL CONCENTRADA NUMERO 224	582	1	7	472	316	465	0	3	0	0	146	472
EDO. PORTUGUESA	MP. SUCRE	PQ. UVENCIO A VELASQUEZ	ESCUELA BASICA CONCENTRADA NUMERO 255	280	1	2	211	135	209	1	0	0	0	73	211
EDO. PORTUGUESA	MP. SUCRE	PQ. UVENCIO A VELASQUEZ	ESCUELA BASICA VICTOR RAMOS VALDERRAMA	2619	5	47	2015	1399	1968	0	8	3	0	558	2015
EDO. PORTUGUESA	MP. SUCRE	PQ. UVENCIO A VELASQUEZ	ESCUELA BASICA UNITARIA SIN NUMERO	453	1	2	360	159	358	0	1	1	0	197	360
EDO. PORTUGUESA	MP. SUCRE	PQ. UVENCIO A VELASQUEZ	ESCUELA ESTADAL UNITARIA NUMERO 240	380	1	2	275	226	273	0	0	0	0	47	275
EDO. PORTUGUESA	MP. SUCRE	PQ. CONCEPCION	ESCUELA ESTADAL CONCENTRADA MIXTA NUMERO 276	313	1	2	240	192	238	0	0	0	0	46	240
EDO. PORTUGUESA	MP. SUCRE	PQ. CONCEPCION	ESCUELA BASICA CONCENTRADA NUMERO 543	230	1	6	197	177	191	0	0	0	0	14	197
EDO. PORTUGUESA	MP. SUCRE	PQ. CONCEPCION	ESCUELA NACIONAL CONCENTRADA NUMERO 3832	528	1	2	415	381	413	0	1	0	0	31	415
EDO. PORTUGUESA	MP. SUCRE	PQ. CONCEPCION	E.B.N. CONCENTRADA N° 281 EL MORICHAL	129	1	8	119	109	111	0	0	0	0	2	119
EDO. PORTUGUESA	MP. SUCRE	PQ. CONCEPCION	ESCUELA ESTADAL UNITARIA NUMERO 268	361	1	9	258	135	249	1	0	0	0	113	258
EDO. PORTUGUESA	MP. SUCRE	PQ. CONCEPCION	ESCUELA ESTADAL CONCENTRADA NUMERO 219	462	1	2	346	252	344	0	2	0	0	90	346
EDO. PORTUGUESA	MP. SUCRE	PQ. CONCEPCION	ESCUELA ESTADAL CONCENTRADA NUMERO 218	878	2	24	639	442	615	0	5	1	0	167	639
EDO. PORTUGUESA	MP. SUCRE	PQ. VILLA ROSA	ESCUELA BASICA VILLA ROSA	1053	2	8	822	479	814	0	4	5	3	323	822
EDO. PORTUGUESA	MP. SUCRE	PQ. VILLA ROSA	ESCUELA BASICA CONCENTRADA NUMERO 233	236	1	5	219	166	214	0	1	0	0	47	219
EDO. PORTUGUESA	MP. SUCRE	PQ. VILLA ROSA	ESCUELA ESTADAL CONCENTRADA NUMERO 227	339	1	5	245	167	240	1	1	1	0	70	245
EDO. PORTUGUESA	MP. SUCRE	PQ. VILLA ROSA	ESCUELA BASICA CONCENTRADA MIXTA NUMERO 207	368	1	4	287	220	283	0	1	0	0	62	287
EDO. PORTUGUESA	MP. SUCRE	PQ. VILLA ROSA	ESCUELA ESTADAL CONCENTRADA NUMERO 231	758	2	10	625	426	615	0	6	0	0	183	625
EDO. PORTUGUESA	MP. SUCRE	PQ. VILLA ROSA	ESCUELA ESTADAL CONCENTRADA NUMERO 230	538	1	3	430	397	427	0	1	0	0	29	430
EDO. PORTUGUESA	MP. SUCRE	PQ. VILLA ROSA	ESCUELA ESTADAL CONCENTRADA NUMERO 206	294	1	6	262	169	256	0	1	0	0	86	262
EDO. PORTUGUESA	MP. SUCRE	PQ. VILLA ROSA	ESCUELA BASICA CONCENTRADA NUMERO 238	207	1	4	180	151	176	0	0	0	0	25	180
EDO. PORTUGUESA	MP. SUCRE	PQ. VILLA ROSA	ESCUELA ESTADAL CONCENTRADA NUMERO 244	314	1	5	259	223	254	0	2	0	0	29	259
EDO. PORTUGUESA	MP. SUCRE	PQ. VILLA ROSA	ESCUELA ESTADAL NUMERO 259	213	1	4	177	101	173	0	1	0	0	71	177
EDO. PORTUGUESA	MP. M.JOSE V DE UNDA	PQ. PE#A BLANCA	LICEO BOLIVARIANO PEÑA BLANCA	730	2	13	610	481	597	0	5	1	0	110	610
EDO. PORTUGUESA	MP. M.JOSE V DE UNDA	PQ. PE#A BLANCA	ESCUELA ESTADAL UNITARIA NUMERO 302 LOS BUCARES	100	1	4	83	51	79	0	1	0	0	27	83
EDO. PORTUGUESA	MP. M.JOSE V DE UNDA	PQ. PE#A BLANCA	ESCUELA BASICA ESTADAL CONCENTRADA NUMERO 316	413	1	6	326	308	320	0	1	0	0	11	326
EDO. PORTUGUESA	MP. M.JOSE V DE UNDA	PQ. PE#A BLANCA	ESCUELA NACIONAL CONCENTRADA NUMERO 189 1170 1184	861	2	9	597	431	588	1	7	0	0	149	597
EDO. PORTUGUESA	MP. M.JOSE V DE UNDA	CM. CHABASQUEN	E.B. CONCENTRADA ESTADAL N° 300 PUEBLO VIEJO	195	1	5	166	136	161	0	0	0	0	25	166
EDO. PORTUGUESA	MP. M.JOSE V DE UNDA	CM. CHABASQUEN	ESCUELA BASICA CONCENTRADA MIXTA NUMERO 285 1785	328	1	3	259	170	256	1	1	0	1	83	259
EDO. PORTUGUESA	MP. M.JOSE V DE UNDA	CM. CHABASQUEN	ESCUELA BASICA CONCENTRADA NUMERO 306 SAN RAFAEL
EDO. PORTUGUESA	MP. M.JOSE V DE UNDA	CM. CHABASQUEN	ESCUELA ESTADAL CONCENTRADA NUMERO 288 EL RINCON	427	1	5	317	261	312	0	4	0	0	47	317
EDO. PORTUGUESA	MP. M.JOSE V DE UNDA	CM. CHABASQUEN	ESCUELA ESTADAL CONCENTRADA NUMERO 506 EL COGOLLAL	104	1	2	88	65	86	0	0	0	0	21	88
EDO. PORTUGUESA	MP. M.JOSE V DE UNDA	CM. CHABASQUEN	MUSEO CHABASQUEN
EDO. PORTUGUESA	MP. M.JOSE V DE UNDA	CM. CHABASQUEN	ESCUELA ESTADAL SANTA ROSA NUMERO 318	458	1	12	379	301	367	0	5	0	0	61	379
EDO. PORTUGUESA	MP. M.JOSE V DE UNDA	CM. CHABASQUEN	CICLO COMBINADO RAMON PAREJO GOMEZ	2227	4	46	1645	973	1599	0	14	1	1	610	1645
EDO. PORTUGUESA	MP. M.JOSE V DE UNDA	CM. CHABASQUEN	LICEO BOLIVARIANO RURAL LA PICA	86	1	1	75	59	74	0	0	0	0	15	75
EDO. PORTUGUESA	MP. M.JOSE V DE UNDA	CM. CHABASQUEN	ESCUELA BASICA ESTADAL CONCENTRADA NUMERO 308 LA GRAN PARADA NER 4	169	1	4	139	126	135	0	0	0	0	9	139
EDO. PORTUGUESA	MP. M.JOSE V DE UNDA	CM. CHABASQUEN	ESCUELA ESTADAL CONCENTRADA NUMERO 240	485	1	5	382	309	377	0	1	0	0	67	382
EDO. PORTUGUESA	MP. M.JOSE V DE UNDA	CM. CHABASQUEN	ESCUELA BASICA ESTADAL CONCENTRADA NUMERO 481 LA GOAJIRITA
EDO. PORTUGUESA	MP. M.JOSE V DE UNDA	CM. CHABASQUEN	ESCUELA BASICA CONCENTRADA NUMERO 310	203	1	4	163	129	159	0	1	1	0	28	163
EDO. PORTUGUESA	MP. M.JOSE V DE UNDA	CM. CHABASQUEN	ESCUELA ESTADAL CONCENTRADA MIXTA NUMERO 291	1161	2	30	778	575	748	0	8	1	0	164	778
EDO. PORTUGUESA	MP. M.JOSE V DE UNDA	CM. CHABASQUEN	CENTRO PREESCOLAR DOCTORA GLADIS DE LUSINCHI	270	1	5	225	153	220	1	0	0	0	66	225
EDO. PORTUGUESA	MP. M.JOSE V DE UNDA	CM. CHABASQUEN	ESCUELA BASICA ESTADAL UNITARIA NUMERO 304	228	1	4	199	167	195	0	1	0	0	27	199
EDO. PORTUGUESA	MP. M.JOSE V DE UNDA	CM. CHABASQUEN	ESCUELA ESTADAL CONCENTRADA NUMERO 294	328	1	4	280	203	276	0	2	0	0	71	280
EDO. PORTUGUESA	MP. M.JOSE V DE UNDA	CM. CHABASQUEN	ESCUELA ESTADAL UNITARIA NUMERO 508	491	1	17	341	245	324	0	6	0	0	73	341
EDO. PORTUGUESA	MP. M.JOSE V DE UNDA	CM. CHABASQUEN	ESCUELA BASICA NUMERO 295	450	1	9	312	275	303	0	0	0	0	28	312
EDO. PORTUGUESA	MP. M.JOSE V DE UNDA	CM. CHABASQUEN	ESCUELA BASICA CONCENTRADA NUMERO 315	202	1	3	154	143	151	0	1	0	0	7	154
EDO. PORTUGUESA	MP. M.JOSE V DE UNDA	CM. CHABASQUEN	ESCUELA ESTADAL UNITARIA NUMERO 317	384	1	6	277	212	271	0	3	0	0	56	277
EDO. PORTUGUESA	MP. M.JOSE V DE UNDA	CM. CHABASQUEN	GRUPO ESCOLAR NACIONAL FRANCISCO DE LA HOZ BERRIOS	129	1	5	107	66	102	0	1	0	0	35	107
EDO. PORTUGUESA	MP. M.JOSE V DE UNDA	CM. CHABASQUEN	ESCUELA ESTADAL UNITARIA NUMERO 312	272	1	3	194	149	191	0	1	0	0	41	194
EDO. PORTUGUESA	MP. M.JOSE V DE UNDA	CM. CHABASQUEN	UNIDAD EDUCATIVA PETRA DE ORELLANA	830	2	15	672	516	657	0	5	2	0	134	672
EDO. PORTUGUESA	MP. M.JOSE V DE UNDA	CM. CHABASQUEN	ESCUELA CONCENTRADA NUMERO 292	476	1	11	336	255	325	1	3	1	0	65	336
EDO. PORTUGUESA	MP. M.JOSE V DE UNDA	CM. CHABASQUEN	ESCUELA BASICA UNITARIA NUMERO 1806	423	1	2	339	291	337	0	0	0	0	46	339
EDO. PORTUGUESA	MP. M.JOSE V DE UNDA	CM. CHABASQUEN	ESCUELA BASICA CONCENTRADA NUMERO 287 EL PUENTE	739	2	14	613	338	599	0	4	0	0	257	613
EDO. PORTUGUESA	MP. M.JOSE V DE UNDA	CM. CHABASQUEN	ESCUELA BASICA CONCENTRADA NUMERO 297	394	1	9	309	236	300	0	1	0	0	63	309
EDO. PORTUGUESA	MP. PAEZ	PQ. PIMPINELA	ESCUELA CONCENTRADA NACIONAL NUMERO 2886	610	2	14	509	470	495	1	1	1	0	22	509
EDO. PORTUGUESA	MP. PAEZ	PQ. PIMPINELA	ESCUELA BASICA PIMPINELA	1994	4	28	1571	1364	1543	2	7	0	0	170	1571
EDO. PORTUGUESA	MP. PAEZ	PQ. PIMPINELA	ESCUELA BASICA CENTRO L	707	2	11	633	556	622	0	3	2	1	60	633
EDO. PORTUGUESA	MP. PAEZ	PQ. PIMPINELA	ESCUELA SIMON RODRIGUEZ LA COCUIZA	359	1	8	296	255	288	0	2	2	0	29	296
EDO. PORTUGUESA	MP. PAEZ	CM. ACARIGUA	ESCUELA BASICA DON ANDRES BELLO	492	1	15	425	382	410	0	0	1	0	27	425
EDO. PORTUGUESA	MP. PAEZ	CM. ACARIGUA	JARDIN DE INFANCIA PROFESORA CARMEN DE FIGUEIRA	664	2	12	531	368	519	0	1	0	0	150	531
EDO. PORTUGUESA	MP. PAEZ	CM. ACARIGUA	ESCUELA GRADUADA BENJAMIN MONTILLA	1820	4	21	1433	1079	1412	3	5	0	3	322	1433
EDO. PORTUGUESA	MP. PAEZ	CM. ACARIGUA	CENTRO COMUNITARIO DE AJEDREZ	93	1	2	84	50	82	0	1	0	0	31	84
EDO. PORTUGUESA	MP. PAEZ	CM. ACARIGUA	CENTRO DE EDUCACION INICIAL BOLIVARIANO ROMULO GALLEGOS	611	2	6	532	418	526	0	5	0	0	103	532
EDO. PORTUGUESA	MP. PAEZ	CM. ACARIGUA	GRUPO ESCOLAR ESTADAL CURPA	2273	4	45	1806	1313	1761	3	14	1	0	430	1806
EDO. PORTUGUESA	MP. PAEZ	CM. ACARIGUA	LICEO BOLIVARIANO INDEPENDENCIA DE VENEZUELA	2368	4	44	2165	1992	2121	0	5	0	0	124	2165
EDO. PORTUGUESA	MP. PAEZ	CM. ACARIGUA	ESCUELA BASICA PALACIO FAJARDO	3167	6	46	2428	982	2382	0	13	0	1	1386	2428
EDO. PORTUGUESA	MP. PAEZ	CM. ACARIGUA	ESCUELA BASICA BOLIVARIANA MANUELITA SAENZ	1772	3	20	1530	1281	1510	0	8	0	0	221	1530
EDO. PORTUGUESA	MP. PAEZ	CM. ACARIGUA	ESCUELA BASICA ALBERTO LEVY MORA	3781	7	86	2922	2305	2836	0	28	0	0	503	2922
EDO. PORTUGUESA	MP. PAEZ	CM. ACARIGUA	CENTRO EDUCACION INICIAL SIMONCITO DURIGUA	302	1	15	263	199	248	0	2	0	0	47	263
EDO. PORTUGUESA	MP. PAEZ	CM. ACARIGUA	CICLO COMBINADO EDUARDO CHOLET	3623	7	42	3183	1582	3141	1	12	0	0	1546	3183
EDO. PORTUGUESA	MP. PAEZ	CM. ACARIGUA	ESCUELA BASICA GOAJIRA I	3258	6	68	2765	1274	2697	1	17	3	2	1400	2765
EDO. PORTUGUESA	MP. PAEZ	CM. ACARIGUA	ESCUELA BASICA LUISA GRATEROL DE PEREZ	1748	3	41	1491	1201	1450	0	3	0	0	246	1491
EDO. PORTUGUESA	MP. PAEZ	CM. ACARIGUA	ESCUELA BASICA TRINA DE MORENO	4022	7	80	3318	2505	3238	1	22	1	0	709	3318
EDO. PORTUGUESA	MP. PAEZ	CM. ACARIGUA	ESCUELA BASICA LUZ DE PEREIRA	3283	6	44	2689	2227	2645	2	13	2	1	400	2689
EDO. PORTUGUESA	MP. PAEZ	CM. ACARIGUA	ESCUELA BASICA ANA SUSANA DE OUSSET	3831	7	62	3109	1568	3047	2	13	2	2	1460	3109
EDO. PORTUGUESA	MP. PAEZ	CM. ACARIGUA	ESCUELA BASICA 5 DE DICIEMBRE	3612	7	42	2918	2617	2876	0	10	1	3	245	2918
EDO. PORTUGUESA	MP. PAEZ	CM. ACARIGUA	UNIVERSIDAD NACIONAL EXPERIMENTAL SIMON RODRIGUEZ	1345	3	11	1071	588	1060	0	10	1	0	461	1071
EDO. PORTUGUESA	MP. PAEZ	CM. ACARIGUA	UNIDAD EDUCATIVA FE Y ALEGRIA SANTA ELENA	1382	3	27	1181	1012	1154	0	5	0	1	136	1181
EDO. PORTUGUESA	MP. PAEZ	CM. ACARIGUA	GIMNASIO CUBIERTO WILBALDO ZABALETA	306	1	1	270	147	269	0	4	0	0	118	270
EDO. PORTUGUESA	MP. PAEZ	CM. ACARIGUA	ESCUELA BASICA CIUDAD DE ACARIGUA	3026	6	57	2339	1231	2282	1	20	1	3	1026	2339
EDO. PORTUGUESA	MP. PAEZ	CM. ACARIGUA	UNIDAD EDUCATIVA LOS CORTIJOS	1920	4	45	1731	1008	1686	0	19	0	2	657	1731
EDO. PORTUGUESA	MP. PAEZ	CM. ACARIGUA	ESCUELA NACIONAL BASICA SAN VICENTE	2312	4	62	1890	1314	1828	1	19	0	2	492	1890
EDO. PORTUGUESA	MP. PAEZ	CM. ACARIGUA	ESCUELA BASICA HERMANAS PERAZAS	3692	7	60	3024	1747	2964	1	19	2	6	1189	3024
EDO. PORTUGUESA	MP. PAEZ	CM. ACARIGUA	CICLO COMBINADO JOSE ANTONIO PAEZ	2996	6	41	2403	1215	2362	2	11	0	2	1132	2403
EDO. PORTUGUESA	MP. PAEZ	CM. ACARIGUA	ESCUELA BOLIVARIANA DURIGUA VIEJA	657	2	10	532	444	522	0	3	1	0	74	532
EDO. PORTUGUESA	MP. PAEZ	CM. ACARIGUA	CICLO COMBINADO 5 DE DICIEMBRE	2273	4	41	1826	1310	1785	0	10	0	1	464	1826
EDO. PORTUGUESA	MP. PAEZ	CM. ACARIGUA	ESCUELA BASICA MIGUEL OTERO SILVA	3193	6	55	2524	1336	2469	1	16	3	1	1112	2524
EDO. PORTUGUESA	MP. PAEZ	CM. ACARIGUA	UNIDAD EDUCATIVA PRIVADA EL AVILA	1457	3	29	1171	434	1142	0	3	1	3	701	1171
EDO. PORTUGUESA	MP. PAEZ	CM. ACARIGUA	UNIDAD EDUCATIVA NACIONAL DURIGUA	1877	4	29	1609	1257	1580	0	9	0	0	314	1609
EDO. PORTUGUESA	MP. PAEZ	CM. ACARIGUA	PRE ESCOLAR LEOWALDO JOSE SORONDO	2552	5	63	2236	1247	2173	2	17	2	3	902	2236
EDO. PORTUGUESA	MP. PAEZ	CM. ACARIGUA	C.E.I  EL ARAGUANEY	95	1	0	87	65	87	0	0	0	0	22	87
EDO. PORTUGUESA	MP. PAEZ	CM. ACARIGUA	ESCUELA BASICA ROMULO GALLEGOS	3768	7	90	3314	2231	3224	2	22	0	1	968	3314
EDO. PORTUGUESA	MP. PAEZ	CM. ACARIGUA	ESCUELA BASICA FE Y ALEGRIA	3521	6	36	2722	1912	2686	3	12	6	1	752	2722
EDO. PORTUGUESA	MP. PAEZ	CM. ACARIGUA	COLEGIO SANTO ANGEL DE LA GUARDA	1696	3	15	1485	632	1470	0	6	0	0	832	1485
EDO. PORTUGUESA	MP. PAEZ	CM. ACARIGUA	GRUPO ESCOLAR RAIMUNDO ANDUEZA PALACIO	2903	5	44	2369	1420	2325	0	20	1	3	881	2369
EDO. PORTUGUESA	MP. PAEZ	CM. ACARIGUA	UNIDAD EDUCATIVA ESTADAL 19 DE ABRIL	374	1	1	330	302	329	0	2	0	0	25	330
EDO. PORTUGUESA	MP. PAEZ	CM. ACARIGUA	ESCUELA TECNICA COMERCIAL PROFESOR ADEMAR VASQUEZ	1377	3	18	1209	689	1191	0	8	0	0	494	1209
EDO. PORTUGUESA	MP. PAEZ	CM. ACARIGUA	PRE ESCOLAR DURIGUA VIEJA	767	2	17	647	547	630	0	6	1	0	76	647
EDO. PORTUGUESA	MP. PAEZ	CM. ACARIGUA	UNIDAD EDUCATIVA PRIVADA GENERALISIMO FRANCISCO DE MIRANDA	1178	2	14	976	440	962	0	1	0	1	520	976
EDO. PORTUGUESA	MP. PAEZ	CM. ACARIGUA	JARDIN DE INFANCIA BOLIVARIANO ALTAMIRA	781	2	11	700	593	689	1	3	1	0	91	700
EDO. PORTUGUESA	MP. PAEZ	CM. ACARIGUA	JARDIN DE INFANCIA EL AMANECER	2881	5	43	2481	1816	2438	0	14	3	3	602	2481
EDO. PORTUGUESA	MP. PAEZ	CM. ACARIGUA	CENTRO DE RECREACION EDUCATIVA ROSALIA	949	2	15	864	640	849	0	6	0	0	203	864
EDO. PORTUGUESA	MP. PAEZ	CM. ACARIGUA	UNIDAD EDUCATIVA COLEGIO VICENTE EMILIO SOJO	1005	2	11	873	403	862	0	4	1	0	454	873
EDO. PORTUGUESA	MP. PAEZ	CM. ACARIGUA	ALDEA UNIVERSITARIA METROPOLITANA DE ACARIGUA ARAURE	131	1	1	113	69	112	0	2	0	1	40	113
EDO. PORTUGUESA	MP. PAEZ	CM. ACARIGUA	COMEDOR POPULAR  GENERAL JOSE ANTONIO PAEZ	85	1	3	76	28	73	0	0	0	0	45	76
EDO. PORTUGUESA	MP. PAEZ	CM. ACARIGUA	GRUPO ESCOLAR BOLIVARIANO DURIGUA	3183	6	62	2604	1792	2542	0	29	3	1	717	2604
EDO. PORTUGUESA	MP. PAEZ	CM. ACARIGUA	JARDIN DE INFANCIA EL CARMELO	1470	3	33	1275	944	1242	1	27	1	1	268	1275
EDO. PORTUGUESA	MP. PAEZ	CM. ACARIGUA	ESCUELA NACIONAL GRADUADA SAN ANTONIO	1903	4	50	1652	1073	1602	0	6	2	0	521	1652
EDO. PORTUGUESA	MP. PAEZ	CM. ACARIGUA	CENTRO DE EDUCACION INICIAL VENEZUELA	434	1	5	402	134	397	0	0	0	0	263	402
EDO. PORTUGUESA	MP. PAEZ	CM. ACARIGUA	ESCUELA BASICA LA VICTORIA	915	2	9	803	711	794	0	4	0	1	78	803
EDO. PORTUGUESA	MP. PAEZ	CM. ACARIGUA	INSTITUTO UNIVERSITARIO DE TECNOLOGIA DEL ESTADO PORTUGUESA	476	1	9	422	281	413	0	1	0	1	130	422
EDO. PORTUGUESA	MP. PAEZ	CM. ACARIGUA	JARDIN DE INFANCIA MIGUEL OCTAVIO	1690	3	60	1470	1020	1410	0	9	1	1	379	1470
EDO. PORTUGUESA	MP. PAEZ	CM. ACARIGUA	ESCUELA BASICA BATALLA DE CARABOBO	3502	6	60	2678	2239	2618	1	5	0	1	372	2678
EDO. PORTUGUESA	MP. PAEZ	CM. ACARIGUA	ESCUELA BASICA 24 DE JULIO	3233	6	55	2743	1676	2688	3	18	2	3	986	2743
EDO. PORTUGUESA	MP. PAEZ	PQ. PAYARA	ESCUELA ESTADAL CONCENTRADA NUMERO 143 CAJARITO	324	1	1	255	223	254	0	1	0	0	30	255
EDO. PORTUGUESA	MP. PAEZ	PQ. PAYARA	LICEO BOLIVARIANO ANDRES ELOY BLANCO	463	1	9	378	331	369	1	4	0	0	33	378
EDO. PORTUGUESA	MP. PAEZ	PQ. PAYARA	ESCUELA ESTADAL EL TAMARINDO	259	1	1	233	229	232	0	1	0	0	2	233
EDO. PORTUGUESA	MP. PAEZ	PQ. PAYARA	ESCUELA ESTADAL CONCENTRADA LOS CHINOS	175	1	2	147	141	145	0	1	0	0	3	147
EDO. PORTUGUESA	MP. PAEZ	PQ. PAYARA	ESCUELA BASICA PAYARA	3827	7	47	2950	2494	2903	2	14	0	2	391	2950
EDO. PORTUGUESA	MP. PAEZ	PQ. PAYARA	ESCUELA CONCENTRADA MIXTA NUMERO 1886 151	523	1	4	438	377	434	1	2	1	0	53	438
EDO. PORTUGUESA	MP. PAEZ	PQ. PAYARA	ESCUELA CONCENTRADA ESTADAL NUMERO 140	734	2	19	612	551	593	1	1	2	1	37	612
EDO. PORTUGUESA	MP. PAEZ	PQ. PAYARA	ESCUELA ESTADAL CONCENTRADA LOS MAMONES NUMERO 138	569	1	6	457	423	451	0	2	0	0	26	457
EDO. PORTUGUESA	MP. PAEZ	PQ. RAMON PERAZA	ESCUELA BASICA SABANETICA	863	2	6	748	650	742	0	5	2	0	85	748
EDO. PORTUGUESA	MP. PAEZ	PQ. RAMON PERAZA	MARATAN NUMERO 142	207	1	8	172	135	164	0	2	0	0	27	172
EDO. PORTUGUESA	MP. PAEZ	PQ. RAMON PERAZA	ESCUELA BASICA ESTADAL  CONCENTRADA NUMERO 144	579	1	16	474	308	458	0	6	0	0	144	474
EDO. PORTUGUESA	MP. PAEZ	PQ. RAMON PERAZA	ESCUELA RURAL BASICA LA EXTENSION MIJAGUITO	1349	3	53	1051	837	998	0	3	1	0	157	1051
EDO. PORTUGUESA	MP. PAEZ	PQ. RAMON PERAZA	UNIDAD EDUCATIVA ESPINITAL	758	2	17	654	505	637	0	4	0	0	128	654
EDO. SUCRE	MP. ANDRES E BLANCO	PQ. ROMULO GALLEGOS	ESCUELA RURAL BOLIVARIANA RÍO CRISTALINO	759	2	10	554	313	544	0	0	0	0	231	554
EDO. SUCRE	MP. ANDRES E BLANCO	PQ. ROMULO GALLEGOS	UNIDAD EDUCATIVA ARMANDO MALAVÉ ROMERO	977	2	9	704	402	695	1	1	2	0	289	704
EDO. SUCRE	MP. ANDRES E BLANCO	PQ. ROMULO GALLEGOS	ESCUELA BOLIVARIANA CAÑO DE CRUZ	550	1	5	378	234	373	0	0	0	0	139	378
EDO. SUCRE	MP. ANDRES E BLANCO	PQ. ROMULO GALLEGOS	ESCUELA RURAL BOLIVARIANA CALICHE	226	1	4	127	55	123	0	0	0	0	68	127
EDO. SUCRE	MP. ANDRES E BLANCO	PQ. ROMULO GALLEGOS	ESCUELA RURAL BOLIVARIANA RÍO GRANDE	1328	3	16	848	461	832	1	5	0	0	365	848
EDO. SUCRE	MP. ANDRES E BLANCO	PQ. ROMULO GALLEGOS	UNIDADA EDUCATIVA RURAL BOLIVARIANA CERRO CANO DE CRUZ	108	1	2	87	29	85	0	2	0	0	54	87
EDO. SUCRE	MP. ANDRES E BLANCO	PQ. ROMULO GALLEGOS	UNIDAD EDUCATIVA ORIENTE	1084	2	11	735	492	724	0	2	0	1	229	735
EDO. SUCRE	MP. ANDRES E BLANCO	PQ. ROMULO GALLEGOS	ESCUELA BÁSICA PARARE
EDO. SUCRE	MP. ANDRES E BLANCO	PQ. ROMULO GALLEGOS	UNIDAD EDUCATIVA DON ROMULO GALLEGOS	304	1	8	252	165	244	0	2	0	0	77	252
EDO. SUCRE	MP. ANDRES E BLANCO	PQ. MARI#O	ESCUELA BASICA GUARAGUAO
EDO. SUCRE	MP. ANDRES E BLANCO	PQ. MARI#O	UNIDAD EDUCATIVA BOLIVARIANA RÍO DE ORO	366	1	2	229	162	227	0	2	0	0	63	229
EDO. SUCRE	MP. ANDRES E BLANCO	PQ. MARI#O	CENTRO EDUCACIÓN INICIAL SANTA CLARA	488	1	8	391	270	383	0	3	1	0	109	391
EDO. SUCRE	MP. ANDRES E BLANCO	PQ. MARI#O	UNIDAD EDUCATIVA BOLIVARIANA RAFAEL RAMOS DÍAZ	1618	3	21	1272	709	1251	0	9	1	0	532	1272
EDO. SUCRE	MP. ANDRES E BLANCO	PQ. MARI#O	CENTRO EDUCACIÓN INICIAL BOLIVARIANO SIMONCITO CASANAY	554	1	5	460	239	455	0	0	0	0	216	460
EDO. SUCRE	MP. ANDRES E BLANCO	PQ. MARI#O	CENTRO DE EUCACION INICIAL EL PUENTE	106	1	3	88	58	85	0	0	0	0	27	88
EDO. SUCRE	MP. ANDRES E BLANCO	PQ. MARI#O	UNIDAD EDUCATIVA LAS VARAS	631	2	15	509	361	494	1	2	1	0	129	509
EDO. SUCRE	MP. ANDRES E BLANCO	PQ. MARI#O	UNIDAD EDUCATIVA JOSÉ MARÍA CARRERA	2897	5	24	2173	1092	2149	3	17	2	2	1033	2173
EDO. SUCRE	MP. ANDRES E BLANCO	PQ. MARI#O	UNIDAD EDUCATIVA ANTONIO JOSE DE SUCRE	1001	2	16	733	379	717	0	7	0	0	331	733
EDO. SUCRE	MP. ANDRES E BLANCO	PQ. MARI#O	UNIDAD EDUCATIVA BOLIVARIANA SANTA LUCIA	661	2	21	446	242	425	0	4	0	0	179	446
EDO. SUCRE	MP. ANDRES E BLANCO	PQ. MARI#O	UNIDAD EDUCATIVA PETRA TINEO DE CARABALLO	632	2	11	514	283	503	1	1	0	0	218	514
EDO. SUCRE	MP. ANDRES E BLANCO	PQ. MARI#O	UNIDAD EDUCATIVA BOLIVARIANA MATÍAS PARRA ALCALÁ	3341	6	32	2373	1211	2341	0	7	0	0	1123	2373
EDO. SUCRE	MP. ANDRES E BLANCO	PQ. MARI#O	UNIDAD EDUCATIVA RURAL BOLIVARIANA SANTA MARTA	630	2	5	455	232	450	0	1	0	0	217	455
EDO. SUCRE	MP. LIBERTADOR	PQ. TUNAPUY	ESCUELA BOLIVARIANA EUGENIO PEÑA	466	1	14	392	243	378	0	0	0	1	134	392
EDO. SUCRE	MP. LIBERTADOR	PQ. TUNAPUY	UNIDAD EDUCATIVA BERNARDO BERMÚDEZ	1618	3	28	1309	797	1281	1	3	0	0	480	1309
EDO. SUCRE	MP. LIBERTADOR	PQ. TUNAPUY	ESCUELA BOLIVARIANA PLATANITO EL BAJO	650	2	7	505	339	498	0	2	0	0	157	505
EDO. SUCRE	MP. LIBERTADOR	PQ. TUNAPUY	ESCUELA BOLIVARIANA ÑO CARLOS	292	1	2	225	181	223	0	2	0	0	40	225
EDO. SUCRE	MP. LIBERTADOR	PQ. TUNAPUY	ESCUELA BOLIVARIANA CUMBRE MARIANO LEÓN	414	1	4	288	187	284	0	1	0	0	96	288
EDO. SUCRE	MP. LIBERTADOR	PQ. TUNAPUY	ESCUELA BOLIVARIANA LAS PRADERAS	820	2	18	660	406	642	0	0	0	0	236	660
EDO. SUCRE	MP. LIBERTADOR	PQ. TUNAPUY	LICEO BOLIVARIANO BRAZON DE ORO	348	1	6	246	179	240	0	1	0	0	60	246
EDO. SUCRE	MP. LIBERTADOR	PQ. TUNAPUY	ESCUELA BÁSICA RÍO ARRIBA	235	1	8	165	105	157	0	1	0	0	51	165
EDO. SUCRE	MP. LIBERTADOR	PQ. TUNAPUY	UNIDAD EDUCATIVA PEDRO ELÍAS MARCANO	1949	4	31	1448	850	1417	0	6	2	2	557	1448
EDO. SUCRE	MP. LIBERTADOR	PQ. TUNAPUY	ESCUELA BÁSICA CATUARO ARRIBA	336	1	7	238	147	231	1	0	0	0	83	238
EDO. SUCRE	MP. LIBERTADOR	PQ. CAMPO ELIAS	ESCUELA BOLIVARIANA GUAYANA	619	2	6	408	296	402	0	2	0	0	104	408
EDO. SUCRE	MP. LIBERTADOR	PQ. CAMPO ELIAS	ESCUELA BOLIVARIIANA RIO DE AGUA	185	1	0	136	123	136	0	0	0	0	13	136
EDO. SUCRE	MP. LIBERTADOR	PQ. CAMPO ELIAS	ESCUELA BOLIVARIANA CANGREJAL	233	1	4	167	127	163	0	1	0	0	35	167
EDO. SUCRE	MP. MARI#O	PQ. CAMPO CLARO	UNIDAD EDUCATIVA  BOLIVARIANA ROMÁN VALECILLO	2419	5	51	1613	980	1562	0	3	1	1	577	1613
EDO. SUCRE	MP. MARI#O	PQ. CAMPO CLARO	ESCUELA BOLIVARIANA ALTO AMARA	156	1	4	120	61	116	0	0	0	0	55	120
EDO. SUCRE	MP. MARI#O	PQ. CAMPO CLARO	ESCUELA BOLIVARIANA MUNDO NUEVO	459	1	2	329	269	327	0	0	0	0	58	329
EDO. SUCRE	MP. MARI#O	PQ. CAMPO CLARO	ESCUELA BÁSICA PUNTA BRAVA	126	1	4	106	88	102	0	1	0	0	13	106
EDO. SUCRE	MP. MARI#O	PQ. MARABAL	ESCUELA BOLIVARIANA MARABAL	1089	2	11	760	546	749	0	6	3	0	194	760
EDO. SUCRE	MP. MARI#O	PQ. MARABAL	ESCUELA BOLIVARIANA VERICALLAR	427	1	3	317	244	314	0	0	0	0	70	317
EDO. SUCRE	MP. MARI#O	PQ. MARABAL	ESCUELA BÁSICA VALENCIA	187	1	1	135	99	134	0	0	0	0	35	135
EDO. SUCRE	MP. MARI#O	PQ. SORO	ESCUELA BOLIVARIANA JUAN PEDRO	480	1	1	320	213	319	0	0	0	0	106	320
EDO. SUCRE	MP. MARI#O	PQ. SORO	UNIDAD EDUCATIVA ANDRÉS ELOY BLANCO	1021	2	11	664	455	653	0	3	0	0	195	664
EDO. SUCRE	MP. MARI#O	PQ. IRAPA	ESCUELA BOLIVARIANA RÍO GRANDE ABAJO	282	1	0	196	109	196	0	0	0	0	87	196
EDO. SUCRE	MP. MARI#O	PQ. IRAPA	ESCUELA BÁSICA PUEBLO VIEJO	456	1	3	327	236	324	0	1	0	0	87	327
EDO. SUCRE	MP. MARI#O	PQ. IRAPA	ESCUELA BÁSICA MUNDO NUEVO	466	1	2	337	256	335	0	0	0	0	79	337
EDO. SUCRE	MP. MARI#O	PQ. IRAPA	ESCUELA BÁSICA EL CHAURE	407	1	8	288	178	280	0	2	0	0	100	288
EDO. SUCRE	MP. MARI#O	PQ. IRAPA	ESCUELA BOLIVARIANA RÍO GRANDE ARRIBA	836	2	17	597	298	580	0	1	0	0	281	597
EDO. SUCRE	MP. MARI#O	PQ. IRAPA	UNIDAD EDUCATIVA  SANTIAGO MARIÑO	920	2	8	644	378	636	0	3	0	0	255	644
EDO. SUCRE	MP. MARI#O	PQ. IRAPA	ESCUELA BASICA LAS MELENAS	70	1	1	56	45	55	0	1	0	0	9	56
EDO. SUCRE	MP. MARI#O	PQ. IRAPA	ESCUELA BOLIVARIANA VIRGINIA BOOZ	617	2	9	492	283	483	0	2	0	0	198	492
EDO. SUCRE	MP. MARI#O	PQ. IRAPA	UNIDAD EDUCATIVA JOSÉ EUSTAQUIO MACHADO	3344	6	36	2224	1214	2188	1	4	0	1	968	2224
EDO. SUCRE	MP. MARI#O	PQ. IRAPA	ESCUELA BÁSICA RÍO SECO	511	1	4	357	238	353	0	3	0	0	112	357
EDO. SUCRE	MP. MARI#O	PQ. IRAPA	ESCUELA BÁSICA RÍO CHIQUITO ARRIBA	520	1	7	402	281	395	0	1	0	0	113	402
EDO. SUCRE	MP. MARI#O	PQ. SAN ANTONIO DE IRAPA	UNIDAD EDUCATIVA SAN ANTONIO	1196	2	15	764	496	749	0	2	0	0	251	764
EDO. SUCRE	MP. MARI#O	PQ. SAN ANTONIO DE IRAPA	ESCUELA BOLIVARIANA MANACAL	248	1	2	180	113	178	0	0	0	0	65	180
EDO. SUCRE	MP. MARI#O	PQ. SAN ANTONIO DE IRAPA	ESCUELA BÁSICA LA MESETA	314	1	3	199	127	196	0	1	0	0	68	199
EDO. SUCRE	MP. ARISMENDI	PQ. ANTONIO JOSE DE SUCRE	ESCUELA BOLIVARIANA MACANILLAR	84	1	0	41	38	41	0	0	0	0	3	41
EDO. SUCRE	MP. ARISMENDI	PQ. ANTONIO JOSE DE SUCRE	ESCUELA BÁSICA PUERTO LA CRUZ
EDO. SUCRE	MP. ARISMENDI	PQ. ANTONIO JOSE DE SUCRE	ESCUELA BÁSICA BOCA DE CUMANA	215	1	0	105	80	105	0	0	0	0	25	105
EDO. SUCRE	MP. ARISMENDI	PQ. ANTONIO JOSE DE SUCRE	ESCUELA BÁSICA PUERTO CABALLO	271	1	1	187	156	186	0	0	0	0	30	187
EDO. SUCRE	MP. ARISMENDI	PQ. ANTONIO JOSE DE SUCRE	ESCUELA BOLIVARIANA PARGO
EDO. SUCRE	MP. ARISMENDI	PQ. ANTONIO JOSE DE SUCRE	ESCUELA BOLIVARIANA LUIS FELIPE RAMÍREZ BLANCO	1173	2	26	745	399	719	0	5	0	0	315	745
EDO. SUCRE	MP. ARISMENDI	PQ. ANTONIO JOSE DE SUCRE	ESCUELA BÁSICA UQUIRE
EDO. SUCRE	MP. ARISMENDI	PQ. ANTONIO JOSE DE SUCRE	ESCUELA BÁSICA PUERTO VIEJO	221	1	2	154	146	152	0	0	0	0	6	154
EDO. SUCRE	MP. ARISMENDI	PQ. ANTONIO JOSE DE SUCRE	ESCUELA BÁSICA SANTA ISABEL	82	1	1	47	45	46	0	0	1	0	0	47
EDO. SUCRE	MP. ARISMENDI	PQ. EL MORRO DE PTO SANTO	U.E. EL MORRO	2776	5	31	2103	1491	2072	0	5	1	2	573	2103
EDO. SUCRE	MP. ARISMENDI	PQ. EL MORRO DE PTO SANTO	UNIDAD EDUCATIVA ALBERTO CARNEVALLI	2625	5	21	1965	1224	1944	2	4	0	1	713	1965
EDO. SUCRE	MP. ARISMENDI	PQ. EL MORRO DE PTO SANTO	UNIDAD EDUCATIVA CONCENTRADA LA CISTERNA	252	1	5	214	158	209	0	1	0	0	50	214
EDO. SUCRE	MP. ARISMENDI	PQ. PUERTO SANTO	ESCUELA BOLIVARIANA RITA SUCRE DE RAMOS	1061	2	6	815	516	809	0	4	0	0	289	815
EDO. SUCRE	MP. ARISMENDI	PQ. PUERTO SANTO	ESCUELA BOLIVARIANA CRUZ DE PUERTO SANTO	1453	3	25	1048	586	1023	0	1	0	0	436	1048
EDO. SUCRE	MP. ARISMENDI	PQ. PUERTO SANTO	CENTRO DE EDUCACION INICIAL DONA ROSALIA CAMPINS DE HERRERA	463	1	8	355	226	347	0	0	0	0	121	355
EDO. SUCRE	MP. ARISMENDI	PQ. PUERTO SANTO	ESCUELA BÁSICA EL GUARICO	181	1	1	127	75	126	0	0	0	0	51	127
EDO. SUCRE	MP. ARISMENDI	PQ. PUERTO SANTO	ESCUELA BOLIVARIANA MAURAQUITO	644	2	5	448	286	443	0	4	0	0	153	448
EDO. SUCRE	MP. ARISMENDI	PQ. PUERTO SANTO	ESCUELA BOLIVARIANA LLANADA DE RIO	381	1	8	319	209	311	1	0	0	0	101	319
EDO. SUCRE	MP. ARISMENDI	PQ. SAN JUAN GALDONAS	CENTRO DE EDUCACION INICIAL EL LIMON	92	1	1	83	72	82	0	0	0	0	10	83
EDO. SUCRE	MP. ARISMENDI	PQ. SAN JUAN GALDONAS	ESCUELA BOLIVARIANA GUACUCO	465	1	4	329	293	325	0	0	0	0	32	329
EDO. SUCRE	MP. ARISMENDI	PQ. SAN JUAN GALDONAS	U.E. GUARATARO	636	2	3	450	295	447	0	2	0	0	150	450
EDO. SUCRE	MP. ARISMENDI	PQ. SAN JUAN GALDONAS	ESCUELA BÁSICA EL SACO	172	1	0	126	105	126	0	2	0	0	19	126
EDO. SUCRE	MP. ARISMENDI	PQ. SAN JUAN GALDONAS	ESCUELA BOLIVARIANA DON ANDRÉS BELLO	1467	3	27	969	610	942	0	7	1	0	324	969
EDO. SUCRE	MP. ARISMENDI	PQ. SAN JUAN GALDONAS	ESCUELA BASICA CANGUA
EDO. SUCRE	MP. ARISMENDI	PQ. SAN JUAN GALDONAS	ESCUELA BÁSICA LLANADA DE CANGUA
EDO. SUCRE	MP. ARISMENDI	PQ. SAN JUAN GALDONAS	ESCUELA BÁSICA BUENA VISTA	183	1	1	108	73	107	1	0	0	0	33	108
EDO. SUCRE	MP. ARISMENDI	PQ. RIO CARIBE	ESCUELA BÁSICA QUEBRADA SECA	413	1	4	264	159	260	0	0	1	0	100	264
EDO. SUCRE	MP. ARISMENDI	PQ. RIO CARIBE	ESCUELA BOLIVARIANA EL PUY PUY	616	2	3	372	206	369	0	2	0	0	161	372
EDO. SUCRE	MP. ARISMENDI	PQ. RIO CARIBE	ESCUELA BOLIVARIANA MEDINA	400	1	4	271	154	267	0	4	0	0	109	271
EDO. SUCRE	MP. ARISMENDI	PQ. RIO CARIBE	ESCUELA BOLIVARIANA GUAYABEROS	1078	2	13	830	506	817	0	4	0	1	306	830
EDO. SUCRE	MP. ARISMENDI	PQ. RIO CARIBE	U.E. DON FRANCISCO CARRASQUERO	982	2	11	753	491	742	0	2	0	0	249	753
EDO. SUCRE	MP. ARISMENDI	PQ. RIO CARIBE	ESCUELA BOLIVARIANA LAS VEGAS	452	1	4	389	247	385	0	1	1	0	136	389
EDO. SUCRE	MP. ARISMENDI	PQ. RIO CARIBE	ESCUELA BÁSICA LA CONCEPCIÓN	360	1	3	240	206	237	0	1	0	0	30	240
EDO. SUCRE	MP. ARISMENDI	PQ. RIO CARIBE	ESCUELA BOLIVARIANA NICOLÁS FLORES	2093	4	22	1585	971	1563	1	4	0	0	587	1585
EDO. SUCRE	MP. ARISMENDI	PQ. RIO CARIBE	ESCUELA BÁSICA CHAGUARAMAS DE LOERO	393	1	5	298	217	293	0	0	0	0	76	298
EDO. SUCRE	MP. ARISMENDI	PQ. RIO CARIBE	ESCUELA BOLIVARIANA LAS GUERRILLAS	168	1	2	162	123	160	0	0	0	0	37	162
EDO. SUCRE	MP. ARISMENDI	PQ. RIO CARIBE	ESCUELA BOLIVARIANA COCOLI	218	1	5	188	118	183	0	1	0	0	64	188
EDO. SUCRE	MP. ARISMENDI	PQ. RIO CARIBE	ESCUELA BOLIVARIANA ROJAS PAÚL	2541	5	26	1920	1108	1894	0	4	0	0	782	1920
EDO. SUCRE	MP. ARISMENDI	PQ. RIO CARIBE	U.E. CARLOS FRANCISCO GRISANTI	3075	6	31	2365	1247	2334	0	5	0	0	1082	2365
EDO. SUCRE	MP. ARISMENDI	PQ. RIO CARIBE	ESCUELA BÁSICA SANTA ISABEL
EDO. SUCRE	MP. ARISMENDI	PQ. RIO CARIBE	UNIDAD EDUCATIVA RIO SALADO	176	1	1	161	146	160	0	2	0	0	12	161
EDO. SUCRE	MP. ARISMENDI	PQ. RIO CARIBE	ESCUELA BÁSICA CARAQUITA	184	1	1	130	114	129	0	0	0	0	15	130
EDO. SUCRE	MP. ARISMENDI	PQ. RIO CARIBE	ESCUELA BÁSICA MAURACO	343	1	5	241	191	236	0	0	0	0	45	241
EDO. SUCRE	MP. ARISMENDI	PQ. RIO CARIBE	ESCUELA BASICA EL CUCHAPE	162	1	3	129	93	126	0	1	0	0	32	129
EDO. SUCRE	MP. ARISMENDI	PQ. RIO CARIBE	U.E.BOLIVARIANA SANTA BARBARA	213	1	1	186	141	185	0	1	0	0	43	186
EDO. SUCRE	MP. ARISMENDI	PQ. RIO CARIBE	ESCUELA BÁSICA PATUCUTAL	203	1	2	168	137	166	0	0	0	0	29	168
EDO. SUCRE	MP. ARISMENDI	PQ. RIO CARIBE	ESCUELA BÁSICA LA GLORIA	363	1	5	284	185	279	0	1	0	0	93	284
EDO. SUCRE	MP. ARISMENDI	PQ. RIO CARIBE	ESCUELA BÁSICA SANTA MARIA	171	1	2	121	110	119	0	1	0	0	8	121
EDO. SUCRE	MP. ARISMENDI	PQ. RIO CARIBE	ESCUELA BÁSICA VUELTA LARGA	281	1	0	186	159	186	0	0	0	0	27	186
EDO. SUCRE	MP. ARISMENDI	PQ. RIO CARIBE	ESCUELA BÁSICA CHACARACUAL	780	2	8	492	348	484	0	3	1	0	132	492
EDO. SUCRE	MP. ARISMENDI	PQ. RIO CARIBE	ESCUELA BÁSICA CATUARITO	197	1	0	150	136	150	0	0	0	0	14	150
EDO. SUCRE	MP. ARISMENDI	PQ. RIO CARIBE	ESCUELA BÁSICA MANACAL	141	1	0	100	95	100	0	0	0	0	5	100
EDO. SUCRE	MP. ARISMENDI	PQ. RIO CARIBE	ESCUELA CATUCHAL	91	1	2	65	35	63	0	1	0	0	27	65
EDO. SUCRE	MP. ARISMENDI	PQ. RIO CARIBE	ESCUELA BOLIVARIANA ISABEL MARÍA ARISMENDI	713	2	11	545	330	534	0	2	0	0	202	545
EDO. SUCRE	MP. ARISMENDI	PQ. RIO CARIBE	ESCUELA BOLIVARIANA CHURUPAL	566	1	5	397	282	392	0	0	0	0	110	397
EDO. SUCRE	MP. ARISMENDI	PQ. RIO CARIBE	ESCUELA BOLIVARIANA AGUA FRÍA ARRIBA	218	1	1	138	81	137	1	1	0	0	54	138
EDO. SUCRE	MP. ARISMENDI	PQ. RIO CARIBE	ESCUELA BÁSICA GUARAPICHE	255	1	2	158	139	156	0	0	0	0	17	158
EDO. SUCRE	MP. ANDRES MATA	PQ. TAVERA ACOSTA	ESCUELA BÁSICA CEDEÑO DE LOS BLANCOS	222	1	0	140	95	140	0	0	0	0	45	140
EDO. SUCRE	MP. ANDRES MATA	PQ. TAVERA ACOSTA	ESCUELA BÁSICA FUENTE DE LOURDES	328	1	2	218	163	216	0	3	0	0	50	218
EDO. SUCRE	MP. ANDRES MATA	PQ. TAVERA ACOSTA	ESCUELA BOLIVARIANA BLANCO LUGAR	387	1	3	266	150	263	0	0	0	0	113	266
EDO. SUCRE	MP. ANDRES MATA	PQ. TAVERA ACOSTA	ESCUELA BOLIVARIANA RÍO CASANAY	566	1	4	407	227	403	0	4	0	0	172	407
EDO. SUCRE	MP. ANDRES MATA	PQ. TAVERA ACOSTA	ESCUELA BOLIVARIANA CANGREJAL	706	2	0	531	394	531	1	2	0	0	134	531
EDO. SUCRE	MP. ANDRES MATA	PQ. TAVERA ACOSTA	ESCUELA BÁSICA PUTUCUAL	448	1	3	304	213	301	0	1	0	0	87	304
EDO. SUCRE	MP. ANDRES MATA	PQ. TAVERA ACOSTA	ESCUELA BASICA LAS TOSCANAS	98	1	1	87	72	86	0	0	0	0	14	87
EDO. SUCRE	MP. ANDRES MATA	PQ. TAVERA ACOSTA	UNIDAD EDUCATIVA BOLIVARIANA SORO	274	1	3	199	138	196	0	0	0	0	58	199
EDO. SUCRE	MP. ANDRES MATA	PQ. TAVERA ACOSTA	UNIDAD EDUCATIVA BOLIVARIANA SALOBRE	350	1	7	234	158	227	0	0	0	0	69	234
EDO. SUCRE	MP. ANDRES MATA	PQ. TAVERA ACOSTA	ESCUELA BÁSICA LA BATEA	205	1	2	152	102	150	0	0	0	0	48	152
EDO. SUCRE	MP. ANDRES MATA	PQ. TAVERA ACOSTA	UNIDAD EDUCATIVA BOLIVARIANA EL CAUTARO	252	1	4	188	148	184	0	3	0	0	33	188
EDO. SUCRE	MP. ANDRES MATA	PQ. TAVERA ACOSTA	ESCUELA BOLIVARIANA AGUA CLARITA	618	2	6	462	402	456	0	2	0	0	52	462
EDO. SUCRE	MP. ANDRES MATA	PQ. TAVERA ACOSTA	UNIDAD EDUCATIVA BOLIVARIANA CEDEÑOS DE LOS NEGROS	96	1	1	24	16	23	0	0	0	0	7	24
EDO. SUCRE	MP. ANDRES MATA	PQ. TAVERA ACOSTA	UNIDAD EDUCATIVA NUEVA COLOMBIA	565	1	2	361	220	359	0	0	0	0	139	361
EDO. SUCRE	MP. ANDRES MATA	PQ. TAVERA ACOSTA	UNIDAD EDUCATIVA ESTADAL AGUAS CALIENTES	119	1	5	101	88	96	0	0	1	0	7	101
EDO. SUCRE	MP. ANDRES MATA	PQ. TAVERA ACOSTA	ESCUELA BOLIVARIANA JUAN SÁNCHEZ	597	1	4	463	317	459	0	1	0	0	141	463
EDO. SUCRE	MP. ANDRES MATA	PQ. TAVERA ACOSTA	ESCUELA BÁSICA GUARUTA	368	1	4	284	156	280	0	1	1	0	122	284
EDO. SUCRE	MP. ANDRES MATA	PQ. TAVERA ACOSTA	ESCUELA BÁSICA SANTA BÁRBARA	309	1	6	220	144	214	0	1	0	1	68	220
EDO. SUCRE	MP. ANDRES MATA	PQ. SAN JOSE DE AREOCUAR	ESCUELA BOLIVARIANA QUEREMENE	585	1	12	483	191	471	0	1	0	0	279	483
EDO. SUCRE	MP. ANDRES MATA	PQ. SAN JOSE DE AREOCUAR	ESCUELA BASICA UNITARIA ESTADAL MACANILLAR	61	1	0	47	38	47	0	1	0	0	8	47
EDO. SUCRE	MP. ANDRES MATA	PQ. SAN JOSE DE AREOCUAR	ESCUELA RURAL BOLIVARIANA GUARICUCO	323	1	2	282	164	280	0	0	0	0	116	282
EDO. SUCRE	MP. ANDRES MATA	PQ. SAN JOSE DE AREOCUAR	ESCUELA BÁSICA LLANADA DE GUIRIA	692	2	9	540	377	531	0	0	0	0	154	540
EDO. SUCRE	MP. ANDRES MATA	PQ. SAN JOSE DE AREOCUAR	ESCUELA BOLIVARIANA LOS MANGOS	75	1	0	58	37	58	0	0	0	0	21	58
EDO. SUCRE	MP. ANDRES MATA	PQ. SAN JOSE DE AREOCUAR	ESCUELA BOLIVARIANA BELLO MONTE	490	1	2	367	312	365	0	0	0	1	52	367
EDO. SUCRE	MP. ANDRES MATA	PQ. SAN JOSE DE AREOCUAR	ESCUELA BÁSICA SAN ROQUE	341	1	11	302	142	291	0	0	0	1	148	302
EDO. SUCRE	MP. ANDRES MATA	PQ. SAN JOSE DE AREOCUAR	ESCUELA BÁSICA RIVILLA	483	1	10	402	241	392	0	1	0	0	150	402
EDO. SUCRE	MP. ANDRES MATA	PQ. SAN JOSE DE AREOCUAR	ESCUELA BASICA SAN ANTONIO	146	1	6	129	76	123	0	0	0	0	47	129
EDO. SUCRE	MP. ANDRES MATA	PQ. SAN JOSE DE AREOCUAR	ESCUELA BÁSICA CAMINO DE GÜIRIA	380	1	5	284	178	279	0	1	0	0	100	284
EDO. SUCRE	MP. ANDRES MATA	PQ. SAN JOSE DE AREOCUAR	ESCUELA PRIMARIA BOLIVARIANA LAS MARGARITAS	424	1	15	311	249	296	0	0	0	0	47	311
EDO. SUCRE	MP. ANDRES MATA	PQ. SAN JOSE DE AREOCUAR	UNIDAD EDUCATIVA CAMPEARE	598	1	6	411	316	405	0	3	0	0	86	411
EDO. SUCRE	MP. ANDRES MATA	PQ. SAN JOSE DE AREOCUAR	ESCUELA BÁSICA LOMA LARGA	282	1	2	207	171	205	0	0	1	0	33	207
EDO. SUCRE	MP. ANDRES MATA	PQ. SAN JOSE DE AREOCUAR	U.E. ANDRÉS MATA	761	2	19	630	316	611	0	1	0	0	294	630
EDO. SUCRE	MP. ANDRES MATA	PQ. SAN JOSE DE AREOCUAR	ESCUELA BÁSICA LOMA DEL CARMEN	235	1	3	151	122	148	0	0	0	0	26	151
EDO. SUCRE	MP. ANDRES MATA	PQ. SAN JOSE DE AREOCUAR	ESCUELA BÁSICA EL INDIO	281	1	0	211	110	211	0	0	0	0	101	211
EDO. SUCRE	MP. ANDRES MATA	PQ. SAN JOSE DE AREOCUAR	ESCUELA BÁSICA LOMAS DE CHUPARIPAL	412	1	4	279	220	275	0	0	0	0	55	279
EDO. SUCRE	MP. ANDRES MATA	PQ. SAN JOSE DE AREOCUAR	ESCUELA BÁSICA CHACARACUAL	111	1	1	56	37	55	0	0	0	0	18	56
EDO. SUCRE	MP. ANDRES MATA	PQ. SAN JOSE DE AREOCUAR	ESCUELA BASICA SANGUIJUELA	329	1	3	250	150	247	0	1	0	0	96	250
EDO. SUCRE	MP. ANDRES MATA	PQ. SAN JOSE DE AREOCUAR	ESCUELA BASICA BUENA VISTA	171	1	1	143	79	142	0	0	1	0	62	143
EDO. SUCRE	MP. ANDRES MATA	PQ. SAN JOSE DE AREOCUAR	CASA DE LA CULTURA DOÑA INÉS SUBERO PÉREZ	1002	2	11	812	369	801	0	1	0	0	431	812
EDO. SUCRE	MP. ANDRES MATA	PQ. SAN JOSE DE AREOCUAR	UNIDAD EDUCATIVA JOSÉ MIGUEL HERNÁNDEZ	868	2	8	708	416	700	0	1	0	0	283	708
EDO. SUCRE	MP. ANDRES MATA	PQ. SAN JOSE DE AREOCUAR	PERIQUITO SECTOR EL TROPESON	100	1	1	52	48	51	0	0	0	0	3	52
EDO. SUCRE	MP. ANDRES MATA	PQ. SAN JOSE DE AREOCUAR	ESCUELA BOLIVARIANA LECHOZAL	184	1	5	149	123	144	0	0	0	2	19	149
EDO. SUCRE	MP. ANDRES MATA	PQ. SAN JOSE DE AREOCUAR	ESCUELA BÁSICA HUESO DE MULA	168	1	5	130	82	125	0	0	0	0	43	130
EDO. SUCRE	MP. BERMUDEZ	PQ. SANTA CATALINA	ESCUELA BOLIVARIANA RÍO SECO EL CHARCAL	940	2	18	630	467	612	0	3	5	0	137	630
EDO. SUCRE	MP. BERMUDEZ	PQ. SANTA CATALINA	UNIDAD EDUCATIVA  SIMÓN BOLÍVAR	1349	3	11	1125	408	1114	0	4	0	0	702	1125
EDO. SUCRE	MP. BERMUDEZ	PQ. SANTA CATALINA	ESCUELA BÁSICA QUEBRADA DE CARATA	544	1	3	405	216	402	0	2	0	0	184	405
EDO. SUCRE	MP. BERMUDEZ	PQ. SANTA CATALINA	UNIDAD EDUCATIVA EL CHARCAL	205	1	4	158	114	154	1	0	0	0	39	158
EDO. SUCRE	MP. BERMUDEZ	PQ. SANTA CATALINA	I.U.T. JACINTO NAVARRO VALLENILLA	1788	3	24	1446	837	1422	0	10	0	1	574	1446
EDO. SUCRE	MP. BERMUDEZ	PQ. SANTA CATALINA	ESCUELA BOLIVARIANA  PUCHURUCO	997	2	10	777	594	767	0	3	0	0	170	777
EDO. SUCRE	MP. BERMUDEZ	PQ. SANTA CATALINA	UNIDAD EDUCATIVA  SANTA ROSA DE LIMA	1569	3	19	1197	704	1178	0	6	2	1	465	1197
EDO. SUCRE	MP. BERMUDEZ	PQ. SANTA CATALINA	ESCUELA BÁSICA 9 DE ABRIL	306	1	2	253	193	251	0	1	2	0	55	253
EDO. SUCRE	MP. BERMUDEZ	PQ. SANTA CATALINA	ESCUELA BOLIVARIANA MARIA RODRÍGUEZ DE VERA	3109	6	46	2396	1263	2350	0	12	1	1	1073	2396
EDO. SUCRE	MP. BERMUDEZ	PQ. SANTA CATALINA	ESCUELA BÁSICA EL MUCO	1643	3	17	1316	759	1299	0	10	1	2	527	1316
EDO. SUCRE	MP. BERMUDEZ	PQ. SANTA CATALINA	CENTRO DE EDUCACION JOSE ANGEL MOYA	192	1	2	184	124	182	0	0	0	0	58	184
EDO. SUCRE	MP. BERMUDEZ	PQ. SANTA CATALINA	LICEO JOSÉ FRANCISCO BERMÚDEZ	4033	7	40	3209	1973	3169	0	14	5	0	1177	3209
EDO. SUCRE	MP. BERMUDEZ	PQ. SANTA CATALINA	CENTRO DE EDUCACION INICIAL MARIA LUISA ORTIZ	589	1	12	533	396	521	0	0	1	0	124	533
EDO. SUCRE	MP. BERMUDEZ	PQ. SANTA CATALINA	UNIDAD EDUCATIVA  JOSÉ JESÚS MARTÍNEZ MATA	2711	5	44	2221	1104	2177	0	12	1	1	1059	2221
EDO. SUCRE	MP. BERMUDEZ	PQ. SANTA CATALINA	INCE POLIVALENTE CARUPANO	2868	5	34	2296	1503	2262	1	9	0	0	749	2296
EDO. SUCRE	MP. BERMUDEZ	PQ. SANTA CATALINA	UNIDAD EDUCATIVA  1RO DE MAYO	3389	6	30	2696	1574	2666	0	14	2	1	1075	2696
EDO. SUCRE	MP. BERMUDEZ	PQ. SANTA CATALINA	ESCUELA BOLIVARIANA GUAYACAN DE LAS FLORES	3354	6	55	2654	1537	2599	0	22	2	2	1036	2654
EDO. SUCRE	MP. BERMUDEZ	PQ. SANTA CATALINA	ESCUELA BASICA CONCENTRADA MIXTA LOS COCOS	1063	2	13	951	633	938	0	2	1	0	302	951
EDO. SUCRE	MP. BERMUDEZ	PQ. SANTA CATALINA	GIMNASIO CUBIERTO CHELO CABRERA	820	2	20	684	349	664	0	1	2	0	312	684
EDO. SUCRE	MP. BERMUDEZ	PQ. SANTA CATALINA	UNIDAD EDUCATIVA BOLIVARIANA JOSE ANTONIO RODRIGUEZ ABREU	3812	7	35	3041	1860	3006	1	14	0	3	1128	3041
EDO. SUCRE	MP. BERMUDEZ	PQ. SANTA CATALINA	ESCUELA BÁSICA PLAYA DE SAL	757	2	10	547	426	537	0	3	0	0	108	547
EDO. SUCRE	MP. BERMUDEZ	PQ. SANTA CATALINA	ESCUELA BÁSICA LA SOLEDAD	380	1	19	205	127	186	0	3	1	0	55	205
EDO. SUCRE	MP. BERMUDEZ	PQ. SANTA CATALINA	CENTRO EDUCACIÓN INICIAL GUAYACAN DE LAS FLORES LOCAL N° 03	226	1	5	202	143	197	0	1	0	0	53	202
EDO. SUCRE	MP. BERMUDEZ	PQ. SANTA CATALINA	UNIDAD EDUCATIVA  JUANITA SALINA DE GAMBOA	2193	4	22	1837	1017	1815	2	4	0	1	791	1837
EDO. SUCRE	MP. BERMUDEZ	PQ. SANTA CATALINA	UNIDAD EDUCATIVA BOLIVARIANA PERIQUITO	84	1	1	69	50	68	1	1	0	0	16	69
EDO. SUCRE	MP. BERMUDEZ	PQ. SANTA CATALINA	ESCUELA BOLIVARIANA PEDRO ELÍAS ARISTIGUIETA	3464	6	37	2360	1034	2323	0	6	0	1	1282	2360
EDO. SUCRE	MP. BERMUDEZ	PQ. SANTA CATALINA	ESCUELA BOLIVARIANA EL LIRIO	858	2	11	745	517	734	1	1	0	0	215	745
EDO. SUCRE	MP. BERMUDEZ	PQ. SANTA CATALINA	ESCUELA BOLIVARIANA LAS AZUCENAS	610	2	6	510	338	504	0	4	1	1	160	510
EDO. SUCRE	MP. BERMUDEZ	PQ. SANTA ROSA	UNIDAD EDUCATIVA REPÚBLICA DE HAITÍ	2167	4	27	1627	672	1600	0	5	1	1	921	1627
EDO. SUCRE	MP. BERMUDEZ	PQ. SANTA ROSA	INTERNADO JUDICIAL DE CARUPANO	390	1	7	229	112	222	0	0	0	1	109	229
EDO. SUCRE	MP. BERMUDEZ	PQ. SANTA ROSA	ESCUELA BOLIVARIANA TACOA	745	2	5	618	440	613	1	1	2	0	169	618
EDO. SUCRE	MP. BERMUDEZ	PQ. SANTA ROSA	UNIDAD EDUCATIVA PRIVADA JOSÉ FRANCISCO BERMÚDEZ	818	2	11	710	252	699	1	1	1	0	444	710
EDO. SUCRE	MP. BERMUDEZ	PQ. SANTA ROSA	LICEO BOLIVARIANO TAVERA ACOSTA	970	2	17	757	415	740	0	5	0	3	317	757
EDO. SUCRE	MP. BERMUDEZ	PQ. SANTA ROSA	LICEO SIMÓN RODRÍGUEZ	1276	3	17	1049	555	1032	0	5	1	1	470	1049
EDO. SUCRE	MP. BERMUDEZ	PQ. SANTA ROSA	FUNDACION CULTURAL ATENEO DE CURACHO	1308	3	10	1014	635	1004	0	2	1	1	365	1014
EDO. SUCRE	MP. BERMUDEZ	PQ. SANTA ROSA	UNIDAD EDUCATIVA  PRIVADA SAN JOSE	789	2	8	595	209	587	1	2	0	0	375	595
EDO. SUCRE	MP. BERMUDEZ	PQ. SANTA ROSA	ESCUELA BOLIVARIANA CRISTÓBAL COLÓN	1113	2	17	869	529	852	0	0	1	0	322	869
EDO. SUCRE	MP. BERMUDEZ	PQ. SANTA ROSA	UNIDAD EDUCATIVA BARRIO BOLIVAR	323	1	4	296	154	292	0	0	0	0	138	296
EDO. SUCRE	MP. BERMUDEZ	PQ. SANTA ROSA	UNIDAD EDUCATIVA PRIVADA DON ANDRÉS BELLO	896	2	18	716	316	698	0	1	0	0	381	716
EDO. SUCRE	MP. BERMUDEZ	PQ. SANTA ROSA	LICEO PEDRO ARISMENDI BRITO	1907	4	35	1603	1075	1568	0	5	0	0	488	1603
EDO. SUCRE	MP. BERMUDEZ	PQ. SANTA ROSA	ESCUELA BÁSICA CHIPICHIPI	811	2	8	626	406	618	0	2	1	0	209	626
EDO. SUCRE	MP. BERMUDEZ	PQ. SANTA ROSA	UNIDAD GERONTOLOGICA JOSE MANUEL ZUNIAGA.	1227	3	24	1015	582	991	1	8	1	0	399	1015
EDO. SUCRE	MP. BERMUDEZ	PQ. SANTA ROSA	LICEO BÁSICO PEDRO JOSÉ SALAZAR	2012	4	18	1554	780	1536	0	6	0	0	750	1554
EDO. SUCRE	MP. BERMUDEZ	PQ. SANTA ROSA	UNIDAD EDUCATIVA ESTADAL EUSTOQUIA LUIGGI	1424	3	14	1178	522	1164	0	5	0	0	637	1178
EDO. SUCRE	MP. BERMUDEZ	PQ. SANTA ROSA	ESCUELA BOLIVARIANA CUSMA	506	1	4	395	248	391	0	1	0	0	142	395
EDO. SUCRE	MP. BERMUDEZ	PQ. SANTA ROSA	UNIDAD EDUCATIVA  MARIA REINA DE LÓPEZ	2322	4	33	1789	1159	1756	0	9	1	0	587	1789
EDO. SUCRE	MP. BERMUDEZ	PQ. MACARAPANA	ESCUELA BOLIVARIANA EUSTOQUIA SOLEDAD LUIGGI	2969	6	43	2406	1303	2363	0	11	0	0	1049	2406
EDO. SUCRE	MP. BERMUDEZ	PQ. MACARAPANA	ESCUELA BOLIVARIANA LA SIERRA	123	1	1	86	63	85	0	0	0	0	22	86
EDO. SUCRE	MP. BERMUDEZ	PQ. MACARAPANA	ESCUELA BÁSICA CANAIMA	156	1	2	85	63	83	0	0	0	0	20	85
EDO. SUCRE	MP. BERMUDEZ	PQ. MACARAPANA	ESCUELA BOLIVARIANA MACARAPANA	1040	2	9	827	543	818	0	4	0	0	271	827
EDO. SUCRE	MP. BERMUDEZ	PQ. SANTA TERESA	CENTRO DE EDUCACION INICIAL TIO PEDRO	1171	2	7	1039	465	1032	0	4	0	0	563	1039
EDO. SUCRE	MP. BERMUDEZ	PQ. SANTA TERESA	UNIDAD EDUCATIVA MANUEL MARIA URBANEJA	2701	5	24	2097	1109	2073	0	9	2	0	953	2097
EDO. SUCRE	MP. BERMUDEZ	PQ. SANTA TERESA	FUNDACIÓN DEPORTIVA ING. MANUEL RODRIGUEZ	149	1	3	135	82	132	0	0	0	0	50	135
EDO. SUCRE	MP. BERMUDEZ	PQ. BOLIVAR	ESCUELA BOLIVARIANA PLAYA GRANDE	2224	4	18	1746	1029	1728	0	8	0	1	690	1746
EDO. SUCRE	MP. BERMUDEZ	PQ. BOLIVAR	ESCUELA BOLIVARIANA POZO COLORADO	683	2	6	588	518	582	0	2	0	0	62	588
EDO. SUCRE	MP. BERMUDEZ	PQ. BOLIVAR	ESCUELA BASICA ESTADO ANZOATEGUI	3832	7	45	2817	2047	2772	0	9	3	0	713	2817
EDO. SUCRE	MP. BERMUDEZ	PQ. BOLIVAR	ESCUELA BASICA LA MARINA II	460	1	7	386	287	379	0	1	0	0	91	386
EDO. SUCRE	MP. BERMUDEZ	PQ. BOLIVAR	ESCUELA BÁSICA LONDRES	732	2	5	567	386	562	1	6	0	0	169	567
EDO. SUCRE	MP. BERMUDEZ	PQ. BOLIVAR	CENTRO DE EDUCACION INICIAL VIRGEN DEL VALLE	611	2	13	541	413	528	0	0	0	0	115	541
EDO. SUCRE	MP. BERMUDEZ	PQ. BOLIVAR	CENTRO COOPERATIVO   EMPRESARIAL HATO ROMAR II	619	2	11	562	406	551	0	3	0	0	142	562
EDO. SUCRE	MP. BERMUDEZ	PQ. BOLIVAR	CASA DE LA CULTURA JULIO MIRANDA	502	1	7	446	277	439	0	1	0	0	161	446
EDO. SUCRE	MP. BERMUDEZ	PQ. BOLIVAR	UNIDAD EDUCATIVA JOSE MARIA VARGAS	241	1	4	223	181	219	0	1	0	0	37	223
EDO. SUCRE	MP. BERMUDEZ	PQ. BOLIVAR	ESCUELA BOLIVARIANA PETRICA REYES DE QUILARQUE	4282	8	65	3310	2091	3245	0	13	2	0	1139	3310
EDO. SUCRE	MP. BERMUDEZ	PQ. BOLIVAR	LICEO NACIONAL BOLIVARIANO CREACIÓN GUACA	696	2	15	566	449	551	0	1	0	0	101	566
EDO. SUCRE	MP. BERMUDEZ	PQ. BOLIVAR	UNIDAD EDUCATIVA  JOSÉ FRANCISCO BERMÚDEZ	948	2	18	823	559	805	0	3	0	0	243	823
EDO. SUCRE	MP. BERMUDEZ	PQ. BOLIVAR	PREFECTURA PARROQUIA BOLIVAR	335	1	7	295	196	288	0	2	0	0	90	295
EDO. SUCRE	MP. BERMUDEZ	PQ. BOLIVAR	CENTRO DE EDUCACION INICIAL GUATAPANARE	582	1	1	291	247	290	0	4	0	0	39	291
EDO. SUCRE	MP. BERMUDEZ	PQ. BOLIVAR	LICEO BOLIVARIANO JORGE ORDOSGOITI	2516	5	27	2162	976	2135	0	14	0	0	1145	2162
EDO. SUCRE	MP. BERMUDEZ	PQ. BOLIVAR	UNIDAD EDUCATIVA   JOSÉ ANTONIO PÁEZ	2073	4	38	1615	1101	1577	2	8	5	1	460	1615
EDO. SUCRE	MP. CAJIGAL	PQ. PAUJIL	ESCUELA BOLIVARIANA QUEBRADA SECA	193	1	4	174	151	170	0	0	0	0	19	174
EDO. SUCRE	MP. CAJIGAL	PQ. PAUJIL	UNIDAD EDUCATIVA DR. JOSÉ MARÍA VARGAS	739	2	7	516	351	509	0	0	0	0	158	516
EDO. SUCRE	MP. CAJIGAL	PQ. PAUJIL	ESCUELA BÁSICA GANCHO SECO	65	1	1	45	42	44	0	0	0	0	2	45
EDO. SUCRE	MP. CAJIGAL	PQ. PAUJIL	ESCUELA BÁSICA SAN AGUSTÍN	47	1	3	21	9	18	0	0	0	0	9	21
EDO. SUCRE	MP. CAJIGAL	PQ. PAUJIL	ESCUELA BOLIVARIANA EL PAUJIL	1540	3	22	1076	684	1054	0	6	0	0	364	1076
EDO. SUCRE	MP. CAJIGAL	PQ. PAUJIL	LICEO BOLIVARIANO EL PAUJIL	172	1	5	118	76	113	0	1	0	0	36	118
EDO. SUCRE	MP. CAJIGAL	PQ. LIBERTAD	ESCUELA BOLIVARIANA RÍO GRANDE	84	1	1	48	38	47	0	1	0	0	8	48
EDO. SUCRE	MP. CAJIGAL	PQ. LIBERTAD	U.E. TERESA DE LA PARRA	1622	3	35	1108	760	1073	0	6	0	0	307	1108
EDO. SUCRE	MP. CAJIGAL	PQ. LIBERTAD	ESCUELA BÁSICA ALGARROBO SANTA ELENA	313	1	2	206	164	204	0	0	0	0	40	206
EDO. SUCRE	MP. CAJIGAL	PQ. LIBERTAD	ESCUELA BOLIVARIANA BOHORDAL	830	2	6	574	458	568	0	3	0	1	106	574
EDO. SUCRE	MP. CAJIGAL	PQ. LIBERTAD	ESCUELA BASICA LOS ALTOS DE SAN PEDRO	150	1	2	121	89	119	0	1	0	0	29	121
EDO. SUCRE	MP. CAJIGAL	PQ. LIBERTAD	ESCUELA BÁSICA TACARICUAL	179	1	2	134	93	132	0	3	1	0	35	134
EDO. SUCRE	MP. CAJIGAL	PQ. LIBERTAD	ESCUELA BÁSICA LAS CATANAS	247	1	4	151	118	147	0	0	0	0	29	151
EDO. SUCRE	MP. CAJIGAL	PQ. LIBERTAD	ESCUELA BÁSICA LAS MARÍAS	65	1	0	39	22	39	0	0	0	0	17	39
EDO. SUCRE	MP. CAJIGAL	PQ. LIBERTAD	ESCUELA BÁSICA SANTA ELENA	138	1	2	80	73	78	0	0	0	0	5	80
EDO. SUCRE	MP. CAJIGAL	PQ. LIBERTAD	ESCUELA BÁSICA RÍO DEL MEDIO	174	1	1	133	117	132	0	0	0	0	15	133
EDO. SUCRE	MP. CAJIGAL	PQ. LIBERTAD	LICEO BOLIVARIANO CREACION RIO SECO	176	1	2	150	115	148	0	1	0	0	32	150
EDO. SUCRE	MP. CAJIGAL	PQ. LIBERTAD	ESCUELA BÁSICA LOS RIÍTOS
EDO. SUCRE	MP. CAJIGAL	PQ. YAGUARAPARO	ESCUELA BÁSICA LA CHIVERA	584	1	3	421	321	418	0	2	0	0	95	421
EDO. SUCRE	MP. CAJIGAL	PQ. YAGUARAPARO	ESCUELA BOLIVARIANA QUEBRADA DE LA NIÑA	716	2	7	512	410	505	0	0	0	0	95	512
EDO. SUCRE	MP. CAJIGAL	PQ. YAGUARAPARO	ALDEA BOLIVARIANA JUAN MANUEL CAJIGAL	167	1	3	146	118	143	0	1	0	0	24	146
EDO. SUCRE	MP. CAJIGAL	PQ. YAGUARAPARO	ESCUELA BOLIVARIANA CHOROCHORO	739	2	19	537	390	518	0	2	0	0	126	537
EDO. SUCRE	MP. CAJIGAL	PQ. YAGUARAPARO	ESCUELA BOLIVARIANA LA HORQUETICA	89	1	1	78	74	77	0	0	0	0	3	78
EDO. SUCRE	MP. CAJIGAL	PQ. YAGUARAPARO	ESCUELA BÁSICA LA HORQUETA DE MATACHIVO	405	1	0	300	282	300	0	0	0	0	18	300
EDO. SUCRE	MP. CAJIGAL	PQ. YAGUARAPARO	ESCUELA BASICA PITOTAN	155	1	2	131	124	129	0	1	0	0	4	131
EDO. SUCRE	MP. CAJIGAL	PQ. YAGUARAPARO	ESCUELA BOLIVARIANA LA MONTAÑA	180	1	2	161	141	159	0	2	0	0	16	161
EDO. SUCRE	MP. CAJIGAL	PQ. YAGUARAPARO	U.E. DIEGO CARBONELL	2028	4	30	1526	965	1496	1	4	0	1	525	1526
EDO. SUCRE	MP. CAJIGAL	PQ. YAGUARAPARO	UNIDAD EDUCATIVA  DR. JUAN MANUEL CAJIGAL	2301	4	47	1673	908	1626	0	2	0	0	716	1673
EDO. SUCRE	MP. CAJIGAL	PQ. YAGUARAPARO	ESCUELA BOLIVARIANA LOS MARINES	98	1	0	87	78	87	0	0	0	0	9	87
EDO. SUCRE	MP. CAJIGAL	PQ. YAGUARAPARO	ESCUELA BOLIVARIANA BARCELÓ	319	1	1	221	181	220	0	2	0	0	37	221
EDO. SUCRE	MP. CAJIGAL	PQ. YAGUARAPARO	ESCUELA BÁSICA QUEBRADA DE PIEDRA	135	1	0	87	76	87	0	0	0	0	11	87
EDO. SUCRE	MP. CAJIGAL	PQ. YAGUARAPARO	ESCUELA BÁSICA BUENOS AIRES	209	1	0	131	110	131	0	1	0	0	20	131
EDO. SUCRE	MP. CAJIGAL	PQ. YAGUARAPARO	ESCUELA BOLIVARIANA LOS PALMARES	100	1	2	86	77	84	0	0	0	0	7	86
EDO. SUCRE	MP. CRUZ S ACOSTA	PQ. ARAYA	PREESCOLAR JUAN JOSE AVILA	1405	3	20	1091	635	1071	0	7	1	0	428	1091
EDO. SUCRE	MP. CRUZ S ACOSTA	PQ. ARAYA	ESCUELA BOLIVARIANA DR. LUIS NAPOLEÓN BLANCO	1980	4	35	1492	972	1457	0	7	0	0	478	1492
EDO. SUCRE	MP. CRUZ S ACOSTA	PQ. ARAYA	ESCUELA BOLIVARIANA NUESTRA SEÑORA DEL CARMEN	923	2	8	689	502	681	0	0	2	0	177	689
EDO. SUCRE	MP. CRUZ S ACOSTA	PQ. ARAYA	LICEO BOLIVARIANO SALVADOR CÓRDOBA	2620	5	43	2182	1393	2139	0	11	1	0	734	2182
EDO. SUCRE	MP. CRUZ S ACOSTA	PQ. ARAYA	ESCUELA CONCENTRADA PUNTA COLORADA	352	1	5	298	261	293	0	1	0	0	31	298
EDO. SUCRE	MP. CRUZ S ACOSTA	PQ. ARAYA	UNIDAD EDUCATIVA ROMAN DELGADO CHALBOUD	1150	2	8	821	506	813	1	0	0	1	305	821
EDO. SUCRE	MP. CRUZ S ACOSTA	PQ. ARAYA	ESCUELA BOLIVARIANA EL CASTILLO	197	1	5	171	125	166	0	0	1	0	40	171
EDO. SUCRE	MP. CRUZ S ACOSTA	PQ. ARAYA	U.E. JOSÉ FÉLIX RIBAS	2572	5	33	1974	1223	1941	0	7	3	0	708	1974
EDO. SUCRE	MP. CRUZ S ACOSTA	PQ. ARAYA	U.E. CRUZ SALMERON ACOSTA	2486	5	42	1871	1165	1829	1	11	0	0	652	1871
EDO. SUCRE	MP. CRUZ S ACOSTA	PQ. MANICUARE	ESCUELA BOLIVARIANA PUNTA ARENA	389	1	6	304	230	298	0	1	0	0	67	304
EDO. SUCRE	MP. CRUZ S ACOSTA	PQ. MANICUARE	ESCUELA BOLIVARIANA LAGUNA CHICA	157	1	3	152	130	149	0	0	0	0	19	152
EDO. SUCRE	MP. CRUZ S ACOSTA	PQ. MANICUARE	UNIDAD EDUCATIVA LA ANGOLETA	642	2	7	509	414	502	0	0	0	0	88	509
EDO. SUCRE	MP. CRUZ S ACOSTA	PQ. MANICUARE	ESCUELA BOLIVARIANA MERITO	653	2	2	572	408	570	0	0	0	0	162	572
EDO. SUCRE	MP. CRUZ S ACOSTA	PQ. MANICUARE	ESCUELA BOLIVARIANA TACARIGUA	605	2	8	553	334	545	0	2	0	0	209	553
EDO. SUCRE	MP. CRUZ S ACOSTA	PQ. MANICUARE	ESCUELA MIXTA CONCENTRADA SALAZAR	231	1	1	206	166	205	0	0	0	0	39	206
EDO. SUCRE	MP. CRUZ S ACOSTA	PQ. MANICUARE	U.E. CRUZ SALMERON ACOSTA	2914	5	38	2257	1312	2219	1	18	0	1	887	2257
EDO. SUCRE	MP. CRUZ S ACOSTA	PQ. CHACOPATA	U.E. NUESTRA SEÑORA DEL ROSARIO	1759	3	16	1379	914	1363	0	4	0	0	445	1379
EDO. SUCRE	MP. CRUZ S ACOSTA	PQ. CHACOPATA	ESCUELA BOLIVARIANA LOS CACHICATOS	416	1	13	343	207	330	0	2	0	0	121	343
EDO. SUCRE	MP. CRUZ S ACOSTA	PQ. CHACOPATA	UNIDAD EDUCATIVA LORENZA ISAVA GUEVARA	2250	4	30	1693	1187	1663	0	4	3	0	469	1693
EDO. SUCRE	MP. CRUZ S ACOSTA	PQ. CHACOPATA	E. B. ELSA JOSEFINA LUNAR	887	2	6	712	413	706	0	3	1	0	289	712
EDO. SUCRE	MP. CRUZ S ACOSTA	PQ. CHACOPATA	ESCUELA UNITARIA EL CEDRO	85	1	0	43	29	43	0	0	0	0	14	43
EDO. SUCRE	MP. BOLIVAR	CM. MARIGUITAR	ESCUELA BOLIVARIANA MATURINCITO	226	1	5	194	152	189	0	1	0	0	36	194
EDO. SUCRE	MP. BOLIVAR	CM. MARIGUITAR	UNIDAD EDUCATIVA BOLIVARIANA ROBERTO MARTÍNEZ CENTENO	1360	3	21	1112	573	1091	0	3	1	0	514	1112
EDO. SUCRE	MP. BOLIVAR	CM. MARIGUITAR	UNIDAD EDUCATIVA JESÚS ALBERTO MARCANO ECHEZURIA	2515	5	30	1947	820	1917	0	11	1	0	1085	1947
EDO. SUCRE	MP. BOLIVAR	CM. MARIGUITAR	ESCUELA BASICA CAPIANTAR	279	1	4	236	170	232	0	1	0	0	61	236
EDO. SUCRE	MP. BOLIVAR	CM. MARIGUITAR	ESCUELA BOLIVARIANA CREACIÓN LA CHICA	1597	3	23	1240	702	1217	0	11	0	0	504	1240
EDO. SUCRE	MP. BOLIVAR	CM. MARIGUITAR	ESCUELA BOLIVARIANA SOTILLO	851	2	13	667	340	654	0	0	0	0	314	667
EDO. SUCRE	MP. BOLIVAR	CM. MARIGUITAR	UNIDAD EDUCATIVA CARATAL	162	1	1	144	101	143	0	2	0	0	40	144
EDO. SUCRE	MP. BOLIVAR	CM. MARIGUITAR	ESCUELA BASICA TOCUCHARE	166	1	1	156	97	155	0	0	0	0	58	156
EDO. SUCRE	MP. BOLIVAR	CM. MARIGUITAR	ESCUELA BASICA LA GLORIA NER.438	97	1	2	87	73	85	0	0	0	0	12	87
EDO. SUCRE	MP. BOLIVAR	CM. MARIGUITAR	ESCUELA BOLIVARIANA CARENERO	582	1	6	459	297	453	0	0	0	0	156	459
EDO. SUCRE	MP. BOLIVAR	CM. MARIGUITAR	ESCUELA BÁSICA SANTA CRUZ DE LAS MERCEDES	155	1	0	72	46	72	0	1	2	0	23	72
EDO. SUCRE	MP. BOLIVAR	CM. MARIGUITAR	UNIDAD EDUCATIVA RÓMULO GALLEGOS	622	2	12	418	248	406	0	4	0	0	154	418
EDO. SUCRE	MP. BOLIVAR	CM. MARIGUITAR	ESCUELA BÁSICA RÍO FRÍO	221	1	6	126	100	120	0	0	0	0	20	126
EDO. SUCRE	MP. BOLIVAR	CM. MARIGUITAR	ESCUELA BASICA LA SOLEDAD	172	1	1	146	98	145	0	1	0	0	46	146
EDO. SUCRE	MP. BOLIVAR	CM. MARIGUITAR	UNIDAD EDUCATIVA PETARE	1096	2	18	817	369	799	0	2	0	0	428	817
EDO. SUCRE	MP. BOLIVAR	CM. MARIGUITAR	UNIDAD EDUCATIVA BUENOS AIRES	358	1	8	312	167	304	0	3	0	0	134	312
EDO. SUCRE	MP. BOLIVAR	CM. MARIGUITAR	UNIDAD EDUCATIVA SAN FRANCISCO	2055	4	45	1616	965	1571	1	7	0	0	598	1616
EDO. SUCRE	MP. BOLIVAR	CM. MARIGUITAR	ESCUELA BOLIVARIANA GUARACAYAR	551	1	4	422	223	418	0	2	0	0	193	422
EDO. SUCRE	MP. BOLIVAR	CM. MARIGUITAR	UNIDAD EDUCATIVA FRANCISCO MEJÍAS	2207	4	21	1703	814	1682	0	8	0	1	859	1703
EDO. SUCRE	MP. BENITEZ	PQ. EL RINCON	ESCUELA BOLIVARIANA GUASIMAL ABAJO	1006	2	5	726	481	721	0	5	0	0	235	726
EDO. SUCRE	MP. BENITEZ	PQ. EL RINCON	UNIDAD EDUCATIVA JOSE RAFAEL PEREZ VALDIVIEZO	1645	3	25	1245	681	1220	0	7	2	0	530	1245
EDO. SUCRE	MP. BENITEZ	PQ. UNION	ESCUELA BOLIVARIANA PUNTA DE EVARISTO	83	1	0	51	32	51	0	0	0	0	19	51
EDO. SUCRE	MP. BENITEZ	PQ. UNION	ESCUELA BÁSICA RÍO MOROCOTO	553	1	5	416	311	411	0	0	0	0	100	416
EDO. SUCRE	MP. BENITEZ	PQ. UNION	ESCUELA BÁSICA JURUPU	195	1	1	136	116	135	0	0	0	0	19	136
EDO. SUCRE	MP. BENITEZ	PQ. UNION	ESCUELA BOLIVARIANA J.J ESCOBAR PACHECO	528	1	3	326	203	323	0	1	0	0	119	326
EDO. SUCRE	MP. BENITEZ	PQ. UNION	ESCUELA BÁSICA GUANOCO	210	1	2	146	133	144	0	0	0	0	11	146
EDO. SUCRE	MP. BENITEZ	PQ. GRAL FCO. A VASQUEZ	U.E. MIGUEL SÁNCHEZ PESQUERA	1569	3	17	1192	722	1175	0	2	0	0	451	1192
EDO. SUCRE	MP. BENITEZ	PQ. GUARAUNOS	UNIDAD EDUCATIVA VALDIVIESO MONTAÑO	987	2	11	743	403	732	0	3	0	0	326	743
EDO. SUCRE	MP. BENITEZ	PQ. TUNAPUICITO	ESCUELA BOLIVARIANA QUEBRADA DE MONO	624	2	8	461	363	453	0	0	0	0	90	461
EDO. SUCRE	MP. BENITEZ	PQ. TUNAPUICITO	ESCUELA BASICA SAN JUAN	156	1	0	124	106	124	0	0	0	0	18	124
EDO. SUCRE	MP. BENITEZ	PQ. TUNAPUICITO	UNIDAD EDUCATIVA  TUNAPUICITO	648	2	10	460	288	450	0	1	0	0	161	460
EDO. SUCRE	MP. BENITEZ	PQ. TUNAPUICITO	ESCUELA BÁSICA LA SABANETA	343	1	2	251	241	249	1	0	1	0	6	251
EDO. SUCRE	MP. BENITEZ	PQ. TUNAPUICITO	ESCUELA BOLIVARIANA LA HIERBA	161	1	1	146	117	145	0	0	1	0	27	146
EDO. SUCRE	MP. BENITEZ	PQ. EL PILAR	ESCUELA BÁSICA AGUAS CALIENTES	157	1	1	124	67	123	0	2	0	0	54	124
EDO. SUCRE	MP. BENITEZ	PQ. EL PILAR	ESCUELA BOLIVARIANA LA LOMA	71	1	2	66	50	64	0	1	0	0	13	66
EDO. SUCRE	MP. BENITEZ	PQ. EL PILAR	ESCUELA BÁSICA QUEBRADA SECA	176	1	2	128	98	126	0	0	0	0	28	128
EDO. SUCRE	MP. BENITEZ	PQ. EL PILAR	ESCUELA BÁSICA LOS POZOTES	380	1	1	275	175	274	0	2	0	0	97	275
EDO. SUCRE	MP. BENITEZ	PQ. EL PILAR	ESCUELA BOLIVARIANA  LA PASTORA	102	1	3	93	79	90	0	1	0	0	10	93
EDO. SUCRE	MP. BENITEZ	PQ. EL PILAR	ESCUELA BÁSICA CAMPO ALEGRE	319	1	6	224	188	218	0	0	1	1	28	224
EDO. SUCRE	MP. BENITEZ	PQ. EL PILAR	ESCUELA BÁSICA PARADERO	136	1	2	71	67	69	0	0	1	0	1	71
EDO. SUCRE	MP. BENITEZ	PQ. EL PILAR	GRUPO ESCOLAR PABLO MARIA FUENTES	1103	2	16	857	502	841	2	2	0	0	335	857
EDO. SUCRE	MP. BENITEZ	PQ. EL PILAR	ESCUELA BOLIVARIANA CAÑO DE AJÍES	1054	2	14	786	687	772	0	1	0	0	84	786
EDO. SUCRE	MP. BENITEZ	PQ. EL PILAR	UNIDAD EDUCATIVA CREACION SABANETA	530	1	6	439	261	433	0	4	0	0	168	439
EDO. SUCRE	MP. BENITEZ	PQ. EL PILAR	ESCUELA BOLIVARIANA LA CEIBA	193	1	0	133	99	133	0	1	0	0	33	133
EDO. SUCRE	MP. BENITEZ	PQ. EL PILAR	ESCUELA BOLIVARIANA EL ALGARROBO
EDO. SUCRE	MP. BENITEZ	PQ. EL PILAR	U.E. BOLIVARIANA LUIS DANIEL BEAPERTHUY	2140	4	27	1629	883	1602	1	5	1	1	711	1629
EDO. SUCRE	MP. BENITEZ	PQ. EL PILAR	ESCUELA BÁSICA LA PICA	431	1	4	314	182	310	0	0	0	0	128	314
EDO. SUCRE	MP. BENITEZ	PQ. EL PILAR	ESCUELA BÁSICA CAITUCO	493	1	0	377	309	377	0	0	0	0	68	377
EDO. SUCRE	MP. BENITEZ	PQ. EL PILAR	ESCUELA BÁSICA ALGARROBITO	259	1	2	155	75	153	0	0	0	0	78	155
EDO. SUCRE	MP. BENITEZ	PQ. EL PILAR	ESCUELA BOLIVARIANA RÍO GRANDE	258	1	3	169	141	166	0	1	1	0	23	169
EDO. SUCRE	MP. BENITEZ	PQ. EL PILAR	ESCUELA BOLIVARIANA GUAYABAL	274	1	5	222	144	217	0	1	0	0	72	222
EDO. SUCRE	MP. BENITEZ	PQ. EL PILAR	ESCUELA BÁSICA MUCURO	78	1	1	53	49	52	0	0	0	0	3	53
EDO. SUCRE	MP. BENITEZ	PQ. EL PILAR	ESCUELA BOLIVARIANA AGUA FRÍA	608	2	2	428	353	426	0	3	0	0	70	428
EDO. SUCRE	MP. BENITEZ	PQ. EL PILAR	ESCUELA BÁSICA LAS PALOMAS	333	1	1	205	163	204	0	2	0	0	39	205
EDO. SUCRE	MP. BENITEZ	PQ. EL PILAR	ESCUELA BOLIVARIANA RÍO COLORADO	187	1	0	167	159	167	0	0	0	0	8	167
EDO. SUCRE	MP. BENITEZ	PQ. EL PILAR	ESCUELA BÁSICA CUMBRE DE RÍO CHIQUITO	235	1	1	167	133	166	0	0	0	0	33	167
EDO. SUCRE	MP. BENITEZ	PQ. EL PILAR	ESCUELA BÁSICA GUATAMARE	479	1	6	340	285	334	0	0	1	0	48	340
EDO. SUCRE	MP. BENITEZ	PQ. EL PILAR	ESCUELA BÁSICA SANTA TECLA	276	1	1	202	129	201	0	1	0	0	71	202
EDO. SUCRE	MP. BENITEZ	PQ. EL PILAR	ESCUELA BOLIVARIANA CAÑO DE CRUZ	436	1	0	301	188	301	0	1	0	0	112	301
EDO. SUCRE	MP. BENITEZ	PQ. EL PILAR	ESCUELA BASICA CUMBRE DE PAPELON	88	1	0	73	54	73	0	0	0	0	19	73
EDO. SUCRE	MP. BENITEZ	PQ. EL PILAR	UNIDAD EDUCATIVA  RÍO EL PILAR	294	1	5	210	146	205	0	0	0	0	59	210
EDO. SUCRE	MP. BENITEZ	PQ. EL PILAR	ESCUELA BOLIVARIANA RIO CHIQUITO	96	1	3	81	73	78	0	0	0	0	5	81
EDO. SUCRE	MP. BENITEZ	PQ. EL PILAR	U.E. JACINTO GUTIÉRREZ	1350	3	10	986	507	976	0	5	0	0	464	986
EDO. SUCRE	MP. BENITEZ	PQ. EL PILAR	ESCUELA BÁSICA COHICUAL	594	1	3	401	292	398	0	2	0	0	104	401
EDO. SUCRE	MP. RIBERO	PQ. RENDON	ESCUELA BOLIVARIANA QUEBRADA SECA DEL TAMBOR	344	1	1	240	185	239	0	0	0	0	54	240
EDO. SUCRE	MP. RIBERO	PQ. RENDON	ESCUELA BÁSICA LOS MANGOS	309	1	4	175	114	171	0	0	0	0	57	175
EDO. SUCRE	MP. RIBERO	PQ. RENDON	ESCUELA BOLIVARIANA BLASCOA	82	1	0	68	46	68	0	0	0	0	22	68
EDO. SUCRE	MP. RIBERO	PQ. RENDON	ESCUELA BOLIVARIANA TERRANOVA	612	2	7	424	312	417	0	6	0	0	99	424
EDO. SUCRE	MP. RIBERO	PQ. RENDON	ESCUELA QUEBRADA SECA DE RIO GRANDE	329	1	5	231	199	226	0	0	0	0	27	231
EDO. SUCRE	MP. RIBERO	PQ. RENDON	LICEO BOLIVARIANO CREACIÓN JABILLAR	602	2	6	380	261	374	0	3	1	0	109	380
EDO. SUCRE	MP. RIBERO	PQ. RENDON	ESCUELA BASICA MARIA VILLEGAS	1525	3	11	1013	558	1002	0	5	1	0	438	1013
EDO. SUCRE	MP. RIBERO	PQ. SANTA CRUZ	ESCUELA BOLIVARIANA SANTA CRUZ	1241	3	26	790	529	764	0	2	1	0	232	790
EDO. SUCRE	MP. RIBERO	PQ. SANTA CRUZ	ESCUELA BOLIVARIANA QUEBRADA DE PIEDRA	123	1	0	108	81	108	0	0	0	0	27	108
EDO. SUCRE	MP. RIBERO	PQ. SANTA CRUZ	ESCUELA BÁSICA SAN RAMÓN	374	1	3	255	210	252	0	0	0	0	42	255
EDO. SUCRE	MP. RIBERO	PQ. CARIACO	LICEO BOLIVARIANO CREACIÓN LA ESMERALDA	402	1	4	336	310	332	0	4	0	0	18	336
EDO. SUCRE	MP. RIBERO	PQ. CARIACO	ESCUELA BÁSICA CACAHUAL	414	1	4	278	217	274	0	0	0	0	57	278
EDO. SUCRE	MP. RIBERO	PQ. CARIACO	ESCUELA BOLIVARIANA EL CORDON	284	1	7	240	169	233	0	0	0	0	64	240
EDO. SUCRE	MP. RIBERO	PQ. CARIACO	ESCUELA BASICA CREACIÓN GUACARAPO	548	1	9	404	295	395	0	0	0	0	100	404
EDO. SUCRE	MP. RIBERO	PQ. CARIACO	CENTRO EDUCATIVO MONSEÑOR ENRIQUE BREKELMANS	903	2	7	705	390	698	0	6	0	0	302	705
EDO. SUCRE	MP. RIBERO	PQ. CARIACO	UNIDAD EDUCATIVA  DEMETRIO JESÚS AGUILERA	810	2	6	543	446	537	0	2	0	0	89	543
EDO. SUCRE	MP. RIBERO	PQ. CARIACO	ESCUELA BASICA LA ESMERALDA	1718	3	20	1281	1034	1261	0	3	1	0	223	1281
EDO. SUCRE	MP. RIBERO	PQ. CARIACO	ESCUELA BASICA AGUAS CALIENTES	511	1	8	372	290	364	0	5	1	0	68	372
EDO. SUCRE	MP. RIBERO	PQ. CARIACO	ESCUELA BASICA VALENTIN VALIENTE	883	2	12	718	461	706	0	1	0	0	244	718
EDO. SUCRE	MP. RIBERO	PQ. CARIACO	ESCUELA BOLIVARIANA CHAMARIAPA AFUERA	445	1	8	321	183	313	0	1	0	0	129	321
EDO. SUCRE	MP. RIBERO	PQ. CARIACO	ESCUELA BOLIVARIANA PALO ROSAL	171	1	9	151	99	142	0	1	0	0	42	151
EDO. SUCRE	MP. RIBERO	PQ. CARIACO	ESCUELA BASICA JUAN BAUTISTA ARISMENDI	976	2	13	715	467	702	0	6	1	0	228	715
EDO. SUCRE	MP. RIBERO	PQ. CARIACO	ESCUELA BASICA ESTADO ZULIA	521	1	7	363	263	356	0	1	0	0	92	363
EDO. SUCRE	MP. RIBERO	PQ. CARIACO	ESCUELA BASICA ETANISLAO RENDÓN	1794	4	24	1432	825	1408	0	6	0	0	577	1432
EDO. SUCRE	MP. RIBERO	PQ. CARIACO	CASA DE LA CULTURA DOLORES BENITA DE LUNAS	1715	3	22	1261	615	1239	1	4	1	0	618	1261
EDO. SUCRE	MP. RIBERO	PQ. CARIACO	ESCUELA BÁSICA CREACIÓN PANTOÑO	1431	3	14	1011	564	997	0	4	0	0	429	1011
EDO. SUCRE	MP. RIBERO	PQ. CARIACO	LICEO BOLIVARIANO RAIMUNDO MARTÍNEZ CENTENO	3021	6	33	2192	1210	2159	1	10	1	1	936	2192
EDO. SUCRE	MP. RIBERO	PQ. CARIACO	ESCUELA BÁSICA CHAMARIAPA GÜIRIA	552	1	5	413	301	408	0	0	0	0	107	413
EDO. SUCRE	MP. RIBERO	PQ. CARIACO	ESCUELA BOLIVARIANA MANZANILLO	155	1	1	126	98	125	0	0	0	0	27	126
EDO. SUCRE	MP. RIBERO	PQ. CARIACO	ESCUELA BOLIVARIANA SIMON BOLIVAR	594	1	9	487	262	478	0	1	0	0	215	487
EDO. SUCRE	MP. RIBERO	PQ. CARIACO	ESCUELA BASICA DIONICIO LÓPEZ ORIHUELA	1127	2	13	840	650	827	0	2	0	0	175	840
EDO. SUCRE	MP. RIBERO	PQ. CARIACO	UNIDAD EDUCATIVA LA FUNCIA	91	1	0	83	51	83	0	0	0	0	32	83
EDO. SUCRE	MP. RIBERO	PQ. CARIACO	ESCUELA BASICA PEDRO CAMEJO	943	2	8	681	549	673	0	1	1	0	122	681
EDO. SUCRE	MP. RIBERO	PQ. CARIACO	ESCUELA BOLIVARIANA AGUA SANTA	535	1	5	411	329	406	1	0	0	0	76	411
EDO. SUCRE	MP. RIBERO	PQ. CARIACO	ESCUELA BASICA JUAN QUIJANO FE Y ALEGRIA	530	1	5	437	311	432	0	3	0	0	118	437
EDO. SUCRE	MP. RIBERO	PQ. CARIACO	UNIVERSIDAD NACIONAL ABIERTA	707	2	16	595	355	579	0	5	1	0	218	595
EDO. SUCRE	MP. RIBERO	PQ. SANTA MARIA	ESCUELA BOLIVARIANA LAS LOMAS	136	1	2	121	99	119	1	0	0	0	19	121
EDO. SUCRE	MP. RIBERO	PQ. SANTA MARIA	ESCUELA BOLIVARIANA AMANITA ABAJO	414	1	1	272	199	271	0	1	1	0	70	272
EDO. SUCRE	MP. RIBERO	PQ. SANTA MARIA	UNIDAD EDUCATIVA SANTA MARIA	366	1	3	268	189	265	0	1	0	0	75	268
EDO. SUCRE	MP. RIBERO	PQ. SANTA MARIA	ESCUELA BOLIVARIANA ELISO SILVA DÍAZ	1214	3	9	751	424	742	0	6	2	0	310	751
EDO. SUCRE	MP. RIBERO	PQ. SANTA MARIA	ESCUELA BOLVARIANA LAS VEGAS	1077	2	14	695	539	681	0	3	0	2	137	695
EDO. SUCRE	MP. RIBERO	PQ. SANTA MARIA	UNIDAD EDUCATIVA BOLIVARIANA INDIGENA LOS ALTOS	181	1	1	162	124	161	0	1	0	0	36	162
EDO. SUCRE	MP. RIBERO	PQ. SANTA MARIA	ESCUELA BÁSICA LA FUNDACIÓN	373	1	2	225	154	223	0	0	0	0	69	225
EDO. SUCRE	MP. RIBERO	PQ. SANTA MARIA	ESCUELA BOLIVARIANA LOS MANGOS	203	1	15	166	110	151	0	2	0	0	39	166
EDO. SUCRE	MP. RIBERO	PQ. SANTA MARIA	ESCUELA BOLIVARIANA SANTA ANA	737	2	6	417	360	411	0	2	0	0	49	417
EDO. SUCRE	MP. RIBERO	PQ. SANTA MARIA	ESCUELA BÁSICA LOS CABIMBOS	336	1	5	203	117	198	0	1	0	0	80	203
EDO. SUCRE	MP. RIBERO	PQ. CATUARO	ESCUELA BOLIVARIANA CATUARO	1027	2	10	632	481	622	0	2	1	1	137	632
EDO. SUCRE	MP. RIBERO	PQ. CATUARO	ESCUELA BASICA CECILIO ACOSTA	1827	4	24	1118	730	1094	0	7	0	1	356	1118
EDO. SUCRE	MP. RIBERO	PQ. CATUARO	ESCUELA BÁSICA SANTA ROSA	472	1	5	310	227	305	0	0	0	0	78	310
EDO. SUCRE	MP. RIBERO	PQ. CATUARO	ESCUELA BÁSICA JUAN ANTONIO	495	1	5	306	166	301	0	0	0	0	135	306
EDO. SUCRE	MP. RIBERO	PQ. CATUARO	UNIDAD EDUCATIVA EL PARAISO	72	1	0	65	62	65	0	0	0	0	3	65
EDO. SUCRE	MP. RIBERO	PQ. CATUARO	UNIDAD EDUCATIVA TONORO	138	1	0	111	83	111	0	0	0	0	28	111
EDO. SUCRE	MP. RIBERO	PQ. CATUARO	UNIDAD EDUCATIVA  DOLORES BENÍTEZ DE LUNA	1033	2	10	646	376	636	1	1	1	0	257	646
EDO. SUCRE	MP. RIBERO	PQ. CATUARO	UNIDAD EDUCATIVA BOLIVITA	116	1	0	95	61	95	0	0	0	0	34	95
EDO. SUCRE	MP. RIBERO	PQ. CATUARO	ESCUELA BÁSICA LA PICA	599	1	4	416	320	412	0	0	1	0	91	416
EDO. SUCRE	MP. RIBERO	PQ. CATUARO	ESCUELA BASICA PICA ARRIBA	89	1	3	69	63	66	0	0	0	0	3	69
EDO. SUCRE	MP. RIBERO	PQ. CATUARO	UNIDAD EDUCATIVA PASO LARGO	165	1	3	110	83	107	0	0	0	0	24	110
EDO. SUCRE	MP. RIBERO	PQ. CATUARO	ESCUELA BOLIVARIANA LA SABANA
EDO. SUCRE	MP. RIBERO	PQ. CATUARO	ESCUELA BÁSICA MALVASCUAL	259	1	1	138	55	137	0	0	0	0	82	138
EDO. SUCRE	CE. SUCRE	PQ.GRAN MARISCAL	ESCUELA BOLIVARIANA SAN PEDRO	953	2	9	584	393	575	0	0	0	0	182	584
EDO. SUCRE	CE. SUCRE	PQ.GRAN MARISCAL	LICEO BOLIVARIANA CREACION ARAPO	1169	2	19	819	474	800	0	5	0	0	321	819
EDO. SUCRE	CE. SUCRE	PQ.GRAN MARISCAL	ESCUELA PRIMARIA BOLIVARIANA ARAPITO	303	1	7	287	188	280	1	1	1	0	89	287
EDO. SUCRE	CE. SUCRE	PQ.GRAN MARISCAL	ESCUELA BOLIVARIANA ARAPO	37	1	1	31	24	30	0	0	0	0	6	31
EDO. SUCRE	CE. SUCRE	PQ.GRAN MARISCAL	ESCUELA BOLIVARIANA INDIGENA MILA DE LA ROCA	2496	5	39	1925	949	1886	1	7	2	4	923	1925
EDO. SUCRE	CE. SUCRE	PQ.GRAN MARISCAL	LICEO BOLIVARIANO BARTOLOME MILA DE LA ROCA	203	1	2	179	135	177	0	2	0	0	40	179
EDO. SUCRE	CE. SUCRE	PQ.GRAN MARISCAL	ESCUELA BÁSICA MAXIMILIANO CORDOVA	609	2	13	525	360	512	0	4	2	1	145	525
EDO. SUCRE	CE. SUCRE	PQ. SANTA INES	ESCUELA BASICA RANCHERÍA	668	2	7	530	313	523	0	2	0	0	208	530
EDO. SUCRE	CE. SUCRE	PQ. SANTA INES	ESCUELA BÁSICA ESTADO MONAGAS	1786	3	20	1363	651	1343	0	9	0	0	683	1363
EDO. SUCRE	CE. SUCRE	PQ. SANTA INES	ESCUELA BOLIVARIANA LOS FRAILES	916	2	5	739	371	734	0	3	0	0	360	739
EDO. SUCRE	CE. SUCRE	PQ. SANTA INES	U.E. JOSÉ ANTONIO RAMOS SUCRE	1729	3	14	1315	742	1301	0	15	0	0	544	1315
EDO. SUCRE	CE. SUCRE	PQ. SANTA INES	ESCUELA BASICA BOLIVARIANA CORAZÓN DE JESÚS	2496	5	22	1950	983	1928	0	10	1	0	934	1950
EDO. SUCRE	CE. SUCRE	PQ. SANTA INES	U.E. REPUBLICA ARGENTINA	3340	6	41	2559	1004	2518	0	13	0	0	1501	2559
EDO. SUCRE	CE. SUCRE	PQ. SANTA INES	U.E. CREACIÓN CANTARRANA	1535	3	23	1301	505	1278	0	2	0	0	771	1301
EDO. SUCRE	CE. SUCRE	PQ. SANTA INES	CENTRO DE PREVENCION INTEGRAL PANCHITO MANDEFUA(CASA DEL NIÑO TRABAJADOR)	153	1	4	139	80	135	0	0	0	0	55	139
EDO. SUCRE	CE. SUCRE	PQ. SANTA INES	LICEO BASICO CORAZÓN DE JESÚS	2038	4	33	1581	803	1548	1	10	1	0	733	1581
EDO. SUCRE	CE. SUCRE	PQ. SANTA INES	U.E. AQUILES NAZOA	1191	2	21	1000	553	979	2	4	0	0	420	1000
EDO. SUCRE	CE. SUCRE	PQ. SANTA INES	CASA COMUNAL VIRGEN DEL VALLE	414	1	7	376	201	369	0	4	2	0	162	376
EDO. SUCRE	CE. SUCRE	PQ. SANTA INES	CENTRO DE EDUCACION INICIAL CENTENARIO ANDRES ELOY BLANCO	466	1	5	421	286	416	0	3	0	0	127	421
EDO. SUCRE	CE. SUCRE	PQ. SANTA INES	CENTRO DE EDUCACION INICIAL BRISA MAR	602	2	7	551	343	544	0	3	0	0	198	551
EDO. SUCRE	CE. SUCRE	PQ. SANTA INES	CENTRO EDUCACIÓN INICIAL SIMONCITO BOLIVARIANO BOCA DE SABANA	474	1	13	374	210	361	0	0	0	0	151	374
EDO. SUCRE	CE. SUCRE	PQ. SANTA INES	PETROCENTRO LAS PALOMAS	201	1	2	159	118	157	0	4	0	0	35	159
EDO. SUCRE	CE. SUCRE	PQ. SANTA INES	INTERNADO JUDICIAL DE CUMANA	478	1	3	124	91	121	0	2	1	0	27	124
EDO. SUCRE	CE. SUCRE	PQ. SANTA INES	ESCUELA BÁSICA SANTA TERESA DE JESÚS	833	2	9	638	256	629	0	5	0	0	368	638
EDO. SUCRE	CE. SUCRE	PQ. SANTA INES	COLEGIO NUESTRA SEÑORA DEL CARMEN	1036	2	8	895	381	887	1	4	0	1	500	895
EDO. SUCRE	CE. SUCRE	PQ. SANTA INES	ESCUELA BÁSICA LUIS BELTRÁN PRIETO FIGUEROA	1776	3	32	1457	941	1425	0	5	0	0	479	1457
EDO. SUCRE	CE. SUCRE	PQ. SANTA INES	ESCUELA BÁSICA RAFAEL CASTRO MACHADO	2337	4	47	1743	1018	1696	0	13	2	0	663	1743
EDO. SUCRE	CE. SUCRE	PQ. SANTA INES	ESCUELA BOLIVARIANA RÍO CARIBE	3879	7	38	2803	1679	2765	0	13	1	2	1070	2803
EDO. SUCRE	CE. SUCRE	PQ. SANTA INES	CASA DE LA CULTURA CANTARRANA	1092	2	13	865	323	852	0	6	0	0	523	865
EDO. SUCRE	CE. SUCRE	PQ. SANTA INES	ESCUELA BOLIVARIANA CRUZ DE LA UNIÓN	1790	4	25	1084	710	1059	0	10	2	0	337	1084
EDO. SUCRE	CE. SUCRE	PQ. SANTA INES	ESCUELA TÉCNICA AGROPECUARIA ROBINSONIANA DE PESCA	1651	3	37	1255	796	1218	1	5	0	1	415	1255
EDO. SUCRE	CE. SUCRE	PQ. SANTA INES	LICEO BOLIVARIANO ANTONIO JOSE DE SUCRE	2162	4	23	1720	637	1697	0	9	1	2	1048	1720
EDO. SUCRE	CE. SUCRE	PQ. SANTA INES	UNIDAD EDUCATIVA NUEVA ANDALUCÍA	3631	7	57	2716	1456	2659	0	17	0	2	1184	2716
EDO. SUCRE	CE. SUCRE	PQ. SANTA INES	U.E. CANDIDO RAMÍREZ	1423	3	20	1177	611	1157	0	9	0	0	537	1177
EDO. SUCRE	CE. SUCRE	PQ. SANTA INES	UNIVERSIDAD ABIERTA SEDE CUMANA	588	1	6	433	175	427	0	3	0	0	249	433
EDO. SUCRE	CE. SUCRE	PQ. SANTA INES	UNIDAD EDUCATIVA PRIVADA SANTO ANGEL	1735	3	27	1422	574	1395	3	1	0	0	817	1422
EDO. SUCRE	CE. SUCRE	PQ. SANTA INES	UNIDAD EDUCATIVA GRAN MARISCAL DE AYACUCHO	3279	6	51	2633	1628	2582	0	15	2	1	936	2633
EDO. SUCRE	CE. SUCRE	PQ. SANTA INES	UNIDAD EDUCATIVA  JAVIER ALCALÁ VÁSQUEZ	3434	6	73	2767	1096	2694	1	15	1	2	1579	2767
EDO. SUCRE	CE. SUCRE	PQ. SANTA INES	LICEO BOLIVARIANO BOCA DE SABANA	678	2	13	566	462	553	0	2	0	1	88	566
EDO. SUCRE	CE. SUCRE	PQ. RAUL LEONI	ESCUELA BASICA BOTALON	258	1	4	225	157	221	1	2	1	0	60	225
EDO. SUCRE	CE. SUCRE	PQ. RAUL LEONI	ESCUELA BOLIVARIANA SANTA CRUZ	245	1	4	206	153	202	0	3	0	0	46	206
EDO. SUCRE	CE. SUCRE	PQ. RAUL LEONI	ESCUELA BOLIVARIANA VEGA GRANDE	347	1	2	247	179	245	0	0	0	1	65	247
EDO. SUCRE	CE. SUCRE	PQ. RAUL LEONI	U.E.NUEVA CÓRDOBA	3820	7	48	2558	1546	2510	0	17	1	0	946	2558
EDO. SUCRE	CE. SUCRE	PQ. RAUL LEONI	U.E. SIMÓN BOLÍVAR	1523	3	15	994	588	979	0	7	0	0	384	994
EDO. SUCRE	CE. SUCRE	PQ. RAUL LEONI	ESCUELA BASICA PIÑANTAL	379	1	6	297	187	291	0	1	1	0	102	297
EDO. SUCRE	CE. SUCRE	PQ. RAUL LEONI	LICEO BOLIVARIANO MARIANO DE LA COVA	524	1	21	423	272	402	0	2	0	1	127	423
EDO. SUCRE	CE. SUCRE	PQ. RAUL LEONI	ANEXO APARTE U.E. NUEVA CÓRDOBA	2103	4	40	1458	862	1418	1	8	0	1	546	1458
EDO. SUCRE	CE. SUCRE	PQ. RAUL LEONI	ESCUELA BOLIVARIANA MARIA ÁNGELA DE FERNÁNDEZ	723	2	7	453	363	446	0	5	1	0	77	453
EDO. SUCRE	CE. SUCRE	PQ. SAN JUAN	ESCUELA BOLIVARIANA CRISTÓBAL COLON	1365	3	20	977	621	957	0	9	0	0	327	977
EDO. SUCRE	CE. SUCRE	PQ. SAN JUAN	ESCUELA BOLIVARIANA LA ZONA	256	1	5	204	114	199	1	3	0	0	81	204
EDO. SUCRE	CE. SUCRE	PQ. SAN JUAN	ESCUELA BOLIVARIANA GUARANACHE ARRIBA	162	1	3	135	84	132	0	0	1	0	47	135
EDO. SUCRE	CE. SUCRE	PQ. SAN JUAN	ESCUELA BOLIVARIANA SAN AGUSTIN	1068	2	16	759	539	743	0	7	0	0	197	759
EDO. SUCRE	CE. SUCRE	PQ. SAN JUAN	UNIDAD EDUCATIVA BOLIVARIANA MACARAPANA
EDO. SUCRE	CE. SUCRE	PQ. SAN JUAN	ESCUELA BÁSICA AGUA SANTA	864	2	12	656	434	644	0	0	0	1	209	656
EDO. SUCRE	CE. SUCRE	PQ. SAN JUAN	ESCUELA BÁSICA GUARANACHE ABAJO	794	2	5	533	366	528	1	4	1	0	156	533
EDO. SUCRE	CE. SUCRE	PQ. SAN JUAN	ESCUELA BOLIVARIANA ADELAIDA NÚÑEZ SUCRE	2364	5	22	1706	1154	1684	1	12	3	3	511	1706
EDO. SUCRE	CE. SUCRE	PQ. SAN JUAN	ESCUELA ESTADAL CHIRICUA	718	2	7	578	400	571	0	4	0	0	167	578
EDO. SUCRE	CE. SUCRE	PQ. SAN JUAN	ESCUELA BOLIVARIANA SIMÓN RODRÍGUEZ	1563	3	33	1103	690	1070	0	3	1	0	376	1103
EDO. SUCRE	CE. SUCRE	PQ. SAN JUAN	ESCUELA BÁSICA EL CHISPERO	354	1	2	231	186	229	0	0	0	0	43	231
EDO. SUCRE	CE. SUCRE	PQ. VALENTIN VALIENTE	UNIDAD EDUCATIVA BOLIVARIANA LA INMACULADA	2597	5	44	2020	1160	1976	3	14	1	0	798	2020
EDO. SUCRE	CE. SUCRE	PQ. VALENTIN VALIENTE	UNIDAD EDUCATIVA PRIVADA LIBERTADOR	2122	4	19	1857	502	1838	0	4	1	1	1330	1857
EDO. SUCRE	CE. SUCRE	PQ. VALENTIN VALIENTE	CENTRO DE EDUCACION INICIAL  NUEVA TOLEDO	541	1	16	447	229	431	0	2	0	0	200	447
EDO. SUCRE	CE. SUCRE	PQ. VALENTIN VALIENTE	ESCUELA TECNICA COMERCIAL MODESTO SILVA	3940	7	35	3292	904	3257	2	12	0	4	2335	3292
EDO. SUCRE	CE. SUCRE	PQ. VALENTIN VALIENTE	ESCUELA PRIMARIA BOLIVARIANA ESTADO NUEVA ESPARTA	3543	7	49	2743	1448	2694	0	21	1	1	1223	2743
EDO. SUCRE	CE. SUCRE	PQ. VALENTIN VALIENTE	UNIDAD EDUCATIVA NUEVA TOLEDO	4615	8	68	3612	1774	3544	2	19	0	1	1748	3612
EDO. SUCRE	CE. SUCRE	PQ. VALENTIN VALIENTE	CENTRO DE EDUCACION INICIAL BATALLA DE PICHINCHA	410	1	3	373	150	370	0	3	0	1	216	373
EDO. SUCRE	CE. SUCRE	PQ. VALENTIN VALIENTE	UNIDAD EDUCATIVA JOSE SILVERIO CORDOVA	290	1	1	265	92	264	0	0	0	1	171	265
EDO. SUCRE	CE. SUCRE	PQ. VALENTIN VALIENTE	ANEXO UNIDAD EDUCATIVA ESTADO NUEVA ESPARTA	1662	3	24	1282	662	1258	1	5	0	0	590	1282
EDO. SUCRE	CE. SUCRE	PQ. VALENTIN VALIENTE	SALON USOS MULTIPLES FUNDACITE	2074	4	30	1910	858	1880	1	5	0	0	1016	1910
EDO. SUCRE	CE. SUCRE	PQ. VALENTIN VALIENTE	TALLER MANZANARES	2380	5	24	2168	734	2144	1	5	0	1	1403	2168
EDO. SUCRE	CE. SUCRE	PQ. VALENTIN VALIENTE	U.E. MADRE ALBERTA JIMENEZ	4972	9	84	3802	2454	3718	0	20	1	0	1243	3802
EDO. SUCRE	CE. SUCRE	PQ. VALENTIN VALIENTE	ESCUELA BÁSICA DON RÓMULO GALLEGOS	1897	4	21	1667	528	1646	0	6	0	1	1111	1667
EDO. SUCRE	CE. SUCRE	PQ. VALENTIN VALIENTE	CENTRO DE EDUCACION INICIAL ROSA MATILDE ARISTIMUÑO	374	1	2	318	151	316	0	0	0	0	165	318
EDO. SUCRE	CE. SUCRE	PQ. VALENTIN VALIENTE	ESCUELA BOLIVARIANA ALI PRIMERA	790	2	13	640	430	627	0	2	0	0	195	640
EDO. SUCRE	CE. SUCRE	PQ. VALENTIN VALIENTE	UNIDAD EDUCATIVA CREACION CAIGUIRE	1883	4	30	1442	927	1412	0	9	1	0	475	1442
EDO. SUCRE	CE. SUCRE	PQ. VALENTIN VALIENTE	MODULO ASOCIACIÓN CIVIL SUCRE	179	1	2	156	121	154	0	0	0	0	33	156
EDO. SUCRE	CE. SUCRE	PQ. VALENTIN VALIENTE	ESCUELA BOLIVARIANA LOS CHAIMAS	1772	3	12	1533	455	1521	0	3	2	0	1061	1533
EDO. SUCRE	CE. SUCRE	PQ. VALENTIN VALIENTE	INFOCENTRO	303	1	3	259	127	256	0	0	0	0	129	259
EDO. SUCRE	CE. SUCRE	PQ. VALENTIN VALIENTE	MODULO DE SERVICIOS MULTIPLES CAIGUIRE	884	2	9	664	421	655	0	1	1	0	232	664
EDO. SUCRE	CE. SUCRE	PQ. VALENTIN VALIENTE	LICEO BOLIVARIANO BACHILLER CASTRO MACHADO	956	2	11	754	294	743	0	3	1	0	445	754
EDO. SUCRE	CE. SUCRE	PQ. AYACUCHO	ESCUELA BOLIVARIANA ELTACAL	2874	5	51	2114	1437	2063	0	15	0	1	610	2114
EDO. SUCRE	CE. SUCRE	PQ. AYACUCHO	ESCUELA BÁSICA LA TRINIDAD	2042	4	35	1519	810	1484	1	8	2	0	663	1519
EDO. SUCRE	CE. SUCRE	PQ. AYACUCHO	ESCUELA BOLIVARIANA PLAN DE LA MESA	811	2	4	636	432	632	1	2	0	0	197	636
EDO. SUCRE	CE. SUCRE	PQ. AYACUCHO	UNEFA	855	2	3	595	307	592	1	3	0	0	281	595
EDO. SUCRE	CE. SUCRE	PQ. AYACUCHO	CENTRO EDUCACION INICIAL ANDRES ELOY BLANCO (ANEXO)	223	1	0	193	67	193	0	2	0	0	124	193
EDO. SUCRE	CE. SUCRE	PQ. AYACUCHO	ESCUELA BÁSICA JUAN FREITES	2744	5	49	2159	876	2110	4	11	0	0	1219	2159
EDO. SUCRE	CE. SUCRE	PQ. AYACUCHO	GIMNASIO CUBIERTO 26 DE OCTUBRE	1259	3	15	1020	594	1005	1	6	0	0	404	1020
EDO. SUCRE	CE. SUCRE	PQ. AYACUCHO	ESCUELA BOLIVARIANA PROF. ZENAIDA VALERA MAGO	1100	2	21	826	544	805	1	2	1	0	257	826
EDO. SUCRE	CE. SUCRE	PQ. AYACUCHO	PRE ESCOLAR LA TRINIDAD	952	2	18	743	415	725	0	1	0	0	309	743
EDO. SUCRE	CE. SUCRE	PQ. AYACUCHO	NUCLEO CULTURAL BERMUDEZ	981	2	8	727	333	719	0	0	0	0	386	727
EDO. SUCRE	CE. SUCRE	PQ. AYACUCHO	ESCUELA BOLIVARIANA MARIN	225	1	5	210	184	205	0	2	1	0	18	210
EDO. SUCRE	CE. SUCRE	PQ. AYACUCHO	LICEO LUIS GRATEROL BOLÍVAR	3303	6	27	2649	1329	2622	0	15	1	0	1277	2649
EDO. SUCRE	CE. SUCRE	PQ. AYACUCHO	JUNTA COMUNAL CUMANAGOTO 2	538	1	0	477	319	477	0	1	1	1	155	477
EDO. SUCRE	CE. SUCRE	PQ. AYACUCHO	ASILO DE ANCIANOS SAN VICENTE DE PAUL	1013	2	9	804	388	795	0	3	0	1	403	804
EDO. SUCRE	CE. SUCRE	PQ. AYACUCHO	U.E. CRUZ ALMANDOZ MORA	2733	5	45	2179	1308	2134	2	9	0	0	815	2179
EDO. SUCRE	CE. SUCRE	PQ. AYACUCHO	ESCUELA CONCENTRADA PETARE DE SANTA FE	196	1	4	152	119	148	0	1	0	0	28	152
EDO. SUCRE	CE. SUCRE	PQ. AYACUCHO	ESCUELA BOLIVARIANA MOCHIMA	745	2	5	569	280	564	0	2	0	1	281	569
EDO. SUCRE	CE. SUCRE	PQ. AYACUCHO	UNIDAD EDUCATIVA FEDERAL SUCRE	2452	5	34	1951	882	1917	0	12	2	1	1020	1951
EDO. SUCRE	CE. SUCRE	PQ. AYACUCHO	UNIDAD EDUCATIVA MARCO ANTONIO SALUZZO	1867	4	17	1397	689	1380	1	9	0	0	681	1397
EDO. SUCRE	CE. SUCRE	PQ. AYACUCHO	UNIDAD EDUCATIVA ANDRÉS ELOY BLANCO	4397	8	38	3489	1311	3451	0	16	1	2	2121	3489
EDO. SUCRE	CE. SUCRE	PQ. AYACUCHO	ESCUELA BOLIVARIANA SANTIAGO MARIÑO	1009	2	11	686	570	675	2	1	0	0	102	686
EDO. SUCRE	CE. SUCRE	PQ. AYACUCHO	ESCUELA BÁSICA ETANISLAO RENDÓN	2422	5	21	1847	875	1826	0	11	2	2	936	1847
EDO. SUCRE	CE. SUCRE	PQ. AYACUCHO	ESCUELA CONCENTRADA BELLA VISTA	212	1	4	189	169	185	0	1	0	0	15	189
EDO. SUCRE	CE. SUCRE	PQ. AYACUCHO	ESCUELA BOLIVARIANA LOS BORDONES	290	1	6	223	185	217	0	1	1	1	29	223
EDO. SUCRE	CE. SUCRE	PQ. ALTAGRACIA	ESCUELA BASICA CONCENTRADA LOS MOLINOS	312	1	3	265	195	262	0	0	0	0	67	265
EDO. SUCRE	CE. SUCRE	PQ. ALTAGRACIA	CENTRO EDUCACIÓN INICIAL BOLIVARIANO HILDA DE LA CRUZ DÍAZ	574	1	14	487	284	473	0	3	0	1	185	487
EDO. SUCRE	CE. SUCRE	PQ. ALTAGRACIA	UNIDAD ESCOLAR PADRE JOSE MARIA VELAZ	629	2	15	543	317	528	0	3	0	0	208	543
EDO. SUCRE	CE. SUCRE	PQ. ALTAGRACIA	UNIDAD EDUCATIVA GRAN MARISCAL	4174	8	35	3237	1921	3202	2	19	2	3	1255	3237
EDO. SUCRE	CE. SUCRE	PQ. ALTAGRACIA	CENTRO DE EDUCACION INICIAL MUNICIPAL LUISA CACERES DE ARISMENDI	716	2	9	616	366	607	0	5	0	0	236	616
EDO. SUCRE	CE. SUCRE	PQ. ALTAGRACIA	CENTRO DE EDUCACION INICIAL LA LLANADA	484	1	4	425	289	421	0	4	0	1	127	425
EDO. SUCRE	CE. SUCRE	PQ. ALTAGRACIA	UNIDAD EDUCATIVA  ALBERTO SANABRIA	3231	6	44	2625	1416	2581	0	20	5	0	1140	2625
EDO. SUCRE	CE. SUCRE	PQ. ALTAGRACIA	PREESCOLAR MI JARDIN	921	2	5	710	451	705	0	6	2	0	246	710
EDO. SUCRE	CE. SUCRE	PQ. ALTAGRACIA	CENTRO DE EDUCACION INICIAL LLANADA III	270	1	4	230	169	226	0	2	0	0	55	230
EDO. SUCRE	CE. SUCRE	PQ. ALTAGRACIA	MODULO DE SERVICIOS COMUNAL DE CASCAJAL	910	2	8	758	384	750	0	7	0	0	359	758
EDO. SUCRE	CE. SUCRE	PQ. ALTAGRACIA	LICEO PEDRO ARNAL	2267	4	30	1663	846	1633	0	10	0	0	777	1663
EDO. SUCRE	CE. SUCRE	PQ. ALTAGRACIA	ESCUELA BASICA BOLIVARIANO	2286	4	32	1793	1016	1761	1	7	3	0	734	1793
EDO. SUCRE	CE. SUCRE	PQ. ALTAGRACIA	INCE INDUSTRIAL	1359	3	18	1057	482	1039	0	4	2	0	551	1057
EDO. SUCRE	CE. SUCRE	PQ. ALTAGRACIA	UNIDAD EDUCATIVA  FRANCISCO DE MIRANDA	2609	5	29	2149	1282	2120	1	13	2	2	820	2149
EDO. SUCRE	CE. SUCRE	PQ. ALTAGRACIA	PRE ESCOLAR AÑO INTERNACIONAL DEL NIÑO	3470	6	42	2726	1528	2684	3	17	3	2	1131	2726
EDO. SUCRE	CE. SUCRE	PQ. ALTAGRACIA	U.E. CRISTÓBAL DE QUEZADA	2664	5	39	2175	1322	2136	0	15	4	1	794	2175
EDO. SUCRE	CE. SUCRE	PQ. ALTAGRACIA	CENTRO EDUCACION INTEGRAL ANDRES ELOY BLANCO	1277	3	15	1055	721	1040	1	4	0	1	313	1055
EDO. SUCRE	CE. SUCRE	PQ. ALTAGRACIA	PRE  ESCOLAR BOLIVARIANO CASCAJAL	1062	2	14	880	460	866	0	1	0	1	404	880
EDO. SUCRE	CE. SUCRE	PQ. ALTAGRACIA	LICEO BOLIVARIANO JOSÉ SILVERIO GONZÁLEZ	3050	6	45	2430	1137	2385	1	18	3	0	1226	2430
EDO. SUCRE	CE. SUCRE	PQ. ALTAGRACIA	UNIDAD EDUCATIVA  ASCANIO VELÁSQUEZ	3213	6	55	2615	1426	2560	0	19	1	1	1113	2615
EDO. SUCRE	CE. SUCRE	PQ. ALTAGRACIA	ESCUELA BOLIVARIANA BRASIL 3	1642	3	15	1220	797	1205	2	12	0	0	394	1220
EDO. SUCRE	CE. SUCRE	PQ. ALTAGRACIA	UNIDAD EDUCATIVA  JOSÉ ANTONIO RAMOS SUCRE	2295	4	20	1895	850	1875	0	3	0	1	1021	1895
EDO. SUCRE	CE. SUCRE	PQ. ALTAGRACIA	UNIDAD EDUCATIVA  MANUEL SATURNINO PEÑALVER GÓMEZ	2794	5	36	2295	1366	2259	3	6	0	0	884	2295
EDO. SUCRE	CE. SUCRE	PQ. ALTAGRACIA	ESCUELA BÁSICA ANEXA PEDRO ARNAL	1856	4	25	1405	794	1380	1	7	0	0	578	1405
EDO. SUCRE	CE. SUCRE	PQ. ALTAGRACIA	LICEO ANTONIO LEMUS PÉREZ	3961	7	80	3312	1874	3232	3	14	0	3	1338	3312
EDO. SUCRE	CE. SUCRE	PQ. ALTAGRACIA	PRE ESCOLAR  AÑO INTERNACIONAL DEL NIÑO	1473	3	7	960	424	953	0	5	0	0	524	960
EDO. SUCRE	CE. SUCRE	PQ. ALTAGRACIA	UNIDAD DE TALENTO DEPORTIVO FRANCISCO MOROCHITO RODRÍGUEZ	4219	8	34	3557	1385	3523	0	8	2	4	2124	3557
EDO. SUCRE	CE. SUCRE	PQ. ALTAGRACIA	CASA COMUNAL ANTONIO GUZMAN BLANCO	629	2	7	537	363	530	0	2	0	0	165	537
EDO. SUCRE	CE. SUCRE	PQ. ALTAGRACIA	UNIDAD EDUCATIVA REBECA MEJIA	5640	10	88	4546	2681	4458	1	31	3	2	1740	4546
EDO. SUCRE	CE. SUCRE	PQ. ALTAGRACIA	PRE ESCOLAR EL BRASIL	2549	5	26	1969	1147	1943	1	12	2	0	781	1969
EDO. SUCRE	CE. SUCRE	PQ. ALTAGRACIA	CENTRO DE EDUCACION INICIAL CREACION FE Y ALEGRIA	365	1	7	323	205	316	0	1	0	0	110	323
EDO. SUCRE	CE. SUCRE	PQ. ALTAGRACIA	CENTRO DE EDUCACIÓN INICIAL MUNICIPAL NUESTRAS RAICES	355	1	2	298	213	296	0	2	0	0	81	298
EDO. SUCRE	CE. SUCRE	PQ. ALTAGRACIA	JARDIN DE INFANCIA ESTADO LARA	1584	3	8	1234	621	1226	0	3	1	0	601	1234
EDO. SUCRE	CE. SUCRE	PQ. ALTAGRACIA	ESCUELA BÁSICA FRANCISCO ARISTIGUIETA BADARACCO	3549	7	14	2894	1214	2880	0	19	1	0	1646	2894
EDO. SUCRE	CE. SUCRE	PQ. ALTAGRACIA	UNIDAD EDUCATIVA VICENTE SUCRE Y URBANEJA	508	1	8	417	249	409	0	3	0	0	157	417
EDO. SUCRE	CE. SUCRE	PQ. ALTAGRACIA	CENTRO DE EDUCACION INICIAL CUMANAGOTO	1721	3	12	1572	599	1560	0	5	0	2	954	1572
EDO. SUCRE	CE. SUCRE	PQ. ALTAGRACIA	LICEO BOLIVARIANO LUIS ANTONIO MORALES RAMIREZ	4534	9	80	3401	2312	3321	0	10	0	1	998	3401
EDO. SUCRE	CE. SUCRE	PQ. ALTAGRACIA	ESCUELA BASICA BRASIL 4TO.	1977	4	26	1537	1028	1511	0	16	1	0	466	1537
EDO. SUCRE	CE. SUCRE	PQ. ALTAGRACIA	MEGAINFOCENTRO GRAN MARISCAL DE AYACUCHO	497	1	3	417	237	414	0	3	0	0	174	417
EDO. SUCRE	CE. SUCRE	PQ. ALTAGRACIA	ESCUELA TÉCNICA INDUSTRIAL ROBINSONIANA EMILIO TEBAR CARRASCO	1738	3	20	1312	773	1292	0	8	1	0	510	1312
EDO. SUCRE	CE. SUCRE	PQ. ALTAGRACIA	INCE CONSTRUCCION	1519	3	9	1166	684	1157	0	9	3	0	461	1166
EDO. SUCRE	CE. SUCRE	PQ. ALTAGRACIA	SAPINAES CRUZ SALMERON ACOSTA	1046	2	13	781	359	768	0	1	1	0	407	781
EDO. SUCRE	CE. SUCRE	PQ. ALTAGRACIA	UNIDAD EDUCATIVA EUTIMIO RIVAS	2857	5	26	2165	1054	2139	1	7	0	1	1076	2165
EDO. SUCRE	CE. SUCRE	PQ. ALTAGRACIA	PETROCENTRO GRAN PARAISO	379	1	6	326	233	320	0	3	0	0	84	326
EDO. SUCRE	CE. SUCRE	PQ. ALTAGRACIA	UNIDAD EDUCATIVA  FE Y ALEGRÍA SAN LUIS	3494	6	58	2822	1441	2764	0	9	2	1	1311	2822
EDO. SUCRE	MP. MONTES	PQ. ARENAS	LICEO BOLIVARIANO CREACION ARENAS	1873	4	29	1382	955	1353	1	10	0	0	387	1382
EDO. SUCRE	MP. MONTES	PQ. ARENAS	ESCUELA BÁSICA BEJUCAL	265	1	2	190	172	188	0	0	0	0	16	190
EDO. SUCRE	MP. MONTES	PQ. ARENAS	U.E. ARENAS	2278	4	22	1743	1213	1721	1	12	0	0	495	1743
EDO. SUCRE	MP. MONTES	PQ. ARENAS	ESCUELA BASICA TRES PICOS	175	1	0	92	81	92	0	1	0	0	10	92
EDO. SUCRE	MP. MONTES	PQ. ARENAS	ESCUELA BOLIVARIANA CALDERA	228	1	1	163	89	162	0	0	0	0	73	163
EDO. SUCRE	MP. MONTES	PQ. COCOLLAR	ESCUELA ESTADAL CONCENTRADA LA SOLEDAD	115	1	2	74	42	72	1	1	0	0	28	74
EDO. SUCRE	MP. MONTES	PQ. COCOLLAR	ESCUELA BOLIVARIANA MONSEÑOR ARIAS BLANCO	1032	2	9	746	401	737	1	1	0	0	334	746
EDO. SUCRE	MP. MONTES	PQ. COCOLLAR	ESCUELA BÁSICA LOS CHORROS	124	1	0	68	50	68	0	0	0	0	18	68
EDO. SUCRE	MP. MONTES	PQ. COCOLLAR	ESCUELA BOLIVARIANA ELVIRA DE GARCÍA DE ROJAS	1885	4	15	1321	762	1306	0	0	1	0	543	1321
EDO. SUCRE	MP. MONTES	PQ. COCOLLAR	ESCUELA BOLIVARIANA BAJO GRANDE DEL LATAL	148	1	1	92	25	91	0	0	0	0	66	92
EDO. SUCRE	MP. MONTES	PQ. COCOLLAR	ESCUELA BOLIVARIANA LAS MESETAS	119	1	0	101	76	101	0	0	0	0	25	101
EDO. SUCRE	MP. MONTES	PQ. SAN LORENZO	ESCUELA BOLIVARIANA ISAÍAS RUIZ DE CORONADO	3431	6	51	2320	1227	2269	2	9	1	0	1030	2320
EDO. SUCRE	MP. MONTES	PQ. SAN LORENZO	ESCUELA CONCENTRADA RURAL BOLIVARIANA ORINOCO	274	1	2	197	146	195	0	1	0	0	48	197
EDO. SUCRE	MP. MONTES	PQ. SAN LORENZO	ESCUELA BOLIVARIANA LA FRAGUA	283	1	4	227	140	223	0	1	0	0	82	227
EDO. SUCRE	MP. MONTES	PQ. SAN LORENZO	ESCUELA BÁSICA BOQUERÓN	124	1	1	55	32	54	0	0	0	0	22	55
EDO. SUCRE	MP. MONTES	PQ. SAN LORENZO	ESCUELA CONCENTRADA RURAL BOLIVARIANA LAS TRINCHERAS	354	1	0	238	195	238	0	0	0	0	43	238
EDO. SUCRE	MP. MONTES	PQ. SAN LORENZO	ESCUELA BÁSICA LA LOMA	221	1	0	145	121	145	0	1	0	0	23	145
EDO. SUCRE	MP. MONTES	PQ. SAN FERNANDO	ESCUELA  ESTADAL BOLIVARIANA PIE DE CUESTA	656	2	8	460	312	452	0	1	1	0	138	460
EDO. SUCRE	MP. MONTES	PQ. SAN FERNANDO	UNIDAD EDUCATIVA BOLIVARIANA SAN FERNANDO	624	2	6	493	397	487	0	0	0	0	90	493
EDO. SUCRE	MP. MONTES	PQ. SAN FERNANDO	ESCUELA BÁSICA SAN JUAN	676	2	5	404	251	399	1	1	0	0	146	404
EDO. SUCRE	MP. MONTES	PQ. SAN FERNANDO	UNIDAD EDUCATIVA  MANUEL CEDEÑO	1281	3	12	891	757	879	0	1	0	0	121	891
EDO. SUCRE	MP. MONTES	PQ. SAN FERNANDO	ESCUELA BASICA GUASIMILLA	553	1	5	444	371	439	0	0	2	0	66	444
EDO. SUCRE	MP. MONTES	PQ. SAN FERNANDO	U.E. SAN FERNANDO DE QUEBRADA SECA	1171	2	8	820	489	812	0	2	0	0	321	820
EDO. SUCRE	MP. MONTES	PQ. CUMANACOA	U.E. PEDRO LUIS CEDEÑO	1873	4	22	1438	909	1416	0	7	0	1	499	1438
EDO. SUCRE	MP. MONTES	PQ. CUMANACOA	U.E. JUAN RANGEL DE ZERPA	2569	5	27	1944	1262	1917	0	7	0	0	648	1944
EDO. SUCRE	MP. MONTES	PQ. CUMANACOA	UNIDAD EDUCATIVA BOLIVARIANA LA MANGA	859	2	3	707	556	704	0	6	0	0	142	707
EDO. SUCRE	MP. MONTES	PQ. CUMANACOA	U.E. DIOMEDES CASTRO RODRÍGUEZ	1387	3	16	926	651	910	1	2	2	1	253	926
EDO. SUCRE	MP. MONTES	PQ. CUMANACOA	ESCUELA BASICA NEVERI DE BUCARAL
EDO. SUCRE	MP. MONTES	PQ. CUMANACOA	ESCUELA BOLIVARIANA RIO CARIBE RÍO CARIBE	544	1	9	355	308	346	0	0	0	0	38	355
EDO. SUCRE	MP. MONTES	PQ. CUMANACOA	LICEO BOLIVARIANO LUIS BELTRAN SANABRIA	2020	4	34	1538	846	1504	2	2	0	0	654	1538
EDO. SUCRE	MP. MONTES	PQ. CUMANACOA	ESCUELA BÁSICA SAN JUANILLO	858	2	3	577	415	574	0	3	0	0	156	577
EDO. SUCRE	MP. MONTES	PQ. CUMANACOA	ESCUELA BOLIVARIANA EL AMAGUTO	534	1	8	366	272	358	0	4	0	0	82	366
EDO. SUCRE	MP. MONTES	PQ. CUMANACOA	LICEO BOLIVARIANO DIEGO DE VALLENILLA	1280	3	13	1012	597	999	0	4	0	1	397	1012
EDO. SUCRE	MP. MONTES	PQ. CUMANACOA	UNIDAD EDUCATIVA JOSE LUIS RAMOS	3473	7	31	2718	1720	2687	0	13	4	1	949	2718
EDO. SUCRE	MP. MONTES	PQ. ARICAGUA	ESCUELA BOLIVARIANA LAS MULAS	110	1	2	82	62	80	0	0	0	0	18	82
EDO. SUCRE	MP. MONTES	PQ. ARICAGUA	UNIDAD EDUCATIVA  MARIA LILIAN GUZMÁN	907	2	12	628	412	616	0	8	0	1	195	628
EDO. SUCRE	MP. MONTES	PQ. ARICAGUA	ESCUELA BÁSICA AGUA BLANCA	462	1	5	235	147	230	0	0	1	0	82	235
EDO. SUCRE	MP. MONTES	PQ. ARICAGUA	UNIDAD EDUCATIVA  TRINA HERNÁNDEZ DE FIGUERA	1041	2	13	755	472	742	0	4	1	0	265	755
EDO. SUCRE	MP. MONTES	PQ. ARICAGUA	ESCUELA CONCENTRADA ESTADAL  MAPURITE	211	1	0	111	60	111	0	1	0	0	50	111
EDO. SUCRE	MP. MONTES	PQ. ARICAGUA	ESCUELA BOLIVARIANA LAS LAGUNAAS	447	1	1	264	130	263	0	4	1	0	128	264
EDO. SUCRE	MP. MONTES	PQ. ARICAGUA	ESCUELA BOLIVARIANA ROSARIO SUCRE DE RAUSSEO	2149	4	28	1621	881	1593	0	3	0	0	709	1621
EDO. SUCRE	MP. MONTES	PQ. ARICAGUA	ESCUELA BOLIVARIANA PARMARITO	77	1	0	58	43	58	0	0	1	0	14	58
EDO. SUCRE	MP. MONTES	PQ. ARICAGUA	ESCUELA BÁSICA VALLE GRANDE	249	1	1	179	162	178	1	1	1	0	13	179
EDO. SUCRE	MP. MEJIA	CM. SAN ANT DEL GOLFO	ESCUELA BOLIVARIANA MATURINCITO	680	2	10	461	363	451	0	1	0	0	87	461
EDO. SUCRE	MP. MEJIA	CM. SAN ANT DEL GOLFO	U.E. EL CARMEN	415	1	4	256	130	252	0	1	0	0	121	256
EDO. SUCRE	MP. MEJIA	CM. SAN ANT DEL GOLFO	ESCUELA BOLIVARIANA PARADERO	742	2	5	527	286	522	0	4	0	1	231	527
EDO. SUCRE	MP. MEJIA	CM. SAN ANT DEL GOLFO	ESCUELA BOLIVARIANA PERICANTAR	930	2	13	756	381	743	1	0	1	0	360	756
EDO. SUCRE	MP. MEJIA	CM. SAN ANT DEL GOLFO	ESCUELA BÁSICA EL ZAMURO	248	1	2	194	118	192	0	0	0	0	74	194
EDO. SUCRE	MP. MEJIA	CM. SAN ANT DEL GOLFO	UNIDAD EDUCATIVA BELÉN	280	1	1	193	98	192	0	0	0	0	94	193
EDO. SUCRE	MP. MEJIA	CM. SAN ANT DEL GOLFO	UNIDAD EDUCATIVA CARATAL	241	1	3	158	108	155	0	1	1	0	45	158
EDO. SUCRE	MP. MEJIA	CM. SAN ANT DEL GOLFO	ESCUELA BOLIVARIANA LA PEÑA	781	2	13	581	379	568	0	2	0	0	187	581
EDO. SUCRE	MP. MEJIA	CM. SAN ANT DEL GOLFO	UNIDAD EDUCATIVA TARABACOA	208	1	1	171	128	170	0	1	0	0	41	171
EDO. SUCRE	MP. MEJIA	CM. SAN ANT DEL GOLFO	UNIDAD EDUCATIVA LA SOLEDAD	569	1	5	461	271	456	1	4	0	0	180	461
EDO. SUCRE	MP. MEJIA	CM. SAN ANT DEL GOLFO	ESCUELA BOLIVARIANA MIRNA VELIZ	1356	3	23	1041	673	1018	0	3	0	0	342	1041
EDO. SUCRE	MP. MEJIA	CM. SAN ANT DEL GOLFO	ESCUELA BOLIVARIANA COTUA	234	1	4	184	113	180	0	0	2	0	65	184
EDO. SUCRE	MP. MEJIA	CM. SAN ANT DEL GOLFO	U.E. LUISA AMALIA DE RAMÍREZ	2241	4	23	1789	976	1766	0	7	0	0	783	1789
EDO. SUCRE	MP. MEJIA	CM. SAN ANT DEL GOLFO	ESCUELA BÁSICA EL CAFÉ	396	1	2	262	99	260	0	1	0	0	160	262
EDO. SUCRE	MP. MEJIA	CM. SAN ANT DEL GOLFO	UNIDAD EDUCATIVA CHUARUAL	255	1	5	221	167	216	0	0	0	0	49	221
EDO. SUCRE	MP. MEJIA	CM. SAN ANT DEL GOLFO	LICEO BOLIVARIANO FRANCISCO ALEMÁN PARRA	1173	2	9	970	530	961	0	6	0	0	425	970
EDO. SUCRE	MP. MEJIA	CM. SAN ANT DEL GOLFO	UNIDAD EDUCATIVA LIMONAR AFUERA	516	1	7	380	262	373	0	0	1	0	110	380
EDO. SUCRE	MP. MEJIA	CM. SAN ANT DEL GOLFO	UNIDAD EDUCATIVA BÁSICA BUCARAL	129	1	2	41	38	39	0	0	0	0	1	41
EDO. SUCRE	MP. VALDEZ	PQ. CRISTOBAL COLON	ESCUELA BOLIVARIANA MACURO	965	2	12	645	537	633	0	3	0	0	93	645
EDO. SUCRE	MP. VALDEZ	PQ. CRISTOBAL COLON	ESCUELA UNITARIA  RIO GRANDE	83	1	0	49	40	49	0	1	0	0	8	49
EDO. SUCRE	MP. VALDEZ	PQ. CRISTOBAL COLON	UNIDAD EDUCATIVA CAPITAN DE NAVIO FRANCISCO JAVIER GUTIERREZ	198	1	3	133	115	130	0	0	0	0	15	133
EDO. SUCRE	MP. VALDEZ	PQ. PUNTA DE PIEDRA	ESCUELA BÁSICA PUNTA DE PIEDRAS	307	1	1	195	142	194	0	0	0	0	52	195
EDO. SUCRE	MP. VALDEZ	PQ. PUNTA DE PIEDRA	ESCUELA BÁSICA LA HORQUETA	203	1	0	143	82	143	0	0	0	0	61	143
EDO. SUCRE	MP. VALDEZ	PQ. PUNTA DE PIEDRA	ESCUELA BOLIVARIANA RÍO BAUTISTA	435	1	6	305	264	299	0	0	1	0	34	305
EDO. SUCRE	MP. VALDEZ	PQ. PUNTA DE PIEDRA	U.E. CREACIÓN YOCO	947	2	4	612	361	608	0	1	0	0	246	612
EDO. SUCRE	MP. VALDEZ	PQ. PUNTA DE PIEDRA	ESCUELA BOLIVARIANA SABANA DE PÍO	126	1	1	106	81	105	0	0	0	0	24	106
EDO. SUCRE	MP. VALDEZ	PQ. PUNTA DE PIEDRA	UNIDAD EDUCATIVA ANTONIO PINTO SALINAS	961	2	14	672	387	658	0	2	0	0	269	672
EDO. SUCRE	MP. VALDEZ	PQ. PUNTA DE PIEDRA	ESCUELA BOLIVARIANA SANTA ROSA	201	1	5	171	142	166	0	0	1	0	23	171
EDO. SUCRE	MP. VALDEZ	PQ. PUNTA DE PIEDRA	ESCUELA BASICA PUEBLO VIEJO DE YOCO	301	1	1	250	164	249	0	0	0	0	85	250
EDO. SUCRE	MP. VALDEZ	PQ. BIDEAU	ESCUELA BOLIVARIANA MAPIRE	114	1	0	52	50	52	0	0	0	0	2	52
EDO. SUCRE	MP. VALDEZ	PQ. BIDEAU	ESCUELA BASICA JUAN DIEGO	55	1	0	36	35	36	0	0	0	0	1	36
EDO. SUCRE	MP. VALDEZ	PQ. BIDEAU	ESCUELA BOLIVARIANA RIO SALADO	1500	3	19	1039	845	1020	0	6	0	0	169	1039
EDO. SUCRE	MP. VALDEZ	PQ. GUIRIA	U.E. MARIA BLANDIN DE ALFONZO	3785	7	53	2724	1889	2671	0	4	0	1	777	2724
EDO. SUCRE	MP. VALDEZ	PQ. GUIRIA	UNIDAD EDUCATIVA LA CAMPIÑA	383	1	6	316	229	310	0	3	0	0	78	316
EDO. SUCRE	MP. VALDEZ	PQ. GUIRIA	UNIDAD EDUCATIVA DR. DOMINGO BADARACO BERMÚDEZ	3476	6	36	2419	1637	2383	1	11	1	1	732	2419
EDO. SUCRE	MP. VALDEZ	PQ. GUIRIA	CENTRO EDUCACIÓN INICIAL GUAYACAN	453	1	19	389	268	370	0	1	0	0	101	389
EDO. SUCRE	MP. VALDEZ	PQ. GUIRIA	ESCUELA BOLIVARIANA GUARA GUARITA	251	1	2	208	156	206	0	2	0	0	48	208
EDO. SUCRE	MP. VALDEZ	PQ. GUIRIA	UNIDAD EDUCATIVA ALEJANDRO VILLANUEVA	3100	6	51	2152	1334	2101	0	5	2	3	757	2152
EDO. SUCRE	MP. VALDEZ	PQ. GUIRIA	ESCUELA BOLIVARIANA MIGUEL LOPEZ ALCALA	1087	2	23	780	616	757	0	4	0	0	137	780
EDO. SUCRE	MP. VALDEZ	PQ. GUIRIA	CASA COMUNAL GUARAMA ARRIBA	100	1	1	89	79	88	0	0	0	0	9	89
EDO. SUCRE	MP. VALDEZ	PQ. GUIRIA	U.E. MANUEL ISAVA	2161	4	31	1534	1018	1503	0	3	2	0	480	1534
EDO. SUCRE	MP. VALDEZ	PQ. GUIRIA	ESCUELA BOLIVARIANA LA SALINA	742	2	5	560	482	555	0	2	0	0	71	560
EDO. SUCRE	MP. VALDEZ	PQ. GUIRIA	ESCUELA BÁSICA EL HOYO	525	1	3	287	261	284	0	0	0	0	23	287
EDO. SUCRE	MP. VALDEZ	PQ. GUIRIA	UNIDAD EDUCATIVA BOLIVARIANA TUBERIA ABAJO	536	1	4	440	387	436	0	0	0	0	49	440
EDO. SUCRE	MP. VALDEZ	PQ. GUIRIA	U.E. SANTA EDUVIGIS	1642	3	15	1247	992	1232	0	7	1	0	232	1247
EDO. SUCRE	MP. VALDEZ	PQ. GUIRIA	UNIDAD EDUCATIVA LA TOMA	246	1	5	219	193	214	1	1	0	0	19	219
EDO. SUCRE	MP. VALDEZ	PQ. GUIRIA	ESCUELA BOLIVARIANA GUARAMAS DEL MEDIO	826	2	8	580	440	572	0	0	0	0	132	580
EDO. SUCRE	MP. VALDEZ	PQ. GUIRIA	ESCUELA BOLIVARIANA LA SABANA	425	1	5	266	220	261	0	2	0	0	39	266
EDO. SUCRE	MP. VALDEZ	PQ. GUIRIA	ESCUELA BASICA LAS TUBERIAS	600	1	8	484	349	476	0	2	0	0	125	484
EDO. SUCRE	MP. VALDEZ	PQ. GUIRIA	UNIDAD EDUCATIVA BOLIVARIANA QUEBRADA DE AGUA	112	1	2	105	89	103	0	0	1	0	13	105
EDO. MERIDA	CE. LIBERTADOR	PQ. ARIAS	UNIDAD EDUCATIVA TULIO FEBRES CORDERO	3007	6	41	2499	740	2458	0	12	0	1	1705	2499
EDO. MERIDA	CE. LIBERTADOR	PQ. ARIAS	COLEGIO NUESTRA SEÑORA DE BELEN	1400	3	29	1192	387	1163	0	5	0	0	771	1192
EDO. MERIDA	CE. LIBERTADOR	PQ. ARIAS	COLEGIO PRIVADO JARDIN FRANCISCANO	2954	6	81	2483	1205	2402	1	12	2	2	1180	2483
EDO. MERIDA	CE. LIBERTADOR	PQ. ARIAS	LICEO TULIO FEBRES CORDERO (B)	480	1	8	413	158	405	1	5	0	2	239	413
EDO. MERIDA	CE. LIBERTADOR	PQ. ARIAS	ESCUELA BASICA NACIONAL RIVAS DAVILA	1102	2	8	911	335	903	1	0	0	0	567	911
EDO. MERIDA	CE. LIBERTADOR	PQ. ARIAS	UNIDAD EDUCATIVA EZEQUIEL ZAMORA	689	2	9	612	316	603	0	1	0	2	284	612
EDO. MERIDA	CE. LIBERTADOR	PQ. ARIAS	UNIDAD EDUCATIVA LA PUEBLITA	559	1	6	484	262	478	0	1	0	0	215	484
EDO. MERIDA	CE. LIBERTADOR	PQ. ARIAS	UNIDAD EDUC ELOY CHALBAUD	1992	4	32	1762	847	1730	0	3	1	1	878	1762
EDO. MERIDA	CE. LIBERTADOR	PQ. EL MORRO	ESCUELA ESTADAL NO 255	269	1	3	226	173	223	0	1	0	0	49	226
EDO. MERIDA	CE. LIBERTADOR	PQ. EL MORRO	ESCUELA BAS EST EL HATICO	82	1	3	59	49	56	0	0	0	0	7	59
EDO. MERIDA	CE. LIBERTADOR	PQ. EL MORRO	CONC AUGUSTO MALAVE VILLALBA	153	1	0	116	95	116	0	0	0	0	21	116
EDO. MERIDA	CE. LIBERTADOR	PQ. EL MORRO	GRUPO ESCOLAR JUAN DE DIOS DAVILA	795	2	13	642	356	629	0	1	0	0	272	642
EDO. MERIDA	CE. LIBERTADOR	PQ. EL MORRO	ESCUELA ESTADAL NO 384
EDO. MERIDA	CE. LIBERTADOR	PQ. CARACCIOLO PARRA P	ESCUELA BASICA FERMIN RUIZ VALERO B	1471	3	16	1331	289	1315	1	2	1	1	1021	1331
EDO. MERIDA	CE. LIBERTADOR	PQ. CARACCIOLO PARRA P	JARDIN DE INF ELOY PAREDES	1744	3	15	1548	288	1533	0	1	0	0	1244	1548
EDO. MERIDA	CE. LIBERTADOR	PQ. CARACCIOLO PARRA P	ESCUELA BASICA FERMIN RUIZ VALERO	3213	6	24	2767	662	2743	0	5	2	2	2072	2767
EDO. MERIDA	CE. LIBERTADOR	PQ. CARACCIOLO PARRA P	ESCUELA. BASICA. ELOY PAREDES	3269	6	37	2731	505	2694	1	7	1	3	2177	2731
EDO. MERIDA	CE. LIBERTADOR	PQ. CARACCIOLO PARRA P	ESCUELA BASICA ELOY PAREDES (B)	1260	3	9	1144	258	1135	0	2	0	1	874	1144
EDO. MERIDA	CE. LIBERTADOR	PQ. LOS NEVADOS	ESCUELA ESTADAL NUMERO 152	619	2	15	476	350	461	0	0	0	0	111	476
EDO. MERIDA	CE. LIBERTADOR	PQ. GONZALO PICON FEBRES	ESCUELA MUNICIPAL MARIA ADELA DE VIELMA	865	2	30	755	334	725	0	3	0	0	388	755
EDO. MERIDA	CE. LIBERTADOR	PQ. GONZALO PICON FEBRES	ESCUELA ESTADAL NUMERO 398	616	2	9	536	238	527	0	0	0	0	289	536
EDO. MERIDA	CE. LIBERTADOR	PQ. GONZALO PICON FEBRES	UNIDAD EDUCATIVA VITALIA GUTIERREZ DE R	2329	4	33	1941	911	1908	3	7	0	0	987	1941
EDO. MERIDA	CE. LIBERTADOR	PQ. GONZALO PICON FEBRES	ESCUELA BASICA EL PLAYON NUMERO 94	1103	2	17	950	381	933	1	4	2	0	545	950
EDO. MERIDA	CE. LIBERTADOR	PQ. MILLA	UNIDAD EDUCATIVA DOCTOR RAMON REINOZO NUÑEZ (B)	945	2	10	839	331	829	1	5	0	1	491	839
EDO. MERIDA	CE. LIBERTADOR	PQ. MILLA	COLEGIO SAN JOSE DE LA SIERRA	1388	3	18	1225	325	1207	2	3	0	2	875	1225
EDO. MERIDA	CE. LIBERTADOR	PQ. MILLA	ESCUELA BASICA CAMILO CONTRERAS	2571	5	53	2182	926	2129	0	7	0	0	1196	2182
EDO. MERIDA	CE. LIBERTADOR	PQ. MILLA	JARDIN DE INFANCIA VICENTE DAVILA	1026	2	7	865	339	858	0	6	0	1	512	865
EDO. MERIDA	CE. LIBERTADOR	PQ. MILLA	ESCUELA BASICA DOCTOR RAMON REINOSO NUEZ	3292	6	47	2766	1075	2719	1	16	1	0	1626	2766
EDO. MERIDA	CE. LIBERTADOR	PQ. MILLA	ESCUELA BASICA VICENTE DAVILA	3645	7	52	2897	900	2845	4	15	2	4	1920	2897
EDO. MERIDA	CE. LIBERTADOR	PQ. MILLA	LICEO ROMULO GALLEGOS	2246	4	20	1931	536	1911	1	3	0	2	1369	1931
EDO. MERIDA	CE. LIBERTADOR	PQ. MILLA	ESCUELA BASICA GLADYS C LOBO DE CARNEVALLI	2009	4	31	1681	564	1650	1	5	0	0	1080	1681
EDO. MERIDA	CE. LIBERTADOR	PQ. MILLA	UNIDAD EDUCATIVA COLEGIO SAGRADA FAMILIA
EDO. MERIDA	CE. LIBERTADOR	PQ. MARIANO PICON SALAS	ESCUELA BOLIVARIANA HUMBERTO TEJERA	3424	6	44	2996	781	2952	1	9	0	0	2161	2996
EDO. MERIDA	CE. LIBERTADOR	PQ. MARIANO PICON SALAS	ESCUELA DEPORTIVA	2863	5	26	2502	606	2476	2	9	1	2	1856	2502
EDO. MERIDA	CE. LIBERTADOR	PQ. MARIANO PICON SALAS	ESCUELA BASICA AMADO GONZALEZ	1522	3	21	1270	362	1249	1	4	0	0	882	1270
EDO. MERIDA	CE. LIBERTADOR	PQ. MARIANO PICON SALAS	LICEO EXPERIM FRAY J RAMOS DE LORA	1124	2	18	963	297	945	2	3	0	0	643	963
EDO. MERIDA	CE. LIBERTADOR	PQ. MARIANO PICON SALAS	UNID EDUC EL RINCON	820	2	10	705	343	695	0	0	0	0	352	705
EDO. MERIDA	CE. LIBERTADOR	PQ. EL LLANO	LICEO LIBERTADOR (B)	2017	4	15	1745	523	1730	0	10	1	0	1196	1745
EDO. MERIDA	CE. LIBERTADOR	PQ. EL LLANO	UNIDAD EDUCATIVA NUESTRA SEÑORA  DE FATIMA	1650	3	13	1450	273	1437	0	1	1	2	1160	1450
EDO. MERIDA	CE. LIBERTADOR	PQ. EL LLANO	UNIDAD EDUCATIVA LA SALLE	3037	6	37	2535	571	2498	0	8	0	1	1918	2535
EDO. MERIDA	CE. LIBERTADOR	PQ. EL LLANO	UNIDAD EDUCATIVA. COLEGIO LA SALLE B	707	2	3	652	114	649	0	1	1	1	532	652
EDO. MERIDA	CE. LIBERTADOR	PQ. EL LLANO	LICEO NACIONAL LIBERTADOR	3914	7	45	3116	834	3071	1	10	1	1	2224	3116
EDO. MERIDA	CE. LIBERTADOR	PQ. DOMINGO PE#A	ESCUELA  BASICA GONZALO PICON FEBRES	1490	3	12	1268	396	1256	1	8	0	0	851	1268
EDO. MERIDA	CE. LIBERTADOR	PQ. DOMINGO PE#A	PRE ESCOLAR NIÑO SIMON	224	1	5	199	85	194	0	0	0	0	109	199
EDO. MERIDA	CE. LIBERTADOR	PQ. DOMINGO PE#A	DEPARTAMENTO DE EDUCACION PARA ADULTO	434	1	4	357	106	353	0	0	0	0	247	357
EDO. MERIDA	CE. LIBERTADOR	PQ. DOMINGO PE#A	ESCUELA BASICA NACIONAL JUAN RUIZ FAJARDO	3010	6	42	2623	860	2581	0	7	1	1	1712	2623
EDO. MERIDA	CE. LIBERTADOR	PQ. DOMINGO PE#A	ESCUELA TECNICA MANUEL ANTONIO PULIDO MENDEZ	3387	6	24	3018	920	2994	1	6	0	2	2065	3018
EDO. MERIDA	CE. LIBERTADOR	PQ. DOMINGO PE#A	UNIDAD  EDUCATIVA 5 DE JULIO	1706	3	17	1419	529	1402	1	4	0	1	867	1419
EDO. MERIDA	CE. LIBERTADOR	PQ. DOMINGO PE#A	ESCUELA  BASICA FILOMENA DAVILA	1954	4	27	1755	629	1728	0	8	1	2	1088	1755
EDO. MERIDA	CE. LIBERTADOR	PQ. DOMINGO PE#A	UNIDAD EDUCATIVA MARIA MOZZARELLO	1595	3	38	1436	619	1398	0	5	0	0	774	1436
EDO. MERIDA	CE. LIBERTADOR	PQ. DOMINGO PE#A	ESCUELA  BASICA 15 DE ENERO	937	2	14	845	433	831	0	4	1	1	392	845
EDO. MERIDA	CE. LIBERTADOR	PQ. DOMINGO PE#A	ESCUELA  BASICA RAFAEL ANTONIO GODOY	3037	6	36	2509	774	2473	2	8	1	3	1685	2509
EDO. MERIDA	CE. LIBERTADOR	PQ. DOMINGO PE#A	UNIDAD  EDUCATIVA ANTONIO N RANGEL	1497	3	19	1291	574	1272	0	6	0	0	692	1291
EDO. MERIDA	CE. LIBERTADOR	PQ. JACINTO PLAZA	GRUPO ESCOLAR EL EDUCADOR (B)	435	1	2	372	220	370	0	1	0	0	149	372
EDO. MERIDA	CE. LIBERTADOR	PQ. JACINTO PLAZA	U.E. BOLIVARIANA MAHATMA GANDHI	455	1	9	395	280	386	0	3	0	0	103	395
EDO. MERIDA	CE. LIBERTADOR	PQ. JACINTO PLAZA	GRUPO ESCOLAR EL EDUCADOR	3755	7	67	3164	1493	3097	1	21	0	0	1582	3164
EDO. MERIDA	CE. LIBERTADOR	PQ. JACINTO PLAZA	ESC BAS JUAN DE ARCO	2882	5	52	2380	1256	2328	1	9	4	0	1058	2380
EDO. MERIDA	CE. LIBERTADOR	PQ. JACINTO PLAZA	ESCUELA BASICA GRADUADA SIMON RODRIGUEZ	3816	7	62	3087	1721	3025	1	12	4	2	1285	3087
EDO. MERIDA	CE. LIBERTADOR	PQ. JACINTO PLAZA	UNIDAD EDUCATIVASAN RAFAEL DEL CHAMA	287	1	4	265	178	261	0	1	0	0	82	265
EDO. MERIDA	CE. LIBERTADOR	PQ. JACINTO PLAZA	UNID EDUC ANDRES ELOY BLANCO	4399	8	75	3730	1831	3655	3	17	0	1	1803	3730
EDO. MERIDA	CE. LIBERTADOR	PQ. JACINTO PLAZA	UNIDAD EDUCATIVA JUANA DE ARCO (B)	1421	3	24	1220	704	1196	0	1	3	0	488	1220
EDO. MERIDA	CE. LIBERTADOR	PQ. ANTONIO SPINETTI DINI	LICEO PRIVADO MONSEÑOR SILVA	4019	7	37	3360	751	3323	0	6	0	4	2562	3360
EDO. MERIDA	CE. LIBERTADOR	PQ. ANTONIO SPINETTI DINI	UNIDAD LARGA ESTANCIA	544	1	3	442	227	439	0	1	1	0	210	442
EDO. MERIDA	CE. LIBERTADOR	PQ. ANTONIO SPINETTI DINI	ESCUELA BASICA ELEAZAR LOPEZ CONTRERAS	2656	5	45	2237	712	2192	1	6	1	2	1470	2237
EDO. MERIDA	CE. LIBERTADOR	PQ. ANTONIO SPINETTI DINI	UNIDAD EDUCATIVA EMIRO FUENMAYOR	2799	5	47	2259	1091	2212	1	10	0	4	1106	2259
EDO. MERIDA	CE. LIBERTADOR	PQ. ANTONIO SPINETTI DINI	ESCUELA BASICA JOSEFA MOLINA DE DUQUE	2912	5	35	2488	778	2453	0	5	3	0	1667	2488
EDO. MERIDA	CE. LIBERTADOR	PQ. ANTONIO SPINETTI DINI	UNIDAD EDUCATIVA ALBERTO CARNEVALI	2038	4	29	1804	751	1775	1	3	0	1	1019	1804
EDO. MERIDA	CE. LIBERTADOR	PQ. ANTONIO SPINETTI DINI	ESCUELA BASICA DOÑA MARCOLINA DE LAMUS	1004	2	15	856	398	841	1	1	0	0	441	856
EDO. MERIDA	CE. LIBERTADOR	PQ. ANTONIO SPINETTI DINI	UNIDAD EDUCATIVA COLEGIO MADRE EMILIA	2166	4	10	1971	413	1961	0	3	0	0	1545	1971
EDO. MERIDA	CE. LIBERTADOR	PQ. ANTONIO SPINETTI DINI	ESCUELA TECNICA  ROBINSONIANA SIMON RODRIGUEZ	415	1	7	364	165	357	0	1	0	0	191	364
EDO. MERIDA	CE. LIBERTADOR	PQ. ANTONIO SPINETTI DINI	UNIDAD EDUCATIVA BASICA MONSEÑOR DOCTOR  SANTIAGO HERNANDEZ MILANEZ	1652	3	25	1415	643	1390	0	6	0	0	741	1415
EDO. MERIDA	CE. LIBERTADOR	PQ. JUAN RODRIGUEZ SUAREZ	CICLO BASICO CARACCIOLO PARRA OLMEDO	3539	7	34	2972	502	2938	1	7	1	2	2425	2972
EDO. MERIDA	CE. LIBERTADOR	PQ. JUAN RODRIGUEZ SUAREZ	ESCUELA BASICA CECILIO ACOSTA	1955	4	17	1711	290	1694	0	3	0	1	1400	1711
EDO. MERIDA	CE. LIBERTADOR	PQ. JUAN RODRIGUEZ SUAREZ	UNIDAD EDUCATIVA CARACIOLO PARRA Y OLMEDO (B)	1325	3	12	1193	244	1181	2	3	1	1	930	1193
EDO. MERIDA	CE. LIBERTADOR	PQ. JUAN RODRIGUEZ SUAREZ	PRE ESCOLAR DON ANDRES BELLO	805	2	4	744	165	740	0	1	0	0	574	744
EDO. MERIDA	CE. LIBERTADOR	PQ. JUAN RODRIGUEZ SUAREZ	ESCUELA  BASICA ZUMBA	1578	3	23	1384	436	1361	1	5	1	0	918	1384
EDO. MERIDA	CE. LIBERTADOR	PQ. JUAN RODRIGUEZ SUAREZ	COLEGIO N SRA DEL ROSARIO	2163	4	21	1889	339	1868	0	3	1	2	1523	1889
EDO. MERIDA	CE. LIBERTADOR	PQ. JUAN RODRIGUEZ SUAREZ	GRUPO ESCOLAR ESTADO LARA	2353	4	16	2040	341	2024	0	3	1	0	1679	2040
EDO. MERIDA	CE. LIBERTADOR	PQ. LASSO DE LA VEGA	ESC BAS RAMON PARRA PICON	3300	6	40	2784	1053	2744	0	8	1	2	1680	2784
EDO. MERIDA	CE. LIBERTADOR	PQ. LASSO DE LA VEGA	UNIDAD EDUCATIVA RAMON IGNAGIO GUERRA (B)	2253	4	35	2020	622	1985	1	8	1	0	1353	2020
EDO. MERIDA	CE. LIBERTADOR	PQ. LASSO DE LA VEGA	ESCUELA BASICA RAMON IGNACIO GUERRA.	3019	6	41	2560	763	2519	0	6	0	3	1747	2560
EDO. MERIDA	CE. LIBERTADOR	PQ. OSUNA RODRIGUEZ	ESCUELA BASICA LOS CUROS	3242	6	41	2709	1175	2668	2	8	1	0	1482	2709
EDO. MERIDA	CE. LIBERTADOR	PQ. OSUNA RODRIGUEZ	UNIDAD EDUCATIVA  BICENTENARIO DEL LIBERTADOR	866	2	14	778	403	764	0	5	0	0	356	778
EDO. MERIDA	CE. LIBERTADOR	PQ. OSUNA RODRIGUEZ	ESCUELA BASICA 10 DE DICIEMBRE	2139	4	37	1816	809	1779	0	5	2	0	963	1816
EDO. MERIDA	CE. LIBERTADOR	PQ. OSUNA RODRIGUEZ	UNIDAD EDUCATIVA ROMULO BETANCOURT B	804	2	11	712	334	701	0	3	1	0	363	712
EDO. MERIDA	CE. LIBERTADOR	PQ. OSUNA RODRIGUEZ	UNIDAD EDUCATIVA ROMULO BETANCOURT	2984	6	53	2579	1170	2526	0	7	1	0	1348	2579
EDO. MERIDA	CE. LIBERTADOR	PQ. OSUNA RODRIGUEZ	ESCUELA BASICA LOS CUROS (B)	1919	4	32	1654	829	1622	0	2	1	1	789	1654
EDO. MERIDA	CE. LIBERTADOR	PQ. SAGRARIO	ESCUELA UNIDAD EDUCATIVA ESTADAL COROMOTO	2438	5	42	1981	618	1939	0	4	1	3	1313	1981
EDO. MERIDA	CE. LIBERTADOR	PQ. SAGRARIO	ESCUELA BASICA  GABRIEL PICON GONZALEZ	2773	5	31	2274	597	2243	0	8	1	2	1635	2274
EDO. MERIDA	MP. PUEBLO LLANO	CM. PUEBLO LLANO	ESCUELA BOLIVARIANA ADELA BASTIDAS	180	1	2	166	103	164	0	0	0	0	61	166
EDO. MERIDA	MP. PUEBLO LLANO	CM. PUEBLO LLANO	ESCUELA BASICA BOLIVARIANA  FOCION F CORDERO	2751	5	45	2272	1004	2227	1	6	0	0	1216	2272
EDO. MERIDA	MP. PUEBLO LLANO	CM. PUEBLO LLANO	UNIDAD EDUCATIVA BOLIVARIANA MUTUS	1143	2	19	983	472	964	0	1	0	0	491	983
EDO. MERIDA	MP. PUEBLO LLANO	CM. PUEBLO LLANO	UNIDAD EDUCATIVA LA CULATA	1412	3	27	1169	658	1142	0	5	0	0	479	1169
EDO. MERIDA	MP. PUEBLO LLANO	CM. PUEBLO LLANO	UNIDAD DUCATIVA BOLIVARIANA MIYOY	125	1	3	116	73	113	0	0	0	0	40	116
EDO. MERIDA	MP. PUEBLO LLANO	CM. PUEBLO LLANO	ESCUELA BOLIVARIANA LA CAPELLANIA	1538	3	17	1256	707	1239	0	1	1	0	530	1256
EDO. MERIDA	MP.OB. RAMOS DE LORA	PQ. PQ R DE ALCAZAR	ESC BAS CONC MIXTA MATA DE COCO	887	2	8	674	406	666	0	2	0	0	258	674
EDO. MERIDA	MP.OB. RAMOS DE LORA	PQ. PQ R DE ALCAZAR	UNIDAD EDUCATIVA BOLIVARIANA PUEBLO NUEVO 1	141	1	1	127	86	126	0	1	0	0	39	127
EDO. MERIDA	MP.OB. RAMOS DE LORA	PQ. PQ R DE ALCAZAR	UNIDAD EDUCATIVA LA PROVIDENCIA	522	1	9	380	231	371	0	1	0	0	139	380
EDO. MERIDA	MP.OB. RAMOS DE LORA	PQ. PQ R DE ALCAZAR	ESC BAS COMB GUACHIZON II	651	2	6	509	263	503	0	2	1	0	237	509
EDO. MERIDA	MP.OB. RAMOS DE LORA	PQ. PQ R DE ALCAZAR	ESCUELA BASICA SAN RAFAEL DE ALCAZAR	1670	3	27	1306	815	1279	0	1	0	0	463	1306
EDO. MERIDA	MP.OB. RAMOS DE LORA	CM. STA ELENA DE ARENALES	INSTITUTO DE EDUCACION ESPECIAL BOLIVARIANO IROSKA APOLINAR DE PORRAS	348	1	6	288	191	282	0	2	0	0	89	288
EDO. MERIDA	MP.OB. RAMOS DE LORA	CM. STA ELENA DE ARENALES	UNIDAD EDUCATIVA BOLIVARIANA CAPAZON ARRIBA	707	2	8	554	340	546	0	1	0	0	205	554
EDO. MERIDA	MP.OB. RAMOS DE LORA	CM. STA ELENA DE ARENALES	UNIDAD EDUCATIVA BOLIVARIANA MARIA DE JESUS NOGUERA DE TORRES	399	1	4	306	203	302	0	0	1	0	98	306
EDO. MERIDA	MP.OB. RAMOS DE LORA	CM. STA ELENA DE ARENALES	UNIDAD EDUCATIVA J J OSUNA RODRIGUEZ	1519	3	23	1291	674	1268	0	8	0	3	583	1291
EDO. MERIDA	MP.OB. RAMOS DE LORA	CM. STA ELENA DE ARENALES	ESCUELA BOLIVARIANA MARIA TERESA DEL TORO	308	1	8	283	222	275	0	0	0	0	53	283
EDO. MERIDA	MP.OB. RAMOS DE LORA	CM. STA ELENA DE ARENALES	ESCUELA ESTADAL SANTA ELENA ABAJO	205	1	1	186	172	185	0	0	0	0	13	186
EDO. MERIDA	MP.OB. RAMOS DE LORA	CM. STA ELENA DE ARENALES	ESCUELA BASICA DOCTOR MARIANO UZCATEGUI	2534	5	31	2060	1018	2029	0	5	1	0	1005	2060
EDO. MERIDA	MP.OB. RAMOS DE LORA	CM. STA ELENA DE ARENALES	ESCUELA NACIONAL NO 1427	678	2	5	555	319	550	0	2	0	0	229	555
EDO. MERIDA	MP.OB. RAMOS DE LORA	CM. STA ELENA DE ARENALES	NER 109	1044	2	6	795	564	789	0	7	1	0	217	795
EDO. MERIDA	MP.OB. RAMOS DE LORA	CM. STA ELENA DE ARENALES	ESC BAS CONC MIXTA	884	2	10	707	323	697	0	1	0	0	373	707
EDO. MERIDA	MP.OB. RAMOS DE LORA	CM. STA ELENA DE ARENALES	UNIDAD EDUCATIVA COLEGIO CRISTO REY	833	2	15	716	427	701	0	5	0	0	269	716
EDO. MERIDA	MP.OB. RAMOS DE LORA	PQ. ELOY PAREDES	UNIDAD EDUCATIVA BOLIVARIANA ANTONIO VERDI	788	2	2	640	413	638	0	6	0	0	219	640
EDO. MERIDA	MP.OB. RAMOS DE LORA	PQ. ELOY PAREDES	LICEO CARLOS ERNESTO MORALES	604	2	11	506	305	495	0	1	0	0	189	506
EDO. MERIDA	MP.OB. RAMOS DE LORA	PQ. ELOY PAREDES	UNIDAD EDUCATIVA DON PEDRO JESUS PINO	2166	4	23	1772	944	1749	0	14	2	1	788	1772
EDO. MERIDA	MP.OB. RAMOS DE LORA	PQ. ELOY PAREDES	UNIDAD EDUCATIVA BOLIVARIANA CAÑO RICO	695	2	6	561	368	555	0	2	0	0	185	561
EDO. MERIDA	MP.OB. RAMOS DE LORA	PQ. ELOY PAREDES	UNIDAD EDUCATIVA BOLIVARIANA CANO OBISPO	88	1	1	82	57	81	0	0	0	0	24	82
EDO. MERIDA	MP.OB. RAMOS DE LORA	PQ. ELOY PAREDES	ESCUELA ESTADAL CANO RICITO	119	1	0	107	97	107	0	0	0	0	10	107
EDO. MERIDA	MP.OB. RAMOS DE LORA	PQ. ELOY PAREDES	UNIDAD EDUCATIVA BOLIVARIANA EL CRUCERO	278	1	3	190	132	187	0	0	0	0	55	190
EDO. MERIDA	MP.OB. RAMOS DE LORA	PQ. ELOY PAREDES	ESCUELA BOLIVARIANA LOMA DE PIEDRA	436	1	3	358	206	355	0	1	0	0	148	358
EDO. MERIDA	MP. SUCRE	PQ. CHIGUARA	UNIDAD EDUCATIVA LLANO EL ANIS	885	2	27	760	459	733	0	3	0	0	271	760
EDO. MERIDA	MP. SUCRE	PQ. CHIGUARA	ESC BAS NAC 242 SAN JOSE	241	1	2	190	161	188	0	0	0	0	27	190
EDO. MERIDA	MP. SUCRE	PQ. CHIGUARA	GRUPO ESCOLAR ESTADO NUEVA ESPARTA	3205	6	71	2597	1183	2526	1	4	1	1	1336	2597
EDO. MERIDA	MP. SUCRE	PQ. CHIGUARA	UNIDAD EDUCATIVA LICEO BOLIVARIANO FRANCISCO A UZCATEGUI	266	1	5	238	119	233	0	0	0	0	114	238
EDO. MERIDA	MP. SUCRE	PQ. CHIGUARA	ES EST BAS EL REMOLINO	454	1	4	337	246	333	0	4	2	0	81	337
EDO. MERIDA	MP. SUCRE	PQ. CHIGUARA	ESCUELA ESTADAL BASICA NUMERO 1294	153	1	4	98	82	94	0	0	0	0	12	98
EDO. MERIDA	MP. SUCRE	PQ. CHIGUARA	U E AGUA LINDA	401	1	5	342	215	337	0	0	0	0	122	342
EDO. MERIDA	MP. SUCRE	PQ. CHIGUARA	ESCUELA ESTADAL EL VERDE	185	1	2	134	45	132	0	0	0	0	87	134
EDO. MERIDA	MP. SUCRE	PQ. PUEBLO NUEVO DEL SUR	ESCUELA ESTADAL BOLIVARIANA LOS AMARILLOS	580	1	5	422	292	417	0	1	1	0	123	422
EDO. MERIDA	MP. SUCRE	PQ. PUEBLO NUEVO DEL SUR	ESCUELA NACIONAL UNITARIA NO 1273	165	1	2	98	72	96	0	0	1	0	23	98
EDO. MERIDA	MP. SUCRE	PQ. PUEBLO NUEVO DEL SUR	ESCUELA ESTADAL BOLIVARIANA EL HORCAZ	139	1	1	128	90	127	0	2	0	0	35	128
EDO. MERIDA	MP. SUCRE	PQ. PUEBLO NUEVO DEL SUR	UNIDAD EDUCATIVA GENARINA DUGARTE C	870	2	8	636	322	628	0	3	0	2	301	636
EDO. MERIDA	MP. SUCRE	PQ. PUEBLO NUEVO DEL SUR	ESCUELA CONCENTRADA MIXTA	246	1	2	174	111	172	0	0	0	0	61	174
EDO. MERIDA	MP. SUCRE	PQ. PUEBLO NUEVO DEL SUR	UNIDAD EDUCATIVA BOLIVARIANA EL CAMBUR 2380	294	1	2	218	215	216	0	0	0	0	1	218
EDO. MERIDA	MP. SUCRE	PQ. PUEBLO NUEVO DEL SUR	UNIDAD EDUCATIVA LA AGUADA	131	1	0	90	82	90	0	0	0	0	8	90
EDO. MERIDA	MP. SUCRE	PQ. PUEBLO NUEVO DEL SUR	ESCUELA ESTADAL NO 126	229	1	2	190	165	188	0	0	0	0	23	190
EDO. MERIDA	MP. SUCRE	CM. LAGUNILLAS	UNIDA EDUCATIVA BOLIVARAIANA EL MOLINO	2310	4	25	1881	1104	1856	0	9	0	0	743	1881
EDO. MERIDA	MP. SUCRE	CM. LAGUNILLAS	U.E.COLEGIO CIUDAD DE LAGUNILLAS	1877	4	43	1504	721	1461	1	6	1	1	731	1504
EDO. MERIDA	MP. SUCRE	CM. LAGUNILLAS	ESC BASICA MANUEL GUAL	3124	6	49	2597	1363	2548	1	10	0	1	1173	2597
EDO. MERIDA	MP. SUCRE	CM. LAGUNILLAS	LICEO BOLIVARIANO LUIS E MARQUEZ B	2598	5	32	2045	1002	2013	2	9	1	1	998	2045
EDO. MERIDA	MP. SUCRE	CM. LAGUNILLAS	ESCUELA BASICA UNIDAD EDUCATIVA LOS ARAQUES	608	2	11	495	322	484	0	2	0	0	160	495
EDO. MERIDA	MP. SUCRE	CM. LAGUNILLAS	ESCUELA BASICA MANUEL GUAL (B)	1214	3	17	1019	582	1002	0	3	1	1	415	1019
EDO. MERIDA	MP. SUCRE	CM. LAGUNILLAS	UNIDAD EDUCATIVA FERMIN TORO	766	2	12	684	486	672	0	3	0	0	183	684
EDO. MERIDA	MP. SUCRE	CM. LAGUNILLAS	JARDIN INFANCIA MANUEL GUAL ANEXO SAN MARTIN	400	1	5	339	266	334	0	1	0	0	67	339
EDO. MERIDA	MP. SUCRE	CM. LAGUNILLAS	ESCUELA BASICA ESTADAL UNITARIA LOS UVITOS	225	1	3	124	83	121	0	0	0	0	38	124
EDO. MERIDA	MP. SUCRE	CM. LAGUNILLAS	UNIDAD EDUCATIVA BOLIVARIANA 24 DE JUNIO	891	2	28	788	435	760	0	8	0	1	316	788
EDO. MERIDA	MP. SUCRE	PQ. SAN JUAN	INTERNADO JUDICIAL	164	1	1	45	31	44	0	0	0	0	13	45
EDO. MERIDA	MP. SUCRE	PQ. SAN JUAN	JARDIN DE INFANCIA ESTADO PORTUGUESA	221	1	2	191	126	189	0	0	0	0	63	191
EDO. MERIDA	MP. SUCRE	PQ. SAN JUAN	PRE ESCOLAR VILLA LIBERTAD	596	1	9	506	278	497	0	2	0	0	217	506
EDO. MERIDA	MP. SUCRE	PQ. SAN JUAN	E.B. ESTADO PORTUGUESA B	619	2	16	536	302	520	0	3	0	0	215	536
EDO. MERIDA	MP. SUCRE	PQ. SAN JUAN	UNIDAD EDUCATIVA FRANCISCO DE MIRANDA	671	2	27	602	385	575	0	4	0	0	186	602
EDO. MERIDA	MP. SUCRE	PQ. SAN JUAN	U E OBISPO ARIAS	522	1	13	436	235	423	0	1	0	0	187	436
EDO. MERIDA	MP. SUCRE	PQ. SAN JUAN	ESCUELA BASICA ESTADAL PORTUGUESA (B)	1776	3	29	1524	877	1495	0	11	0	0	607	1524
EDO. MERIDA	MP. SUCRE	PQ. SAN JUAN	ESCUELA BASICA ESTADO PORTUGUESA	2838	5	41	2188	1200	2147	0	10	2	1	934	2188
EDO. MERIDA	MP. SUCRE	PQ. ESTANQUES	ESC BAS EST NO 246	419	1	8	338	160	330	2	1	0	0	167	338
EDO. MERIDA	MP. SUCRE	PQ. ESTANQUES	ESCUELA ESTADAL BASICA 1133 RINCON DEL PALMAR	336	1	0	225	199	225	0	0	0	0	26	225
EDO. MERIDA	MP. SUCRE	PQ. ESTANQUES	ESCUELA ESTADAL NUMERO 107	286	1	1	205	173	204	0	0	0	0	31	205
EDO. MERIDA	MP. SUCRE	PQ. ESTANQUES	UNIDAD EDUCATIVA SANTO DOMINGO	151	1	1	131	94	130	0	0	0	0	36	131
EDO. MERIDA	MP. SUCRE	PQ. ESTANQUES	CONCENTRACION ESCOLAR ESTANQUEZ	995	2	14	793	424	779	0	3	0	0	352	793
EDO. MERIDA	MP. SUCRE	PQ. ESTANQUES	ESCUELA ESTADAL LAS LABRANZAS NUMERO 058	204	1	3	153	111	150	0	1	0	0	38	153
EDO. MERIDA	MP. SUCRE	PQ. ESTANQUES	ESCUELA ESTADAL EL HATO	329	1	3	264	123	261	0	4	0	0	134	264
EDO. MERIDA	MP. SUCRE	PQ. ESTANQUES	ESCUELA ESTADAL SAN ANTONIO	211	1	5	171	139	166	0	0	0	0	27	171
EDO. MERIDA	MP. SUCRE	PQ. ESTANQUES	ESCUELA ESTADAL SAN PABLO ALTO	206	1	5	152	112	147	0	0	0	0	35	152
EDO. MERIDA	MP. SUCRE	PQ. LA TRAMPA	ESC BAS ESTADAL NO 51	377	1	6	256	184	250	0	2	0	0	64	256
EDO. MERIDA	MP. SUCRE	PQ. LA TRAMPA	UNIDAD EDUCATIVA LA TRAMPA	500	1	3	374	209	371	0	2	2	0	158	374
EDO. MERIDA	MP. SUCRE	PQ. LA TRAMPA	ESC BASICA ESTADAL NO 441	373	1	2	273	229	271	0	2	2	0	38	273
EDO. MERIDA	MP. SUCRE	PQ. LA TRAMPA	ESCUELA BASICA EL ESTANQUILLO	189	1	5	139	90	134	0	0	0	0	44	139
EDO. MERIDA	MP. SUCRE	PQ. LA TRAMPA	ESCUELA BASICA ESTADAL BELEN	133	1	2	107	51	105	0	0	0	0	54	107
EDO. MERIDA	MP. SUCRE	PQ. LA TRAMPA	ESCUELA BASICA ESTADAL NO 174	148	1	7	103	81	96	0	1	0	0	14	103
EDO. MERIDA	MP. MIRANDA	PQ. PI#ANGO	UNIDAD EDUCATIVA BOLIVARIANA DR IGNACIO FERNANDEZ PENA	524	1	6	449	227	443	0	3	0	0	213	449
EDO. MERIDA	MP. MIRANDA	PQ. PI#ANGO	UNIDAD EDUCATIVA EL ARBOLITO	259	1	3	216	180	213	0	0	0	0	33	216
EDO. MERIDA	MP. MIRANDA	PQ. PI#ANGO	ESCUELA ESTADAL NO 108	164	1	1	136	96	135	1	0	0	0	38	136
EDO. MERIDA	MP. MIRANDA	PQ. PI#ANGO	ESCUELA LAS TAPIAS	135	1	4	119	41	115	0	0	0	1	73	119
EDO. MERIDA	MP. MIRANDA	PQ. LA VENTA	UNIDAD EDUCATIVA BOLIVARIANA LA VENTA	950	2	17	794	309	777	0	7	0	0	461	794
EDO. MERIDA	MP. MIRANDA	PQ. LA VENTA	ESCUELA ESTADAL BOLIVARIANA CRUZ CHIQUITA	307	1	8	239	116	231	0	1	0	0	114	239
EDO. MERIDA	MP. MIRANDA	PQ. ANDRES ELOY BLANCO	UNIDAD EDUCATIVA EMILIO MALDONADO	1594	3	33	1242	554	1209	0	10	1	1	643	1242
EDO. MERIDA	MP. MIRANDA	CM. CHACHOPO	ESCUELA BASICA FILOMENA RUIZ DE RODRIGUEZ	2360	4	37	2051	924	2014	0	5	0	1	1084	2051
EDO. MERIDA	MP. MIRANDA	CM. CHACHOPO	UNIDAD EDUCATIVA FRANCISCO DE PAULA ANDRADE	2414	5	71	2057	866	1986	0	7	1	0	1112	2057
EDO. MERIDA	MP. MIRANDA	CM. CHACHOPO	ESCUELA ESTADAL TAFALLEZ	288	1	4	257	177	253	0	0	0	0	76	257
EDO. MERIDA	MP. MIRANDA	CM. CHACHOPO	GRUPO ESCOLAR CANONIGO UZCATEGUI	2515	5	56	2033	1019	1977	0	6	0	1	951	2033
EDO. MERIDA	MP. MIRANDA	CM. CHACHOPO	UNIDAD EDUCATIVA LA JOYA	658	2	13	551	223	538	0	4	2	0	309	551
EDO. MERIDA	MP. MIRANDA	CM. CHACHOPO	ESCUELA NACIONAL BOLIVARIANA LAS MESAS	280	1	3	237	88	234	0	0	0	0	146	237
EDO. MERIDA	MP. MIRANDA	CM. CHACHOPO	UNIDAD EDUCATIVA LA VEGA	199	1	2	180	134	178	1	0	1	1	41	180
EDO. MERIDA	MP. MIRANDA	CM. CHACHOPO	ESCUELA ESTADAL BOLIVARIANA MESA CERRADA	749	2	15	656	438	641	1	3	2	0	197	656
EDO. MERIDA	MP. MIRANDA	CM. CHACHOPO	ESCUELA  ESTADAL SANTA CRUZ DE TAFALLEZ	187	1	5	133	94	128	0	1	0	0	33	133
EDO. MERIDA	MP. MIRANDA	CM. CHACHOPO	UNIDAD EDUCATIVA NACIONAL CHIJOS	1300	3	32	1139	663	1107	1	4	1	0	438	1139
EDO. MERIDA	MP.JULIO CESAR SALAS	PQ. PALMIRA	ESCUELA PRIMARIA ESTADAL EL CERRO	703	2	3	547	299	544	0	2	0	0	243	547
EDO. MERIDA	MP.JULIO CESAR SALAS	PQ. PALMIRA	UNIDAD EDUCATIVA PALMIRA	1057	2	8	859	562	851	0	3	0	0	286	859
EDO. MERIDA	MP.JULIO CESAR SALAS	PQ. PALMIRA	UNIDAD EDUCATIVA PALMIRA B	159	1	1	140	92	139	0	0	0	0	47	140
EDO. MERIDA	MP.JULIO CESAR SALAS	CM. ARAPUEY	INSTITUTO DE EDUCACION ESPECIAL ARAPUEY	1230	3	42	944	601	902	0	0	1	0	300	944
EDO. MERIDA	MP.JULIO CESAR SALAS	CM. ARAPUEY	ESCUELA ESTADAL LA ARENOSA	171	1	3	149	121	146	0	1	0	0	24	149
EDO. MERIDA	MP.JULIO CESAR SALAS	CM. ARAPUEY	ESCUELA ESTADAL SAN MIGUEL	899	2	15	699	402	684	0	2	0	0	280	699
EDO. MERIDA	MP.JULIO CESAR SALAS	CM. ARAPUEY	ESCUELA PRIMARIA ROBERTO PICON LARES	2480	5	24	1765	1071	1741	0	5	0	0	665	1765
EDO. MERIDA	MP.JULIO CESAR SALAS	CM. ARAPUEY	ESCUELA ESTADAL EL POCO	160	1	5	137	107	132	0	1	0	0	24	137
EDO. MERIDA	MP.JULIO CESAR SALAS	CM. ARAPUEY	LICEO BOLIVARIANO ROBERTO PICON LARES	1285	3	21	1039	681	1018	0	6	0	0	331	1039
EDO. MERIDA	MP.JULIO CESAR SALAS	CM. ARAPUEY	ESCUELA ESTADAL EL QUINCE	778	2	15	576	423	561	0	3	0	0	135	576
EDO. MERIDA	MP.JULIO CESAR SALAS	CM. ARAPUEY	ESCUELA ESTADAL BOLIVARIANA 23 DE ENERO	656	2	8	518	329	510	1	0	0	0	180	518
EDO. MERIDA	MP.JULIO CESAR SALAS	CM. ARAPUEY	ESCUELA ESTADAL LA ALCABALA	285	1	3	251	175	248	1	1	0	0	71	251
EDO. MERIDA	MP.JULIO CESAR SALAS	CM. ARAPUEY	ESCUELA ESTADAL MESA BONITA	81	1	2	73	59	71	0	0	0	0	12	73
EDO. MERIDA	MP. SANTOS MARQUINA	CM. TABAY	UNID EDUC SAN RAFAEL DE TABAY	2383	5	33	1998	974	1965	0	6	0	0	985	1998
EDO. MERIDA	MP. SANTOS MARQUINA	CM. TABAY	ESCUELA ESTADO APURE	3569	7	51	3026	1396	2975	3	8	2	2	1564	3026
EDO. MERIDA	MP. SANTOS MARQUINA	CM. TABAY	ESCUELA BASICA 21 DE NOVIEMBRE	2144	4	58	1836	933	1778	1	5	3	1	835	1836
EDO. MERIDA	MP. SANTOS MARQUINA	CM. TABAY	UNIDAD EDUCATIVA FRANCISCO ZERPA	1016	2	17	873	492	856	0	1	0	1	362	873
EDO. MERIDA	MP. SANTOS MARQUINA	CM. TABAY	ESC BAS NAC 2206 475 Y MUNC 18	837	2	13	722	315	709	1	3	3	1	386	722
EDO. MERIDA	MP. SANTOS MARQUINA	CM. TABAY	LICEO MIGUEL OTERO SILVA	760	2	16	654	406	638	1	3	0	1	227	654
EDO. MERIDA	MP. SANTOS MARQUINA	CM. TABAY	ESC BAS INTEGRAL EL PEDREGAL	834	2	22	709	451	687	0	4	1	0	231	709
EDO. MERIDA	MP. SANTOS MARQUINA	CM. TABAY	UNIDAD EDUCATIVA AQUILES NAZOA	458	1	9	423	238	414	0	2	1	0	173	423
EDO. MERIDA	MP. JUSTO BRICE#O	CM. TORONDOY	ESCUELA BASICA ESTADAL CEIBAL	333	1	3	279	196	276	0	1	0	1	78	279
EDO. MERIDA	MP. JUSTO BRICE#O	CM. TORONDOY	UNIDAD EDUCATIVA ESTADAL SANTA ROSA	635	2	14	494	303	480	0	0	0	0	177	494
EDO. MERIDA	MP. JUSTO BRICE#O	CM. TORONDOY	UNIDAD EDUCATIVA EL JUMANGAL	146	1	2	131	100	129	0	0	0	0	29	131
EDO. MERIDA	MP. JUSTO BRICE#O	CM. TORONDOY	LICEO BOLIVARIANO TORONDOY	1866	4	22	1459	855	1437	0	7	1	0	574	1459
EDO. MERIDA	MP. JUSTO BRICE#O	CM. TORONDOY	ESCUELA BASICA OFICIAL COMBINADA	191	1	0	138	93	138	0	0	0	0	45	138
EDO. MERIDA	MP. JUSTO BRICE#O	CM. TORONDOY	ESCUELA BASICA SANTA ANA	305	1	4	234	172	230	0	1	1	0	56	234
EDO. MERIDA	MP. JUSTO BRICE#O	CM. TORONDOY	UNIDAD EDUCATIVA MUNICIPAL COGOLLAL	225	1	4	179	121	175	0	1	0	0	53	179
EDO. MERIDA	MP. JUSTO BRICE#O	PQ. SAN CRISTOBAL DE T	UNIDAD EDUCATIVA SAN CRISTOBAL	1311	3	21	1082	645	1061	1	0	0	0	415	1082
EDO. MERIDA	MP. CAMPO ELIAS	PQ. MONTALBAN	LICEO EJIDO	3730	7	52	3207	1266	3155	0	6	1	1	1881	3207
EDO. MERIDA	MP. CAMPO ELIAS	PQ. MONTALBAN	ESCUELA BASICA EL SALADO	2460	5	40	2067	1128	2027	0	5	1	0	893	2067
EDO. MERIDA	MP. CAMPO ELIAS	PQ. MONTALBAN	UNIDAD  EDUCATIVA MANZANO BAJO	2311	4	33	1975	999	1942	1	4	0	0	938	1975
EDO. MERIDA	MP. CAMPO ELIAS	PQ. MONTALBAN	UNIDAD GERONTOLOGICA DR RICARDO SERGENT	1328	3	7	1132	448	1125	0	2	0	0	675	1132
EDO. MERIDA	MP. CAMPO ELIAS	PQ. MONTALBAN	UNIDAD EDUCATIVA INTEGRAL JUAN XXIII	1077	2	28	910	456	882	0	1	0	1	424	910
EDO. MERIDA	MP. CAMPO ELIAS	PQ. MONTALBAN	ESCUELA BASICA MONSEÑOR JAUREGUI	4406	8	55	3707	1146	3652	1	9	0	2	2494	3707
EDO. MERIDA	MP. CAMPO ELIAS	PQ. MONTALBAN	ESCUELA BASICA MONSEÑOR JAUREGUI (B)	1918	4	28	1736	680	1708	0	4	0	0	1024	1736
EDO. MERIDA	MP. CAMPO ELIAS	PQ. MONTALBAN	ESCUELA NACIONAL DOÑA EDELMIRA QUINTERO DE LOBO	1053	2	11	964	475	953	0	2	0	0	476	964
EDO. MERIDA	MP. CAMPO ELIAS	PQ. MONTALBAN	UNIDAD EDUCATIVA PEDRO J ANDRADE	1503	3	18	1242	722	1224	1	7	0	0	494	1242
EDO. MERIDA	MP. CAMPO ELIAS	PQ. JAJI	UNID EDUCT LOMA DEL CARMEN	317	1	4	253	161	249	0	0	0	0	88	253
EDO. MERIDA	MP. CAMPO ELIAS	PQ. JAJI	ESC EST UNIT S N	395	1	7	332	179	325	0	1	0	0	145	332
EDO. MERIDA	MP. CAMPO ELIAS	PQ. JAJI	UNIDAD EDUCATIVA BOLIVARIANA JAJI	1236	3	19	1006	475	987	2	1	1	0	508	1006
EDO. MERIDA	MP. CAMPO ELIAS	PQ. JAJI	UNID EDUCT PIEDRAS BLANCAS	326	1	3	267	174	264	0	0	0	0	90	267
EDO. MERIDA	MP. CAMPO ELIAS	PQ. JAJI	ESCUELA BASICA CONCENTRADA EL MACHO	231	1	1	195	97	194	0	1	0	0	96	195
EDO. MERIDA	MP. CAMPO ELIAS	PQ. MATRIZ	ESCUELA  BASICA CAMPO ELIAS	2979	6	28	2313	868	2285	2	10	2	0	1403	2313
EDO. MERIDA	MP. CAMPO ELIAS	PQ. MATRIZ	ESCUELA TECNICA ROBINSONIANA PROFESOR  JOSE RICARDO GUILEN SUAREZ	1543	3	14	1337	514	1323	1	3	0	0	805	1337
EDO. MERIDA	MP. CAMPO ELIAS	PQ. MATRIZ	ESCUELA BOLIVARIANA LOS GUAIMAROS	1138	2	21	969	581	948	0	5	0	0	362	969
EDO. MERIDA	MP. CAMPO ELIAS	PQ. MATRIZ	ESC BAS MIXTA LA RANCHERIA	1494	3	27	1230	815	1203	0	3	0	1	384	1230
EDO. MERIDA	MP. CAMPO ELIAS	PQ. MATRIZ	ESCUELA BASICA CAMPO ELIAS (B)	997	2	12	860	412	848	0	1	0	1	434	860
EDO. MERIDA	MP. CAMPO ELIAS	PQ. MATRIZ	ESCUELA BASICA GRAN MARISCAL DE AYACUCHO (B)	1832	4	39	1577	840	1538	0	3	1	2	692	1577
EDO. MERIDA	MP. CAMPO ELIAS	PQ. MATRIZ	ESC BAS 19 DE ABRIL	2216	4	45	1801	1232	1756	0	10	0	1	513	1801
EDO. MERIDA	MP. CAMPO ELIAS	PQ. MATRIZ	UND ED HERMANAS ALMARZA	2338	4	53	1932	1175	1879	2	11	3	4	684	1932
EDO. MERIDA	MP. CAMPO ELIAS	PQ. MATRIZ	ESCUELA  BASICA GRAN MARISCAL DE AYACUCHO	3167	6	53	2615	1143	2562	1	10	1	1	1406	2615
EDO. MERIDA	MP. CAMPO ELIAS	PQ. MATRIZ	AULAS ANEXAS EDELMIRA LOBO	3311	6	54	2866	1462	2812	1	13	2	0	1334	2866
EDO. MERIDA	MP. CAMPO ELIAS	PQ. MATRIZ	UNIDAD EDUCATIVA 5 DE JULIO	1194	2	17	1036	532	1019	0	5	0	0	482	1036
EDO. MERIDA	MP. CAMPO ELIAS	PQ. MATRIZ	COLEGIO SAN PIO X (B)	2326	4	40	2033	829	1993	0	12	1	2	1149	2033
EDO. MERIDA	MP. CAMPO ELIAS	PQ. MATRIZ	UNIDAD EDUCATIVA BOLIVARIANA SAN MIGUEL DE EJIDO	852	2	12	774	448	762	0	3	0	1	310	774
EDO. MERIDA	MP. CAMPO ELIAS	PQ. MATRIZ	COLEGIO SAN PIO X	3409	6	45	2860	1059	2815	2	15	0	2	1737	2860
EDO. MERIDA	MP. CAMPO ELIAS	PQ. SAN JOSE	ESCUELA BASICA TOSTOS	149	1	4	100	46	96	0	1	0	0	49	100
EDO. MERIDA	MP. CAMPO ELIAS	PQ. SAN JOSE	ESCUELA BASICA MUCUMPIZ	259	1	1	191	114	190	0	0	0	0	76	191
EDO. MERIDA	MP. CAMPO ELIAS	PQ. SAN JOSE	UNIDAD EDUCATIVA BOLIVARIANA SAN JOSE	493	1	7	367	169	360	0	0	0	0	191	367
EDO. MERIDA	MP. CAMPO ELIAS	PQ. LA MESA	ESCUELA ESTADAL LAS GONZALEZ	1172	2	29	893	447	864	0	3	0	0	414	893
EDO. MERIDA	MP. CAMPO ELIAS	PQ. LA MESA	UNIDAD ESCOLAR JULIO CESAR DAVILA	1566	3	25	1265	693	1240	0	1	0	0	546	1265
EDO. MERIDA	MP. CAMPO ELIAS	PQ. LA MESA	UNIDAD EDUCATIVA MUCUSURI	693	2	7	566	389	559	1	1	0	0	168	566
EDO. MERIDA	MP. CAMPO ELIAS	PQ. FERNANDEZ PE#A	UNIDAD EDUCATIVA HIPOLITO E GONZALEZ	3197	6	54	2748	1145	2694	1	8	2	1	1537	2748
EDO. MERIDA	MP. CAMPO ELIAS	PQ. FERNANDEZ PE#A	UNIDAD EDUCATIVA POZO HONDO	2134	4	47	1846	798	1799	0	7	0	6	988	1846
EDO. MERIDA	MP. CAMPO ELIAS	PQ. FERNANDEZ PE#A	UNIDAD EDUCATIVA BOLIVARIANA LLANO GRANDE	303	1	9	220	124	211	0	1	0	1	85	220
EDO. MERIDA	MP. CAMPO ELIAS	PQ. FERNANDEZ PE#A	ESCUELA BASICA RURAL ESCUQUE	104	1	2	85	42	83	0	0	0	0	41	85
EDO. MERIDA	MP. CAMPO ELIAS	PQ. FERNANDEZ PE#A	UNID EDUCATIVA SAN ONOFRE	560	1	23	462	276	439	0	0	2	0	161	462
EDO. MERIDA	MP. CAMPO ELIAS	PQ. FERNANDEZ PE#A	U.E. HIPOLITO GONZALEZ B	1884	4	38	1672	665	1634	0	4	0	0	965	1672
EDO. MERIDA	MP. CAMPO ELIAS	PQ. ACEQUIAS	ESCUELA NACIONAL ACEQUIAS	429	1	5	317	203	312	0	2	0	0	107	317
EDO. MERIDA	MP. CAMPO ELIAS	PQ. ACEQUIAS	ESCUELA ESTADAL SAN PEDRO	211	1	1	129	89	128	0	2	0	0	37	129
EDO. MERIDA	MP. ARICAGUA	PQ. SAN ANTONIO	ESCUELA CONCENTRADA NACIONAL MIXTA	922	2	7	671	335	664	0	1	1	0	327	671
EDO. MERIDA	MP. ARICAGUA	CM. ARICAGUA	ESCUELA BASICA INTEGRAL LOS AZULES	709	2	6	572	211	566	0	0	0	0	355	572
EDO. MERIDA	MP. ARICAGUA	CM. ARICAGUA	ESCUELA BASICA FRANCISCO UZCATEGUI DAVILA	1708	3	27	1390	527	1363	0	6	1	0	829	1390
EDO. MERIDA	MP. ARICAGUA	CM. ARICAGUA	ESC BAS CONC NAC	366	1	3	283	189	280	0	0	0	0	91	283
EDO. MERIDA	MP. ARICAGUA	CM. ARICAGUA	ESC CONC NAC. MIXTA	119	1	1	75	23	74	0	0	0	0	51	75
EDO. MERIDA	MP. ARZOBISPO CHACON	PQ. CAPURI	UNIDAD EDUCATIVA BOLIVARIANA LAS TIENDAS	464	1	4	326	185	322	0	0	0	0	137	326
EDO. MERIDA	MP. ARZOBISPO CHACON	PQ. CAPURI	UNIDAD EDUCATIVA BOLIVARIANA MESITAS DE CAPURI	132	1	1	117	105	116	0	0	0	0	11	117
EDO. MERIDA	MP. ARZOBISPO CHACON	PQ. EL MOLINO	ESCUELA BASICA EL MOLINO II	1264	3	21	1004	486	983	0	3	0	0	494	1004
EDO. MERIDA	MP. ARZOBISPO CHACON	CM. CANAGUA	CICLO BASICO HECTOR GARCIA CHUECOS	504	1	8	460	260	452	1	0	1	0	190	460
EDO. MERIDA	MP. ARZOBISPO CHACON	CM. CANAGUA	ESCUELA BOLIVARIANA ESTADO BARINAS	1821	4	24	1444	754	1420	1	3	0	0	662	1444
EDO. MERIDA	MP. ARZOBISPO CHACON	CM. CANAGUA	UNIDAD EDUCATIVA BOLIVARIANA EL RINCON	230	1	12	204	92	192	0	2	0	0	98	204
EDO. MERIDA	MP. ARZOBISPO CHACON	PQ. CHACANTA	UNIDAD EDUCATIVA LOS UVITOS	360	1	3	273	187	270	0	1	0	0	82	273
EDO. MERIDA	MP. ARZOBISPO CHACON	PQ. CHACANTA	ESCUELA ESTADAL BASICA LOS RASTROJOS	212	1	2	138	63	136	0	0	1	0	72	138
EDO. MERIDA	MP. ARZOBISPO CHACON	PQ. CHACANTA	UNIDAD EDUCATIVA BOLIVARIANA CHACANTA	725	2	1	561	390	560	0	4	0	1	165	561
EDO. MERIDA	MP. ARZOBISPO CHACON	PQ. CHACANTA	UNIDAD EDUCATIVA EL CURO	107	1	1	98	81	97	0	0	0	0	16	98
EDO. MERIDA	MP. ARZOBISPO CHACON	PQ. GUAIMARAL	ESCUELA ESTADAL EL ENCIERRO	87	1	0	60	22	60	0	0	0	0	38	60
EDO. MERIDA	MP. ARZOBISPO CHACON	PQ. GUAIMARAL	ESCUELA BASICA ESTADAL LOS CUROS	240	1	1	173	79	172	0	0	0	0	93	173
EDO. MERIDA	MP. ARZOBISPO CHACON	PQ. GUAIMARAL	UNIDAD EDUCATIVA BOLIVARIANA EL VIENTO	335	1	1	228	105	227	0	1	0	0	121	228
EDO. MERIDA	MP. ARZOBISPO CHACON	PQ. MUCUTUY	ESCUELA BOLIVARIANA MALDONADO LOPEZ	947	2	30	699	415	669	0	5	1	1	247	699
EDO. MERIDA	MP. ARZOBISPO CHACON	PQ. MUCUTUY	ESCUELA ESTADAL BASICA MUCUCHARANI	159	1	0	108	70	108	0	0	0	0	38	108
EDO. MERIDA	MP. ARZOBISPO CHACON	PQ. MUCUTUY	UNIDAD EDUCATIVA BOLIVARIANA SAN MIGUEL	145	1	3	101	24	98	0	0	0	0	74	101
EDO. MERIDA	MP. ARZOBISPO CHACON	PQ. MUCUTUY	UNIDAD EDUCATIVA BOLIVARIANA LA PROVIDENCIA	75	1	1	55	14	54	0	0	0	0	40	55
EDO. MERIDA	MP. ARZOBISPO CHACON	PQ. MUCUTUY	UNIDAD EDUCATIVA BOLIVARIANA EL PANTANO DE MIJARA	362	1	2	249	111	247	0	0	0	0	136	249
EDO. MERIDA	MP. ARZOBISPO CHACON	PQ. MUCUTUY	ESCUELA ESTADAL LA VEGUILLA	329	1	20	267	88	247	0	0	0	0	159	267
EDO. MERIDA	MP. ARZOBISPO CHACON	PQ. MUCUCHACHI	ESC BAS SANTA INES	69	1	0	41	18	41	0	0	0	0	23	41
EDO. MERIDA	MP. ARZOBISPO CHACON	PQ. MUCUCHACHI	ESCUELA BASICA AGUA BLANCA	54	1	0	40	26	40	0	0	0	0	14	40
EDO. MERIDA	MP. ARZOBISPO CHACON	PQ. MUCUCHACHI	ESCUELA BASICA SANTA ROSA	42	1	0	17	12	17	0	0	0	0	5	17
EDO. MERIDA	MP. ARZOBISPO CHACON	PQ. MUCUCHACHI	ESCUELA ESTADAL BASICA EL PORTACHUELO	137	1	2	85	64	83	0	4	0	0	15	85
EDO. MERIDA	MP. ARZOBISPO CHACON	PQ. MUCUCHACHI	UNIDAD EDUCATIVA BOLIVARIANA ESTADO COJEDES	1101	2	10	833	503	823	0	2	0	0	318	833
EDO. MERIDA	MP. ARZOBISPO CHACON	PQ. MUCUCHACHI	UNIDAD EDUCATIVA BOLIVARIANA SANTA LUCIA	100	1	2	68	27	66	0	0	0	0	39	68
EDO. MERIDA	MP. RANGEL	CM. MUCUCHIES	ESCUELA INTEGRAL MISINTA	595	1	18	543	263	525	0	2	0	0	260	543
EDO. MERIDA	MP. RANGEL	CM. MUCUCHIES	UNIDAD EDUCATIVA GAVIDIA	394	1	7	340	263	333	1	0	0	0	69	340
EDO. MERIDA	MP. RANGEL	CM. MUCUCHIES	ESCUELA  BASICA ARTESANAL	2554	5	59	2215	1006	2156	0	5	0	0	1145	2215
EDO. MERIDA	MP. RANGEL	CM. MUCUCHIES	LICEO COMBINADO MUCUCHIES	1697	3	20	1503	599	1483	2	3	0	0	879	1503
EDO. MERIDA	MP. RANGEL	PQ. SAN RAFAEL	ESCUELA ESTADAL CONCENTRADA 029 LLANO DEL HATO	240	1	5	208	115	203	0	2	1	0	85	208
EDO. MERIDA	MP. RANGEL	PQ. SAN RAFAEL	UNIDAD EDUCATIVA BOLIVARIANA LUIS ORLANDO MONSALVE	1545	3	48	1305	579	1257	0	7	2	0	669	1305
EDO. MERIDA	MP. RANGEL	PQ. SAN RAFAEL	U.E BOLIVARIANA MUCUCHIES	919	2	26	765	410	739	0	8	0	0	321	765
EDO. MERIDA	MP. RANGEL	PQ. LA TOMA	UNIDAD EDUCATIVA LA TOMA	1346	3	56	1156	635	1100	0	2	0	1	462	1156
EDO. MERIDA	MP. RANGEL	PQ. CACUTE	UNIDAD EDUCATIVA CACUTE	1044	2	37	879	482	842	0	3	0	0	357	879
EDO. MERIDA	MP. RANGEL	PQ. MUCURUBA	UNIDAD EDUCATIVA ESCAGUEY	669	2	16	555	251	539	1	4	1	0	282	555
EDO. MERIDA	MP. RANGEL	PQ. MUCURUBA	ESCUELA BASICA ESTADO ANZOATEGUI	1841	4	30	1572	801	1542	0	6	0	1	734	1572
EDO. MERIDA	MP. PADRE NOGUERA	CM. STA MARIA DE CAPARO	ESCUELA BASICA ESTADAL JOSE VICENTE NUCETE	2531	5	32	2106	1054	2074	0	15	1	0	1004	2106
EDO. MERIDA	MP. GUARAQUE	PQ. MESA DE QUINTERO	UNIDAD EDUCATIVA BOLIVARIANA LIGIA ESPERANZA MOLINA	890	2	8	691	438	683	0	0	0	0	245	691
EDO. MERIDA	MP. GUARAQUE	CM. GUARAQUE	UNIDAD EDUCATIVA BOLIVARIANA ESTADO ARAGUA	1638	3	21	1219	802	1198	0	2	0	0	394	1219
EDO. MERIDA	MP. GUARAQUE	CM. GUARAQUE	ESCUELA ESTADAL EL MORAL	378	1	1	295	155	294	0	0	0	0	139	295
EDO. MERIDA	MP. GUARAQUE	CM. GUARAQUE	ESCUELA ESTADAL LOS RASTROJOS	448	1	4	343	172	339	1	0	0	0	166	343
EDO. MERIDA	MP. GUARAQUE	CM. GUARAQUE	UNIDAD EDUCATIVA LOS CAÑUTALES	536	1	7	437	252	430	0	0	0	0	178	437
EDO. MERIDA	MP. GUARAQUE	CM. GUARAQUE	ESCUELA ESTADAL MESA DE MORENO	443	1	16	339	253	323	0	0	0	0	70	339
EDO. MERIDA	MP. GUARAQUE	CM. GUARAQUE	UNIDAD EDUCATIVA BOLIVARIANA QUEBRADA SECA	362	1	2	261	159	259	0	0	0	0	100	261
EDO. MERIDA	MP. GUARAQUE	PQ. RIO NEGRO	ESCUELA ESTADAL  EL AMPARO	423	1	20	342	128	322	0	0	0	0	194	342
EDO. MERIDA	MP. GUARAQUE	PQ. RIO NEGRO	UNIDAD EDUCATIVA BOLIVARIANA EL PUEBLITO	1252	3	8	978	495	970	0	0	1	0	474	978
EDO. MERIDA	MP. GUARAQUE	PQ. RIO NEGRO	UNIDAD EDUCATIVA BOLIVARIANA LAS LOMAS	540	1	1	457	260	456	0	0	0	0	196	457
EDO. MERIDA	MP. GUARAQUE	PQ. RIO NEGRO	UNIDAD EDUCATIVA BOLIVARIANA PIE DE CUESTA	467	1	1	359	135	358	0	0	0	0	223	359
EDO. MERIDA	MP. TULIO F CORDERO	CM. NUEVA BOLIVIA	ESCUELA BASICA PRESBISTERO TOMAS AGUSTIN CASTELAO FERNANDEZ	477	1	13	411	249	398	0	0	1	0	148	411
EDO. MERIDA	MP. TULIO F CORDERO	CM. NUEVA BOLIVIA	UNIDAD EDUCATIVA BOLIVARIANA MIGUEL ARISMENDI, ANEXO LICEO.	66	1	0	59	35	59	0	1	0	0	23	59
EDO. MERIDA	MP. TULIO F CORDERO	CM. NUEVA BOLIVIA	UNIDAD EDUCATIVA CAÑO DE AGUA	463	1	7	371	222	364	0	0	0	0	142	371
EDO. MERIDA	MP. TULIO F CORDERO	CM. NUEVA BOLIVIA	UNIDAD EDUCATIVA NUEVA BOLIVIA	2219	4	23	1835	1046	1812	1	12	1	0	752	1835
EDO. MERIDA	MP. TULIO F CORDERO	CM. NUEVA BOLIVIA	UNIDAD EDUCATIVA ESTADAL PALMICHOSO	851	2	13	709	461	696	0	1	0	0	234	709
EDO. MERIDA	MP. TULIO F CORDERO	CM. NUEVA BOLIVIA	UNIDAD EDUCATIVA BOLIVARIANA  LA MACARENA	407	1	7	366	288	359	0	2	0	0	69	366
EDO. MERIDA	MP. TULIO F CORDERO	CM. NUEVA BOLIVIA	LICEO BOLIVARIANO JOSE MANUEL BRICEÑO MONZILLO	2693	5	49	2162	1155	2113	1	16	2	0	939	2162
EDO. MERIDA	MP. TULIO F CORDERO	CM. NUEVA BOLIVIA	ESCUELA BASICA MIGUEL ARISMENDI	1569	3	21	1311	762	1290	1	4	0	2	521	1311
EDO. MERIDA	MP. TULIO F CORDERO	CM. NUEVA BOLIVIA	LICEO BOLIVARIANO JOSE MANUEL BRICEÑO MONZILLO (B)	1337	3	31	1148	690	1117	1	5	0	1	420	1148
EDO. MERIDA	MP. TULIO F CORDERO	PQ. SANTA APOLONIA	ESCUELA BASICA ESTADO MONAGAS	951	2	11	740	402	729	0	0	0	0	327	740
EDO. MERIDA	MP. TULIO F CORDERO	PQ. SANTA APOLONIA	ESCUELA BASICA PRIMARIA LA PUEBLITA	189	1	2	172	129	170	0	2	0	0	39	172
EDO. MERIDA	MP. TULIO F CORDERO	PQ. SANTA APOLONIA	ESCUELA ESTADAL BOLIVARIANA MONTE AVENTINO CONCENTRADA	592	1	10	473	263	463	0	0	1	0	199	473
EDO. MERIDA	MP. TULIO F CORDERO	PQ. SANTA APOLONIA	ESCUELA BASICA ESTADAL UNITARIA NUMERO 115	257	1	3	182	95	179	0	1	0	1	82	182
EDO. MERIDA	MP. TULIO F CORDERO	PQ. SANTA APOLONIA	ESCUELA BASICA ESTADAL UNITARIA NUMERO 255	244	1	2	171	113	169	0	1	0	0	55	171
EDO. MERIDA	MP. TULIO F CORDERO	PQ. MARIA C PALACIOS	ESCUELA BASICA CONCENTRADA LA PICA	139	1	0	109	93	109	0	0	0	0	16	109
EDO. MERIDA	MP. TULIO F CORDERO	PQ. MARIA C PALACIOS	ESCUELA BASICA UNITARIA ESTADAL	238	1	8	183	156	175	0	0	0	0	19	183
EDO. MERIDA	MP. TULIO F CORDERO	PQ. MARIA C PALACIOS	ESCUELA BASICA MIXTA PUEBLO NUEVO	710	2	35	596	468	561	0	1	0	0	92	596
EDO. MERIDA	MP. TULIO F CORDERO	PQ. MARIA C PALACIOS	UNIDAD EDUCATIVA DORLISA GUERRA	1385	3	14	1071	674	1057	0	5	0	0	378	1071
EDO. MERIDA	MP. TULIO F CORDERO	PQ. MARIA C PALACIOS	UNIDAD EDUCATIVA LAS TRINCHERAS	104	1	4	99	85	95	0	0	1	0	9	99
EDO. MERIDA	MP. TULIO F CORDERO	PQ. MARIA C PALACIOS	ESCUELA CONCENTRADA 209845	28	1	2	25	21	23	0	0	0	0	2	25
EDO. MERIDA	MP. TULIO F CORDERO	PQ. MARIA C PALACIOS	UNIDAD EDUCATIVA OFICIAL COMBINADA NUMERO 3554 361	260	1	9	201	161	192	0	1	0	0	30	201
EDO. MERIDA	MP. TULIO F CORDERO	PQ. INDEPENDENCIA	UNIDAD EDUCATIVA MIGUEL M CANDALES	1914	4	48	1568	1083	1520	0	3	1	0	433	1568
EDO. MERIDA	MP. TULIO F CORDERO	PQ. INDEPENDENCIA	ESCUELA BASICA OFICIAL COMBINADA NACIONAL 223 SIN NUMERO NUCLEO ESCOLAR RURAL 106	559	1	6	444	329	438	0	4	1	0	104	444
EDO. MERIDA	MP. TULIO F CORDERO	PQ. INDEPENDENCIA	UNIDAD EDUCATIVA NUMERO 472 616	698	2	7	579	467	572	0	5	0	0	100	579
EDO. MERIDA	MP. TULIO F CORDERO	PQ. INDEPENDENCIA	ESCUELA CONCENTRADA MIXTA NOS 90 4350 1231	757	2	21	596	326	575	0	0	0	0	249	596
EDO. MERIDA	MP. TULIO F CORDERO	PQ. INDEPENDENCIA	ESCUELA BASICA PALMARITO	1483	3	25	1185	905	1160	0	7	0	0	248	1185
EDO. MERIDA	MP. TULIO F CORDERO	PQ. INDEPENDENCIA	LICEO BOLIVARIANO INDEPENDENCIA	73	1	1	65	53	64	0	0	0	0	11	65
EDO. MERIDA	MP. ANTONIO PINTO S.	PQ. MESA DE LAS PALMAS	ESCUELA ESTADAL LA ESTRELLA	103	1	4	96	74	92	0	0	0	0	18	96
EDO. MERIDA	MP. ANTONIO PINTO S.	PQ. MESA DE LAS PALMAS	ESCUELA ESTADAL CAMPO ALEGRE	200	1	5	170	123	165	0	0	0	0	42	170
EDO. MERIDA	MP. ANTONIO PINTO S.	PQ. MESA DE LAS PALMAS	UNIDAD EDUCATIVA BOLIVARIANA SAN JOSE DE CAMPO ALEGRE	180	1	0	138	97	138	0	0	0	0	41	138
EDO. MERIDA	MP. ANTONIO PINTO S.	PQ. MESA DE LAS PALMAS	ESCUELA ESTADAL FRANCISCO DE ASISS	181	1	1	168	102	167	0	0	0	0	65	168
EDO. MERIDA	MP. ANTONIO PINTO S.	PQ. MESA DE LAS PALMAS	ESCUELA BOLIVARIANA MESAS DE LAS PALMAS	1183	2	22	995	578	973	0	0	0	1	394	995
EDO. MERIDA	MP. ANTONIO PINTO S.	PQ. MESA BOLIVAR	UNIDAD EDUCATIVA BOLIVARIANA SAN JOSE	542	1	6	438	302	432	0	0	0	0	130	438
EDO. MERIDA	MP. ANTONIO PINTO S.	PQ. MESA BOLIVAR	UNIDAD EDUCATIVA LA PROVIDENCIA	194	1	2	180	128	178	0	0	0	0	50	180
EDO. MERIDA	MP. ANTONIO PINTO S.	PQ. MESA BOLIVAR	ESCUELA BASICA ESTADAL BOLERO BAJO	337	1	2	265	196	263	0	4	0	0	63	265
EDO. MERIDA	MP. ANTONIO PINTO S.	PQ. MESA BOLIVAR	ESCUELA BOLIVARIANA RAFAEL ANTONIO GONZALEZ	2250	4	48	1781	916	1733	0	6	0	0	811	1781
EDO. MERIDA	MP. ANTONIO PINTO S.	PQ. MESA BOLIVAR	LICEO BOLIVARIANO SANTOS MARQUINA	215	1	6	195	123	189	0	0	0	1	65	195
EDO. MERIDA	MP. ANTONIO PINTO S.	CM. STA CRUZ DE MORA	LICEO BOLIVARIANO EUTIMIO RIVAS	807	2	20	713	317	693	0	3	0	0	373	713
EDO. MERIDA	MP. ANTONIO PINTO S.	CM. STA CRUZ DE MORA	UNIDAD EDUCATIVA PAIVA	521	1	9	468	277	459	0	1	0	0	181	468
EDO. MERIDA	MP. ANTONIO PINTO S.	CM. STA CRUZ DE MORA	UNIDAD EDUCATIVA COLEGIO NUESTRA SRA. DEL CARMEN	1228	3	11	1126	495	1115	0	6	1	0	613	1126
EDO. MERIDA	MP. ANTONIO PINTO S.	CM. STA CRUZ DE MORA	PREESCOLAR CARLOS ZERPA	2395	5	41	1975	767	1934	0	5	0	0	1162	1975
EDO. MERIDA	MP. ANTONIO PINTO S.	CM. STA CRUZ DE MORA	UNIDAD EDUCATIVA BOLIVARIANA SAN ISIDRO ALTO	560	1	4	481	276	477	0	0	0	0	201	481
EDO. MERIDA	MP. ANTONIO PINTO S.	CM. STA CRUZ DE MORA	ESCUELA ESTADAL LIBERTAD	492	1	5	358	245	353	0	3	1	0	104	358
EDO. MERIDA	MP. ANTONIO PINTO S.	CM. STA CRUZ DE MORA	UNIDAD EDUCATIVA ESTADAL 740 1007 PREESCOLAR SANTA MARTA BAJA	596	1	7	510	271	503	0	0	0	0	232	510
EDO. MERIDA	MP. ANTONIO PINTO S.	CM. STA CRUZ DE MORA	GRUPO ESCOLAR CARLOS ZERPA	1991	4	26	1627	607	1601	1	7	1	0	985	1627
EDO. MERIDA	MP. ANTONIO PINTO S.	CM. STA CRUZ DE MORA	UNIDAD EDUCATIVA CUCHILLA DE HUACAS	597	1	3	455	321	452	0	4	0	0	127	455
EDO. MERIDA	MP. ANTONIO PINTO S.	CM. STA CRUZ DE MORA	UNIDAD EDUCATIVA QUEBRADA DEL BARRO	1092	2	16	911	483	895	0	2	0	0	410	911
EDO. MERIDA	MP. ANTONIO PINTO S.	CM. STA CRUZ DE MORA	UNIDAD EDUCATIVA BOLIVARIANA EL GUAYABAL	963	2	10	812	449	802	0	2	0	0	351	812
EDO. MERIDA	MP. ANTONIO PINTO S.	CM. STA CRUZ DE MORA	UNIDAD EDUCATIVA BOLIVARIANA EL PORTON	964	2	14	766	495	752	0	4	0	0	253	766
EDO. MERIDA	MP. ANTONIO PINTO S.	CM. STA CRUZ DE MORA	UNIDAD EDUCATIVA BOLIVARIANA LOS AMOGRES	536	1	14	428	267	414	0	1	0	0	146	428
EDO. MERIDA	MP. ANDRES BELLO	CM. LA AZULITA	UNIDAD EDUCATIVA RAFAEL MARIA TORRES	2715	5	47	2227	1078	2180	0	12	0	2	1088	2227
EDO. MERIDA	MP. ANDRES BELLO	CM. LA AZULITA	UNIDAD EDUCATIVA BOLIVARIANA GRAN MARISCAL DE AYACUCHO	435	1	4	373	220	369	0	2	0	0	147	373
EDO. MERIDA	MP. ANDRES BELLO	CM. LA AZULITA	UNIDAD EDUCATIVA BOLIVARIANA HOLANDA	719	2	11	558	358	547	0	2	0	0	187	558
EDO. MERIDA	MP. ANDRES BELLO	CM. LA AZULITA	LICEO UNIDAD EDUCATIVA LA AZULITA	890	2	12	783	419	771	0	1	0	1	350	783
EDO. MERIDA	MP. ANDRES BELLO	CM. LA AZULITA	ESCUELA ESTADAL JOSE FELIX RIVAS	95	1	3	93	63	90	0	0	0	0	27	93
EDO. MERIDA	MP. ANDRES BELLO	CM. LA AZULITA	UNIDAD EDUCATIVA SIMON RODRIGUEZ	340	1	3	266	189	263	0	0	0	0	74	266
EDO. MERIDA	MP. ANDRES BELLO	CM. LA AZULITA	UNIDAD EDUCATIVA EL PARAMITO	239	1	2	199	115	197	0	0	0	0	82	199
EDO. MERIDA	MP. ANDRES BELLO	CM. LA AZULITA	UNIDAD EDUCATIVA BOLIVARIANA CARLOS SOUBLETTE	266	1	2	226	204	224	0	0	0	0	20	226
EDO. MERIDA	MP. ANDRES BELLO	CM. LA AZULITA	ESCUELA ESTADAL SIMONCITO ANDRES BELLO	256	1	7	242	213	235	0	1	0	0	21	242
EDO. MERIDA	MP. ANDRES BELLO	CM. LA AZULITA	UNIDAD EDUCATIVA MARIA CONCEPCION PALACIOS	345	1	1	275	206	274	0	0	0	0	68	275
EDO. MERIDA	MP. ANDRES BELLO	CM. LA AZULITA	UNIDAD EDUCATIVA BOLIVARIANA LA UVA	478	1	8	375	220	367	0	0	0	0	147	375
EDO. MERIDA	MP. ANDRES BELLO	CM. LA AZULITA	UNIDAD EDUCATIVA OLINDA II
EDO. MERIDA	MP. ANDRES BELLO	CM. LA AZULITA	UNIDAD EDUCATIVA ESTADAL EL MAPORA	339	1	12	272	234	260	0	0	0	0	26	272
EDO. MERIDA	MP. ANDRES BELLO	CM. LA AZULITA	UNIDAD EDUCATIVA LUISA CACERES DE ARISMENDI	274	1	2	219	149	217	0	0	0	0	68	219
EDO. MERIDA	MP. ANDRES BELLO	CM. LA AZULITA	ESCUELA BASICA SAN EUSEBIO	300	1	7	247	108	240	0	1	0	0	131	247
EDO. MERIDA	MP. ANDRES BELLO	CM. LA AZULITA	UNIDAD EDUCATIVA BOLIVARIANA MESA ALTA	509	1	10	452	274	442	0	4	0	0	164	452
EDO. MERIDA	MP. ANDRES BELLO	CM. LA AZULITA	ESCUELA ESTADAL CAÑO GUAYABO ALTO	144	1	2	138	110	136	0	0	0	0	26	138
EDO. MERIDA	MP. ANDRES BELLO	CM. LA AZULITA	UNIDAD EDUCATIVA ANDRES BELLO	284	1	3	227	135	224	0	1	0	0	88	227
EDO. MERIDA	MP. ANDRES BELLO	CM. LA AZULITA	UNIDAD EDUCATIVA QUEBRADA AZUL	455	1	6	337	231	331	0	0	0	0	100	337
EDO. MERIDA	MP. ANDRES BELLO	CM. LA AZULITA	ESC BAS EST CONC 979 Y SN	242	1	3	191	103	188	0	0	0	0	85	191
EDO. MERIDA	MP. ANDRES BELLO	CM. LA AZULITA	UNIDAD EDUCATIVA CAPAZ	327	1	0	273	156	273	0	2	0	0	115	273
EDO. MERIDA	MP. TOVAR	PQ. EL LLANO	ESCUELA BASICA ANANIAS AVENDAÑO (B)	1774	3	13	1555	609	1542	1	2	0	0	930	1555
EDO. MERIDA	MP. TOVAR	PQ. EL LLANO	ESCUELA BASICA ANANIAS AVENDAÑO	2667	5	31	2225	848	2194	2	9	0	1	1334	2225
EDO. MERIDA	MP. TOVAR	PQ. EL LLANO	PREESCOLAR ANANIAS AVENDAÑO	1946	4	22	1682	676	1660	0	4	1	0	979	1682
EDO. MERIDA	MP. TOVAR	PQ. SAN FRANCISCO	ESCUELA BASICA NACIONAL GRADUADA SAN FRANCISCO	1232	3	8	1034	567	1026	0	1	0	1	457	1034
EDO. MERIDA	MP. TOVAR	PQ. SAN FRANCISCO	LICEO BOLIVARIANO SAN FRANCISCO I	150	1	0	130	68	130	0	0	0	0	62	130
EDO. MERIDA	MP. TOVAR	PQ. SAN FRANCISCO	ESCUELA CONCENTRADA NUMERO 72 212 592 JARDIN DE INFANCIA EL CARRIZAL	451	1	5	398	231	393	0	1	0	0	161	398
EDO. MERIDA	MP. TOVAR	PQ. EL AMPARO	ESCUELA BOLIVARIANA JUAN PICON GONZALEZ	1434	3	24	1148	658	1124	0	2	0	0	464	1148
EDO. MERIDA	MP. TOVAR	PQ. EL AMPARO	ESCUELA TECNICA ROBINSONIANA GENOVEVA MONTERO DE VEGA	166	1	5	147	91	142	0	1	0	0	50	147
EDO. MERIDA	MP. TOVAR	PQ. TOVAR	UNIDAD EDUCATIVA COLEGIO FE Y ALEGRIA (B)	385	1	3	341	137	338	0	0	0	0	201	341
EDO. MERIDA	MP. TOVAR	PQ. TOVAR	CICLO BASICO FELIX ROMAN DUQUE	1915	4	29	1603	629	1574	0	6	2	0	937	1603
EDO. MERIDA	MP. TOVAR	PQ. TOVAR	UNIDAD EDUCATIVA BOLIVARIANA MONSENOR MORENO	1074	2	19	904	532	885	0	1	0	0	352	904
EDO. MERIDA	MP. TOVAR	PQ. TOVAR	UNIDAD EDUCATIVA BOLIVARIANA EL PENON	920	2	27	754	451	727	0	2	0	0	274	754
EDO. MERIDA	MP. TOVAR	PQ. TOVAR	ESCUELA BASICA SIN NUMERO NUCLEO 015	229	1	1	170	125	169	0	0	0	1	43	170
EDO. MERIDA	MP. TOVAR	PQ. TOVAR	ESCUELA BASICA CORONEL ANTONIO RANGEL	2065	4	24	1674	633	1650	0	5	0	0	1012	1674
EDO. MERIDA	MP. TOVAR	PQ. TOVAR	UNIDAD EDUCATIVA COLEGIO FE Y ALEGRIA	2289	4	34	1952	716	1918	0	6	0	1	1195	1952
EDO. MERIDA	MP. TOVAR	PQ. TOVAR	ESCUELA BASICA CLAUDIO VIVAS (B)	540	1	5	481	222	476	0	2	0	1	251	481
EDO. MERIDA	MP. TOVAR	PQ. TOVAR	ESCUELA ESTADAL BOLIVARIANA EL CACIQUE	304	1	5	253	140	248	0	1	0	0	107	253
EDO. MERIDA	MP. TOVAR	PQ. TOVAR	ESCUELA BASICA CLAUDIO VIVAS	3308	6	43	2708	1090	2665	0	6	0	0	1569	2708
EDO. MERIDA	MP. TOVAR	PQ. TOVAR	UNIDAD EDUCATIVA MONSE OR CHACON	2050	4	34	1797	828	1763	0	12	2	0	921	1797
EDO. MERIDA	MP. TOVAR	PQ. TOVAR	CONC MIXTA PATA DE GALLINA	560	1	4	441	344	437	0	1	0	0	92	441
EDO. MERIDA	MP. TOVAR	PQ. TOVAR	ESCUELA NACIONAL UNITARIA NO 461	873	2	12	680	466	668	0	2	2	0	198	680
EDO. MERIDA	MP. CARACCIOLO PARRA	CM. TUCANI	UNIDAD EDUC. EL CHARAL	987	2	17	780	498	763	0	3	3	1	258	780
EDO. MERIDA	MP. CARACCIOLO PARRA	CM. TUCANI	LICEO BOLIVARIANO  VICENTE CAMPO ELIAS (B)	792	2	17	638	327	621	0	5	1	0	288	638
EDO. MERIDA	MP. CARACCIOLO PARRA	CM. TUCANI	UNIDAD EDUCATIVA TUCANICITO NER 042	617	2	17	530	344	513	1	1	0	0	167	530
EDO. MERIDA	MP. CARACCIOLO PARRA	CM. TUCANI	UNIDAD EDUCATIVA  BOLIVARIANA EL VIJAO	227	1	5	195	92	190	0	0	0	0	98	195
EDO. MERIDA	MP. CARACCIOLO PARRA	CM. TUCANI	ESCUELA ESTADAL MONTE BELLO BAJO	732	2	13	605	461	592	0	2	0	0	129	605
EDO. MERIDA	MP. CARACCIOLO PARRA	CM. TUCANI	ESCUELA ESTADAL BOLIVARIANA PROF ANTONIO MORALES	142	1	7	126	84	119	0	0	0	0	35	126
EDO. MERIDA	MP. CARACCIOLO PARRA	CM. TUCANI	UNIDAD EDUCATIVA MESA DE JULIA	1549	3	21	1216	648	1195	1	2	1	0	543	1216
EDO. MERIDA	MP. CARACCIOLO PARRA	CM. TUCANI	ESCUELA ESTADAL PASCUAL I VILLAZMIL	2664	5	59	2043	943	1984	0	12	1	0	1028	2043
EDO. MERIDA	MP. CARACCIOLO PARRA	CM. TUCANI	ESCULA ESTADAL PASCUAL VILLASMIL	569	1	22	472	236	450	0	0	0	0	214	472
EDO. MERIDA	MP. CARACCIOLO PARRA	CM. TUCANI	LICEO BOLIVARIANO VICENTE CAMPO ELIAS	2589	5	59	1948	1005	1889	1	6	1	0	876	1948
EDO. MERIDA	MP. CARACCIOLO PARRA	CM. TUCANI	CENTRO EDUCACION  INICIAL PREESCOLAR LOS APAMATES	734	2	26	609	329	583	0	1	0	0	253	609
EDO. MERIDA	MP. CARACCIOLO PARRA	CM. TUCANI	UNIDAD EDUCACION BOLIVARIANA  LA CHIQUINQUIRA	264	1	9	218	155	209	0	1	0	0	53	218
EDO. MERIDA	MP. CARACCIOLO PARRA	PQ. FLORENCIO RAMIREZ	ESC BAS OF CONB RIO FRIO	1371	3	21	1117	666	1096	0	1	1	0	428	1117
EDO. MERIDA	MP. CARACCIOLO PARRA	PQ. FLORENCIO RAMIREZ	IUTE EXTENCION TUCANI	597	1	13	476	351	463	0	2	0	0	110	476
EDO. MERIDA	MP. CARACCIOLO PARRA	PQ. FLORENCIO RAMIREZ	UNIDAD EDUCATIVA JOSE ANTONIO PAEZ	2155	4	24	1643	1126	1619	0	7	0	1	485	1643
EDO. MERIDA	MP. ZEA	CM. ZEA	CONC NAC SANTA BARBARA	297	1	2	220	135	218	1	0	0	0	82	220
EDO. MERIDA	MP. ZEA	CM. ZEA	CASA DE LOS NI OS LOS TUCUSITOS	867	2	11	747	245	736	0	1	0	0	490	747
EDO. MERIDA	MP. ZEA	CM. ZEA	COLEGIO RITA MORA DE BARRIOS	386	1	6	346	138	340	0	3	0	1	198	346
EDO. MERIDA	MP. ZEA	CM. ZEA	ESCUELA BOLIVARIANA MARUJA VELAZCO DE RAMIREZ (SAN MIGUEL)	349	1	3	307	192	304	0	1	0	0	111	307
EDO. MERIDA	MP. ZEA	CM. ZEA	ESCUELA BOLIVARIANA FELIX ROMAN DUQUE	1840	4	14	1536	535	1522	0	7	2	2	976	1536
EDO. MERIDA	MP. ZEA	CM. ZEA	UNIDAD EDUCATIVA DOCTOR JOSE RAMON VEGAS	1487	3	9	1288	601	1279	0	3	1	0	674	1288
EDO. MERIDA	MP. ZEA	CM. ZEA	ESCUELA NACIONAL NO 1351	455	1	6	350	187	344	0	1	0	0	156	350
EDO. MERIDA	MP. ZEA	CM. ZEA	UNIDAD EDUCATIVA LAS COCUIZAS NUCLEO ESTADAL RURAL 017	168	1	5	148	100	143	0	0	0	0	43	148
EDO. MERIDA	MP. ZEA	PQ. CA#O EL TIGRE	UNIDAD EDUCATIVA BOLIVARIANA SANTA LUCIA	433	1	7	384	241	377	0	2	1	0	133	384
EDO. MERIDA	MP. ZEA	PQ. CA#O EL TIGRE	ESCUELA BOLIVARIANA CAÑO DE TIGRE	1719	3	24	1394	805	1370	0	6	0	0	559	1394
EDO. MERIDA	MP.CARDENAL QUINTERO	CM. SANTO DOMINGO	ESCUELA BASICA MARTHA GONZALEZ	2625	5	66	2184	1118	2118	0	9	1	0	990	2184
EDO. MERIDA	MP.CARDENAL QUINTERO	CM. SANTO DOMINGO	PREESCOLAR BOLIVARIANO MARTHA GONZALEZ	417	1	11	371	224	360	0	0	0	0	136	371
EDO. MERIDA	MP.CARDENAL QUINTERO	CM. SANTO DOMINGO	ESCUELA ESTADAL NO 369	797	2	25	690	447	665	0	0	0	0	218	690
EDO. MERIDA	MP.CARDENAL QUINTERO	PQ. LAS PIEDRAS	ESCUELA BASICA ESTADAL NUMERO 861 LAS MESAS	291	1	11	236	147	225	0	3	0	0	75	236
EDO. MERIDA	MP.CARDENAL QUINTERO	PQ. LAS PIEDRAS	ESCUELA ESTADAL NUMERO 1039 EL CONEJO	362	1	5	296	262	291	0	3	1	0	25	296
EDO. MERIDA	MP.CARDENAL QUINTERO	PQ. LAS PIEDRAS	UNIDAD EDUCATIVA BOLIVARIANA  LAS PIEDRAS	1526	3	23	1218	773	1195	0	2	0	0	420	1218
EDO. MERIDA	MP.CARDENAL QUINTERO	PQ. LAS PIEDRAS	ESCUELA . BASICA OFICIAL COMBINADA NUMERO 802 1463	429	1	5	346	197	341	0	1	0	0	143	346
EDO. MERIDA	MP.CARDENAL QUINTERO	PQ. LAS PIEDRAS	ESCUELA BASICA ESTADAL  CONCENTRADA 1345 EL CAÑUTAL  (NUCLEO ESTADAL RURAL 028)	243	1	3	206	179	203	0	1	0	1	22	206
EDO. MERIDA	MP.CARDENAL QUINTERO	PQ. LAS PIEDRAS	ESCUELA ESTADAL EL CANEY	136	1	3	127	82	124	0	1	0	0	41	127
EDO. MERIDA	MP.CARDENAL QUINTERO	PQ. LAS PIEDRAS	ESCUELA BOLIVARIANA LA MITISUS	125	1	0	111	73	111	0	0	0	0	38	111
EDO. MERIDA	MP. RIVAS DAVILA	CM. BAILADORES	UNIDAD EDUCATIVA ESTADAL BOLIVARIANA PRESBISTERO DR EZEQUIEL ARELLANO	1129	2	18	996	520	978	1	5	0	1	451	996
EDO. MERIDA	MP. RIVAS DAVILA	CM. BAILADORES	UND EDUC OFC COMB LAS PLAYITAS	978	2	24	784	252	760	1	6	0	0	501	784
EDO. MERIDA	MP. RIVAS DAVILA	CM. BAILADORES	LICEO BOLIVARIANO DR GERONIMO MALDONADO	3470	6	41	2727	1256	2686	0	8	1	3	1418	2727
EDO. MERIDA	MP. RIVAS DAVILA	CM. BAILADORES	UNIDAD EDUCATIVA BOLIVARIANA OTRA BANDA	234	1	2	216	121	214	0	2	1	0	90	216
EDO. MERIDA	MP. RIVAS DAVILA	CM. BAILADORES	UNIDAD EDUCATIVA TULIO FEBRES CORDERO	887	2	17	776	316	759	0	4	0	0	439	776
EDO. MERIDA	MP. RIVAS DAVILA	CM. BAILADORES	CONCENTRADA MIXTA MARINO NUMERO 58	603	2	25	520	364	495	0	0	0	0	131	520
EDO. MERIDA	MP. RIVAS DAVILA	CM. BAILADORES	ESCUELA GRADUADA JOSE GREGORIO RAMIREZ	962	2	10	810	402	800	0	1	0	1	396	810
EDO. MERIDA	MP. RIVAS DAVILA	CM. BAILADORES	ESCUELA BOLIVARIANA SAN PABLO	328	1	4	306	201	302	0	0	0	0	101	306
EDO. MERIDA	MP. RIVAS DAVILA	CM. BAILADORES	UNIDAD EDUCATIVA BOLIVARIANA PROFESOR   VICTOR EVENCIO CASTILLO	130	1	3	122	91	119	0	2	0	0	26	122
EDO. MERIDA	MP. RIVAS DAVILA	CM. BAILADORES	E.B. APOLONIO ROSALES	996	2	15	859	359	844	0	3	0	0	482	859
EDO. MERIDA	MP. RIVAS DAVILA	CM. BAILADORES	ESCUELA ESTADAL UNITARIA LOS QUEMADOS	165	1	3	125	91	122	0	0	0	0	31	125
EDO. MERIDA	MP. RIVAS DAVILA	CM. BAILADORES	UNID EDUC PROF. FELIZ MANUEL LUCES	917	2	14	750	496	736	0	4	0	0	236	750
EDO. MERIDA	MP. RIVAS DAVILA	CM. BAILADORES	ESCUELA ESTADAL BORDO SECO	207	1	5	185	137	180	0	0	0	0	43	185
EDO. MERIDA	MP. RIVAS DAVILA	PQ. GERONIMO MALDONADO	ESCUELA BASICA BOLIVARIANA FLOR DE MALDONADO	2665	5	28	2257	1042	2229	0	9	0	1	1177	2257
EDO. MERIDA	MP. ALBERTO ADRIANI	PQ. PRESIDENTE PAEZ	COLEGIO PRIVADO ROMULO GALLEGOS	954	2	7	763	219	756	0	5	0	0	532	763
EDO. MERIDA	MP. ALBERTO ADRIANI	PQ. PRESIDENTE PAEZ	UNIDAD EDUCATIVA ESPERANZA BOLIVARIANA	994	2	15	840	683	825	0	3	0	0	139	840
EDO. MERIDA	MP. ALBERTO ADRIANI	PQ. PRESIDENTE PAEZ	UNIDAD EDUCATIVA ANDRES BELLO (B)	1937	4	25	1595	874	1570	1	5	0	0	690	1595
EDO. MERIDA	MP. ALBERTO ADRIANI	PQ. PRESIDENTE PAEZ	ESCUELA BASICA ANDRES BELLO	4493	8	67	3587	1854	3520	1	12	1	0	1652	3587
EDO. MERIDA	MP. ALBERTO ADRIANI	PQ. PRESIDENTE PAEZ	UNIDAD EDUCATIVA LIBERTADOR BOLIVAR	2170	4	53	1816	796	1763	1	9	1	1	955	1816
EDO. MERIDA	MP. ALBERTO ADRIANI	PQ. PRESIDENTE PAEZ	COLEGIO DR. RAMON REINOSO NUÑEZ	73	1	3	65	33	62	0	0	0	0	29	65
EDO. MERIDA	MP. ALBERTO ADRIANI	PQ. PRESIDENTE PAEZ	ESCUELA BASICA 12 DE FEBRERO	1124	2	15	949	432	934	0	4	0	0	498	949
EDO. MERIDA	MP. ALBERTO ADRIANI	PQ. PRESIDENTE PAEZ	ESCUELA BASICA 24 DE JULIO	223	1	6	196	118	190	1	2	0	0	69	196
EDO. MERIDA	MP. ALBERTO ADRIANI	PQ. PRESIDENTE PAEZ	UNIDAD EDUCATIVA ESTADAL LA PEDREGOSA	2432	5	35	2046	1372	2011	1	10	0	1	627	2046
EDO. MERIDA	MP. ALBERTO ADRIANI	PQ. PRESIDENTE PAEZ	ESCUELA BASICA CONCENTRADA DANTAS	739	2	27	556	321	529	1	1	2	0	204	556
EDO. MERIDA	MP. ALBERTO ADRIANI	PQ. PRESIDENTE PAEZ	UNIDAD EDUCATIVA ARTURO MICHELENA	310	1	8	283	226	275	0	1	0	0	48	283
EDO. MERIDA	MP. ALBERTO ADRIANI	PQ. PRESIDENTE PAEZ	UNIDAD EDUCATIVA BOLIVARIANA LUISA CACERES DE ARISMENDI	254	1	2	230	183	228	0	4	0	0	41	230
EDO. MERIDA	MP. ALBERTO ADRIANI	PQ. PRESIDENTE PAEZ	UNIDAD EDUC. MAURICIO ENCINOSO	3036	6	45	2433	841	2388	1	13	1	1	1531	2433
EDO. MERIDA	MP. ALBERTO ADRIANI	PQ. PRESIDENTE PAEZ	UNIDAD EDUCATIVA COLEGIO CECILIO ACOSTA	100	1	3	91	39	88	0	0	0	1	48	91
EDO. MERIDA	MP. ALBERTO ADRIANI	PQ. PRESIDENTE PAEZ	UNIDAD EDUCATIVA BOLIVARIANA ONIA CAÑO ISABEL	1330	3	21	1059	672	1038	0	4	0	0	362	1059
EDO. MERIDA	MP. ALBERTO ADRIANI	PQ. PRESIDENTE PAEZ	PREESCOLAR BUBUQUI III	174	1	2	153	67	151	0	0	0	0	84	153
EDO. MERIDA	MP. ALBERTO ADRIANI	PQ. PRESIDENTE PAEZ	JARDIN DE INFANCIA MAURICIO ENCINOSA	738	2	9	637	249	628	0	0	0	0	379	637
EDO. MERIDA	MP. ALBERTO ADRIANI	PQ. PRESIDENTE PAEZ	ESCUELA BASICA SUR AMERICA	2715	5	38	2231	890	2193	1	14	5	0	1283	2231
EDO. MERIDA	MP. ALBERTO ADRIANI	PQ. PTE. ROMULO GALLEGOS	LICEO BOLIVARIANO DOCTOR ARTURO USLAR PIETRI	2960	6	31	2456	1003	2425	2	9	1	1	1409	2456
EDO. MERIDA	MP. ALBERTO ADRIANI	PQ. PTE. ROMULO GALLEGOS	PREESCOLAR CARLOS SOUBLETTE	2725	5	50	2334	1401	2284	2	7	1	1	872	2334
EDO. MERIDA	MP. ALBERTO ADRIANI	PQ. PTE. ROMULO GALLEGOS	ESCUELA BASICA PRESBISTERO JOSE IGNACIO OLIVARES	2753	5	33	2343	1045	2310	1	5	1	0	1258	2343
EDO. MERIDA	MP. ALBERTO ADRIANI	PQ. PTE. ROMULO GALLEGOS	UNIDAD EDUCATIVA BOLIVARIANA LA VEGA I	893	2	14	733	397	719	0	4	0	0	318	733
EDO. MERIDA	MP. ALBERTO ADRIANI	PQ. PTE. ROMULO GALLEGOS	UNIDAD EDUCATIVA  23 DE ENERO	1004	2	12	851	559	839	0	2	1	0	277	851
EDO. MERIDA	MP. ALBERTO ADRIANI	PQ. PTE. ROMULO GALLEGOS	ESCUELA BOLIVARIANA EL CIMIENTO	379	1	4	320	232	316	0	1	0	0	83	320
EDO. MERIDA	MP. ALBERTO ADRIANI	PQ. PTE. ROMULO GALLEGOS	ESCUELA BASICA PRIMERO DE MAYO	3016	6	46	2435	1063	2389	1	9	3	0	1313	2435
EDO. MERIDA	MP. ALBERTO ADRIANI	PQ. PTE. ROMULO GALLEGOS	UNIDAD EDUCATIVA KILOMETRO 15	1038	2	18	813	542	795	0	5	0	0	248	813
EDO. MERIDA	MP. ALBERTO ADRIANI	PQ. PTE. ROMULO GALLEGOS	LICEO BOLIVARIANO EL VIGIA	2548	5	49	2117	1035	2068	0	10	0	0	1023	2117
EDO. MERIDA	MP. ALBERTO ADRIANI	PQ. HECTOR AMABLE MORA	ESCUELA BASICA SIMON RODRIGUEZ	3267	6	48	2585	1465	2537	1	10	3	2	1056	2585
EDO. MERIDA	MP. ALBERTO ADRIANI	PQ. HECTOR AMABLE MORA	UNIDAD EDUCATIVA BOLIVARIANA CAÑO BLANCO ABAJO	404	1	4	316	171	312	0	1	0	0	140	316
EDO. MERIDA	MP. ALBERTO ADRIANI	PQ. HECTOR AMABLE MORA	UNIDAD EDUCATIVA BOLIVARIANA EL CEIBAL	481	1	10	376	230	366	0	0	0	0	136	376
EDO. MERIDA	MP. ALBERTO ADRIANI	PQ. HECTOR AMABLE MORA	UNIDAD EDUCATIVA BOLIVARIANA QUEBRADA BLANCA	386	1	4	317	208	313	0	4	1	0	100	317
EDO. MERIDA	MP. ALBERTO ADRIANI	PQ. HECTOR AMABLE MORA	UNIDAD EDUCATIVA FRANCISCO DE MIRANDA	837	2	19	657	424	638	0	0	0	1	213	657
EDO. MERIDA	MP. ALBERTO ADRIANI	PQ. HECTOR AMABLE MORA	L.B. RAFAEL ANGEL RONDON MARQUEZ	641	2	12	536	373	524	0	1	0	0	150	536
EDO. MERIDA	MP. ALBERTO ADRIANI	PQ. HECTOR AMABLE MORA	ESCUELA BASICA UNITARIA 774 CAÑO BLANCO ALTO	66	1	1	58	47	57	0	0	0	0	10	58
EDO. MERIDA	MP. ALBERTO ADRIANI	PQ. HECTOR AMABLE MORA	UNIDAD EDUCATIVA BOLIVARIANA EZEQUIEL ZAMORA	214	1	4	180	110	176	0	0	0	0	66	180
EDO. MERIDA	MP. ALBERTO ADRIANI	PQ. HECTOR AMABLE MORA	ESCUELA ESTADAL CANO ARENA	293	1	7	244	158	237	0	1	0	0	78	244
EDO. MERIDA	MP. ALBERTO ADRIANI	PQ. JOSE NUCETE SARDI	ESCUELA BOLIVARIANA JOSE FELIX RIBAS	333	1	12	270	200	258	0	3	0	0	55	270
EDO. MERIDA	MP. ALBERTO ADRIANI	PQ. JOSE NUCETE SARDI	LICEO ESTADAL MARIA FLORA OVALLES	1215	3	13	936	768	923	0	1	0	0	154	936
EDO. MERIDA	MP. ALBERTO ADRIANI	PQ. PULIDO MENDEZ	ESCUELA BASICA CAÑO SECO	1457	3	19	1227	706	1208	0	7	0	0	495	1227
EDO. MERIDA	MP. ALBERTO ADRIANI	PQ. PULIDO MENDEZ	UNIDAD EDUCATIVA BOLIVARIANA ANTONIO JOSE DE SUCRE	264	1	9	232	182	223	0	0	0	0	41	232
EDO. MERIDA	MP. ALBERTO ADRIANI	PQ. PULIDO MENDEZ	ESCUELA BASICA LUIS BELTRAN PRIETO FIGUEROA	2139	4	54	1789	1030	1735	0	11	0	0	694	1789
EDO. MERIDA	MP. ALBERTO ADRIANI	PQ. PULIDO MENDEZ	UNIDAD EDUCATIVA VILLA DE LOS ANGELES	702	2	12	607	410	595	0	1	0	0	184	607
EDO. MERIDA	MP. ALBERTO ADRIANI	PQ. PULIDO MENDEZ	ESCUELA BASICA MOCACAY	319	1	16	228	120	212	0	0	0	1	91	228
EDO. MERIDA	MP. ALBERTO ADRIANI	PQ. PULIDO MENDEZ	UND EDUC BOLIVARIANA JOSEFA CAMEJO	498	1	5	451	248	446	0	0	0	0	198	451
EDO. MERIDA	MP. ALBERTO ADRIANI	PQ. PULIDO MENDEZ	ESC. NAC. BAS. 12 DE OCTUBRE.	3635	7	73	2973	1715	2900	2	8	0	0	1175	2973
EDO. MERIDA	MP. ALBERTO ADRIANI	PQ. PULIDO MENDEZ	SIMONCITO NANCY MORA	207	1	5	182	113	177	0	1	0	0	63	182
EDO. MERIDA	MP. ALBERTO ADRIANI	PQ. PULIDO MENDEZ	UNIDAD BASICA LA BLANCA	3595	7	55	2953	1598	2898	1	12	0	0	1287	2953
EDO. MERIDA	MP. ALBERTO ADRIANI	PQ. PULIDO MENDEZ	UNIDAD EDUCATIVA MI ABUELA ROSA INES CHAVEZ	194	1	8	164	112	156	0	0	0	0	44	164
EDO. MERIDA	MP. ALBERTO ADRIANI	PQ. PULIDO MENDEZ	ARQUITECTO CLAUDIO CORREDOR MULLER	2109	4	33	1816	899	1783	1	6	0	0	877	1816
EDO. MERIDA	MP. ALBERTO ADRIANI	PQ. PRESIDENTE BETANCOURT	UNIDAD EDUCATIVA TOVAR B	892	2	13	743	320	730	0	4	0	0	406	743
EDO. MERIDA	MP. ALBERTO ADRIANI	PQ. PRESIDENTE BETANCOURT	ESCUELA BASICA LA CAÑA BRAVA	186	1	3	117	74	114	0	0	0	0	40	117
EDO. MERIDA	MP. ALBERTO ADRIANI	PQ. PRESIDENTE BETANCOURT	UNIDAD EDUCATIVA TOVAR	2682	5	39	2142	868	2103	1	7	1	0	1226	2142
EDO. MERIDA	MP. ALBERTO ADRIANI	PQ. PRESIDENTE BETANCOURT	UNIDAD EDUCATIVA 1630 ANEXO EL TAPARO	549	1	4	448	269	444	0	3	0	0	172	448
EDO. MERIDA	MP. ALBERTO ADRIANI	PQ. PRESIDENTE BETANCOURT	UNIDAD EDUCATIVA JOSE MARTI	805	2	15	730	299	715	0	5	0	0	411	730
EDO. MERIDA	MP. ALBERTO ADRIANI	PQ. PRESIDENTE BETANCOURT	UNIDAD EDUCATIVA ESTADAL BOLIVARIANA FELIX MARIA RUIZ	313	1	4	274	151	270	0	0	0	0	119	274
EDO. MERIDA	MP. ALBERTO ADRIANI	PQ. PRESIDENTE BETANCOURT	UNIDAD EDUCATIVA CHIGUARA	1137	2	18	922	391	904	1	2	0	1	509	922
EDO. MERIDA	MP. ALBERTO ADRIANI	PQ. PRESIDENTE BETANCOURT	UNIDAD EDUCATIVA OFELIA TANCREDI CORREDOR	3197	6	69	2617	1470	2548	0	12	4	2	1060	2617
EDO. MERIDA	MP. ALBERTO ADRIANI	PQ. PRESIDENTE BETANCOURT	LICEO DR ALBERTO ADRIANI	3593	7	87	3063	1231	2976	0	14	1	2	1728	3063
EDO. MERIDA	MP. ALBERTO ADRIANI	PQ. PRESIDENTE BETANCOURT	UNIDAD EDUCATIVA BOLIVARIANA MANUELITA SAENZ	2564	5	42	1931	1164	1889	2	8	2	0	713	1931
EDO. MERIDA	MP. ALBERTO ADRIANI	PQ. GABRIEL PICON G.	ESCUELA BASICA LA PALMITA	1940	4	26	1470	790	1444	2	4	0	0	648	1470
EDO. MERIDA	MP. ALBERTO ADRIANI	PQ. GABRIEL PICON G.	UNIDAD EDUCATIVA BOLIVARIANA LA COROMOTO	66	1	3	59	38	56	0	1	0	0	17	59
EDO. MERIDA	MP. ALBERTO ADRIANI	PQ. GABRIEL PICON G.	ESCUELA ESTADAL LA LAGUNITA	631	2	9	528	293	519	0	6	0	0	220	528
EDO. MERIDA	MP. ALBERTO ADRIANI	PQ. GABRIEL PICON G.	ESCUELA BASICA LA HONDA	523	1	15	384	240	369	0	1	1	0	127	384
EDO. MERIDA	MP. ALBERTO ADRIANI	PQ. GABRIEL PICON G.	UNIDAD EDUCATIVA PALO QUEMADO	59	1	2	53	38	51	0	0	0	0	13	53
EDO. AMAZONAS	MP. ATABAPO	PQ. YAPACANA	CENTRO MOVIL CARIDA
EDO. AMAZONAS	MP. ATABAPO	PQ. YAPACANA	ESCUELA EDUARDO BLANCO
EDO. AMAZONAS	MP. ATABAPO	PQ. YAPACANA	CENTRO MOVIL PICUA	174	1	11	132	18	121	0	4	0	0	99	132
EDO. AMAZONAS	MP. ATABAPO	PQ. CANAME	ESCUELA JOSE FELIX RIVAS	232	1	5	144	76	139	0	0	0	0	63	144
EDO. AMAZONAS	MP. ATABAPO	PQ. UCATA	ESCUELA BASICA VICENTE SALIAS	337	1	9	245	129	236	0	4	0	0	103	245
EDO. AMAZONAS	MP. ATABAPO	PQ. UCATA	UNIDAD EDUCATIVA BOLIVARIANA JOSE MARIA ESPAÑA	337	1	7	286	162	279	0	1	1	0	115	286
EDO. AMAZONAS	MP. ATABAPO	CM. SAN FERNANDO DE ATABA	CENTRO MOVIL EL PUENTE	345	1	4	288	162	284	0	2	0	3	117	288
EDO. AMAZONAS	MP. ATABAPO	CM. SAN FERNANDO DE ATABA	ESCUELA INTEGRAL BOLIVARIANA SAN FRANCISCO DE ATABAPO II	230	1	5	163	72	158	0	4	0	0	82	163
EDO. AMAZONAS	MP. ATABAPO	CM. SAN FERNANDO DE ATABA	E.I.B. SAN FRANCISCO II	40	1	0	28	14	28	0	0	0	0	14	28
EDO. AMAZONAS	MP. ATABAPO	CM. SAN FERNANDO DE ATABA	ESCUELA JUNIN	1396	3	42	986	384	944	0	13	0	1	546	986
EDO. AMAZONAS	MP. ATABAPO	CM. SAN FERNANDO DE ATABA	UNIDAD EDUCATIVA JOSE GUMILLAS	2573	5	49	1934	758	1885	3	22	1	2	1099	1934
EDO. AMAZONAS	MP. RIO NEGRO	PQ. SOLANO	ESCUELA BASICA ROMULO GALLEGOS	270	1	13	199	66	186	1	4	0	0	115	199
EDO. AMAZONAS	MP. RIO NEGRO	PQ. SOLANO	MEREY 2	59	1	1	48	29	47	0	7	0	0	11	48
EDO. AMAZONAS	MP. RIO NEGRO	CM. SAN CARLOS DE RIO NEG	GRUPO ESCOLAR ANTONIO JOSE DE SUCRE	1401	3	28	904	371	876	0	17	0	0	488	904
EDO. AMAZONAS	MP. RIO NEGRO	CM. SAN CARLOS DE RIO NEG	CENTRO MOVIL WARINUMA	262	1	5	222	92	217	0	3	0	0	122	222
EDO. AMAZONAS	MP. RIO NEGRO	PQ. CASIQUIARE	CENTRO MOVIL WIRIONABE	146	1	1	125	46	124	0	0	0	0	78	125
EDO. AMAZONAS	MP. RIO NEGRO	PQ. COCUY	ESCUELA BASICA  JOSE ANGEL LAMAS	165	1	1	87	24	86	0	1	0	0	61	87
EDO. AMAZONAS	CE. ATURES	PQ. FERNANDO GIRON TOVAR	CENTRO DE EDUC. ESPECIAL AMAZONAS	2247	4	52	1617	787	1565	0	13	0	1	764	1617
EDO. AMAZONAS	CE. ATURES	PQ. FERNANDO GIRON TOVAR	ESCUELA BASICA MONSEÑOR ENRIQUE DE FERRARI	2844	5	76	2102	954	2026	0	23	0	0	1049	2102
EDO. AMAZONAS	CE. ATURES	PQ. FERNANDO GIRON TOVAR	ESCUELA BASICA TACHIRA	1814	4	52	1384	656	1332	0	15	0	1	660	1384
EDO. AMAZONAS	CE. ATURES	PQ. FERNANDO GIRON TOVAR	PREESCOOLAR LOS LOROS	373	1	6	343	203	337	2	2	0	0	130	343
EDO. AMAZONAS	CE. ATURES	PQ. FERNANDO GIRON TOVAR	ESCUELA BASICA CACIQUE ARAMARE	1914	4	50	1595	640	1545	0	14	0	0	891	1595
EDO. AMAZONAS	CE. ATURES	PQ. FERNANDO GIRON TOVAR	CENTRO MOVIL ALTO PARIMA	433	1	8	393	209	385	0	3	0	1	172	393
EDO. AMAZONAS	CE. ATURES	PQ. FERNANDO GIRON TOVAR	ESCUELA BASICA MENCA DE LEONI	3019	6	58	2415	1174	2357	1	20	0	0	1162	2415
EDO. AMAZONAS	CE. ATURES	PQ. FERNANDO GIRON TOVAR	ESCUELA BASICA ANDRES ELOY BLANCO	2304	4	71	1826	790	1755	0	11	0	1	953	1826
EDO. AMAZONAS	CE. ATURES	PQ. FERNANDO GIRON TOVAR	ESCUELA BASICA SIMON BOLIVAR	1772	4	42	1412	598	1370	0	13	0	0	759	1412
EDO. AMAZONAS	CE. ATURES	PQ. FERNANDO GIRON TOVAR	ESCUELA DE EDUCACION INICIAL AMAZONAS LA ARMADA	273	1	3	217	186	214	0	0	0	0	28	217
EDO. AMAZONAS	CE. ATURES	PQ. FERNANDO GIRON TOVAR	PRE ESCOLAR MONSEÑOR ENRIQUE DE FERRARI	326	1	5	266	133	261	1	5	0	0	122	266
EDO. AMAZONAS	CE. ATURES	PQ. FERNANDO GIRON TOVAR	ESCUELA GRADUADA GABRIELA MISTRAL	1805	4	59	1494	625	1435	0	10	1	0	799	1494
EDO. AMAZONAS	CE. ATURES	PQ. FERNANDO GIRON TOVAR	PRESCOLAR DIA INTERNACIONAL DEL NIÑO	203	1	5	169	93	164	1	2	0	1	67	169
EDO. AMAZONAS	CE. ATURES	PQ. FERNANDO GIRON TOVAR	LICEO SANTIAGO AGUERREVERE	1772	3	52	1334	555	1282	0	11	0	0	716	1334
EDO. AMAZONAS	CE. ATURES	PQ. FERNANDO GIRON TOVAR	CASA DE LOS NIÑOS WANADI CENTRO RECREATIVO	1891	4	40	1562	743	1522	0	8	0	3	768	1562
EDO. AMAZONAS	CE. ATURES	PQ. FERNANDO GIRON TOVAR	CENTRO MOVIL CASIQUIARE	233	1	7	211	157	204	0	0	1	1	45	211
EDO. AMAZONAS	CE. ATURES	PQ. FERNANDO GIRON TOVAR	CENTRO MOVIL 5 DE JULIO	379	1	8	332	154	324	0	0	0	0	170	332
EDO. AMAZONAS	CE. ATURES	PQ. FERNANDO GIRON TOVAR	SIMONCITO PIEDRA DE LA TORTUGA	114	1	5	108	71	103	0	1	0	0	31	108
EDO. AMAZONAS	CE. ATURES	PQ. PARHUE#A	CENTROP MOVIL BAMBU LUCERA	263	1	10	233	105	223	0	1	0	0	117	233
EDO. AMAZONAS	CE. ATURES	PQ. PARHUE#A	CENTRO MOVIL BETANIA	285	1	7	276	186	269	0	1	0	0	82	276
EDO. AMAZONAS	CE. ATURES	PQ. PARHUE#A	CENTRO MOVIL PROVINCIAL	1065	2	24	884	472	860	0	3	1	0	384	884
EDO. AMAZONAS	CE. ATURES	PQ. PARHUE#A	ESCUELA SANTIAGO AGUERREVERE	1087	2	20	809	351	789	0	6	0	0	432	809
EDO. AMAZONAS	CE. ATURES	PQ. PARHUE#A	CENTRO MOVIL GALIPERO	154	1	16	137	73	121	0	1	0	0	47	137
EDO. AMAZONAS	CE. ATURES	PQ. PARHUE#A	CENTRO MOVIL OJO DE AGUA
EDO. AMAZONAS	CE. ATURES	PQ. PARHUE#A	CENTRO MOVIL TOPOCHO	282	1	13	264	150	251	0	0	0	0	101	264
EDO. AMAZONAS	CE. ATURES	PQ. PARHUE#A	CENTRO MOVIL PAVONI
EDO. AMAZONAS	CE. ATURES	PQ. PARHUE#A	CENTRO MOVIL POZON DE BABILLA	641	2	34	492	296	458	0	6	1	0	155	492
EDO. AMAZONAS	CE. ATURES	PQ. PARHUE#A	CENTRO MOVIL EL CEJAL
EDO. AMAZONAS	CE. ATURES	PQ. PARHUE#A	UNIDAD EDUCATIVA INTEGRAL BOLIVARIANA FELIX RAMON RIVAS	1020	2	17	803	340	786	0	4	0	0	442	803
EDO. AMAZONAS	CE. ATURES	PQ. PARHUE#A	UNIDAD EDUCATIVA MARIA TERESA DEL TORO	204	1	9	190	114	181	0	1	0	0	66	190
EDO. AMAZONAS	CE. ATURES	PQ. LUIS ALBERTO GOMEZ	CENTRO MOVIL EL MOÑITO	526	1	14	457	266	443	0	2	0	0	175	457
EDO. AMAZONAS	CE. ATURES	PQ. LUIS ALBERTO GOMEZ	ESCUELA BASICA CECILIO ACOSTA	2520	5	42	1878	984	1836	3	14	0	1	834	1878
EDO. AMAZONAS	CE. ATURES	PQ. LUIS ALBERTO GOMEZ	UNIDAD EDUCATIVA SOR ANA EMILIA MORENO	441	1	16	411	321	395	0	4	1	0	69	411
EDO. AMAZONAS	CE. ATURES	PQ. LUIS ALBERTO GOMEZ	CENTRO MOVIL RUIZ PINEDA	1087	2	19	929	571	910	0	5	0	2	332	929
EDO. AMAZONAS	CE. ATURES	PQ. LUIS ALBERTO GOMEZ	PREESCOLAR MADRE TERESA DE CALCUTA	2892	5	51	2387	1202	2336	0	11	2	1	1120	2387
EDO. AMAZONAS	CE. ATURES	PQ. LUIS ALBERTO GOMEZ	ESCUELA LIBERTADOR	972	2	30	835	416	805	0	4	0	0	385	835
EDO. AMAZONAS	CE. ATURES	PQ. LUIS ALBERTO GOMEZ	CENTRO MOVIL CUEVA DEL INDIO	371	1	3	327	219	324	0	0	0	0	105	327
EDO. AMAZONAS	CE. ATURES	PQ. LUIS ALBERTO GOMEZ	UNIDAD BASICA COLEGIO PADRE MAYANET	1048	2	34	881	468	847	2	6	0	0	371	881
EDO. AMAZONAS	CE. ATURES	PQ. LUIS ALBERTO GOMEZ	CENTRO MOVIL UPATA	311	1	6	292	209	286	1	1	0	1	74	292
EDO. AMAZONAS	CE. ATURES	PQ. LUIS ALBERTO GOMEZ	ESCUELA BASICA JUAN IVIRNA CASTILLO	2810	5	67	2190	1147	2123	0	19	1	3	953	2190
EDO. AMAZONAS	CE. ATURES	PQ. LUIS ALBERTO GOMEZ	PREESCOLAR CERRO PERICO	720	2	31	634	232	603	0	7	0	1	363	634
EDO. AMAZONAS	CE. ATURES	PQ. LUIS ALBERTO GOMEZ	CENTRO MOVIL MORICHALITO	378	1	13	353	198	340	0	5	1	0	136	353
EDO. AMAZONAS	CE. ATURES	PQ. LUIS ALBERTO GOMEZ	AMBULATORIO CASA INDIGENA	480	1	12	413	178	401	0	2	0	0	221	413
EDO. AMAZONAS	CE. ATURES	PQ. LUIS ALBERTO GOMEZ	UNIVERSIDAD PEDAGOGICA EXPERIMENTAL LIBERTADOR	2674	5	45	2172	980	2127	1	15	2	0	1129	2172
EDO. AMAZONAS	CE. ATURES	PQ. LUIS ALBERTO GOMEZ	UNIDAD EDUCATIVA BOLIVARIANA AUTANA	108	1	3	103	53	100	0	0	0	0	47	103
EDO. AMAZONAS	CE. ATURES	PQ. LUIS ALBERTO GOMEZ	PREESCOLAR SIMON BOLIVAR	1325	3	27	1076	502	1049	0	9	1	0	537	1076
EDO. AMAZONAS	CE. ATURES	PQ. LUIS ALBERTO GOMEZ	PREESCOLAR LAS MANACAS	475	1	16	404	285	388	0	5	0	0	98	404
EDO. AMAZONAS	CE. ATURES	PQ. LUIS ALBERTO GOMEZ	PREESCOLAR TAMANACO	186	1	3	168	134	165	0	1	0	0	30	168
EDO. AMAZONAS	CE. ATURES	PQ. LUIS ALBERTO GOMEZ	UNIDAD EDUCATIVA BOLIVARIANA LA INDEPENDENCIA	1119	2	29	903	435	874	0	6	0	0	433	903
EDO. AMAZONAS	CE. ATURES	PQ. LUIS ALBERTO GOMEZ	CENTRO DE EDUCACION INICIAL LOS TUNCANCITOS	712	2	18	645	449	627	0	5	0	0	173	645
EDO. AMAZONAS	CE. ATURES	PQ. LUIS ALBERTO GOMEZ	ESCUELA BASICA SIMON RODRIGUEZ	2501	5	56	2058	1132	2002	1	13	1	0	855	2058
EDO. AMAZONAS	CE. ATURES	PQ. LUIS ALBERTO GOMEZ	LICEO BOLIVARIANO CECILIO ACOSTA	652	2	18	553	304	535	0	2	0	2	227	553
EDO. AMAZONAS	CE. ATURES	PQ. LUIS ALBERTO GOMEZ	ESCUELA BASICA DON ROMULO BETANCOURT	2995	6	79	2361	1325	2282	0	12	0	0	945	2361
EDO. AMAZONAS	CE. ATURES	PQ. LUIS ALBERTO GOMEZ	ESCUELA BASICA FELIX SOLANO	3147	6	74	2468	1389	2394	2	20	1	0	982	2468
EDO. AMAZONAS	CE. ATURES	PQ. LUIS ALBERTO GOMEZ	PREESCOLAR CENTRO DE EDUCACION INICIAL CURUMI	144	1	3	136	92	133	0	2	0	0	39	136
EDO. AMAZONAS	CE. ATURES	PQ. LUIS ALBERTO GOMEZ	LICEO MARAHUACA	308	1	4	264	229	260	0	0	0	0	31	264
EDO. AMAZONAS	CE. ATURES	PQ. LUIS ALBERTO GOMEZ	CENTRO MOVIL SANTA ROSA	464	1	11	414	302	403	0	2	1	0	98	414
EDO. AMAZONAS	CE. ATURES	PQ. LUIS ALBERTO GOMEZ	PRESCOLAR ROMULO BETANCOURT	934	2	31	787	402	756	0	3	0	1	350	787
EDO. AMAZONAS	CE. ATURES	PQ. PLATANILLAL	CENTRO MOVIL PARIA GRANDE	486	1	5	451	258	446	1	1	0	0	186	451
EDO. AMAZONAS	CE. ATURES	PQ. PLATANILLAL	CENTRO MOVIL SAN PABLO DE CATANIAPO	101	1	3	97	32	94	0	2	0	0	60	97
EDO. AMAZONAS	CE. ATURES	PQ. PLATANILLAL	CENTRO MOVIL PINTAO	333	1	15	310	205	295	0	3	1	0	86	310
EDO. AMAZONAS	CE. ATURES	PQ. PLATANILLAL	CENTRO MOVIL GAVILAN	396	1	32	348	140	316	0	3	0	0	173	348
EDO. AMAZONAS	CE. ATURES	PQ. PLATANILLAL	CENTRO MOVIL SAN PEDRO DE CATANIAPO	111	1	2	100	32	98	0	0	0	0	66	100
EDO. AMAZONAS	CE. ATURES	PQ. PLATANILLAL	ESCUELA  BASICA DANIEL NAVEA	1025	2	37	820	471	783	0	6	0	0	306	820
EDO. AMAZONAS	CE. ATURES	PQ. PLATANILLAL	ESCUELA BASICA PADRE LUIS ROTTMAYER	582	1	10	420	214	410	0	3	0	0	193	420
EDO. AMAZONAS	CE. ATURES	PQ. PLATANILLAL	PRE ESCOLAR DANIEL NAVEA	493	1	10	388	244	378	0	6	0	0	128	388
EDO. AMAZONAS	CE. ATURES	PQ. PLATANILLAL	CENTRO MOVIL PLATANILLAL	649	2	19	536	288	517	0	4	0	0	225	536
EDO. AMAZONAS	CE. ATURES	PQ. PLATANILLAL	CENTRO MOVIL DE AGUA  BLANCA	291	1	6	266	149	260	0	2	0	0	109	266
EDO. AMAZONAS	CE. ATURES	PQ. PLATANILLAL	CENTRO MOVIL RUEDA	194	1	3	177	98	174	0	0	0	0	76	177
EDO. AMAZONAS	CE. ATURES	PQ. PLATANILLAL	ESCUELA BASICA EL LIBERTADOR	187	1	7	174	135	167	0	0	0	0	32	174
EDO. AMAZONAS	CE. ATURES	PQ. PLATANILLAL	CENTRO MOVIL SABANA DE TIGRE	301	1	55	277	133	222	0	1	1	0	87	277
EDO. AMAZONAS	CE. ATURES	PQ. PLATANILLAL	CENTRO MOVIL LA REFORMA	764	2	22	698	347	676	0	4	0	0	325	698
EDO. AMAZONAS	MP. MANAPIARE	PQ. MEDIO VENTUARI	UNIDAD EDUCATIVA TITO SALAS
EDO. AMAZONAS	MP. MANAPIARE	PQ. MEDIO VENTUARI	ESCUELA UNITARIA CRISTOBAL MENDOZA	275	1	6	172	98	166	0	4	0	0	64	172
EDO. AMAZONAS	MP. MANAPIARE	CM. SAN JUAN DE MANAPIARE	UNIDAD EDUCATIVA SIMON BOLIVAR	197	1	5	160	147	155	0	1	1	0	6	160
EDO. AMAZONAS	MP. MANAPIARE	CM. SAN JUAN DE MANAPIARE	ESCUELA  BASICA MARIA AUXILIADORA	2361	5	41	1728	1199	1687	1	12	0	0	475	1728
EDO. AMAZONAS	MP. MANAPIARE	PQ. ALTO VENTUARI	ESCUELA BASICA ANTONIO JOSE  DE SUCRE	709	2	13	516	441	503	0	5	0	0	57	516
EDO. AMAZONAS	MP. MANAPIARE	PQ. ALTO VENTUARI	CENTRO MOVIL CAÑO IGUANA
EDO. AMAZONAS	MP. MANAPIARE	PQ. ALTO VENTUARI	CENTRO MOVIL TENCUA
EDO. AMAZONAS	MP. MANAPIARE	PQ. BAJO VENTUARI	ESCUELA BASICA ALBERTO LOVERA
EDO. AMAZONAS	MP. ALTO ORINOCO	CM. LA ESMERALDA	UNIDAD EDUCATIVA CARDENAL JOSE HUMBERTO QUINTERO	251	1	3	197	119	194	0	4	0	0	71	197
EDO. AMAZONAS	MP. ALTO ORINOCO	CM. LA ESMERALDA	CENTRO MOVIL LA PUNTA	130	1	2	103	78	101	0	1	0	0	22	103
EDO. AMAZONAS	MP. ALTO ORINOCO	CM. LA ESMERALDA	ESCUELA LA ESMERALDA	789	2	10	435	277	425	0	8	0	0	140	435
EDO. AMAZONAS	MP. ALTO ORINOCO	PQ. SIERRA PARIMA	ESCUELA BASICA CACIQUE TAMANACO
EDO. AMAZONAS	MP. ALTO ORINOCO	PQ. SIERRA PARIMA	CENTRO MOVIL KOYOWAITERI
EDO. AMAZONAS	MP. ALTO ORINOCO	PQ. MARAWAKA	CENTRO MOVIL COSCHOCOLOWATERI	321	1	49	223	105	174	0	1	0	0	68	223
EDO. AMAZONAS	MP. ALTO ORINOCO	PQ. MARAWAKA	ESCUELA BASICA GERVACIO RUBIO	783	2	6	532	239	526	0	7	0	0	280	532
EDO. AMAZONAS	MP. ALTO ORINOCO	PQ. HUACHAMACARE	ESCUELA BASICA LOS PROCERES	85	1	1	65	28	64	0	2	0	0	34	65
EDO. AMAZONAS	MP. ALTO ORINOCO	PQ. HUACHAMACARE	ESCUELA BOLIVARIANA WASUDY	254	1	0	218	135	218	0	4	1	0	78	218
EDO. AMAZONAS	MP. ALTO ORINOCO	PQ. HUACHAMACARE	ESCUELA JUNIN	274	1	1	178	118	177	0	3	0	0	56	178
EDO. AMAZONAS	MP. ALTO ORINOCO	PQ. MAVACA	ESCUELA INTERCULTURAL BILINGUE YANOMAMI II	604	2	6	421	251	415	0	2	0	1	161	421
EDO. AMAZONAS	MP. ALTO ORINOCO	PQ. MAVACA	UNIDAD EDUCATIVA YANOMAMI I	433	1	1	379	283	378	0	2	0	0	93	379
EDO. AMAZONAS	MP. ALTO ORINOCO	PQ. MAVACA	CENTRO MOVIL PLATANAL
EDO. AMAZONAS	MP. ALTO ORINOCO	PQ. MAVACA	CENTRO MOVIL SIPOI	314	1	2	301	259	299	0	0	0	0	40	301
EDO. AMAZONAS	MP. MAROA	PQ. VICTORINO	ESCUELA SIMON RODRIGUEZ	153	1	4	117	49	113	0	1	0	0	63	117
EDO. AMAZONAS	MP. MAROA	PQ. VICTORINO	ESCUELA BASICA LUISA CACERES DE ARISMENDI	236	1	0	191	153	191	0	0	0	0	38	191
EDO. AMAZONAS	MP. MAROA	PQ. COMUNIDAD	ESCUELA ACOSTA ORTIZ	177	1	1	129	94	128	0	0	0	0	34	129
EDO. AMAZONAS	MP. MAROA	CM. MAROA	GRUPO ESCOLAR MARIO BRICEÑO IRAGORRI	1587	3	19	1185	700	1166	0	10	0	1	455	1185
EDO. AMAZONAS	MP. AUTANA	PQ. MUNDUAPO	CENTRO MOVIL RAUDAL DEL DANTO	278	1	3	247	130	244	0	1	0	0	113	247
EDO. AMAZONAS	MP. AUTANA	PQ. MUNDUAPO	ESCUELA BASICA RAFAEL URDANETA	569	1	10	473	119	463	0	9	0	0	335	473
EDO. AMAZONAS	MP. AUTANA	PQ. GUAYAPO	UNIDAD EDUCATIVA JUAN JOSE FLORES	307	1	5	287	251	282	0	0	0	0	31	287
EDO. AMAZONAS	MP. AUTANA	PQ. GUAYAPO	ESCUELA ANTONIO RICAURTE	503	1	10	345	148	335	0	4	1	0	182	345
EDO. AMAZONAS	MP. AUTANA	PQ. SIPAPO	UNIDAD EDUCATIVA RAFAEL MARIA BARALT	633	2	20	567	267	547	0	2	0	0	278	567
EDO. AMAZONAS	MP. AUTANA	PQ. SIPAPO	CENTRO MOVIL CAÑO UÑA	291	1	12	264	141	252	0	3	0	0	108	264
EDO. AMAZONAS	MP. AUTANA	CM. ISLA DE RATON	SIMONSITO MANUELITA SAENZ	450	1	7	429	256	422	0	2	0	0	164	429
EDO. AMAZONAS	MP. AUTANA	CM. ISLA DE RATON	ESCUELA BASICA MIGUEL ANTONIO CARO	1559	3	28	1049	333	1021	1	12	1	0	674	1049
EDO. AMAZONAS	MP. AUTANA	PQ. SAMARIAPO	ESCUELA BASICA  SAN PEDRO ALEJANDRINO	1234	3	28	914	462	886	0	9	2	1	412	914
EDO. AMAZONAS	MP. AUTANA	PQ. SAMARIAPO	CENTRO MOVIL CAÑO PASA	214	1	2	201	103	199	0	0	0	0	96	201
EDO. AMAZONAS	MP. AUTANA	PQ. SAMARIAPO	CENTRO MOVIL  CAMPO FLORIDO	301	1	3	269	122	266	0	3	0	0	141	269
EDO. DELTA AMAC	CE. TUCUPITA	PQ. JOSE VIDAL MARCANO	GRUPO ESCOLAR BACHILLER VIDAL	2332	4	55	1905	827	1850	0	14	1	1	1007	1905
EDO. DELTA AMAC	CE. TUCUPITA	PQ. JOSE VIDAL MARCANO	BIBLIOTECA PUBLICA SIMON BOLIVAR	275	1	5	244	141	239	0	3	0	0	95	244
EDO. DELTA AMAC	CE. TUCUPITA	PQ. JOSE VIDAL MARCANO	CONCENTRADA ESCOLAR LEONCIO MARTINEZ	716	2	7	580	352	573	0	7	0	0	214	580
EDO. DELTA AMAC	CE. TUCUPITA	PQ. JOSE VIDAL MARCANO	CASA COMUNAL	725	2	10	648	312	638	1	10	0	0	315	648
EDO. DELTA AMAC	CE. TUCUPITA	PQ. JOSE VIDAL MARCANO	MEDICATURA EL JOBO	254	1	5	219	119	214	0	4	0	1	90	219
EDO. DELTA AMAC	CE. TUCUPITA	PQ. JOSE VIDAL MARCANO	ESCUELA BÁSICA CRISTOBAL COLÓN	266	1	6	215	170	209	0	0	0	0	39	215
EDO. DELTA AMAC	CE. TUCUPITA	PQ. JOSE VIDAL MARCANO	CASA DE LOS NIÑOS DELTANOS	327	1	11	289	182	278	0	1	0	1	94	289
EDO. DELTA AMAC	CE. TUCUPITA	PQ. JOSE VIDAL MARCANO	CASA COMUNAL VILLA BOLIVARIANA	302	1	9	256	160	247	0	3	0	0	84	256
EDO. DELTA AMAC	CE. TUCUPITA	PQ. JOSE VIDAL MARCANO	ESCUELA BASICA LUISA TABLANTE DE MARCANO	1071	2	23	899	495	876	1	6	0	0	374	899
EDO. DELTA AMAC	CE. TUCUPITA	PQ. JOSE VIDAL MARCANO	CENTRO DE EDUCACION INICIAL	311	1	4	281	146	277	0	6	1	0	124	281
EDO. DELTA AMAC	CE. TUCUPITA	PQ. JOSE VIDAL MARCANO	ESCUELA CONCENTRADA NUMERO 29 LAS MULAS	210	1	3	172	117	169	0	1	0	0	51	172
EDO. DELTA AMAC	CE. TUCUPITA	PQ. JOSE VIDAL MARCANO	INSTITUTO UNIVERSITARIO DE TECNOLOGIA DOCTOR DELFIN MENDOZA	863	2	21	708	385	687	1	8	1	0	292	708
EDO. DELTA AMAC	CE. TUCUPITA	PQ. JOSE VIDAL MARCANO	CENTRO DE EDUCACION INICIAL ROMULO GALLEGOS	750	2	19	678	246	659	0	5	0	0	408	678
EDO. DELTA AMAC	CE. TUCUPITA	PQ. JOSE VIDAL MARCANO	ESCUELA CONCENTRADA  BOLIVARIANA LOS GÜIRES	197	1	0	157	144	157	0	2	1	0	10	157
EDO. DELTA AMAC	CE. TUCUPITA	PQ. JOSE VIDAL MARCANO	ESCUELA ANDRES BELLO	587	1	7	362	242	355	0	5	0	0	108	362
EDO. DELTA AMAC	CE. TUCUPITA	PQ. JOSE VIDAL MARCANO	ESCUELA BASICA ANGELICA DE FERMIN	1212	3	19	1033	514	1014	0	10	0	0	490	1033
EDO. DELTA AMAC	CE. TUCUPITA	PQ. JOSE VIDAL MARCANO	MODULO NEGRO PRIMERO	160	1	3	128	56	125	0	2	0	0	67	128
EDO. DELTA AMAC	CE. TUCUPITA	PQ. SAN RAFAEL	ESCUELA CONCENTRADA BOLIVARIANA  SANTIAGO MARIÑO	55	1	0	48	46	48	0	0	0	0	2	48
EDO. DELTA AMAC	CE. TUCUPITA	PQ. SAN RAFAEL	UNIDAD EDUCATIVA MI PEQUEÑO MUNDO	405	1	14	359	199	345	0	3	0	1	142	359
EDO. DELTA AMAC	CE. TUCUPITA	PQ. SAN RAFAEL	GRUPO ESCOLAR BACHILLER JOSE GABRIEL LANZA	807	2	35	649	340	614	0	5	0	1	268	649
EDO. DELTA AMAC	CE. TUCUPITA	PQ. SAN RAFAEL	CONCENTRADA ESCUELA CONDE CABALLERO	223	1	2	175	111	173	0	2	0	0	60	175
EDO. DELTA AMAC	CE. TUCUPITA	PQ. SAN RAFAEL	CONCENTRACION ESCOLAR NUMERO 6	304	1	4	209	152	205	0	2	0	0	51	209
EDO. DELTA AMAC	CE. TUCUPITA	PQ. SAN RAFAEL	CASA COMUNAL LA VICTORIA	148	1	3	128	88	125	0	1	0	0	36	128
EDO. DELTA AMAC	CE. TUCUPITA	PQ. SAN RAFAEL	ESCUELA ANTONIO JOSE DE SUCRE	711	2	13	556	390	543	0	7	0	0	146	556
EDO. DELTA AMAC	CE. TUCUPITA	PQ. SAN RAFAEL	U.E.N. BOLIVARIANA CACIQUE GUAICAIPURO	247	1	9	210	174	201	1	0	1	0	25	210
EDO. DELTA AMAC	CE. TUCUPITA	PQ. SAN RAFAEL	ESCUELA CONCENTRADA NUMERO 2	107	1	1	87	70	86	0	1	0	0	15	87
EDO. DELTA AMAC	CE. TUCUPITA	PQ. SAN RAFAEL	ESCUELA CONCENTRADA NUMERO 7	86	1	2	73	45	71	0	1	0	0	25	73
EDO. DELTA AMAC	CE. TUCUPITA	PQ. SAN RAFAEL	CONCENTRACION ESCOLAR NUMERO 93	257	1	5	139	114	134	2	1	0	0	17	139
EDO. DELTA AMAC	CE. TUCUPITA	PQ. SAN RAFAEL	LICEO JOSE ENRIQUE RODO	350	1	13	299	199	286	0	2	0	0	85	299
EDO. DELTA AMAC	CE. TUCUPITA	PQ. SAN RAFAEL	PREESCOLAR MIGUEL OTERO SILVA	64	1	2	62	48	60	0	0	0	0	12	62
EDO. DELTA AMAC	CE. TUCUPITA	PQ. SAN RAFAEL	ESCUELA FERMIN TORO	262	1	3	179	93	176	1	1	0	0	81	179
EDO. DELTA AMAC	CE. TUCUPITA	PQ. SAN RAFAEL	CONCENTRACION ESCOLAR NUMERO 19	262	1	1	151	125	150	0	0	0	0	25	151
EDO. DELTA AMAC	CE. TUCUPITA	PQ. SAN RAFAEL	E.B. CONC. BOLIV. ROMULO GALLEGOS	154	1	2	122	108	120	2	1	1	0	8	122
EDO. DELTA AMAC	CE. TUCUPITA	PQ. SAN RAFAEL	GRUPO ESCOLAR CARLOS RAFAEL CONTRERAS	2288	4	63	1790	895	1727	0	15	0	0	817	1790
EDO. DELTA AMAC	CE. TUCUPITA	PQ. SAN RAFAEL	OFICINA DE OBRAS PUBLICAS ESTADALES	265	1	8	231	143	223	1	4	0	0	75	231
EDO. DELTA AMAC	CE. TUCUPITA	PQ. SAN RAFAEL	BIBLIOTECA JOSE VALZA	127	1	1	115	82	114	0	1	0	0	31	115
EDO. DELTA AMAC	CE. TUCUPITA	PQ. SAN RAFAEL	JARDIN DE INFANCIA LA GLORIA	557	1	10	474	285	464	0	6	1	0	172	474
EDO. DELTA AMAC	CE. TUCUPITA	PQ. SAN RAFAEL	GERIATRICO MENCA DE LEONI	322	1	10	246	164	236	0	1	0	0	71	246
EDO. DELTA AMAC	CE. TUCUPITA	PQ. SAN RAFAEL	ESCUELA EULALIA BUROZ	175	1	3	121	99	118	0	0	1	0	18	121
EDO. DELTA AMAC	CE. TUCUPITA	PQ. SAN RAFAEL	DEPOSITO MINISTERIO DE SANIDAD	416	1	9	352	192	343	0	4	0	1	146	352
EDO. DELTA AMAC	CE. TUCUPITA	PQ. SAN RAFAEL	CASA COMUNAL EL GARCERO	115	1	1	95	80	94	0	1	0	0	13	95
EDO. DELTA AMAC	CE. TUCUPITA	PQ. SAN RAFAEL	ESCUELA CONCENTRADA NUMERO 137	64	1	2	36	33	34	0	0	0	0	1	36
EDO. DELTA AMAC	CE. TUCUPITA	PQ. VIRGEN DEL VALLE	CENTRO DE EDUCACION INICIAL TERESA EDUARDO	127	1	2	118	92	116	0	0	0	0	24	118
EDO. DELTA AMAC	CE. TUCUPITA	PQ. VIRGEN DEL VALLE	CASA COMUNAL SAN JOSE	100	1	3	96	83	93	0	0	0	0	10	96
EDO. DELTA AMAC	CE. TUCUPITA	PQ. VIRGEN DEL VALLE	CENTRO COMUNITARIO LA FLORIDA	456	1	9	398	291	389	0	3	0	0	95	398
EDO. DELTA AMAC	CE. TUCUPITA	PQ. VIRGEN DEL VALLE	ESCUELA ROSA DE TENORIO	606	2	14	507	347	493	1	5	0	0	140	507
EDO. DELTA AMAC	CE. TUCUPITA	PQ. VIRGEN DEL VALLE	UNIDAD EDUCATIVA BOLIVARIANA DOCTOR  JOSE GREGORIO HERNANDEZ	154	1	3	109	73	106	0	0	1	0	32	109
EDO. DELTA AMAC	CE. TUCUPITA	PQ. VIRGEN DEL VALLE	E.B.E. CONC. BOLIV. N° 13 REMANZON	147	1	10	113	84	103	0	0	0	0	19	113
EDO. DELTA AMAC	CE. TUCUPITA	PQ. VIRGEN DEL VALLE	PRESCOLAR NI#O SIMON	78	1	1	73	60	72	0	0	0	0	12	73
EDO. DELTA AMAC	CE. TUCUPITA	PQ. VIRGEN DEL VALLE	CENTRO INTEGRAL CENTRO POBLADO DE COCUINA	112	1	0	105	95	105	1	0	0	0	9	105
EDO. DELTA AMAC	CE. TUCUPITA	PQ. VIRGEN DEL VALLE	ESCUELA BASICA CARDENAL JOSE QUINTERO	387	1	5	326	207	321	0	4	0	0	110	326
EDO. DELTA AMAC	CE. TUCUPITA	PQ. VIRGEN DEL VALLE	E.B.N. CONC. BOLIV. ANDRES ELOY BLANCO	105	1	2	103	98	101	0	0	0	0	3	103
EDO. DELTA AMAC	CE. TUCUPITA	PQ. VIRGEN DEL VALLE	GRUPO ESCOLAR TERESA EDUARDO	819	2	7	570	421	563	0	3	0	0	139	570
EDO. DELTA AMAC	CE. TUCUPITA	PQ. VIRGEN DEL VALLE	GRUPO ESCOLAR LA FLORIDA	759	2	32	644	276	612	1	6	0	0	329	644
EDO. DELTA AMAC	CE. TUCUPITA	PQ. VIRGEN DEL VALLE	LICEO BOLIVARIANO TERESA EDUARDO	48	1	0	44	33	44	0	0	0	0	11	44
EDO. DELTA AMAC	CE. TUCUPITA	PQ. VIRGEN DEL VALLE	ESCUELA UNITARIA SIN NUMERO	266	1	6	235	116	229	0	4	0	0	109	235
EDO. DELTA AMAC	CE. TUCUPITA	PQ. VIRGEN DEL VALLE	ESCUELA MANUEL DIAZ RODRIGUEZ	383	1	4	295	203	291	0	3	0	0	85	295
EDO. DELTA AMAC	CE. TUCUPITA	PQ. VIRGEN DEL VALLE	ESCUELA UNITARIA NUMERO 22	218	1	4	185	124	181	0	2	0	0	55	185
EDO. DELTA AMAC	CE. TUCUPITA	PQ.MCL.ANTONIO J DE SUCRE	ASOAGNA
EDO. DELTA AMAC	CE. TUCUPITA	PQ.MCL.ANTONIO J DE SUCRE	ESCUELA DOCTOR JOSE MARIA VARGAS	920	2	26	728	427	702	1	6	0	0	268	728
EDO. DELTA AMAC	CE. TUCUPITA	PQ.MCL.ANTONIO J DE SUCRE	CONCENTRADA ESCOLAR NUMERO 74	839	2	14	680	374	666	0	5	0	1	286	680
EDO. DELTA AMAC	CE. TUCUPITA	PQ.MCL.ANTONIO J DE SUCRE	ESCUELA SIMON RODRIGUEZ	2776	5	94	2144	1086	2050	2	22	1	3	936	2144
EDO. DELTA AMAC	CE. TUCUPITA	PQ.MCL.ANTONIO J DE SUCRE	PREESCOLAR CAPITAN DE NAVIO ANTONIO DIAZ	509	1	9	406	230	397	0	3	0	1	163	406
EDO. DELTA AMAC	CE. TUCUPITA	PQ.MCL.ANTONIO J DE SUCRE	CASA COMUNAL AGUA NEGRA	141	1	6	119	87	113	0	2	0	0	24	119
EDO. DELTA AMAC	CE. TUCUPITA	PQ.MCL.ANTONIO J DE SUCRE	CASA COMUNAL EL PALOMAR	408	1	10	353	225	343	0	6	0	0	112	353
EDO. DELTA AMAC	CE. TUCUPITA	PQ.MCL.ANTONIO J DE SUCRE	CENTRO DE EDUCACION INICIAL BOLIVARIANO MANUELITA SAENZ	228	1	5	199	120	194	1	3	0	0	70	199
EDO. DELTA AMAC	CE. TUCUPITA	PQ.MCL.ANTONIO J DE SUCRE	UNIDAD EDUCATIVA NACIONAL BOLIVARIANA YAKARIYENE	288	1	0	261	208	261	2	1	1	1	48	261
EDO. DELTA AMAC	CE. TUCUPITA	PQ.MCL.ANTONIO J DE SUCRE	CONSULTORIO POPULAR YAKARIYENI	99	1	6	95	73	89	0	0	0	0	16	95
EDO. DELTA AMAC	CE. TUCUPITA	PQ. JUAN MILLAN	CASA COMUNAL CAMPO FLORIDO	140	1	3	121	103	118	0	0	0	0	15	121
EDO. DELTA AMAC	CE. TUCUPITA	PQ. JUAN MILLAN	SALA DE BATALLA CAMPO FLORIDO	107	1	0	85	78	85	0	0	0	0	7	85
EDO. DELTA AMAC	CE. TUCUPITA	PQ. JUAN MILLAN	ESCUELA CONCENTRADA NUMERO 5	430	1	0	320	278	320	0	0	0	0	42	320
EDO. DELTA AMAC	CE. TUCUPITA	PQ. JUAN MILLAN	ESCUELA JOSE LUIS RAMOS	589	1	8	416	251	408	1	3	1	0	152	416
EDO. DELTA AMAC	CE. TUCUPITA	PQ. JUAN MILLAN	CENTRO MEDICO BOCA DE MACAREO	125	1	0	106	93	106	0	1	0	0	12	106
EDO. DELTA AMAC	CE. TUCUPITA	PQ. JUAN MILLAN	CBIT DE MACAREITO
EDO. DELTA AMAC	CE. TUCUPITA	PQ. JUAN MILLAN	GRUPO ESCOLAR DOCTOR RAUL VAN PRAG	343	1	3	284	156	281	0	1	0	0	124	284
EDO. DELTA AMAC	CE. TUCUPITA	PQ. JUAN MILLAN	ESCUELA GUARA CARAPAL	1092	2	29	880	497	851	1	9	0	1	343	880
EDO. DELTA AMAC	CE. TUCUPITA	PQ. JUAN MILLAN	ESCUELA CONCENT NUMERO 12	248	1	4	157	144	153	0	1	0	0	8	157
EDO. DELTA AMAC	CE. TUCUPITA	PQ. JUAN MILLAN	ESCUELA CONCENTRADA NUMERO 26	565	1	0	313	310	313	0	0	0	0	3	313
EDO. DELTA AMAC	CE. TUCUPITA	PQ. JUAN MILLAN	ESCUELA DIEGO CARBONELL	637	2	11	491	379	480	1	9	0	0	91	491
EDO. DELTA AMAC	CE. TUCUPITA	PQ. JUAN MILLAN	LICEO JOSE ANTONIO PAEZ	395	1	5	329	219	324	0	3	0	0	102	329
EDO. DELTA AMAC	CE. TUCUPITA	PQ. JUAN MILLAN	ESCUELA CONCENTRADA DE MARIUSA	353	1	3	275	260	272	1	2	3	0	6	275
EDO. DELTA AMAC	CE. TUCUPITA	PQ. JUAN MILLAN	ESCUELA CONCENTRADA NUMERO 38	400	1	1	254	235	253	0	0	0	0	18	254
EDO. DELTA AMAC	CE. TUCUPITA	PQ. JUAN MILLAN	CONCENTRACION ESCOLAR NUMERO 1	1005	2	13	746	507	733	1	10	4	0	211	746
EDO. DELTA AMAC	CE. TUCUPITA	PQ. SAN JOSE	GRUPO ESCOLAR CARABOBO	1602	3	39	1321	673	1282	1	15	0	1	592	1321
EDO. DELTA AMAC	CE. TUCUPITA	PQ. SAN JOSE	SECRETARIA GENERAL SECTORIAL DE DESARROLLO SOCIAL	564	1	12	403	171	391	0	4	0	1	215	403
EDO. DELTA AMAC	CE. TUCUPITA	PQ. SAN JOSE	ESCUELA ARTES Y OFICIOS MELANIA DE BRITO	128	1	4	115	60	111	0	0	0	0	51	115
EDO. DELTA AMAC	CE. TUCUPITA	PQ. SAN JOSE	COLEGIO SAGRADA FAMILIA	1304	3	20	1038	371	1018	0	12	0	1	634	1038
EDO. DELTA AMAC	CE. TUCUPITA	PQ. SAN JOSE	INSTITUTO DE MEJORAMIENTO PROFESIONAL DEL MAGISTERIO	634	2	8	499	225	491	0	2	0	0	264	499
EDO. DELTA AMAC	CE. TUCUPITA	PQ. SAN JOSE	GRUPO ESCOLAR PETION	1844	4	26	1456	595	1430	1	13	0	1	820	1456
EDO. DELTA AMAC	CE. TUCUPITA	PQ. SAN JOSE	INCES	179	1	4	150	79	146	0	0	0	0	67	150
EDO. DELTA AMAC	CE. TUCUPITA	PQ. MONS. ARGIMIRO GARCIA	PARQUE DE RECREACION DE TUCUPITA II	1749	3	53	1429	742	1376	1	11	0	1	621	1429
EDO. DELTA AMAC	CE. TUCUPITA	PQ. MONS. ARGIMIRO GARCIA	PARQUE CENTRAL TUCUPITA	1639	3	49	1363	721	1314	1	12	2	0	578	1363
EDO. DELTA AMAC	CE. TUCUPITA	PQ. MONS. ARGIMIRO GARCIA	CASA PARROQUIAL ARGIMIRO GARCIA	95	1	1	74	51	73	0	0	0	0	22	74
EDO. DELTA AMAC	CE. TUCUPITA	PQ. MONS. ARGIMIRO GARCIA	CENTRO DE EDUCACION INICIAL ESTADAL. BOLIVARIANO CEFERINO ROJAS	289	1	5	269	147	264	0	2	0	0	115	269
EDO. DELTA AMAC	CE. TUCUPITA	PQ. MONS. ARGIMIRO GARCIA	LICEO DIONISIO LOPEZ ORIHUELA	1686	3	33	1399	632	1366	0	16	1	0	717	1399
EDO. DELTA AMAC	CE. TUCUPITA	PQ. MONS. ARGIMIRO GARCIA	GRUPO ESCOLAR CEFERINO ROJAS DIAZ	1906	4	40	1608	790	1568	0	19	1	0	758	1608
EDO. DELTA AMAC	CE. TUCUPITA	PQ. MONS. ARGIMIRO GARCIA	GRUPO ESCOLAR TARCISIA DE ROMERO	1844	4	32	1581	738	1549	0	13	0	0	798	1581
EDO. DELTA AMAC	CE. TUCUPITA	PQ. MONS. ARGIMIRO GARCIA	CENTRO EDUCATIVO INTEGRAL MAYASHITA	1160	2	26	967	635	941	0	5	2	0	299	967
EDO. DELTA AMAC	CE. TUCUPITA	PQ. MONS. ARGIMIRO GARCIA	ASOC. CIVIL SOCIAL CULTURA Y DESARROLLO	196	1	4	169	110	165	0	2	0	0	53	169
EDO. DELTA AMAC	CE. TUCUPITA	PQ. LEONARDO RUIZ PINEDA	SINDICATO UNICO DEL MAGISTERIO	938	2	34	816	432	782	0	8	2	1	339	816
EDO. DELTA AMAC	CE. TUCUPITA	PQ. LEONARDO RUIZ PINEDA	GRUPO ESCOLAR JUAN VICENTE GONZALEZ	1864	4	40	1509	808	1469	0	14	4	0	643	1509
EDO. DELTA AMAC	CE. TUCUPITA	PQ. LEONARDO RUIZ PINEDA	CICLO BASICO ANIBAL ROJAS PEREZ	1013	2	23	831	353	808	0	14	0	0	441	831
EDO. DELTA AMAC	CE. TUCUPITA	PQ. LEONARDO RUIZ PINEDA	GIMNASIO CUBIERTO TUCUPITA	1627	3	58	1302	647	1244	0	10	0	0	587	1302
EDO. DELTA AMAC	CE. TUCUPITA	PQ. LEONARDO RUIZ PINEDA	CASA COMUNAL JOSE ANGEL TABLANTE	390	1	4	347	294	343	0	3	0	0	46	347
EDO. DELTA AMAC	CE. TUCUPITA	PQ. LEONARDO RUIZ PINEDA	SIMONCITO BOLIVARIANO DIVINO NIÑO	615	2	15	567	404	552	0	13	0	0	135	567
EDO. DELTA AMAC	CE. TUCUPITA	PQ. LEONARDO RUIZ PINEDA	GRUPO ESCOLAR CELESTINO PERAZA	1465	3	28	1228	609	1200	1	11	1	1	577	1228
EDO. DELTA AMAC	MP. PEDERNALES	PQ. PEDERNALES	ESCUELA CONCENTRADA NUMERO 55	719	2	6	450	281	444	0	0	0	0	163	450
EDO. DELTA AMAC	MP. PEDERNALES	PQ. PEDERNALES	ESCUELA CONCENTRADA SIN NUMERO	1157	2	12	708	573	696	0	1	0	1	121	708
EDO. DELTA AMAC	MP. PEDERNALES	PQ. PEDERNALES	ESCUELA CONCENTRADA SIN NUMERO GUINAMORENA	528	1	2	306	246	304	0	1	0	0	57	306
EDO. DELTA AMAC	MP. PEDERNALES	PQ. PEDERNALES	ESCUELA SAMUEL DARIO MALDONADO	2764	5	31	1581	1206	1550	0	6	0	0	338	1581
EDO. DELTA AMAC	MP. PEDERNALES	PQ. LUIS B PRIETO FIGUERO	ESCUELA CONCENTRADA NUMERO 121	531	1	0	264	212	264	0	0	0	0	52	264
EDO. DELTA AMAC	MP. PEDERNALES	PQ. LUIS B PRIETO FIGUERO	ESCUELA GRADUADA CAPURE	1084	2	16	704	496	688	0	8	0	1	183	704
EDO. DELTA AMAC	MP. PEDERNALES	PQ. LUIS B PRIETO FIGUERO	ESCUELA CONCENTRADA SIN NUMERO GUARANOKO	716	2	3	505	473	502	0	0	0	0	29	505
EDO. DELTA AMAC	MP. PEDERNALES	PQ. LUIS B PRIETO FIGUERO	ESCUELA CONCENTRADA SIN NUMERO	637	2	8	485	363	477	0	2	0	0	112	485
EDO. DELTA AMAC	MP. PEDERNALES	PQ. LUIS B PRIETO FIGUERO	ESCUELA CONCENTRADA SIN NUMERO PEPEINA	559	1	6	355	261	349	0	3	1	0	84	355
EDO. DELTA AMAC	MP. ANTONIO DIAZ	PQ. SANTOS DE ABELGAS	ESCUELA UNITARIA SIN NUMERO EL REMANSO	270	1	1	213	196	212	0	0	0	0	16	213
EDO. DELTA AMAC	MP. ANTONIO DIAZ	PQ. SANTOS DE ABELGAS	GRUPO ESCOLAR DIVINA PASTORA	624	2	8	445	355	437	0	0	0	0	82	445
EDO. DELTA AMAC	MP. ANTONIO DIAZ	PQ. SANTOS DE ABELGAS	ESCUELA UNITARIA SIN NUMERO JANAMANA	118	1	0	77	71	77	0	2	0	0	4	77
EDO. DELTA AMAC	MP. ANTONIO DIAZ	PQ. SANTOS DE ABELGAS	ESCUELA UNITARIA SIN NUMERO SANTA ROSA	161	1	1	124	104	123	0	0	0	0	19	124
EDO. DELTA AMAC	MP. ANTONIO DIAZ	PQ. MANUEL RENAUD	ESCUELA CONCENTRADA NUMERO 57	938	2	3	696	630	693	0	2	0	0	61	696
EDO. DELTA AMAC	MP. ANTONIO DIAZ	PQ. MANUEL RENAUD	ESCUELA CONCENTRADA NUMERO 66	580	1	8	441	278	433	1	5	1	0	148	441
EDO. DELTA AMAC	MP. ANTONIO DIAZ	PQ. MANUEL RENAUD	UNIDAD EDUCATIVA SIGUANI	225	1	0	193	193	193	0	0	0	0	0	193
EDO. DELTA AMAC	MP. ANTONIO DIAZ	PQ. MANUEL RENAUD	ESCUELA CONCENTRADA SIN NUMERO DIARUKABANOKO	185	1	0	136	108	136	0	0	0	0	28	136
EDO. DELTA AMAC	MP. ANTONIO DIAZ	PQ. MANUEL RENAUD	ESCUELA CONCENTRADA SIN NUMERO KOBERUNA	252	1	1	190	149	189	2	0	0	0	38	190
EDO. DELTA AMAC	MP. ANTONIO DIAZ	PQ. MANUEL RENAUD	ESCUELA CONCENTRADA SIN NUMERO ARAGUABISI	682	2	0	522	514	522	0	0	0	1	7	522
EDO. DELTA AMAC	MP. ANTONIO DIAZ	PQ. MANUEL RENAUD	ESCUELA CONCENTRADA NUMERO 94	1370	3	4	742	690	738	0	2	1	0	45	742
EDO. DELTA AMAC	MP. ANTONIO DIAZ	PQ. MANUEL RENAUD	ESCUELA CONCENTRADA SIN NUMERO BARAKATAINA	168	1	4	113	68	109	0	0	1	1	39	113
EDO. DELTA AMAC	MP. ANTONIO DIAZ	PQ. ANICETO LUGO	ESCUELA UNITARIA SIN NUMERO	348	1	2	210	188	208	0	6	0	0	14	210
EDO. DELTA AMAC	MP. ANTONIO DIAZ	PQ. ANICETO LUGO	ESCUELA CONCENTRADA SIN NUMERO	100	1	0	22	17	22	0	0	0	0	5	22
EDO. DELTA AMAC	MP. ANTONIO DIAZ	PQ. ANICETO LUGO	ESCUELA NACIONAL NUMERO 95	1360	3	2	490	434	488	0	1	1	0	52	490
EDO. DELTA AMAC	MP. ANTONIO DIAZ	PQ. ALMIRANTE LUIS BRION	ESCUELA CONCENTRADA NUMERO 125	109	1	2	74	63	72	0	0	0	0	9	74
EDO. DELTA AMAC	MP. ANTONIO DIAZ	PQ. ALMIRANTE LUIS BRION	ESCUELA UNITARIA NUMERO 123	194	1	0	131	125	131	0	0	0	0	6	131
EDO. DELTA AMAC	MP. ANTONIO DIAZ	PQ. ALMIRANTE LUIS BRION	ESCUELA UNITARIA SIN NUMERO	239	1	2	171	152	169	0	0	0	0	17	171
EDO. DELTA AMAC	MP. ANTONIO DIAZ	PQ. ALMIRANTE LUIS BRION	ESCUELA UNITARIA NUMERO 21	316	1	1	172	160	171	0	1	0	0	10	172
EDO. DELTA AMAC	MP. ANTONIO DIAZ	PQ. ALMIRANTE LUIS BRION	GRUPO ESCOLAR ISLA DE GUASINA	343	1	2	220	154	218	0	1	0	0	63	220
EDO. DELTA AMAC	MP. ANTONIO DIAZ	PQ. ALMIRANTE LUIS BRION	ESCUELA CONCENTRADA NUMERO 14	211	1	3	138	122	135	0	1	0	0	12	138
EDO. DELTA AMAC	MP. ANTONIO DIAZ	PQ. PADRE BARRAL	ESCUELA SAN FRANCISCO DE GUAYO	2836	5	26	1447	1255	1421	1	2	3	0	160	1447
EDO. DELTA AMAC	MP. ANTONIO DIAZ	PQ. PADRE BARRAL	ESCUELA CONCENTRADA SIN NUMERO	739	2	0	558	554	558	0	0	0	0	4	558
EDO. DELTA AMAC	MP. ANTONIO DIAZ	PQ. PADRE BARRAL	ESCUELA UNITARIA SIN NUMERO	527	1	0	327	316	327	0	0	1	0	10	327
EDO. DELTA AMAC	MP. ANTONIO DIAZ	PQ. CURIAPO	ESCUELA CONCENTRADA SIN NUMERO JUANEIDA	616	2	0	435	405	435	0	0	0	0	30	435
EDO. DELTA AMAC	MP. ANTONIO DIAZ	PQ. CURIAPO	ESCUELA CONCENTRADA SIN NUMERO	121	1	1	101	69	100	0	0	0	0	31	101
EDO. DELTA AMAC	MP. ANTONIO DIAZ	PQ. CURIAPO	ESCUELA CONCENTRADA SIN NUMERO CANGREJITO	522	1	5	381	246	376	0	2	0	0	128	381
EDO. DELTA AMAC	MP. ANTONIO DIAZ	PQ. CURIAPO	ESCUELA CONCT BELLA VISTA	680	2	7	381	284	374	0	1	1	0	88	381
EDO. DELTA AMAC	MP. ANTONIO DIAZ	PQ. CURIAPO	CONCENTRACION ESCOLAR NUMERO 8	1637	3	0	896	819	896	0	1	0	0	76	896
EDO. DELTA AMAC	MP. ANTONIO DIAZ	PQ. CURIAPO	ESCUELA PEDERNALES	2288	4	24	1081	765	1057	1	8	1	0	282	1081
EDO. DELTA AMAC	MP. CASACOIMA	PQ. ROMULO GALLEGOS	ESCUELA JOSE CONRADO AZOCAR	274	1	4	184	125	180	0	5	0	1	49	184
EDO. DELTA AMAC	MP. CASACOIMA	PQ. ROMULO GALLEGOS	ESCUELA GRANJA SANTA CATALINA	852	2	11	622	323	611	0	4	1	0	283	622
EDO. DELTA AMAC	MP. CASACOIMA	PQ. ROMULO GALLEGOS	ESCUELA CONCENTRADA MANACAL DE TORTOLA	260	1	1	189	161	188	0	1	0	0	26	189
EDO. DELTA AMAC	MP. CASACOIMA	PQ. ROMULO GALLEGOS	ESCUELA UNITARIA NUMERO 25	120	1	0	78	69	78	0	0	0	0	9	78
EDO. DELTA AMAC	MP. CASACOIMA	PQ. ROMULO GALLEGOS	TORTOLA	51	1	1	40	30	39	1	0	0	0	8	40
EDO. DELTA AMAC	MP. CASACOIMA	PQ. ROMULO GALLEGOS	ESCUELA CONCENTRADA NUMERO 34	101	1	0	64	50	64	0	0	0	0	14	64
EDO. DELTA AMAC	MP. CASACOIMA	PQ. ROMULO GALLEGOS	PIEDRAS PRECIOSAS	35	1	0	28	20	28	0	0	0	0	8	28
EDO. DELTA AMAC	MP. CASACOIMA	PQ. ROMULO GALLEGOS	ESCUELA CONCENTRADA NUMERO 15	298	1	6	195	137	189	0	1	1	0	50	195
EDO. DELTA AMAC	MP. CASACOIMA	PQ. IMATACA	ESCUELA ALTERNATIVA CUYAS	101	1	2	73	61	71	0	0	0	0	10	73
EDO. DELTA AMAC	MP. CASACOIMA	PQ. IMATACA	LICEO BOLIVARIANO CASACOIMA	460	1	4	325	247	321	0	4	1	0	69	325
EDO. DELTA AMAC	MP. CASACOIMA	PQ. IMATACA	ESCUELA BASICA CASACOIMA	2252	4	60	1590	1144	1530	1	11	5	0	369	1590
EDO. DELTA AMAC	MP. CASACOIMA	PQ. IMATACA	CENTRO EDUCATIVO INICIAL BOLIVARIANO	234	1	4	203	165	199	1	2	1	0	30	203
EDO. DELTA AMAC	MP. CASACOIMA	PQ. IMATACA	ESCUELA CONCENTRADA SIN NUMERO	505	1	12	365	273	353	0	3	2	0	75	365
EDO. DELTA AMAC	MP. CASACOIMA	PQ. JUAN BAUTISTA ARISMEN	ESCUELA PEDRO EMILIO COLL	1715	3	28	1269	927	1241	1	6	1	0	306	1269
EDO. DELTA AMAC	MP. CASACOIMA	PQ. JUAN BAUTISTA ARISMEN	ESCUELA CONCENTRADA NUMERO 11	89	1	2	72	66	70	0	0	0	0	4	72
EDO. DELTA AMAC	MP. CASACOIMA	PQ. JUAN BAUTISTA ARISMEN	ESCUELA BASICA BOLIVARIANA MUNICIPAL PEDRO PABLO GONZALEZ	41	1	2	34	27	32	0	0	0	0	5	34
EDO. DELTA AMAC	MP. CASACOIMA	PQ. JUAN BAUTISTA ARISMEN	CONCENTRACION ESCOLAR NUMERO 10	1069	2	12	785	591	773	1	1	0	0	180	785
EDO. DELTA AMAC	MP. CASACOIMA	PQ. JUAN BAUTISTA ARISMEN	ESCUELA UNITARIA LA FE	322	1	6	228	209	222	0	0	0	0	13	228
EDO. DELTA AMAC	MP. CASACOIMA	PQ. MANUEL PIAR	CENTRO EDUCATIVO INTEGRAL MUNICIPAL BOLIVARIANO ARCOIRIS	148	1	1	128	106	127	0	1	1	0	19	128
EDO. DELTA AMAC	MP. CASACOIMA	PQ. MANUEL PIAR	UNIDAD EDUCATIVA MARIA DEL JESUS ALMEIDA	2735	5	31	2124	1545	2093	1	15	2	0	530	2124
EDO. DELTA AMAC	MP. CASACOIMA	PQ. MANUEL PIAR	PRE ESCOLAR LOS CARATALES	812	2	8	651	487	643	0	6	1	0	149	651
EDO. DELTA AMAC	MP. CASACOIMA	PQ. MANUEL PIAR	UNIDAD EDUCATIVA CREACION SIMON BOLIVAR	273	1	7	215	150	208	0	4	0	0	54	215
EDO. DELTA AMAC	MP. CASACOIMA	PQ. MANUEL PIAR	ESCUELA BASICA NACIONAL EL TRIUNFO	2743	5	74	2112	1515	2038	1	12	2	0	508	2112
EDO. DELTA AMAC	MP. CASACOIMA	PQ. MANUEL PIAR	ESCUELA CRECACION EL TRIUNFO	1361	3	35	1117	870	1082	0	2	0	0	210	1117
EDO. DELTA AMAC	MP. CASACOIMA	PQ. MANUEL PIAR	UNIDAD EDUCATIVA BOLIVARIANA EL TRIUNFITO	2644	5	61	2137	1630	2076	0	10	0	1	435	2137
EDO. DELTA AMAC	MP. CASACOIMA	PQ. 5 DE JULIO	ESCUELA 5 DE JULIO	378	1	4	239	198	235	0	3	0	0	34	239
EDO. DELTA AMAC	MP. CASACOIMA	PQ. 5 DE JULIO	ESCUELA CONCENTRADA NUMERO 138	845	2	17	605	492	588	1	6	1	0	88	605
EDO. DELTA AMAC	MP. CASACOIMA	PQ. 5 DE JULIO	ESCUELA NACIONAL NUEVO MUNDO	228	1	1	142	119	141	0	1	0	1	20	142
EDO. DELTA AMAC	MP. CASACOIMA	PQ. 5 DE JULIO	ESCUELA MARIA TERESA CARREÑO	314	1	14	253	222	239	0	0	0	0	17	253
EDO. GUARICO	MP. ZARAZA	PQ. SAN JOSE DE UNARE	ESCUELA BOLIVARIANA DOCTOR BENITO GUTIERREZ LOPEZ	1652	3	40	1242	810	1202	0	6	0	0	386	1242
EDO. GUARICO	MP. ZARAZA	PQ. SAN JOSE DE UNARE	ESCUELA BASICA F 78 GUARIBITO	352	1	8	241	190	233	1	1	0	0	41	241
EDO. GUARICO	MP. ZARAZA	PQ. SAN JOSE DE UNARE	ESCUELA NACIONAL UNITARIA F 83 PALO SANO	262	1	4	191	137	187	0	3	1	0	46	191
EDO. GUARICO	MP. ZARAZA	PQ. ZARAZA	ESCUELA BASICA NACIONAL BONIFACIO GOMEZ	765	2	13	633	393	620	1	4	1	0	221	633
EDO. GUARICO	MP. ZARAZA	PQ. ZARAZA	ESCUELA BASICA NOHEMY HIGUERA DE GUZMAN	3136	6	46	2366	1384	2320	3	14	3	2	914	2366
EDO. GUARICO	MP. ZARAZA	PQ. ZARAZA	ALDEA UNIVERSITARIA BOLIVARIANA NUCLEO ZARAZA	431	1	8	322	258	314	0	6	0	0	50	322
EDO. GUARICO	MP. ZARAZA	PQ. ZARAZA	ESCUELA BASICA NACIONAL RÓMULO GALLEGOS	4993	9	67	3668	2317	3601	3	20	4	3	1254	3668
EDO. GUARICO	MP. ZARAZA	PQ. ZARAZA	ESCUELA BOLIVARIANA MAZAGUARO	380	1	7	243	199	236	0	2	1	0	34	243
EDO. GUARICO	MP. ZARAZA	PQ. ZARAZA	LICEO BOLIVARIANO PADRE FRANCISCO HURTADO	814	2	10	631	429	621	0	5	2	0	185	631
EDO. GUARICO	MP. ZARAZA	PQ. ZARAZA	ESCUELA PRIMARIA FC 17 LOS TAPARITOS	852	2	7	558	462	551	0	3	1	0	85	558
EDO. GUARICO	MP. ZARAZA	PQ. ZARAZA	UNIVERSIDAD NACIONAL EXPERIMENTAL SIMON RODRIGUEZ	259	1	5	212	170	207	0	1	0	0	36	212
EDO. GUARICO	MP. ZARAZA	PQ. ZARAZA	ESCUELA BOLIVARIANA AGUA NEGRA	907	2	9	606	486	597	1	5	2	0	103	606
EDO. GUARICO	MP. ZARAZA	PQ. ZARAZA	ESCUELA NACIONAL LA PEREÑA	74	1	0	59	53	59	0	1	0	0	5	59
EDO. GUARICO	MP. ZARAZA	PQ. ZARAZA	ESCUELA ESTADAL DELFINA FEMAYOR DE MOLINA	3472	6	37	2662	1930	2625	0	22	1	1	671	2662
EDO. GUARICO	MP. ZARAZA	PQ. ZARAZA	ESCUELA ESTADAL COLUMBA MENDOZA RODRIGUEZ	790	2	12	588	444	576	0	3	0	0	129	588
EDO. GUARICO	MP. ZARAZA	PQ. ZARAZA	ESCUELA NACIONAL UNITARIA F 80 EL DIVIDIVI
EDO. GUARICO	MP. ZARAZA	PQ. ZARAZA	ESCUELA ESTADAL LA PIEDRA	407	1	3	263	200	260	1	1	1	0	57	263
EDO. GUARICO	MP. ZARAZA	PQ. ZARAZA	ESCUELA CONCENTRADA FC 13 SANTA CRUZ DE UNARE	398	1	2	274	242	272	0	0	0	0	30	274
EDO. GUARICO	MP. ZARAZA	PQ. ZARAZA	ESCUELA BASICA ANTONIO JOSE SOTILLO	2178	4	37	1673	1000	1636	0	15	0	1	620	1673
EDO. GUARICO	MP. ZARAZA	PQ. ZARAZA	LICEO EDUARDO DELFIN MENDEZ II	285	1	2	244	119	242	0	3	1	0	119	244
EDO. GUARICO	MP. ZARAZA	PQ. ZARAZA	LICEO BOLIVARIANO GRAN MARISCAL DE AYACUCHO	128	1	1	83	72	82	0	0	0	0	10	83
EDO. GUARICO	MP. ZARAZA	PQ. ZARAZA	ESCUELA BOLIVARIANA ARTURO ALVAREZ ALAYÓN	1248	3	19	1032	663	1013	0	8	1	0	341	1032
EDO. GUARICO	MP. ZARAZA	PQ. ZARAZA	ESCUELA BOLIVARIANA TACALITO	1611	3	14	1178	941	1164	1	9	2	1	210	1178
EDO. GUARICO	MP. ZARAZA	PQ. ZARAZA	ESCUELA ESTADAL OLGA ROJAS DE CABEZA	2571	5	44	1985	1405	1941	1	11	2	1	521	1985
EDO. GUARICO	MP. ZARAZA	PQ. ZARAZA	CASA DE LA CULTURA ERNESTO LUIS RODRIGUEZ	465	1	4	378	185	374	0	4	0	0	185	378
EDO. GUARICO	MP. ZARAZA	PQ. ZARAZA	LICEO EDUARDO DELFIN MENDEZ	3819	7	47	3103	1472	3056	2	25	2	0	1555	3103
EDO. GUARICO	MP. ZARAZA	PQ. ZARAZA	ESCUELA BASICA NACIONAL FRANCISCO SALIAS	4369	8	50	3477	1714	3427	1	24	2	1	1685	3477
EDO. GUARICO	MP. ZARAZA	PQ. ZARAZA	ESCUELA BOLIVARIANA LA ESPERANZA	1250	3	8	867	812	859	1	2	0	0	44	867
EDO. GUARICO	MP. ZARAZA	PQ. ZARAZA	CENTRO DE EDUCACION INICIAL FC 59 LAS LAGUNITAS	145	1	0	113	111	113	0	0	0	0	2	113
EDO. GUARICO	MP. ZARAZA	PQ. ZARAZA	ESCUELA ESPECIALIDADES MERCEDES SOTILLO	128	1	0	115	85	115	0	0	0	0	30	115
EDO. GUARICO	MP. ZARAZA	PQ. ZARAZA	INSTITUTO DE EDUCACION BOLIVARIANA ESPECIAL ZARAZA	296	1	4	249	191	245	1	1	0	0	52	249
EDO. GUARICO	MP. CHAGUARAMAS	PQ. CHAGUARAMAS	SALA DE COMPUTACION CARLOS CORONADO	244	1	6	199	111	193	0	1	0	0	81	199
EDO. GUARICO	MP. CHAGUARAMAS	PQ. CHAGUARAMAS	BIBLIOTECA PUBLICA FLOR MARIA MANUITT	537	1	6	420	283	414	1	0	0	0	130	420
EDO. GUARICO	MP. CHAGUARAMAS	PQ. CHAGUARAMAS	ESCUELA BASICA DC 58 LAS CAMAZAS	165	1	3	90	54	87	0	0	1	0	32	90
EDO. GUARICO	MP. CHAGUARAMAS	PQ. CHAGUARAMAS	ESCUELA BASICA SAN LORENZO MARTIR	1213	3	39	953	603	914	0	7	2	0	302	953
EDO. GUARICO	MP. CHAGUARAMAS	PQ. CHAGUARAMAS	ESCUELA GC 37 MAMONAL	432	1	3	329	242	326	0	0	0	0	84	329
EDO. GUARICO	MP. CHAGUARAMAS	PQ. CHAGUARAMAS	ESCUELA BASICA BOLIVARIANA CHAGUARAMAS	3067	6	66	2362	1261	2296	0	16	1	1	1017	2362
EDO. GUARICO	MP. CHAGUARAMAS	PQ. CHAGUARAMAS	ESCUELA DC 22 EL ARBOLITO	341	1	10	247	138	237	0	1	0	0	98	247
EDO. GUARICO	MP. CHAGUARAMAS	PQ. CHAGUARAMAS	ESCUELA BASICA DC 57 SANTA EDELMIRA	428	1	10	322	266	312	0	2	0	1	43	322
EDO. GUARICO	MP. CHAGUARAMAS	PQ. CHAGUARAMAS	ESCUELA BASICA DC 6 SAN NICOLAS	260	1	8	241	197	233	0	1	0	0	35	241
EDO. GUARICO	MP. CHAGUARAMAS	PQ. CHAGUARAMAS	UNIDAD EDUCATIVA PRUDENCIO ESAA	288	1	17	237	155	220	1	0	0	0	64	237
EDO. GUARICO	MP. CHAGUARAMAS	PQ. CHAGUARAMAS	CONCENTRACIÓN ESCOLAR DC 5 LAS PIEDRAS	416	1	4	297	200	293	0	1	0	0	92	297
EDO. GUARICO	MP. CHAGUARAMAS	PQ. CHAGUARAMAS	CONCENTRACIÓN ESCOLAR DC 25 ROBLECITO	512	1	4	358	277	354	0	0	0	0	77	358
EDO. GUARICO	MP. CHAGUARAMAS	PQ. CHAGUARAMAS	JARDIN DE INFANCIA LAS MALVINAS	244	1	3	184	128	181	0	1	0	0	52	184
EDO. GUARICO	MP. CHAGUARAMAS	PQ. CHAGUARAMAS	ESCUELA ESTADAL DC 54 CASIANERO	438	1	1	341	244	340	0	0	0	0	96	341
EDO. GUARICO	MP. CHAGUARAMAS	PQ. CHAGUARAMAS	ESCUELA DC 19 PAJA BRAVA	1152	2	40	923	587	883	0	4	1	0	291	923
EDO. GUARICO	CE. ROSCIO	PQ. CANTAGALLO	UNIDAD EDUCATIVA BOLIVARIANA ROGELIA MAYO TORREALBA	1405	3	10	1182	799	1172	0	6	0	0	367	1182
EDO. GUARICO	CE. ROSCIO	PQ. CANTAGALLO	ESCUELA BOLIVARIANA AC 9 PASO PELAO	276	1	2	262	212	260	0	1	0	0	47	262
EDO. GUARICO	CE. ROSCIO	PQ. PARAPARA	GRUPO ESCOLAR BOLIVARIANO LUCIA ALVAREZ RIVERO	1424	3	10	1119	757	1109	0	2	1	0	349	1119
EDO. GUARICO	CE. ROSCIO	PQ. PARAPARA	PREESCOLAR BOLIVARIANO PARAPARA	197	1	0	167	133	167	0	1	0	0	33	167
EDO. GUARICO	CE. ROSCIO	PQ. PARAPARA	LICEO BOLIVARIANO JOAQUIN CRESPO	355	1	5	303	238	298	1	1	0	0	58	303
EDO. GUARICO	CE. ROSCIO	PQ. PARAPARA	ESCUELA ESTADAL CONCENTRADA AC 15	606	2	6	486	377	480	0	2	1	0	100	486
EDO. GUARICO	CE. ROSCIO	PQ.SAN JUAN DE LOS MORROS	CENTRO DE EDUCACION INICIAL LOS LLANERITOS	79	1	0	76	42	76	0	0	0	0	34	76
EDO. GUARICO	CE. ROSCIO	PQ.SAN JUAN DE LOS MORROS	CENTRO PREESCOLAR EDUCATIVO AÑO INTERNACIONAL DEL NIÑO NUCLEO OLGA DE BRUGUERA	615	2	7	543	406	536	0	4	0	0	126	543
EDO. GUARICO	CE. ROSCIO	PQ.SAN JUAN DE LOS MORROS	UNIDAD EDUCATIVA NACIONAL RAFAEL CABRERA MALO	2652	5	20	2234	974	2214	0	7	0	1	1232	2234
EDO. GUARICO	CE. ROSCIO	PQ.SAN JUAN DE LOS MORROS	ESCUELA BASICA RURAL  MONSEÑOR ENRIQUE RODRIGUEZ ALVAREZ	1718	3	29	1454	914	1425	0	7	2	2	500	1454
EDO. GUARICO	CE. ROSCIO	PQ.SAN JUAN DE LOS MORROS	ESCUELA RURAL BOLIVARIANA AC 48 LAS MINAS	413	1	14	379	322	365	0	3	1	0	39	379
EDO. GUARICO	CE. ROSCIO	PQ.SAN JUAN DE LOS MORROS	ESCUELA BASICA JOSE TOMAS LEAL	1456	3	30	1271	843	1241	1	6	0	2	389	1271
EDO. GUARICO	CE. ROSCIO	PQ.SAN JUAN DE LOS MORROS	TALLER EDUCACION LABORAL GUARICO	808	2	7	693	391	686	2	6	0	1	286	693
EDO. GUARICO	CE. ROSCIO	PQ.SAN JUAN DE LOS MORROS	LICEO BOLIVARIANO VICENTE EMILIO SOJO	3859	7	54	3290	1672	3236	0	13	0	0	1551	3290
EDO. GUARICO	CE. ROSCIO	PQ.SAN JUAN DE LOS MORROS	ESCUELA BASICA GENERAL RAFAEL URDANETA	560	1	10	459	382	449	0	1	0	0	66	459
EDO. GUARICO	CE. ROSCIO	PQ.SAN JUAN DE LOS MORROS	CENTRO DEL NIÑO Y LA FAMILIA LAS VEGAS	358	1	3	313	226	310	0	2	0	0	82	313
EDO. GUARICO	CE. ROSCIO	PQ.SAN JUAN DE LOS MORROS	ESCUELA BASICA LERMITH HERNANDEZ	2927	5	73	2333	1348	2260	1	14	1	0	896	2333
EDO. GUARICO	CE. ROSCIO	PQ.SAN JUAN DE LOS MORROS	ESCUELA BASICA ZULME AZUEJE SANTAELLA	1157	2	28	988	552	960	1	7	0	0	400	988
EDO. GUARICO	CE. ROSCIO	PQ.SAN JUAN DE LOS MORROS	ESCUELA AC 24 CAMBURITO	339	1	2	258	192	256	1	1	0	0	62	258
EDO. GUARICO	CE. ROSCIO	PQ.SAN JUAN DE LOS MORROS	CENTRO DE EDUCACIÓN INICIAL BOLIVARIANO LUISA CACERES DE ARISMENDI	459	1	12	398	254	386	0	3	0	0	129	398
EDO. GUARICO	CE. ROSCIO	PQ.SAN JUAN DE LOS MORROS	ESCUELA BASICA BOLIVARIANA EDUARDO MENDEZ	3300	6	48	2789	1732	2741	0	16	1	2	990	2789
EDO. GUARICO	CE. ROSCIO	PQ.SAN JUAN DE LOS MORROS	UNIDAD EDUCATIVA NACIONAL BOLIVARIANA LICENCIADO FERDERICO BRITO FIGUEROA	481	1	4	427	311	423	0	2	0	0	110	427
EDO. GUARICO	CE. ROSCIO	PQ.SAN JUAN DE LOS MORROS	ESCUELA BASICA JOSE ANTONIO PAEZ	1478	3	29	1214	875	1185	0	10	1	0	299	1214
EDO. GUARICO	CE. ROSCIO	PQ.SAN JUAN DE LOS MORROS	PENITENCIARIA GENERAL DE VENEZUELA	247	1	3	118	86	115	0	1	0	0	28	118
EDO. GUARICO	CE. ROSCIO	PQ.SAN JUAN DE LOS MORROS	CENTRO DE EDUCACION INICIAL JOSE DE LOS SANTOS PEREIRA	246	1	6	212	117	206	0	2	0	0	87	212
EDO. GUARICO	CE. ROSCIO	PQ.SAN JUAN DE LOS MORROS	ESCUELA BASICA AMALIA DE LARA	3379	6	66	2829	1864	2763	1	10	1	2	885	2829
EDO. GUARICO	CE. ROSCIO	PQ.SAN JUAN DE LOS MORROS	UNIDAD EDUCATIVA NACIONAL BOLIVARIANA FEDERACION VENEZOLANA DE MAESTROS	4135	8	45	3442	1968	3397	1	27	3	5	1393	3442
EDO. GUARICO	CE. ROSCIO	PQ.SAN JUAN DE LOS MORROS	NUCLEO INTEGRAL DE BIENESTAR ESTUDIANTIL	1161	2	12	954	386	942	0	5	1	2	548	954
EDO. GUARICO	CE. ROSCIO	PQ.SAN JUAN DE LOS MORROS	ESCUELA BASICA NACIONAL REPUBLICA DEL BRASIL	4115	8	58	3407	1683	3349	0	20	1	1	1644	3407
EDO. GUARICO	CE. ROSCIO	PQ.SAN JUAN DE LOS MORROS	CENTRO EDUCATIVO BOLIVARIANO INICIAL LOS LAURELES	1200	3	14	1020	610	1006	0	5	1	0	390	1020
EDO. GUARICO	CE. ROSCIO	PQ.SAN JUAN DE LOS MORROS	ESCUELA BASICA BOLIVARIANA GENERAL JOAQUIN CRESPO	337	1	4	303	188	299	0	0	0	0	111	303
EDO. GUARICO	CE. ROSCIO	PQ.SAN JUAN DE LOS MORROS	PRE ESCOLAR BOLIVARIANO EZEQUIEL ZAMORA	830	2	19	736	478	717	0	7	1	0	231	736
EDO. GUARICO	CE. ROSCIO	PQ.SAN JUAN DE LOS MORROS	ESCUELA BASICA NACIONAL DOCTOR VICENTE PEÑA	1892	4	13	1568	610	1555	0	13	0	1	931	1568
EDO. GUARICO	CE. ROSCIO	PQ.SAN JUAN DE LOS MORROS	ESCUELA BASICA ANDRES BELLO	2479	5	39	2039	1228	2000	1	12	1	1	757	2039
EDO. GUARICO	CE. ROSCIO	PQ.SAN JUAN DE LOS MORROS	ESCUELA BASICA RURAL BOLIVARIANA AC 10 LUCIANERO	228	1	6	213	154	207	0	2	0	0	51	213
EDO. GUARICO	CE. ROSCIO	PQ.SAN JUAN DE LOS MORROS	LICEO JUAN GERMAN ROSCIO	3654	7	38	3043	1195	3005	0	26	1	1	1782	3043
EDO. GUARICO	CE. ROSCIO	PQ.SAN JUAN DE LOS MORROS	ESCUELA BASICA ANTONIO JOSE DE SUCRE	1896	4	48	1638	1057	1590	1	9	0	0	523	1638
EDO. GUARICO	CE. ROSCIO	PQ.SAN JUAN DE LOS MORROS	ESCUELA BASICA JOSEFA MOLINA DE DUQUE	1944	4	32	1624	902	1592	0	6	2	0	682	1624
EDO. GUARICO	CE. ROSCIO	PQ.SAN JUAN DE LOS MORROS	ESCUELA BASICA BOLIVARIANA FRANCISCO DE MIRANDA	1377	3	21	1158	787	1137	0	9	0	1	340	1158
EDO. GUARICO	CE. ROSCIO	PQ.SAN JUAN DE LOS MORROS	UNIDAD EDUCATIVA NACIONAL JOSE FELIX RIBAS	2100	4	22	1805	766	1783	0	16	0	2	999	1805
EDO. GUARICO	CE. ROSCIO	PQ.SAN JUAN DE LOS MORROS	UNIDAD EDUCATIVA NACIONAL PUENTE GUARICO	51	1	2	43	31	41	0	1	0	0	9	43
EDO. GUARICO	CE. ROSCIO	PQ.SAN JUAN DE LOS MORROS	GRUPO ESCOLAR JOSE FELIX RIBAS	2994	6	55	2586	1125	2531	0	12	0	1	1393	2586
EDO. GUARICO	CE. ROSCIO	PQ.SAN JUAN DE LOS MORROS	CENTRO PREESCOLAR AÑO INTERNACIONAL DEL NIÑO	924	2	9	755	405	746	0	8	1	0	332	755
EDO. GUARICO	CE. ROSCIO	PQ.SAN JUAN DE LOS MORROS	JARDINES INTEGRADOS AL NER 015	280	1	1	222	158	221	0	2	0	1	60	222
EDO. GUARICO	CE. ROSCIO	PQ.SAN JUAN DE LOS MORROS	ESCUELA BOLIVARIANA FELIPE ANTONIO ACOSTA CARLES	575	1	13	497	381	484	0	1	1	0	101	497
EDO. GUARICO	CE. ROSCIO	PQ.SAN JUAN DE LOS MORROS	RESIDENCIA DE ANCIANOS FRANCISCO LAZO MARTI	1955	4	28	1633	1221	1605	0	10	0	1	373	1633
EDO. GUARICO	CE. ROSCIO	PQ.SAN JUAN DE LOS MORROS	ESCUELA BASICA JUAN ANTONIO PADILLA	2236	4	25	2007	582	1982	1	4	0	2	1393	2007
EDO. GUARICO	CE. ROSCIO	PQ.SAN JUAN DE LOS MORROS	INTERNADO JUDICIAL LOS PINOS	518	1	1	189	167	188	1	1	0	0	19	189
EDO. GUARICO	CE. ROSCIO	PQ.SAN JUAN DE LOS MORROS	GRUPO ESCOLAR JOSE DE LOS SANTOS PEREIRA	3323	6	54	2830	1525	2776	1	10	0	0	1240	2830
EDO. GUARICO	CE. ROSCIO	PQ.SAN JUAN DE LOS MORROS	ESCUELA BASICA RURAL BOLIVARIA AC 19 LOS BAGRES	229	1	3	225	184	222	0	2	1	0	35	225
EDO. GUARICO	CE. ROSCIO	PQ.SAN JUAN DE LOS MORROS	CICLO BASICO LUIS BARRIOS CRUZ	4015	7	64	3513	1830	3449	2	15	1	2	1599	3513
EDO. GUARICO	CE. ROSCIO	PQ.SAN JUAN DE LOS MORROS	GRUPO ESCOLAR LIC. FRANCISCO ARANDA	3433	6	73	2919	1389	2846	1	15	0	1	1440	2919
EDO. GUARICO	CE. ROSCIO	PQ.SAN JUAN DE LOS MORROS	ESCUELA BASICA RURAL BOLIVARIANA AC 41 EL CASTRERO	747	2	9	629	397	620	0	2	0	0	221	629
EDO. GUARICO	CE. ROSCIO	PQ.SAN JUAN DE LOS MORROS	CENTRO DE EDUCACION INICIAL PREESCOLAR REPUBLICA DEL BRASIL	1095	2	16	972	532	956	1	5	0	0	418	972
EDO. GUARICO	CE. ROSCIO	PQ.SAN JUAN DE LOS MORROS	ESCUELA ESTADAL PEDRO ZARAZA	2032	4	29	1663	1227	1634	0	6	1	1	399	1663
EDO. GUARICO	CE. ROSCIO	PQ.SAN JUAN DE LOS MORROS	ESCUELA CENTRO DE EDUCACION INICIAL BOLIVARIANO VALLECITO GUAFAL	1202	3	13	1099	679	1086	0	6	1	0	400	1099
EDO. GUARICO	MP. MELLADO	PQ. EL SOMBRERO	ESCUELA DE EDUCACION INICIAL NACIONAL BOLIVARIANA MONSEÑOR ARTURO CELESTINO ALVAREZ	323	1	8	274	192	266	0	2	0	0	72	274
EDO. GUARICO	MP. MELLADO	PQ. EL SOMBRERO	ESCUELA BOLIVARIANA BC 11 LA GUÁSIMA	335	1	5	292	235	287	0	1	0	0	51	292
EDO. GUARICO	MP. MELLADO	PQ. EL SOMBRERO	CENTRO MOVIL	265	1	7	214	174	207	0	1	1	0	31	214
EDO. GUARICO	MP. MELLADO	PQ. EL SOMBRERO	UNIDAD EDUCATIVA NACIONAL JULIAN MELLADO	2772	5	53	2233	1451	2180	1	12	2	0	714	2233
EDO. GUARICO	MP. MELLADO	PQ. EL SOMBRERO	GRUPO ESCOLAR JUAN JOSE TOVAR	3396	6	52	2571	1430	2519	0	17	0	1	1071	2571
EDO. GUARICO	MP. MELLADO	PQ. EL SOMBRERO	ESCUELA ESTADAL CONCENTRADA BC 3 LAGUNA SECA	322	1	9	246	191	237	0	1	0	0	45	246
EDO. GUARICO	MP. MELLADO	PQ. EL SOMBRERO	LICEO ALBERTO ISAAC PADRA	1437	3	15	1242	860	1227	0	9	2	1	355	1242
EDO. GUARICO	MP. MELLADO	PQ. EL SOMBRERO	ESCUELA DE EDUCACIÓN INICIAL ALICIA SANCHEZ ESAAC	461	1	10	400	330	390	0	2	0	0	58	400
EDO. GUARICO	MP. MELLADO	PQ. EL SOMBRERO	INSTITUTO DE EDUCACION ESPECIAL SAN JUDAS TADEO	601	2	12	489	319	477	1	3	0	0	154	489
EDO. GUARICO	MP. MELLADO	PQ. EL SOMBRERO	ESCUELA BOLIVARIANA LA CACHAMA	207	1	3	189	147	186	0	0	0	0	39	189
EDO. GUARICO	MP. MELLADO	PQ. EL SOMBRERO	ESCUELA ESTADAL CONCENTRADA BC 7 LA FUNDACIÓN	195	1	2	145	134	143	0	0	0	1	8	145
EDO. GUARICO	MP. MELLADO	PQ. EL SOMBRERO	ESCUELA BOLIVARIANA PUEBLO NUEVO	882	2	12	731	568	719	0	6	0	0	145	731
EDO. GUARICO	MP. MELLADO	PQ. EL SOMBRERO	ESCUELA BOLIVARIANA NER 053 LAS LAJITAS	324	1	2	279	244	277	0	0	0	0	33	279
EDO. GUARICO	MP. MELLADO	PQ. EL SOMBRERO	CENTRO DE EDUCACIÓN INICIAL EL TURPIAL	625	2	6	554	359	548	1	2	1	0	185	554
EDO. GUARICO	MP. MELLADO	PQ. EL SOMBRERO	ESCUELA PRE VOCACIONAL DOCTOR JOSE CECILIO MONTILLA	2798	5	33	2220	1346	2187	0	6	2	1	832	2220
EDO. GUARICO	MP. MELLADO	PQ. EL SOMBRERO	ESCUELA BASICA CAMPO ALEGRE	2107	4	38	1719	1329	1681	0	10	1	1	340	1719
EDO. GUARICO	MP. MELLADO	PQ. SOSA	ESCUELA TECNICA AGROPECUARIA SOSA	961	2	9	779	442	770	0	3	0	0	325	779
EDO. GUARICO	MP. MELLADO	PQ. SOSA	ESCUELA BOLIVARIANA BC 9 LA JUANERA	196	1	4	183	156	179	0	0	0	0	23	183
EDO. GUARICO	MP.SAN GERONIMO DE G	PQ. CAZORLA	ESCUELA BASICA CONCENTRADA SAN JOSE	344	1	4	282	185	278	0	1	0	0	92	282
EDO. GUARICO	MP.SAN GERONIMO DE G	PQ. CAZORLA	ESCUELA CONCENTRADA   20 PASO DE HATO	989	2	9	673	448	664	0	2	0	0	214	673
EDO. GUARICO	MP.SAN GERONIMO DE G	PQ. CAZORLA	ESCUELA BASICA LA CHIPOLA	111	1	0	82	56	82	0	0	0	0	26	82
EDO. GUARICO	MP.SAN GERONIMO DE G	PQ. CAZORLA	UNIDAD EDUCATIVA LEONARDO INFANTE	1959	4	13	1296	776	1283	0	7	1	0	499	1296
EDO. GUARICO	MP.SAN GERONIMO DE G	PQ. CAZORLA	ESCUELA ESTADAL CC 46 MANGAS COBERAS	412	1	0	228	162	228	0	0	0	0	66	228
EDO. GUARICO	MP.SAN GERONIMO DE G	PQ. CAZORLA	ESCUELA ESTADAL CC 19 EL PERICO	466	1	9	341	248	332	0	0	0	0	84	341
EDO. GUARICO	MP.SAN GERONIMO DE G	PQ. GUAYABAL	ESCUELA ESTADAL C 56 MEDIA LUNA	275	1	4	187	121	183	0	1	0	0	61	187
EDO. GUARICO	MP.SAN GERONIMO DE G	PQ. GUAYABAL	ESCUELA BASICA ANDRES BELLO	290	1	4	257	199	253	0	2	1	0	51	257
EDO. GUARICO	MP.SAN GERONIMO DE G	PQ. GUAYABAL	ESCUELA ESTADAL C 07 SAMANCITO	224	1	7	158	123	151	0	1	0	0	27	158
EDO. GUARICO	MP.SAN GERONIMO DE G	PQ. GUAYABAL	GRUPO ESCOLAR CARLOS DEL POZO	5485	10	77	4178	2809	4101	0	28	5	0	1259	4178
EDO. GUARICO	MP.SAN GERONIMO DE G	PQ. GUAYABAL	ESCUELA ESTADAL CC 11 ORORAL	895	2	17	660	414	643	0	4	0	0	225	660
EDO. GUARICO	MP.SAN GERONIMO DE G	PQ. GUAYABAL	ESCUELA ESTADAL C 9 AGUA VERDE	832	2	3	589	444	586	0	3	0	0	139	589
EDO. GUARICO	MP.SAN GERONIMO DE G	PQ. GUAYABAL	UNIDAD EDUCATIVA DOCTOR JULIO DE ARMAS	1027	2	17	858	605	841	0	2	0	0	234	858
EDO. GUARICO	MP.SAN GERONIMO DE G	PQ. GUAYABAL	UNIDAD EDUCATIVA CC 49 CAMORUCO ESPAÑOLERO	200	1	1	155	99	154	0	0	0	0	55	155
EDO. GUARICO	MP. INFANTE	PQ. VALLE DE LA PASCUA	ESCUELA BASICA DC  21 EL BOSTERO
EDO. GUARICO	MP. INFANTE	PQ. VALLE DE LA PASCUA	UNIDAD EDUCATIVA GENERAL JOSE ANTONIO PAEZ	388	1	3	297	197	294	0	1	0	1	95	297
EDO. GUARICO	MP. INFANTE	PQ. VALLE DE LA PASCUA	INCES	435	1	5	378	229	373	0	1	0	1	142	378
EDO. GUARICO	MP. INFANTE	PQ. VALLE DE LA PASCUA	INSTITUTO UNIVERSITARIO TECNOLOGICO DE LOS LLANOS	3291	6	47	2847	1377	2800	0	9	0	1	1413	2847
EDO. GUARICO	MP. INFANTE	PQ. VALLE DE LA PASCUA	LICEO JOSE GREGORIO GONZALEZ	334	1	8	296	183	288	0	1	0	0	104	296
EDO. GUARICO	MP. INFANTE	PQ. VALLE DE LA PASCUA	PRESCOLAR ARAGUANEY	1323	3	9	1103	516	1094	0	3	1	0	574	1103
EDO. GUARICO	MP. INFANTE	PQ. VALLE DE LA PASCUA	FUNDACION NACIONAL EL NIÑO SIMON	580	1	1	506	276	505	0	2	0	0	227	506
EDO. GUARICO	MP. INFANTE	PQ. VALLE DE LA PASCUA	ESCUELA BASICA CLARA MATOS ARZOLA	3789	7	53	3141	1859	3088	1	25	3	5	1195	3141
EDO. GUARICO	MP. INFANTE	PQ. VALLE DE LA PASCUA	ESCUELA NACIONAL 3712, JACOME ABAJO.	731	2	8	601	380	593	0	5	0	1	207	601
EDO. GUARICO	MP. INFANTE	PQ. VALLE DE LA PASCUA	ESCUELA BASICA FRANCISCO LAZO MARTÍ	5239	10	64	4373	1946	4309	1	26	2	3	2331	4373
EDO. GUARICO	MP. INFANTE	PQ. VALLE DE LA PASCUA	ESCUELA BASICA JOSE MANUEL FUENTES ACEVEDO	3973	7	64	3248	2172	3184	0	28	2	0	982	3248
EDO. GUARICO	MP. INFANTE	PQ. VALLE DE LA PASCUA	CASA DE LA CULTURA LORENZO RUBIN ZAMORA	383	1	6	317	202	311	0	2	0	0	107	317
EDO. GUARICO	MP. INFANTE	PQ. VALLE DE LA PASCUA	UNIVERSIDAD ROMULO GALLEGOS	316	1	5	271	116	266	0	0	0	0	150	271
EDO. GUARICO	MP. INFANTE	PQ. VALLE DE LA PASCUA	ESCUELA BASICA BOLIVARIANA CARLOS JOSE BELLO	3180	6	50	2665	1243	2615	0	19	1	0	1352	2665
EDO. GUARICO	MP. INFANTE	PQ. VALLE DE LA PASCUA	ESCUELA BASICA DC 20 EL PÁRAMO	770	2	15	637	469	622	0	4	0	0	149	637
EDO. GUARICO	MP. INFANTE	PQ. VALLE DE LA PASCUA	ASOCIACION MONSEÑOR SALAS	1500	3	8	1292	871	1284	0	2	0	1	410	1292
EDO. GUARICO	MP. INFANTE	PQ. VALLE DE LA PASCUA	UNIDAD EDUCATIVA CELESTINO PERAZA	449	1	9	372	250	363	0	1	0	0	112	372
EDO. GUARICO	MP. INFANTE	PQ. VALLE DE LA PASCUA	ESCUELA BOLIVARIANA CE 41 MERCEDES DE MELO MAMONAL	1035	2	18	845	642	827	1	4	1	0	179	845
EDO. GUARICO	MP. INFANTE	PQ. VALLE DE LA PASCUA	UNIDAD EDUCATIVA PREBISPERO JUAN SANTIAGO GUASCO	3911	7	59	3182	2156	3123	0	20	0	3	944	3182
EDO. GUARICO	MP. INFANTE	PQ. VALLE DE LA PASCUA	ESCUELA ESTADAL CONCENTRADA DC 42 LOMA DE PIEDRA	299	1	3	242	203	239	0	0	1	0	35	242
EDO. GUARICO	MP. INFANTE	PQ. VALLE DE LA PASCUA	COMPLEJO CULTURAL OTO RODRIGUEZ	243	1	2	219	150	217	0	1	0	0	66	219
EDO. GUARICO	MP. INFANTE	PQ. VALLE DE LA PASCUA	UNIVERSIDAD NACIONAL EXPERIMENTAL SIMON RODRIGUEZ	448	1	13	389	226	376	0	0	0	0	150	389
EDO. GUARICO	MP. INFANTE	PQ. VALLE DE LA PASCUA	UNIDAD EDUCATIVA BOLIVARIANA JUAN GERMAN ROSCIO	1356	3	17	1109	415	1092	0	6	0	0	671	1109
EDO. GUARICO	MP. INFANTE	PQ. VALLE DE LA PASCUA	UNIDAD EDUCATIVA JUAN JOSE RONDON	3947	7	58	3265	2016	3207	1	12	2	2	1174	3265
EDO. GUARICO	MP. INFANTE	PQ. VALLE DE LA PASCUA	GRUPO ESCOLAR JUANA JOSEFA VARGAS	4351	8	50	3615	1675	3565	1	22	2	1	1864	3615
EDO. GUARICO	MP. INFANTE	PQ. VALLE DE LA PASCUA	ESCUELA BASICA DC 08 LOS ALGODONES	850	2	15	651	475	636	1	2	0	0	158	651
EDO. GUARICO	MP. INFANTE	PQ. VALLE DE LA PASCUA	ESCUELA BASICA DC 9 LA PEREÑA	313	1	1	268	183	267	0	1	1	0	82	268
EDO. GUARICO	MP. INFANTE	PQ. VALLE DE LA PASCUA	UNIDAD EDUCATIVA BOLIVARIANA LIBERTADOR EC 040	688	2	11	548	245	537	2	1	0	0	289	548
EDO. GUARICO	MP. INFANTE	PQ. VALLE DE LA PASCUA	CENTRO PRE ESCOLAR ABIERTO ANDRES BELLO	1575	3	25	1347	876	1322	0	4	0	4	438	1347
EDO. GUARICO	MP. INFANTE	PQ. VALLE DE LA PASCUA	UNIDAD EDUCATIVA LICEO BOLIVARIANO MONSEÑOR RAFAEL CHACIN	3836	7	50	3215	2177	3165	2	31	4	1	950	3215
EDO. GUARICO	MP. INFANTE	PQ. VALLE DE LA PASCUA	UNIVERSIDAD ROMULO GALLEGOS EDIFICIO NUMERO 2	467	1	6	404	219	398	0	1	0	1	177	404
EDO. GUARICO	MP. INFANTE	PQ. VALLE DE LA PASCUA	ESCUELA DE ESPECIALIDADES SAN JOSE	1006	2	15	844	312	829	0	4	0	1	512	844
EDO. GUARICO	MP. INFANTE	PQ. VALLE DE LA PASCUA	ESCUELA BOLIVARIANA 12 DE OCTUBRE	1101	2	10	971	584	961	0	6	1	0	370	971
EDO. GUARICO	MP. INFANTE	PQ. VALLE DE LA PASCUA	ESCUELA ESTADAL UNITARIA DC 58 LAS GARZAS	270	1	5	170	112	165	0	1	0	0	52	170
EDO. GUARICO	MP. INFANTE	PQ. VALLE DE LA PASCUA	ESCUELA BASICA MARIANO MONTILLA	3850	7	39	3155	1818	3116	2	16	0	1	1279	3155
EDO. GUARICO	MP. INFANTE	PQ. VALLE DE LA PASCUA	GRUPO ESCOLAR RAFAEL GONZALEZ UDIS	5322	10	64	4304	2382	4240	1	23	5	1	1828	4304
EDO. GUARICO	MP. INFANTE	PQ. VALLE DE LA PASCUA	AMBULATORIO ALFALLANOS	1490	3	24	1205	768	1181	0	1	0	0	412	1205
EDO. GUARICO	MP. INFANTE	PQ. VALLE DE LA PASCUA	CENTRO DE VOTACION MOVIL	228	1	4	200	80	196	0	3	0	0	113	200
EDO. GUARICO	MP. INFANTE	PQ. VALLE DE LA PASCUA	UNIDAD EDUCATIVA LOURDES CAMERO RAMIREZ	3576	7	35	2920	2047	2885	2	16	1	2	817	2920
EDO. GUARICO	MP. INFANTE	PQ. VALLE DE LA PASCUA	ESCUELA BASICA BANDERA BLANCA	146	1	2	131	110	129	0	0	0	0	19	131
EDO. GUARICO	MP. INFANTE	PQ. VALLE DE LA PASCUA	UNIDAD EDUCATIVA APAMATE	232	1	4	211	182	207	0	0	0	0	25	211
EDO. GUARICO	MP. INFANTE	PQ. VALLE DE LA PASCUA	LICEO BOLIVARIANO JOSE GIL FORTOUL	3182	6	50	2707	1138	2657	0	15	1	2	1501	2707
EDO. GUARICO	MP. INFANTE	PQ. VALLE DE LA PASCUA	UNIDAD EDUCATIVA ANDRES BELLO	826	2	15	730	407	715	1	5	0	0	302	730
EDO. GUARICO	MP. INFANTE	PQ. VALLE DE LA PASCUA	ESCUELA BASICA ESTADAL UNITARIA D 52 COROZALITO	207	1	4	133	112	129	0	2	0	0	15	133
EDO. GUARICO	MP. INFANTE	PQ. VALLE DE LA PASCUA	UNIDAD EDUCATIVA JESUS LOPEZ ESCOBAR	533	1	9	393	269	384	1	2	2	0	110	393
EDO. GUARICO	MP. INFANTE	PQ. VALLE DE LA PASCUA	UNIVERSIDAD NACIONAL ABIERTA	441	1	2	379	259	377	0	3	0	0	115	379
EDO. GUARICO	MP. INFANTE	PQ. VALLE DE LA PASCUA	COLEGIO NUESTRA SEÑORA DEL VALLE	2605	5	20	2243	701	2223	0	12	0	3	1507	2243
EDO. GUARICO	MP. INFANTE	PQ. ESPINO	ESCUELA ESTADAL CONCENTRADA NUMERO DC 36 PARMANA	494	1	4	336	256	332	0	4	3	0	69	336
EDO. GUARICO	MP. INFANTE	PQ. ESPINO	ESCUELA BASICA ENRIQUE BENITO NUÑEZ	2659	5	30	2058	1633	2028	0	8	1	0	386	2058
EDO. GUARICO	MP. INFANTE	PQ. ESPINO	ESCUELA ESTADAL NUMERO DC 62  RABANAL	237	1	3	186	142	183	0	2	0	0	39	186
EDO. GUARICO	MP. INFANTE	PQ. ESPINO	ESCUELA NACIONAL UNITARIA NUMERO D 84 LA IGUANA	174	1	1	120	107	119	1	1	0	0	10	120
EDO. GUARICO	MP. INFANTE	PQ. ESPINO	ESCUELA BASICA NUMERO D 70 PABLO MARIA MATOS	170	1	0	115	81	115	0	0	0	0	34	115
EDO. GUARICO	MP. EL SOCORRO	PQ. EL SOCORRO	ESCUELA NACIONAL CONCENTRADA NÚMERO  2924 3500  LA PUENTE	436	1	6	350	243	344	0	0	0	0	101	350
EDO. GUARICO	MP. EL SOCORRO	PQ. EL SOCORRO	UNIDAD EDUCATIVA NACIONAL JOSE MELECIO CAMACHO	1156	2	26	923	623	897	0	6	1	0	267	923
EDO. GUARICO	MP. EL SOCORRO	PQ. EL SOCORRO	ESCUELA DE ESPECIALIDADES CORAZON DE JESUS	796	2	5	689	475	684	0	1	0	0	208	689
EDO. GUARICO	MP. EL SOCORRO	PQ. EL SOCORRO	ESCUELA BASICA BOLIVARIANA FC 50 CORRAL VIEJO	828	2	15	630	373	615	0	3	1	0	238	630
EDO. GUARICO	MP. EL SOCORRO	PQ. EL SOCORRO	NUCLEO ESCOLAR RURAL 497 BOQUERON	90	1	3	81	66	78	0	0	0	0	12	81
EDO. GUARICO	MP. EL SOCORRO	PQ. EL SOCORRO	ESCUELA BASICA BOLIVARIANA JOBO GACHO	462	1	10	395	306	385	0	2	0	0	77	395
EDO. GUARICO	MP. EL SOCORRO	PQ. EL SOCORRO	ESCUELA BASICA ESTADAL FC 37 MAHOMAL	121	1	1	114	94	113	0	0	0	0	19	114
EDO. GUARICO	MP. EL SOCORRO	PQ. EL SOCORRO	ESCUELA ESTADAL FC 43 LOMAS PERDOMERAS	405	1	6	288	199	282	1	1	0	0	81	288
EDO. GUARICO	MP. EL SOCORRO	PQ. EL SOCORRO	ESCUELA BASICA NACIONAL CREACION SALSIPUEDES	385	1	6	331	275	325	0	1	0	0	49	331
EDO. GUARICO	MP. EL SOCORRO	PQ. EL SOCORRO	ESCUELA COROCITO PEÑERO	489	1	8	377	315	369	0	3	1	0	50	377
EDO. GUARICO	MP. EL SOCORRO	PQ. EL SOCORRO	ESCUELA TECNICA AGROPECUARIA HENRY PITIER	1057	2	22	912	645	890	0	2	0	1	242	912
EDO. GUARICO	MP. EL SOCORRO	PQ. EL SOCORRO	ESCUELA BASICA CARLOS IRAZABAL PEREZ	4832	9	73	3616	2234	3543	0	17	2	2	1288	3616
EDO. GUARICO	MP. EL SOCORRO	PQ. EL SOCORRO	ESCUELA BASICA MARGOT RISSO DE MALAVE	1101	2	25	894	661	869	0	6	1	1	200	894
EDO. GUARICO	MP. EL SOCORRO	PQ. EL SOCORRO	ESCUELA BASICA NACIONAL NUMERO 0080 DIVIDIVE	184	1	1	172	144	171	0	0	0	0	27	172
EDO. GUARICO	MP. EL SOCORRO	PQ. EL SOCORRO	ESCUELA BASICA ESTATAL UNITARIA FC 86 MANIRAL	387	1	3	268	179	265	0	3	0	0	83	268
EDO. GUARICO	MP. MIRANDA	PQ. EL CALVARIO	ESCUELA NACIONAL CONCENTRADA NUMERO 178 1778 EL CALVARIO	1127	2	30	844	577	814	0	3	1	0	233	844
EDO. GUARICO	MP. MIRANDA	PQ. GUARDATINAJAS	ESCUELA ESTADAL CC 17 MONTE OSCURO
EDO. GUARICO	MP. MIRANDA	PQ. GUARDATINAJAS	GRUPO ESCOLAR FRANCISCO CONDE	2169	4	30	1673	1164	1643	1	6	0	0	472	1673
EDO. GUARICO	MP. MIRANDA	PQ. GUARDATINAJAS	UNIDAD EDUCATIVA DOCTOR LUIS JOSE ACOSTA RODRIGUEZ	454	1	8	368	269	360	1	0	0	0	90	368
EDO. GUARICO	MP. MIRANDA	PQ. CALABOZO	UNIDAD EDUCATIVA PARMENIA DIAZ DE CARVAJAL	529	1	12	459	331	447	0	3	0	1	112	459
EDO. GUARICO	MP. MIRANDA	PQ. CALABOZO	ESCUELA BOLIVARIANA LECHERITO 5	485	1	7	389	347	382	0	1	0	0	34	389
EDO. GUARICO	MP. MIRANDA	PQ. CALABOZO	COLEGIO NUESTRA SEÑORA DE LA COROMOTO	1958	4	26	1676	660	1650	1	7	1	2	979	1676
EDO. GUARICO	MP. MIRANDA	PQ. CALABOZO	ESCUELA BASICA ANTONIO ESTEVEZ	642	2	20	560	403	540	0	1	0	0	136	560
EDO. GUARICO	MP. MIRANDA	PQ. CALABOZO	ESCUELA BASICA DOCTOR FRANCISCO LAZO MARTI	3766	7	27	3168	1594	3141	0	30	0	1	1516	3168
EDO. GUARICO	MP. MIRANDA	PQ. CALABOZO	JARDIN DE INFANCIA MARIA TERESA DEL TORO	1651	3	33	1371	978	1338	0	7	0	0	353	1371
EDO. GUARICO	MP. MIRANDA	PQ. CALABOZO	GRUPO ESCOLAR JOSE RAFAEL VISO RODRIGUEZ	3792	7	61	3066	2114	3005	2	21	4	0	864	3066
EDO. GUARICO	MP. MIRANDA	PQ. CALABOZO	GRUPO ESCOLAR CAMAGUAN	1717	3	26	1389	911	1363	0	6	0	1	445	1389
EDO. GUARICO	MP. MIRANDA	PQ. CALABOZO	GRUPO ESCOLAR PEDRO ITRIAGO CHACIN	3342	6	51	2701	1784	2650	1	11	0	3	851	2701
EDO. GUARICO	MP. MIRANDA	PQ. CALABOZO	ESCUELA BASICA ANDRES BELLO
EDO. GUARICO	MP. MIRANDA	PQ. CALABOZO	ESCUELA TECNICA COMERCIAL DOCTOR RAFAEL LORETO LORETO	1092	2	26	939	554	913	0	6	0	0	353	939
EDO. GUARICO	MP. MIRANDA	PQ. CALABOZO	CASA DE LA CULTURA FRANCISCO LAZO MARTÍ	2321	4	20	1906	916	1886	0	10	2	0	958	1906
EDO. GUARICO	MP. MIRANDA	PQ. CALABOZO	ESCUELA BOLIVARIANA RURAL CC 81 NER 016 UVERITO PEREÑO
EDO. GUARICO	MP. MIRANDA	PQ. CALABOZO	UNIDAD EDUCATIVA JUAN EDUVIGES LEDEZMA ALVAREZ	934	2	18	782	670	764	1	4	0	0	89	782
EDO. GUARICO	MP. MIRANDA	PQ. CALABOZO	ESCUELA NUESTRA SEÑORA DE LOS DOLORES	1255	3	23	1067	863	1044	3	8	0	0	170	1067
EDO. GUARICO	MP. MIRANDA	PQ. CALABOZO	ESCUELA ESTADAL C 20 LOS ANDRESEROS	231	1	2	171	143	169	0	1	1	0	24	171
EDO. GUARICO	MP. MIRANDA	PQ. CALABOZO	ESCUELA BOLIVARIANA CC 71 COROZOPANDO NER 485	596	1	29	427	332	398	0	2	0	0	64	427
EDO. GUARICO	MP. MIRANDA	PQ. CALABOZO	CENTRO MOVIL	485	1	2	406	298	404	0	3	0	0	103	406
EDO. GUARICO	MP. MIRANDA	PQ. CALABOZO	CICLO BASICO JOAQUIN CRESPO	1016	2	6	843	630	837	0	3	0	1	203	843
EDO. GUARICO	MP. MIRANDA	PQ. CALABOZO	ESCUELA BASICA CELINA ACOSTA DE VIANA	2835	5	47	2301	1424	2254	0	13	2	1	814	2301
EDO. GUARICO	MP. MIRANDA	PQ. CALABOZO	UNIDAD EDUCATIVA JOSE FELIX RIBAS	2266	4	19	1810	1449	1791	0	15	0	1	326	1810
EDO. GUARICO	MP. MIRANDA	PQ. CALABOZO	CENTRO EDUCATIVO INICIAL ANTONIO JOSE DE SUCRE	1094	2	13	935	656	922	0	7	1	0	258	935
EDO. GUARICO	MP. MIRANDA	PQ. CALABOZO	ESCUELA BASICA CC 25 SOCORRO DE PORTUGUESA
EDO. GUARICO	MP. MIRANDA	PQ. CALABOZO	GRUPO ESCOLAR ESTADOS UNIDOS DE AMERICA	2591	5	30	2082	1027	2052	0	11	3	2	1009	2082
EDO. GUARICO	MP. MIRANDA	PQ. CALABOZO	UNIDAD EDUCATIVA SIMON RODRIGUEZ	1937	4	18	1600	1206	1582	0	9	2	2	363	1600
EDO. GUARICO	MP. MIRANDA	PQ. CALABOZO	UNIDAD EDUCATIVA NACIONAL DOCTOR JOSE MARIA VARGAS	328	1	5	260	217	255	0	1	0	0	37	260
EDO. GUARICO	MP. MIRANDA	PQ. CALABOZO	NUCLEO EDUCACION UNIVERSIDAD ROMULO GALLEGOS	1496	3	23	1224	727	1201	1	6	0	2	465	1224
EDO. GUARICO	MP. MIRANDA	PQ. CALABOZO	GRUPO ESCOLAR OTONIEL GUGLIETA	3120	6	52	2481	1882	2429	3	18	3	2	521	2481
EDO. GUARICO	MP. MIRANDA	PQ. CALABOZO	UNIDAD EDUCATIVA JUAN GERMAN ROSCIO	3291	6	69	2617	1950	2548	2	15	1	1	579	2617
EDO. GUARICO	MP. MIRANDA	PQ. CALABOZO	ESCUELA ESTADAL RURAL CC 13 PASO DE MUJICA
EDO. GUARICO	MP. MIRANDA	PQ. CALABOZO	ESCUELA BOLIVARIANA LUISA CACERES DE ARISMENDI	746	2	18	638	490	620	0	7	0	0	123	638
EDO. GUARICO	MP. MIRANDA	PQ. CALABOZO	LICEO FRANCISCO DE MIRANDA	3975	7	40	3321	2123	3281	2	17	0	4	1135	3321
EDO. GUARICO	MP. MIRANDA	PQ. CALABOZO	ESCUELA BOLIVARIANA NUMERO 1988	379	1	7	309	253	302	0	3	0	0	46	309
EDO. GUARICO	MP. MIRANDA	PQ. CALABOZO	CONCENTRACION ESCOLAR CC 03 PALO SECO
EDO. GUARICO	MP. MIRANDA	PQ. CALABOZO	CENTRO MÓVIL BOQUERONES
EDO. GUARICO	MP. MIRANDA	PQ. CALABOZO	INSTITUTO NACIONAL DE COOPERACION EDUCATIVA SOCIALISTA CALABOZO	943	2	7	777	456	770	2	5	0	0	307	777
EDO. GUARICO	MP. MIRANDA	PQ. CALABOZO	ESCUELA BOLIVARIANA PIRITU
EDO. GUARICO	MP. MIRANDA	PQ. CALABOZO	ESCUELA BASICA ESTADAL LA MATICA	416	1	11	377	329	366	0	1	0	0	36	377
EDO. GUARICO	MP. MIRANDA	PQ. CALABOZO	UNIDAD EDUCATIVA BICENTENARIO DE LAS AMERICAS	2624	5	35	2335	2055	2300	0	11	1	0	233	2335
EDO. GUARICO	MP. MIRANDA	PQ. CALABOZO	UNIDAD EDUCATIVA BOLIVARIANA LECHERITO 2	186	1	2	176	149	174	1	1	1	0	22	176
EDO. GUARICO	MP. MIRANDA	PQ. CALABOZO	LICEO HUMBOLDT	3589	7	59	2982	1612	2923	3	15	1	1	1291	2982
EDO. GUARICO	MP. MIRANDA	PQ. CALABOZO	CENTRO DE EDUCACION INICIAL DOCTOR GUSTAVO HURDANETA DELGADO	670	2	9	590	386	581	1	3	0	0	191	590
EDO. GUARICO	MP. MIRANDA	PQ. CALABOZO	ESCUELA BASICA VERITA	1575	3	14	1270	1030	1256	0	4	2	1	219	1270
EDO. GUARICO	MP. MIRANDA	PQ. CALABOZO	ESCUELA TECNICA INDUSTRIAL DOCTOR HUMBERTO FERNANDEZ MORAN
EDO. GUARICO	MP. MIRANDA	PQ. CALABOZO	UNIDAD EDUCATIVA VIRGEN MILAGROSA	1289	3	15	1064	867	1049	1	8	1	0	172	1064
EDO. GUARICO	MP. MIRANDA	PQ. CALABOZO	GRUPO ESCOLAR RAMON FRANCISCO FEO	2937	6	29	2387	1184	2358	2	16	1	1	1154	2387
EDO. GUARICO	MP. MIRANDA	PQ. CALABOZO	UNIDAD EDUCATIVA SIMON BOLIVAR	1644	3	18	1332	1094	1314	1	7	0	1	211	1332
EDO. GUARICO	MP. MIRANDA	PQ. CALABOZO	ESCUELA DE NIÑOS ESPECIALES	783	2	16	661	378	645	0	4	1	0	262	661
EDO. GUARICO	MP. MIRANDA	PQ. CALABOZO	UNIDAD EDUCATIVA GRAN MARISCAL DE AYACUCHO	659	2	15	551	451	536	0	1	1	0	83	551
EDO. GUARICO	MP. MIRANDA	PQ. CALABOZO	ESCUELA ESTADAL C 41 LAS BARBAS	234	1	3	178	122	175	0	3	0	0	50	178
EDO. GUARICO	MP. MIRANDA	PQ. CALABOZO	ESCUELA ESTADAL CC 14 NER 016
EDO. GUARICO	MP. MIRANDA	PQ. EL RASTRO	ESCUELA BASICA CREACION EL RASTRO	308	1	3	244	193	241	0	0	0	0	48	244
EDO. GUARICO	MP. MIRANDA	PQ. EL RASTRO	ESCUELA BOLIVARIANA FELIPE DAGER	1872	4	49	1444	948	1395	1	11	0	0	435	1444
EDO. GUARICO	MP. CAMAGUAN	PQ. CAMAGUAN	ESCUELA BOLIVARIANA LA NEGRA	943	2	18	796	572	778	1	4	1	0	200	796
EDO. GUARICO	MP. CAMAGUAN	PQ. CAMAGUAN	ESCUELA BOLIVARIANA LA ROMPIA	245	1	4	166	99	162	0	1	1	0	61	166
EDO. GUARICO	MP. CAMAGUAN	PQ. CAMAGUAN	CASA DE LAS MISIONES	312	1	6	274	196	268	0	0	0	0	72	274
EDO. GUARICO	MP. CAMAGUAN	PQ. CAMAGUAN	ESCUELA BOLIVARIANA JOSEFINA MORENO DE OLIVARES	1681	3	28	1302	885	1274	0	7	0	0	382	1302
EDO. GUARICO	MP. CAMAGUAN	PQ. CAMAGUAN	CENTRO DE EDUCACION INICIAL MARIA ENRIQUETA HURTADO	323	1	3	269	179	266	0	3	0	0	84	269
EDO. GUARICO	MP. CAMAGUAN	PQ. CAMAGUAN	ESCUELA BOLIVARIANA INMACULADA NIÑA	1132	2	33	948	515	915	0	5	0	0	395	948
EDO. GUARICO	MP. CAMAGUAN	PQ. CAMAGUAN	ESCUELA BOLIVARIANA JOAQUIN CRESPO	3524	6	77	2677	1388	2600	1	20	4	0	1187	2677
EDO. GUARICO	MP. CAMAGUAN	PQ. CAMAGUAN	ESCUELA BASICA BRISAS DE CAMAGUAN	769	2	13	669	455	656	1	6	0	0	194	669
EDO. GUARICO	MP. CAMAGUAN	PQ. CAMAGUAN	ESCUELA BOLIVARIANA SOMBRERITO	613	2	9	453	390	444	0	2	1	0	51	453
EDO. GUARICO	MP. CAMAGUAN	PQ. CAMAGUAN	CENTRO DE EDUCACION TOQUITO	221	1	4	194	123	190	0	2	0	0	65	194
EDO. GUARICO	MP. CAMAGUAN	PQ. PUERTO MIRANDA	CASA COMUNAL SAN FERNANDO 2000 PRIMERA ETAPA	48	1	0	44	20	44	0	1	0	0	23	44
EDO. GUARICO	MP. CAMAGUAN	PQ. PUERTO MIRANDA	ESCUELA BOLIVARIANA PUERTO MIRANDA	2448	5	57	1936	1295	1879	1	8	1	0	574	1936
EDO. GUARICO	MP. CAMAGUAN	PQ. UVERITO	UNIDAD EDUCATIVA BOLIVARIANA SIMON BOLIVAR	128	1	5	113	77	108	0	3	0	0	28	113
EDO. GUARICO	MP. CAMAGUAN	PQ. UVERITO	ESCUELA BOLIVARIANA UVERITO	1332	3	23	1006	703	983	0	8	3	1	268	1006
EDO. GUARICO	MP. ORTIZ	PQ. ORTIZ	ESCUELA BASICA JUAN GERMAN ROSCIO	1896	4	25	1551	1001	1526	0	11	0	0	514	1551
EDO. GUARICO	MP. ORTIZ	PQ. ORTIZ	ESCUELA ESTADAL AC 16 TIGUIGUE	747	2	14	583	432	569	0	5	4	0	128	583
EDO. GUARICO	MP. ORTIZ	PQ. ORTIZ	ESCUELA PRIMARIA AC 25 BUCARAL	196	1	4	166	130	162	0	1	0	0	31	166
EDO. GUARICO	MP. ORTIZ	PQ. ORTIZ	ESCUELA BASICA  CREACION LA ROMANA NER 392	554	1	3	476	320	473	0	4	0	0	149	476
EDO. GUARICO	MP. ORTIZ	PQ. ORTIZ	JARDIN DE INFANCIA JUAN GERMAN ROSCIO	368	1	6	292	196	286	0	2	0	0	88	292
EDO. GUARICO	MP. ORTIZ	PQ. ORTIZ	ESCUELA ESTADAL BOLIVARIANA BATALLA DE LA VICTORIA	198	1	5	162	127	157	0	1	0	0	29	162
EDO. GUARICO	MP. ORTIZ	PQ. ORTIZ	CICLO COMBINADO BEATRIZ DE RODRIGUEZ	3052	6	40	2441	1382	2401	0	23	3	1	992	2441
EDO. GUARICO	MP. ORTIZ	PQ. SAN FCO. DE TIZNADOS	UNIDAD EDUCATIVA EL CARITO	91	1	1	67	62	66	0	0	0	0	4	67
EDO. GUARICO	MP. ORTIZ	PQ. SAN FCO. DE TIZNADOS	ESCUELA BOLIVARIANA LUISA CACERES DE ARISMENDI	1520	3	36	1166	877	1130	1	4	0	0	248	1166
EDO. GUARICO	MP. ORTIZ	PQ. SAN FCO. DE TIZNADOS	ESCUELA ESTADAL UNITARIA AC 23 EL CARITO	276	1	1	219	201	218	0	2	0	0	15	219
EDO. GUARICO	MP. ORTIZ	PQ. SAN FCO. DE TIZNADOS	ESCUELA AC 34 LAS LAJITAS	168	1	2	149	145	147	0	0	0	0	2	149
EDO. GUARICO	MP. ORTIZ	PQ. SAN FCO. DE TIZNADOS	ESCUELA BASICA AC 36 GUAITOCO	259	1	2	186	145	184	0	2	1	0	36	186
EDO. GUARICO	MP. ORTIZ	PQ. SAN JOSE DE TIZNADOS	ESCUELA BOLIVARIANA JOSE ANGEL RODRIGUEZ TRUJILLO	1417	3	25	1112	859	1087	0	3	1	0	224	1112
EDO. GUARICO	MP. ORTIZ	PQ. SAN JOSE DE TIZNADOS	PREESCOLAR BOLIVARIANO MARIA DE TABARE	169	1	6	143	99	137	0	1	0	0	37	143
EDO. GUARICO	MP. ORTIZ	PQ. SAN JOSE DE TIZNADOS	ESCUELA BOLIVARIANA ASENTAMIENTO CAMPESINO LOS CHIGUIRES	284	1	9	246	194	237	0	3	0	1	39	246
EDO. GUARICO	MP. ORTIZ	PQ. SAN JOSE DE TIZNADOS	ESCUELA BASICA BOLIVARIANA SAN JOSE	989	2	6	773	488	767	0	1	0	0	278	773
EDO. GUARICO	MP. ORTIZ	PQ. S LORENZO DE TIZNADOS	ESCUELA PRIMARIA AC 17 BERSUGA	350	1	6	237	198	231	0	1	0	0	32	237
EDO. GUARICO	MP. ORTIZ	PQ. S LORENZO DE TIZNADOS	ESCUELA ESTADAL BOLIVARIANA AC 14 CHIRGUA	418	1	2	327	224	325	0	1	0	0	100	327
EDO. GUARICO	MP. ORTIZ	PQ. S LORENZO DE TIZNADOS	ESCUELA BASICA AC 47 PARADERO	178	1	1	158	144	157	0	0	0	0	13	158
EDO. GUARICO	MP. ORTIZ	PQ. S LORENZO DE TIZNADOS	ESCUELA ESTADAL LA FLORIDA 1	268	1	1	167	99	166	0	0	0	0	67	167
EDO. GUARICO	MP. ORTIZ	PQ. S LORENZO DE TIZNADOS	ESCUELA ESTADAL AC 18 CANUTO	740	2	7	562	487	555	0	1	0	0	67	562
EDO. GUARICO	MP. S MARIA DE IPIRE	PQ. ALTAMIRA	ESCUELA ESTADAL F 64 PUERTO REQUENA	332	1	4	260	240	256	0	0	0	0	16	260
EDO. GUARICO	MP. S MARIA DE IPIRE	PQ. ALTAMIRA	ESCUELA ESTADAL FC 45 ALTAMIRA	515	1	11	370	315	359	0	1	3	0	40	370
EDO. GUARICO	MP. S MARIA DE IPIRE	PQ. SANTA MARIA DE IPIRE	ESCUELA ESTADAL FC 44 LAS PARAULATAS	225	1	7	168	108	161	1	2	0	0	50	168
EDO. GUARICO	MP. S MARIA DE IPIRE	PQ. SANTA MARIA DE IPIRE	ESCUELA BOLIVARIANA ANTONIO DE ARMAS MATUTE	2554	5	47	1853	1057	1806	0	8	5	1	735	1853
EDO. GUARICO	MP. S MARIA DE IPIRE	PQ. SANTA MARIA DE IPIRE	ESCUELA NACIONAL UNITARIA NÚMERO 1566 AGUA AMARILLA	300	1	0	209	183	209	1	0	0	0	25	209
EDO. GUARICO	MP. S MARIA DE IPIRE	PQ. SANTA MARIA DE IPIRE	ESCUELA DE ARTES Y OFICIOS NUESTRA SEÑORA DE LA CANDELARIA	1684	3	19	1309	902	1290	0	4	0	0	384	1309
EDO. GUARICO	MP. S MARIA DE IPIRE	PQ. SANTA MARIA DE IPIRE	PRE ESCOLAR DOCTOR CECILIO REQUENA OSORIO	436	1	9	331	218	322	1	5	0	0	98	331
EDO. GUARICO	MP. S MARIA DE IPIRE	PQ. SANTA MARIA DE IPIRE	ESCUELA ESTADAL CONCENTRADA FC 16 CHAGUARAMAL DE MAYORGA	215	1	1	136	122	135	0	2	0	0	11	136
EDO. GUARICO	MP. S MARIA DE IPIRE	PQ. SANTA MARIA DE IPIRE	ASOCIACION DE PRODUCTORES AGRICOLAS SANTA MARIA DE IPIRE	343	1	3	273	179	270	0	2	2	0	87	273
EDO. GUARICO	MP. S MARIA DE IPIRE	PQ. SANTA MARIA DE IPIRE	ESCUELA CONCENTRADA FC 40 EL VENADO	360	1	3	237	191	234	0	2	1	0	40	237
EDO. GUARICO	MP. S MARIA DE IPIRE	PQ. SANTA MARIA DE IPIRE	ESCUELA ESTADAL CONCENTRADA FC 75 LOS GUATACAROS	411	1	8	277	228	269	1	1	0	0	39	277
EDO. GUARICO	MP. S MARIA DE IPIRE	PQ. SANTA MARIA DE IPIRE	ESCUELA ESTADAL CONCENTRADA FC 38 EL MANGUITO	560	1	4	404	314	400	0	6	0	1	79	404
EDO. GUARICO	MP. S MARIA DE IPIRE	PQ. SANTA MARIA DE IPIRE	UNIDAD EDUCATIVA BALTAZAR PADRON	224	1	0	182	128	182	0	2	0	0	52	182
EDO. GUARICO	MP. S MARIA DE IPIRE	PQ. SANTA MARIA DE IPIRE	ESCUELA ESTADAL CONCENTRADA FC 47 LAGUNA GRANDE	81	1	3	73	58	70	0	2	0	0	10	73
EDO. GUARICO	MP. S MARIA DE IPIRE	PQ. SANTA MARIA DE IPIRE	INSTITUTO DE EDUCACIÓN ESPECIAL SANTA MARIA	680	2	9	549	356	540	0	6	0	0	178	549
EDO. GUARICO	MP. S MARIA DE IPIRE	PQ. SANTA MARIA DE IPIRE	UNIDAD EDUCATIVA ANA MELENDEZ DE RAMIREZ	1080	2	13	850	601	837	1	9	2	0	224	850
EDO. GUARICO	MP. S MARIA DE IPIRE	PQ. SANTA MARIA DE IPIRE	ESCUELA NACIONAL CONCENTRADA NÚMERO 3614 3498 MATA DE LOS INDIOS	251	1	5	180	129	175	0	0	1	0	45	180
EDO. GUARICO	MP. S MARIA DE IPIRE	PQ. SANTA MARIA DE IPIRE	UNIDAD EDUCATIVA NACIONAL FRANCISCO DE MIRANDA	234	1	11	183	123	172	0	1	1	0	47	183
EDO. GUARICO	MP. LAS MERCEDES	PQ. LAS MERCEDES	CENTRO DE EDUCACION INICIAL LAS PALMAS	499	1	16	375	282	359	0	1	0	0	76	375
EDO. GUARICO	MP. LAS MERCEDES	PQ. LAS MERCEDES	CENTRO DE EDUCACION INICIAL LAS PERLAS
EDO. GUARICO	MP. LAS MERCEDES	PQ. LAS MERCEDES	UNIDAD EDUCATIVA NACIONAL RAFAEL PAREDES	3507	7	74	2615	1623	2541	0	17	3	0	898	2615
EDO. GUARICO	MP. LAS MERCEDES	PQ. LAS MERCEDES	UNIDAD EDUCATIVA MONSEÑOR RODRIGUEZ ALVAREZ	4035	7	101	3085	1687	2984	0	19	3	0	1275	3085
EDO. GUARICO	MP. LAS MERCEDES	PQ. LAS MERCEDES	CENTRO EDUCACION INICIAL EL AZULEJO	445	1	8	329	255	321	0	1	0	0	65	329
EDO. GUARICO	MP. LAS MERCEDES	PQ. LAS MERCEDES	UNIDAD EDUCATIVA NACIONAL PEDRO ITRIAGO CHACIN	410	1	20	318	235	298	0	1	0	0	62	318
EDO. GUARICO	MP. LAS MERCEDES	PQ. LAS MERCEDES	ESCUELA NACIONAL EL GAVILAN	146	1	6	122	96	116	0	0	0	0	20	122
EDO. GUARICO	MP. LAS MERCEDES	PQ. LAS MERCEDES	UNIDAD EDUCATIVA MIGUEL GONZALEZ CONTRERAS	2052	4	54	1548	939	1494	0	6	1	0	548	1548
EDO. GUARICO	MP. LAS MERCEDES	PQ. LAS MERCEDES	ESCUELA BOLIVARIANA MODESTO JUVENCIO MANUITT
EDO. GUARICO	MP. LAS MERCEDES	PQ. LAS MERCEDES	MUNICIPIO ESCOLAR NÚMERO 8	923	2	24	690	425	666	0	6	1	0	234	690
EDO. GUARICO	MP. LAS MERCEDES	PQ. CABRUTA	ESCUELA BASICA ANGEL MORENO	4085	8	70	3116	2404	3046	1	18	1	0	622	3116
EDO. GUARICO	MP. LAS MERCEDES	PQ. CABRUTA	UNIDAD EDUCATIVA VICENTE YANEZ PINZON	1396	3	14	1133	974	1119	2	6	1	0	136	1133
EDO. GUARICO	MP. LAS MERCEDES	PQ. CABRUTA	ESCUELA BASICA ESTADAL D 72 MEDANOS DE GOMEZ	194	1	0	79	74	79	0	0	1	0	4	79
EDO. GUARICO	MP. LAS MERCEDES	PQ. CABRUTA	ESC ESTADAL D 68 GOLFO TRISTE	170	1	3	108	89	105	0	0	1	0	15	108
EDO. GUARICO	MP. LAS MERCEDES	PQ. CABRUTA	ESCUELA BOLIVARIANA ESTADAL DC 43 TERECAY	486	1	11	381	324	370	0	1	0	0	45	381
EDO. GUARICO	MP. LAS MERCEDES	PQ. STA RITA DE MANAPIRE	UNIDAD EDUCATIVA ESTADAL BOLIVARIANA DC 7 SANTA RITA	1435	3	20	1121	910	1101	1	2	0	0	188	1121
EDO. GUARICO	MP.S JOSE DE GUARIBE	PQ. SAN JOSE DE GUARIBE	ESCUELA BASICA BOLIVARIANA GC 27 EL CINCO	375	1	7	273	189	266	0	3	0	0	74	273
EDO. GUARICO	MP.S JOSE DE GUARIBE	PQ. SAN JOSE DE GUARIBE	ESCUELA BASICA GC 19 RIO NEGRO	152	1	1	103	71	102	0	0	0	0	31	103
EDO. GUARICO	MP.S JOSE DE GUARIBE	PQ. SAN JOSE DE GUARIBE	ESCUELA BASICA MONSEÑOR CRESPO	3165	6	38	2474	1584	2436	1	21	0	0	830	2474
EDO. GUARICO	MP.S JOSE DE GUARIBE	PQ. SAN JOSE DE GUARIBE	CENTRO MOVIL	250	1	9	206	143	197	0	1	0	0	53	206
EDO. GUARICO	MP.S JOSE DE GUARIBE	PQ. SAN JOSE DE GUARIBE	UNIDAD EDUCATIVA COLEGIO SANTIAGO MARIÑO	341	1	8	297	207	289	0	0	0	0	82	297
EDO. GUARICO	MP.S JOSE DE GUARIBE	PQ. SAN JOSE DE GUARIBE	CENTRO DE EDUCACION INICIAL INAVI	1391	3	35	1155	677	1120	0	7	1	1	434	1155
EDO. GUARICO	MP.S JOSE DE GUARIBE	PQ. SAN JOSE DE GUARIBE	ESCUELA BASICA BOLIVARIANA GC 57 GUARIBITO	210	1	0	173	153	173	0	0	0	0	20	173
EDO. GUARICO	MP.S JOSE DE GUARIBE	PQ. SAN JOSE DE GUARIBE	ESCUELA TECNICA ROBINSONIANA DIEGO BAUTISTA URBANEJA	1031	2	29	846	594	817	0	2	0	0	221	846
EDO. GUARICO	MP.S JOSE DE GUARIBE	PQ. SAN JOSE DE GUARIBE	ESCUELA BÁSICA EC 25 EL CEDRO	112	1	1	98	87	97	0	0	0	0	10	98
EDO. GUARICO	MP.S JOSE DE GUARIBE	PQ. SAN JOSE DE GUARIBE	ESCUELA BASICA BOLIVARIANA GC 36 CONGOROCHO	277	1	5	227	97	222	0	2	1	0	122	227
EDO. GUARICO	MP.S JOSE DE GUARIBE	PQ. SAN JOSE DE GUARIBE	ESCUELA BOLIVARIANA GC 13 LAS LAJAS	282	1	5	217	169	212	0	1	0	0	42	217
EDO. GUARICO	MP.S JOSE DE GUARIBE	PQ. SAN JOSE DE GUARIBE	ESCUELA BASICA BOLIVARIANA GC 23 UVERAL	466	1	8	342	269	334	0	3	0	0	62	342
EDO. GUARICO	MP. MONAGAS	PQ. LEZAMA	ESCUELA BASICA GC PUNTERAL	147	1	2	122	97	120	0	1	0	0	22	122
EDO. GUARICO	MP. MONAGAS	PQ. LEZAMA	ESCUELA BASICA GC 17 LOS NEGROS	411	1	7	308	159	301	0	5	0	0	137	308
EDO. GUARICO	MP. MONAGAS	PQ. LEZAMA	ESCUELA NACIONAL GC 35 LA ESPERANZA	271	1	3	214	97	211	0	0	1	0	113	214
EDO. GUARICO	MP. MONAGAS	PQ. LEZAMA	ESCUELA BASICA CONCENTRADA GC BELLAS BRISAS	258	1	8	218	168	210	0	1	0	0	41	218
EDO. GUARICO	MP. MONAGAS	PQ. LEZAMA	UNIDAD EDUCATIVA JESUS BANDRES	2269	4	39	1694	1126	1655	1	9	1	1	517	1694
EDO. GUARICO	MP. MONAGAS	PQ. SOUBLETTE	ESCUELA UNITARIA NÚMERO 5 TUCUPIDO ARAGORT	190	1	3	144	95	141	0	0	0	0	46	144
EDO. GUARICO	MP. MONAGAS	PQ. SOUBLETTE	ESCUELA BASICA GC 45 ORUZ DE PALMARITO	416	1	3	342	253	339	0	1	0	0	85	342
EDO. GUARICO	MP. MONAGAS	PQ. SOUBLETTE	ESCUELA BASICA BOLIVARIANA GC 21 ARENITAS	438	1	10	326	234	316	0	2	0	0	80	326
EDO. GUARICO	MP. MONAGAS	PQ. SOUBLETTE	UNIDAD EDUCATIVA NACIONAL BOLIVARIANA DOCTOR PEDRO MARÍA ARÉVALO	1130	2	5	834	550	829	1	4	0	0	274	834
EDO. GUARICO	MP. MONAGAS	PQ. SAN FCO DE MACAIRA	GRUPO ESCOLAR MACAIRA	1513	3	15	1128	865	1113	0	3	2	0	243	1128
EDO. GUARICO	MP. MONAGAS	PQ. SAN FCO DE MACAIRA	ESCUELA MIXTA 196 JABILLAL DE MACAIRA	561	1	6	398	324	392	0	0	0	0	68	398
EDO. GUARICO	MP. MONAGAS	PQ. ALTAGRACIA DE ORITUCO	ESCUELA BASICA RUBEN HURTADO RODRIGUEZ	2029	4	51	1581	1170	1530	1	10	2	0	347	1581
EDO. GUARICO	MP. MONAGAS	PQ. ALTAGRACIA DE ORITUCO	ESCUELA BASICA ANDRES BELLO	678	2	15	587	487	572	0	7	0	0	78	587
EDO. GUARICO	MP. MONAGAS	PQ. ALTAGRACIA DE ORITUCO	UNIDAD EDUCATIVA LICEO DOCTOR RAMON BUENAHORA	1369	3	31	1155	616	1124	0	2	0	1	505	1155
EDO. GUARICO	MP. MONAGAS	PQ. ALTAGRACIA DE ORITUCO	ESCUELA BASICA JOSE RAMON CAMEJO	3086	6	46	2401	1259	2355	1	23	3	0	1069	2401
EDO. GUARICO	MP. MONAGAS	PQ. ALTAGRACIA DE ORITUCO	ESCUELA BASICA BOLIVARIANA GC 54 BOTALON	559	1	5	451	382	446	0	0	0	0	64	451
EDO. GUARICO	MP. MONAGAS	PQ. ALTAGRACIA DE ORITUCO	UNIDA EDUCATIVA SAN PABLO APOSTOL	125	1	2	115	60	113	0	0	0	0	53	115
EDO. GUARICO	MP. MONAGAS	PQ. ALTAGRACIA DE ORITUCO	UNIDAD EDUCATIVA COLEGIO MADRE CANDELARIA	201	1	4	182	106	178	0	2	0	0	70	182
EDO. GUARICO	MP. MONAGAS	PQ. ALTAGRACIA DE ORITUCO	UNIDAD EDUCATIVA COLEGIO BATALLA DE LA VICTORIA	57	1	2	45	22	43	0	0	0	0	21	45
EDO. GUARICO	MP. MONAGAS	PQ. ALTAGRACIA DE ORITUCO	ESCUELA BASICA ALTAGRACIA	1035	2	9	864	560	855	0	6	1	0	288	864
EDO. GUARICO	MP. MONAGAS	PQ. ALTAGRACIA DE ORITUCO	UNIDAD EDUCATIVA COLEGIO LIBERTADOR	126	1	5	106	46	101	0	0	0	0	55	106
EDO. GUARICO	MP. MONAGAS	PQ. ALTAGRACIA DE ORITUCO	CENTRO MOVIL	418	1	7	365	218	358	0	3	0	0	137	365
EDO. GUARICO	MP. MONAGAS	PQ. ALTAGRACIA DE ORITUCO	ESCUELA BASICA ROMULO GALLEGOS	1528	3	38	1132	899	1094	2	6	1	0	186	1132
EDO. GUARICO	MP. MONAGAS	PQ. ALTAGRACIA DE ORITUCO	CENTRO DE SERVICIO SOCIAL MADRE CANDELARIA	1370	3	29	1131	835	1102	0	8	1	1	257	1131
EDO. GUARICO	MP. MONAGAS	PQ. ALTAGRACIA DE ORITUCO	ESCUELA PRE VOCACIONAL CAP MONSEÑOR SIXTO SOSA	324	1	4	247	153	243	0	1	0	0	89	247
EDO. GUARICO	MP. MONAGAS	PQ. ALTAGRACIA DE ORITUCO	ESCUELA BASICA LA CUMANA	381	1	8	353	216	345	0	1	0	0	128	353
EDO. GUARICO	MP. MONAGAS	PQ. ALTAGRACIA DE ORITUCO	ESCUELA ESTADAL GC 3 TAGUAPIRE	474	1	13	360	268	347	0	4	0	0	75	360
EDO. GUARICO	MP. MONAGAS	PQ. ALTAGRACIA DE ORITUCO	INSTITUTO NACIONAL DE CAPACITACION Y EDUCACION SOCIALISTA	308	1	5	263	215	258	0	1	1	0	41	263
EDO. GUARICO	MP. MONAGAS	PQ. ALTAGRACIA DE ORITUCO	ESCUELA BASICA BOLIVARIANA GC 01 OROCOLLAL	952	2	17	678	593	661	2	1	2	0	63	678
EDO. GUARICO	MP. MONAGAS	PQ. ALTAGRACIA DE ORITUCO	ESCUELA BASICA SIMON RODRIGUEZ	378	1	5	332	302	327	0	1	0	0	24	332
EDO. GUARICO	MP. MONAGAS	PQ. ALTAGRACIA DE ORITUCO	UNIDAD EDUCATIVA COLEGIO GENERALISIMO FRANCISCO DE MIRANDA	52	1	2	43	27	41	0	0	0	0	14	43
EDO. GUARICO	MP. MONAGAS	PQ. ALTAGRACIA DE ORITUCO	ESCUELA BASICA DR. JOSE FRANCISCO TORREALBA	2318	4	27	1838	1066	1811	0	7	1	0	737	1838
EDO. GUARICO	MP. MONAGAS	PQ. ALTAGRACIA DE ORITUCO	ESCUELA DE ARTES Y OFICIOS HIGINIO MORALES	1392	3	24	1203	697	1179	1	4	0	3	474	1203
EDO. GUARICO	MP. MONAGAS	PQ. ALTAGRACIA DE ORITUCO	ESCUELA BASICA ABELARDO MENDEZ	3442	6	52	2832	1513	2780	0	16	2	1	1248	2832
EDO. GUARICO	MP. MONAGAS	PQ. ALTAGRACIA DE ORITUCO	ESCUELA BASICA LOS GUAIQUERIES	2850	5	42	2264	1729	2222	0	14	2	0	477	2264
EDO. GUARICO	MP. MONAGAS	PQ. ALTAGRACIA DE ORITUCO	ESCUELA BASICA BOLIVARIANA ORITUCO	2331	4	48	1937	1267	1889	1	11	0	0	610	1937
EDO. GUARICO	MP. MONAGAS	PQ. ALTAGRACIA DE ORITUCO	JARDIN DE INFANCIA SIMON BOLIVAR	255	1	1	239	131	238	0	6	0	0	101	239
EDO. GUARICO	MP. MONAGAS	PQ. ALTAGRACIA DE ORITUCO	ESCUELA BASICA PROSPERO INFANTE	2770	5	48	2237	1679	2189	0	17	2	3	488	2237
EDO. GUARICO	MP. MONAGAS	PQ. ALTAGRACIA DE ORITUCO	ESCUELA BASICA JOSE TADEO MONAGAS	2687	5	48	2223	1695	2175	0	10	3	1	466	2223
EDO. GUARICO	MP. MONAGAS	PQ. ALTAGRACIA DE ORITUCO	UNIDAD EDUCATIVA COLEGIO NUESTRA SEÑORA DE ALTAGRACIA	438	1	2	387	133	385	0	2	0	0	250	387
EDO. GUARICO	MP. MONAGAS	PQ. ALTAGRACIA DE ORITUCO	UNIDAD EDUCATIVA JUAN BARNUEVO	1705	3	31	1427	560	1396	0	10	0	1	825	1427
EDO. GUARICO	MP. MONAGAS	PQ. ALTAGRACIA DE ORITUCO	ESCUELA BASICA BOLIVARIANA GC 1525 JULIO ORTIZ	248	1	2	232	188	230	0	1	0	0	41	232
EDO. GUARICO	MP. MONAGAS	PQ. LIBERTAD DE ORITUCO	CONCENTRACION ESCOLAR G 42 SAMANITO	185	1	6	134	90	128	0	1	0	0	37	134
EDO. GUARICO	MP. MONAGAS	PQ. LIBERTAD DE ORITUCO	ESCUELA ESTADAL GC 34 LIBERTAD	485	1	5	357	285	352	0	0	0	0	67	357
EDO. GUARICO	MP. MONAGAS	PQ. SAN RAFAEL DE ORITUCO	CONCENTRACION ESCOLAR GC 8 TUIRA PILONCITO	320	1	11	255	229	244	0	0	0	0	15	255
EDO. GUARICO	MP. MONAGAS	PQ. SAN RAFAEL DE ORITUCO	GRUPO ESCOLAR LUISA ROJAS DE GONZALEZ	2340	4	50	1858	1213	1808	0	10	0	1	584	1858
EDO. GUARICO	MP. MONAGAS	PQ. SAN RAFAEL DE ORITUCO	UNIDAD EDUCATIVA BOLIVARIANA EZEQUIEL ZAMORA	633	2	15	563	444	548	0	1	0	0	103	563
EDO. GUARICO	MP. MONAGAS	PQ. PASO REAL DE MACAIRA	ESCUELA DOCTOR BENITO GUTIERREZ LOPEZ	2074	4	24	1583	981	1559	0	9	3	0	566	1583
EDO. GUARICO	MP. MONAGAS	PQ. PASO REAL DE MACAIRA	ESCUELA ESTADAL CONCENTRADA GC 22 SAN ANTONIO DE TAMANACO	670	2	12	494	420	482	1	3	0	0	58	494
EDO. GUARICO	MP. MONAGAS	PQ. PASO REAL DE MACAIRA	UNIDAD EDUCATIVA NACIONAL PATRIA NUEVA	550	1	12	440	342	428	0	3	0	0	83	440
EDO. GUARICO	MP. RIBAS	PQ. TUCUPIDO	ESCUELA ESTADAL UNITARIA EL DOS	130	1	1	119	88	118	0	1	0	0	29	119
EDO. GUARICO	MP. RIBAS	PQ. TUCUPIDO	ESCUELA BOLIVARIANA EC 21 CUJI NEGRO	570	1	4	511	409	507	0	3	0	1	94	511
EDO. GUARICO	MP. RIBAS	PQ. TUCUPIDO	ESCUELA BASICA EC 45 LEONES DE FAJARDO	333	1	4	250	150	246	0	2	0	1	93	250
EDO. GUARICO	MP. RIBAS	PQ. TUCUPIDO	ESCUELA BASICA ARTURO ALVAREZ ALAYON	1406	3	23	1159	713	1136	0	11	1	2	409	1159
EDO. GUARICO	MP. RIBAS	PQ. TUCUPIDO	CENTRO DE EDUCACION INICIAL LOMAS DEL PARAISO	132	1	1	108	88	107	0	0	0	0	19	108
EDO. GUARICO	MP. RIBAS	PQ. TUCUPIDO	PRE ESCOLAR BOLIVARIANO NARCISO LOPEZ CAMACHO	394	1	6	333	188	327	0	0	1	0	138	333
EDO. GUARICO	MP. RIBAS	PQ. TUCUPIDO	ESCUELA DE ESPECIALIDADES VICTORIO CABEZA	546	1	5	461	207	456	0	1	0	0	248	461
EDO. GUARICO	MP. RIBAS	PQ. TUCUPIDO	ESCUELA PRIMARIA BOLIVARIANA EC 24 LA CABRERA	282	1	4	252	190	248	0	0	0	0	58	252
EDO. GUARICO	MP. RIBAS	PQ. TUCUPIDO	ESCUELA BOLIVARIANA SAN VICENTE	407	1	1	299	241	298	0	0	0	0	57	299
EDO. GUARICO	MP. RIBAS	PQ. TUCUPIDO	ESCUELA BASICA NACIONAL BOLIVARIANA ARENITA	305	1	1	221	149	220	0	0	2	0	69	221
EDO. GUARICO	MP. RIBAS	PQ. TUCUPIDO	UNIVERSIDAD NACIONAL EXPERIMENTAL DE LA FUERZA ARMADA   UNEFA	188	1	3	163	82	160	0	0	0	0	78	163
EDO. GUARICO	MP. RIBAS	PQ. TUCUPIDO	ESCUELA BASICA NARCISO LOPEZ CAMACHO	2850	5	46	2190	1055	2144	1	17	1	0	1070	2190
EDO. GUARICO	MP. RIBAS	PQ. TUCUPIDO	UNIDAD EDUCATIVA ESTADAL CONCENTRADA BOLIVARIANA DC 40 SOLEDAD Y BONANZA	162	1	1	156	120	155	0	5	0	0	30	156
EDO. GUARICO	MP. RIBAS	PQ. TUCUPIDO	ESCUELA BOLIVARIANA EC 7 EL JOBO	433	1	1	307	219	306	0	0	0	0	87	307
EDO. GUARICO	MP. RIBAS	PQ. TUCUPIDO	UNIDAD EDUCATIVA DC 23 SAN JOSE DE PUÑO DE ORO	349	1	2	275	208	273	1	1	1	0	62	275
EDO. GUARICO	MP. RIBAS	PQ. TUCUPIDO	CASA DEL PODER POPULAR	160	1	4	140	82	136	0	0	0	0	54	140
EDO. GUARICO	MP. RIBAS	PQ. TUCUPIDO	CENTRO DE EDUCACION INICIAL ROSA ELVIRA AQUINO	189	1	0	170	134	170	0	1	0	0	35	170
EDO. GUARICO	MP. RIBAS	PQ. TUCUPIDO	ESCUELA BASICA CAMPO ALEGRE	171	1	0	163	133	163	0	1	0	0	29	163
EDO. GUARICO	MP. RIBAS	PQ. TUCUPIDO	ESCUELA ESTADAL UNITARIA E 25 CERRO GRANDE	586	1	11	424	271	413	0	1	1	0	140	424
EDO. GUARICO	MP. RIBAS	PQ. TUCUPIDO	CASA DE LA CULTURA RAFAEL RENGIFO	472	1	9	412	236	403	0	3	0	0	164	412
EDO. GUARICO	MP. RIBAS	PQ. TUCUPIDO	ESCUELA NUCLEO ESCOLAR RURAL 498 LAS PALMAS	224	1	6	144	101	138	0	0	0	0	37	144
EDO. GUARICO	MP. RIBAS	PQ. TUCUPIDO	ESCUELA BOLIVARIANA EC 17 CAMACHO	550	1	6	372	205	366	0	1	0	0	160	372
EDO. GUARICO	MP. RIBAS	PQ. TUCUPIDO	UNIDAD EDUCATIVA BOLIVARIANA PEDRO DEL CORRAL	1087	2	13	907	520	894	0	6	0	0	368	907
EDO. GUARICO	MP. RIBAS	PQ. TUCUPIDO	CENTRO DE EDUCACION INICIAL ONDINA BALZA BENITEZ	211	1	4	189	146	185	0	4	0	0	35	189
EDO. GUARICO	MP. RIBAS	PQ. TUCUPIDO	ESCUELA NACIONAL BOLIVARIANA BELLA VISTA	977	2	19	770	557	751	0	2	0	0	192	770
EDO. GUARICO	MP. RIBAS	PQ. TUCUPIDO	GRUPO ESCOLAR FELIX ANTONIO SAA	2914	5	41	2198	1134	2157	2	17	4	0	1000	2198
EDO. GUARICO	MP. RIBAS	PQ. TUCUPIDO	CENTRO DE EDUCACION INICIAL EL ARRENDAJO	350	1	0	314	246	314	0	2	1	0	65	314
EDO. GUARICO	MP. RIBAS	PQ. TUCUPIDO	LICEO BOLIVARIANO VICTOR MANUEL OVALLES	2307	4	55	1830	789	1775	0	8	1	2	975	1830
EDO. GUARICO	MP. RIBAS	PQ. TUCUPIDO	UNIDAD EDUCATIVA NACIONAL JOSE CALIXTO MORIN	790	2	7	652	406	645	0	2	0	0	237	652
EDO. GUARICO	MP. RIBAS	PQ. TUCUPIDO	ESCUELA BOLIVARIANA MUERTO ZORRO	207	1	3	156	118	153	0	1	0	0	34	156
EDO. GUARICO	MP. RIBAS	PQ. TUCUPIDO	SIMONCITO JOSE FELIX RIBAS	829	2	13	698	474	685	0	6	0	1	204	698
EDO. GUARICO	MP. RIBAS	PQ. TUCUPIDO	ESCUELA BASICA SAN GERONIMO	140	1	0	128	80	128	0	0	0	0	48	128
EDO. GUARICO	MP. RIBAS	PQ. TUCUPIDO	ESCUELA E 12 CHAPARRAL	303	1	5	215	168	210	0	1	0	0	41	215
EDO. GUARICO	MP. RIBAS	PQ. TUCUPIDO	ESCUELA BASICA UNITARIA E 20 PARATE BUENO	223	1	4	165	136	161	0	2	0	0	23	165
EDO. GUARICO	MP. RIBAS	PQ. TUCUPIDO	ESCUELA ESTADAL ROBLECITO	275	1	4	209	151	205	0	0	1	0	53	209
EDO. GUARICO	MP. RIBAS	PQ. TUCUPIDO	UNIDAD EDUCATIVA BOLIVARIANA NACIONAL CARO DE LA NEGRA	1700	3	10	1250	883	1240	1	1	1	0	354	1250
EDO. GUARICO	MP. RIBAS	PQ. TUCUPIDO	EC 2 PAN DE AZUCAR	175	1	5	155	125	150	0	1	0	0	24	155
EDO. GUARICO	MP. RIBAS	PQ. TUCUPIDO	ESCUELA BOLIVARIANA LUIS GUGLIETA RAMOS	1569	3	30	1287	739	1257	0	7	0	1	510	1287
EDO. GUARICO	MP. RIBAS	PQ. SAN RAFAEL DE LAYA	JUNTA PARROQUIAL SAN RAFAEL DE LAYA	384	1	2	277	219	275	0	0	0	0	56	277
EDO. GUARICO	MP. RIBAS	PQ. SAN RAFAEL DE LAYA	ESCUELA TECNICA JOSE ANTONIO HURTADO ASCANIO	1901	4	23	1438	1034	1415	1	3	0	0	377	1438
EDO. GUARICO	MP. RIBAS	PQ. SAN RAFAEL DE LAYA	ESCUELA ESTADAL EC 22 LA ESTRELLA	268	1	5	191	99	186	0	1	0	0	86	191
EDO. YARACUY	MP. INDEPENDENCIA	CM. INDEPENDENCIA	CENTRO DE EDUCACION INICIAL INDEPENDENCIA	1618	3	30	1284	480	1254	0	17	1	0	756	1284
EDO. YARACUY	MP. INDEPENDENCIA	CM. INDEPENDENCIA	ESCUELA INTEGRAL BOLIVARIANA MARIA EVA DE LISCANO	2781	5	55	2345	1029	2290	2	12	2	2	1243	2345
EDO. YARACUY	MP. INDEPENDENCIA	CM. INDEPENDENCIA	INSTITUTO UNIVERSITARIO DE TECNOLOGIA DEL YARACUY IUTY	2956	6	46	2567	755	2521	0	5	1	0	1760	2567
EDO. YARACUY	MP. INDEPENDENCIA	CM. INDEPENDENCIA	CENTRO DE EDUCACION INICIAL DON JUANCHO	345	1	4	316	223	312	0	0	0	1	88	316
EDO. YARACUY	MP. INDEPENDENCIA	CM. INDEPENDENCIA	ESCUELA BASICA RAFAEL ANDRADE	1607	3	41	1381	573	1340	0	7	0	0	760	1381
EDO. YARACUY	MP. INDEPENDENCIA	CM. INDEPENDENCIA	ESCUELA INTEGRAL BOLIVARIANA LA NEGRITA	505	1	19	407	307	388	0	3	0	0	78	407
EDO. YARACUY	MP. INDEPENDENCIA	CM. INDEPENDENCIA	INTERNADO JUDICIAL	664	2	15	463	236	448	0	3	0	0	209	463
EDO. YARACUY	MP. INDEPENDENCIA	CM. INDEPENDENCIA	CENTRO DE EDUCACION INICIAL CUERPO DE BOMBEROS	602	2	16	532	260	516	0	1	1	0	254	532
EDO. YARACUY	MP. INDEPENDENCIA	CM. INDEPENDENCIA	OFICINA DE TRANSPORTE BOLIVARIANO	1219	3	29	942	602	913	0	6	0	0	305	942
EDO. YARACUY	MP. INDEPENDENCIA	CM. INDEPENDENCIA	CENTRO DE EDUCACION INICIAL  CONVENCIONAL DOCTOR RUBEN VILLALBA	1039	2	30	858	373	828	1	5	0	0	449	858
EDO. YARACUY	MP. INDEPENDENCIA	CM. INDEPENDENCIA	ESCUELA BASICA ANA ELISA LOPEZ	2923	6	68	2415	1028	2347	0	2	1	1	1315	2415
EDO. YARACUY	MP. INDEPENDENCIA	CM. INDEPENDENCIA	GIMNASIO CUBIERTO JESUS PIMPO ELORZA	1262	3	26	1145	468	1119	0	6	1	1	643	1145
EDO. YARACUY	MP. INDEPENDENCIA	CM. INDEPENDENCIA	ALDEA UNIVERSITARIA MISION SUCRE INDEPENDENCIA	1425	3	37	1321	644	1284	0	6	4	0	630	1321
EDO. YARACUY	MP. INDEPENDENCIA	CM. INDEPENDENCIA	UNIVERSIDAD SIMON RODRIGUEZ	28	1	1	25	11	24	0	0	0	0	13	25
EDO. YARACUY	MP. INDEPENDENCIA	CM. INDEPENDENCIA	ESCUELA BOLIVARIANA IGNACIO GREGORIO MENDEZ	1664	3	62	1339	586	1277	0	13	2	2	674	1339
EDO. YARACUY	MP. INDEPENDENCIA	CM. INDEPENDENCIA	ESCUELA INTEGRAL BOLIVARIANA TAMANAVARE	189	1	20	168	105	148	0	4	0	0	39	168
EDO. YARACUY	MP. INDEPENDENCIA	CM. INDEPENDENCIA	CENTRO DE EDUCACION  INICIAL BOLIVARIANO  IGNACIO GREGORIO MENDEZ	989	2	29	802	395	773	0	5	1	1	371	802
EDO. YARACUY	MP. INDEPENDENCIA	CM. INDEPENDENCIA	ESCUELA INTEGRAL BOLIVARIANA CAÑAVERAL	1462	3	33	1218	689	1185	0	4	0	0	492	1218
EDO. YARACUY	MP. INDEPENDENCIA	CM. INDEPENDENCIA	CENTRO DE EDUCACION INICIAL RAFAEL ANTONIO REYES ZUMETA	378	1	6	318	106	312	0	1	0	0	205	318
EDO. YARACUY	MP. INDEPENDENCIA	CM. INDEPENDENCIA	TALLER DE EDUCACION LABORAL BOLIVARIANO PILAR DE KREUBELL	345	1	7	301	143	294	0	2	0	0	149	301
EDO. YARACUY	MP. INDEPENDENCIA	CM. INDEPENDENCIA	ESCUELA INTEGRAL BOLIVARIANA VIJAGUAL	501	1	12	409	187	397	0	0	0	0	210	409
EDO. YARACUY	MP. INDEPENDENCIA	CM. INDEPENDENCIA	ESCUELA INTEGRAL BOLIVARIANA CASCABEL	2466	5	56	2089	803	2033	2	12	2	2	1212	2089
EDO. YARACUY	MP. INDEPENDENCIA	CM. INDEPENDENCIA	ESCUELA BASICA  BOLIVARIANA INDEPENDENCIA	3379	6	111	2735	1016	2624	0	14	1	3	1590	2735
EDO. YARACUY	MP. INDEPENDENCIA	CM. INDEPENDENCIA	CENTRO DE EDUCACION INICIAL VALLE DE LAS FLORES	823	2	8	694	251	686	0	8	1	0	426	694
EDO. YARACUY	MP. INDEPENDENCIA	CM. INDEPENDENCIA	LICEO BOLIVARIANO COMUNITARIO CASA TALLER CECILIA MUJICA	6	352	444
EDO. YARACUY	MP. INDEPENDENCIA	CM. INDEPENDENCIA	CENTRO DE EDUCACION  INICIAL YURUBI	1015	2	13	895	375	882	0	6	0	0	501	895
EDO. YARACUY	MP. INDEPENDENCIA	CM. INDEPENDENCIA	GIMNASIO CUBIERTO NICOLAS OJEDA PARRA	825	2	17	710	278	693	0	2	1	1	411	710
EDO. YARACUY	MP. INDEPENDENCIA	CM. INDEPENDENCIA	ESCUELA INTEGRAL BOLIVARIANA EZEQUIEL ZAMORA	975	2	23	811	511	788	0	8	1	0	268	811
EDO. YARACUY	MP. INDEPENDENCIA	CM. INDEPENDENCIA	CENTRO DE EDUCACION INICIAL MENCA DE LEONI	302	1	6	236	154	230	0	1	0	0	75	236
EDO. YARACUY	MP. INDEPENDENCIA	CM. INDEPENDENCIA	ESCUELA INTEGRAL BOLIVARIANA ADOLFO NAVAS CORONADO	2207	4	40	1814	780	1774	1	14	0	0	979	1814
EDO. YARACUY	MP. INDEPENDENCIA	CM. INDEPENDENCIA	ESCUELA BASICA SAN RAFAEL. NER 298	605	2	11	550	284	539	0	5	0	0	250	550
EDO. YARACUY	MP.JOSE ANTONIO PAEZ	CM. SABANA DE PARRA	ESCUELA BASICA MIGUEL ANTONIO FLORES	2450	5	46	2097	1443	2051	0	17	1	1	589	2097
EDO. YARACUY	MP.JOSE ANTONIO PAEZ	CM. SABANA DE PARRA	ESCUELA INTEGRAL BOLIVARIANA MAYURUPI	1540	3	32	1236	709	1204	0	11	1	0	483	1236
EDO. YARACUY	MP.JOSE ANTONIO PAEZ	CM. SABANA DE PARRA	ESCUELA BASICA JOSE ANTONIO PAEZ	746	2	12	646	452	634	1	2	0	0	179	646
EDO. YARACUY	MP.JOSE ANTONIO PAEZ	CM. SABANA DE PARRA	ESCUELA INTEGRAL BOLIVARIANA COPA REDONDA	2071	4	60	1719	1238	1659	1	14	0	0	406	1719
EDO. YARACUY	MP.JOSE ANTONIO PAEZ	CM. SABANA DE PARRA	ESCUELA INTEGRAL BOLIVARIANA RAFAEL CALDERA	884	2	20	746	596	726	0	2	1	0	127	746
EDO. YARACUY	MP.JOSE ANTONIO PAEZ	CM. SABANA DE PARRA	ESCUELA INTRGRAL BOLIVARIANA LA LIMA	337	1	4	302	259	298	0	1	0	0	38	302
EDO. YARACUY	MP.JOSE ANTONIO PAEZ	CM. SABANA DE PARRA	ESCUELA INTEGRAL BOLIVARIANA LA BLANQUERA	624	2	9	565	378	556	0	3	1	0	174	565
EDO. YARACUY	MP.JOSE ANTONIO PAEZ	CM. SABANA DE PARRA	ESCUELA INTEGRAL BOLIVARIANA LEOPOLDO TORREZ	912	2	28	789	617	761	0	4	2	0	138	789
EDO. YARACUY	MP.JOSE ANTONIO PAEZ	CM. SABANA DE PARRA	CENTRO DE EDUCACION INICIAL BOLIVARIANO MAYURUPI	1052	2	15	825	494	810	0	8	1	0	307	825
EDO. YARACUY	MP.JOSE ANTONIO PAEZ	CM. SABANA DE PARRA	ESCUELA INTEGRAL BOLIVARIANA PROFESORA REINA PARRA	1564	3	21	1298	812	1277	0	10	0	1	454	1298
EDO. YARACUY	MP.JOSE ANTONIO PAEZ	CM. SABANA DE PARRA	JARDIN DE INFANCIA SABANA DE PARRA	533	1	10	455	307	445	0	5	0	0	133	455
EDO. YARACUY	MP. NIRGUA	CM. NIRGUA	UNIDAD EDUCATIVA CAMPO AMOR	125	1	0	69	40	69	0	1	0	0	28	69
EDO. YARACUY	MP. NIRGUA	CM. NIRGUA	ESCUELA RURAL LAGUNA VERDE	324	1	4	245	188	241	0	3	0	0	50	245
EDO. YARACUY	MP. NIRGUA	CM. NIRGUA	ESCUELA INTEGRAL BOLIVARIANA  MIGUEL ANGEL GRANADO	2754	5	57	2265	1179	2208	1	8	2	1	1017	2265
EDO. YARACUY	MP. NIRGUA	CM. NIRGUA	ESCUELA INTEGRAL BOLIVARIANA PANCHITO	216	1	5	196	135	191	0	0	0	0	56	196
EDO. YARACUY	MP. NIRGUA	CM. NIRGUA	CASA COMUNAL DE GUERRERO	126	1	0	86	75	86	0	0	0	0	11	86
EDO. YARACUY	MP. NIRGUA	CM. NIRGUA	SEMILLERO CULTURAL AIRE LIBRE	391	1	13	369	203	356	0	0	0	0	153	369
EDO. YARACUY	MP. NIRGUA	CM. NIRGUA	ESCUELA  INTEGRAL BOLIVARIANA  LAS CAOBAS	119	1	3	92	79	89	0	1	0	0	9	92
EDO. YARACUY	MP. NIRGUA	CM. NIRGUA	ESCUELA CONCENTRADA LA MIEL CINCO LOMAS	277	1	4	196	163	192	0	0	0	0	29	196
EDO. YARACUY	MP. NIRGUA	CM. NIRGUA	ESCUELA INTEGRAL BOLIVARIANA LAS PIEDRITAS	631	2	11	545	400	534	0	2	0	2	130	545
EDO. YARACUY	MP. NIRGUA	CM. NIRGUA	ESCUELA INTEGRAL BOLIVARIANA SAN VICENTE	359	1	7	286	235	279	0	0	1	0	43	286
EDO. YARACUY	MP. NIRGUA	CM. NIRGUA	CENTRO DE EDUCACON INTEGRAL  NIRGUA	1369	3	33	1091	629	1058	0	4	0	0	425	1091
EDO. YARACUY	MP. NIRGUA	CM. NIRGUA	ESCUELA INTEGRAL BOLIVARIANA CEDEÑO	134	1	0	71	58	71	1	0	1	0	11	71
EDO. YARACUY	MP. NIRGUA	CM. NIRGUA	ESCUELA BASICA SAN LUIS	65	1	2	54	52	52	0	0	0	0	0	54
EDO. YARACUY	MP. NIRGUA	CM. NIRGUA	CENTRO DE EDUCACION INICIAL BOLIVARIANO MIGUEL ANGEL GRANADOS	1246	3	24	1013	528	989	1	8	0	1	451	1013
EDO. YARACUY	MP. NIRGUA	CM. NIRGUA	LICEO BOLIVARIANO HERIBERTO NUÑEZ OLIVEROS	1835	4	37	1505	878	1468	0	9	1	0	580	1505
EDO. YARACUY	MP. NIRGUA	CM. NIRGUA	NUCLEO ESCOLAR RURAL PALMARITO	159	1	0	126	123	126	0	0	0	0	3	126
EDO. YARACUY	MP. NIRGUA	CM. NIRGUA	TALLER DE EDUCACION LABORAL BOLIVARIANO NIRGUA	884	2	16	707	271	691	0	2	1	1	416	707
EDO. YARACUY	MP. NIRGUA	CM. NIRGUA	ESCUELA BASICA SANTA CRUZ NER 206	41	1	1	37	33	36	0	0	0	0	3	37
EDO. YARACUY	MP. NIRGUA	CM. NIRGUA	ESCUELA CONCENTRADA VAQUIRA	223	1	1	187	125	186	0	0	0	0	61	187
EDO. YARACUY	MP. NIRGUA	CM. NIRGUA	CENTRO DE EDUCACION INICIAL BOLIVARIANO DOCTOR HUMBERTO CUENCA ( EL MOSCU)	191	1	4	173	133	169	0	3	0	0	33	173
EDO. YARACUY	MP. NIRGUA	CM. NIRGUA	ESCUELA BASICA PALO SOLO	294	1	2	255	226	253	0	1	0	0	26	255
EDO. YARACUY	MP. NIRGUA	CM. NIRGUA	ESCUELA INTEGRAL BOLIVARIANA CERRO DE PAJA	65	1	1	47	18	46	0	0	1	0	27	47
EDO. YARACUY	MP. NIRGUA	CM. NIRGUA	ESCUELA INTEGRAL BOLIVARIANA SANTA ROSA DE TEJERIAS	341	1	1	260	241	259	0	1	0	0	17	260
EDO. YARACUY	MP. NIRGUA	CM. NIRGUA	UNIDAD EDUCATIVA BURIA	1880	4	38	1465	964	1427	1	10	1	0	451	1465
EDO. YARACUY	MP. NIRGUA	CM. NIRGUA	ALDEA UNIVERSITARIA BOLIVARIANA MISION SUCRE	311	1	4	262	163	258	0	1	0	0	94	262
EDO. YARACUY	MP. NIRGUA	CM. NIRGUA	ESCUELA RURAL LAS GLORIAS	208	1	5	170	95	165	0	0	1	0	69	170
EDO. YARACUY	MP. NIRGUA	CM. NIRGUA	CENTRO DE EDUCACION INICIAL ANDRES BELLO	974	2	17	782	506	765	0	3	0	0	256	782
EDO. YARACUY	MP. NIRGUA	CM. NIRGUA	ESCUELA RURAL NUARITO	341	1	4	270	231	266	0	0	0	0	35	270
EDO. YARACUY	MP. NIRGUA	CM. NIRGUA	ESCUELA INTEGRAL BOLIVARIANA CABUY	1107	2	26	885	677	859	5	3	1	1	172	885
EDO. YARACUY	MP. NIRGUA	CM. NIRGUA	CENTRO DE EDUCACION INCIAL FRANCISCO JAVIER USTARIZ	950	2	11	762	389	751	0	2	1	2	357	762
EDO. YARACUY	MP. NIRGUA	CM. NIRGUA	ESCUELA RURAL ORUBAL	79	1	0	49	45	49	0	0	0	0	4	49
EDO. YARACUY	MP. NIRGUA	CM. NIRGUA	ESCUELA INTEGRAL BOLIVARIANA LOS COGOLLOS	515	1	12	344	201	332	0	5	0	0	126	344
EDO. YARACUY	MP. NIRGUA	CM. NIRGUA	ESCUELA BASICA EL PICACHO	317	1	4	254	212	250	0	0	0	0	38	254
EDO. YARACUY	MP. NIRGUA	CM. NIRGUA	ESCUELAINTEGRAL BOLIVARIANA PARACAJE	279	1	4	203	179	199	0	0	0	0	20	203
EDO. YARACUY	MP. NIRGUA	CM. NIRGUA	CENTRO DE EDUCACIÓN INICIAL BOLIVARIANO SIMONCITO DOCTOR ARTURO USLAR PIETRI	249	1	6	229	167	223	0	1	0	0	55	229
EDO. YARACUY	MP. NIRGUA	CM. NIRGUA	ESCUELA BOLIVARIANA EL CHARAY	150	1	1	113	90	112	0	1	0	1	20	113
EDO. YARACUY	MP. NIRGUA	CM. NIRGUA	ESCUELA RURAL LA LAGUNITA	81	1	0	50	45	50	0	1	0	0	4	50
EDO. YARACUY	MP. NIRGUA	CM. NIRGUA	ESCUELA BASICA LOS PINOS	971	2	22	830	536	808	0	6	0	0	266	830
EDO. YARACUY	MP. NIRGUA	CM. NIRGUA	ESCUELA INTEGRAL BOLIVARIANA GUAYABAL	129	1	0	115	108	115	0	0	1	0	6	115
EDO. YARACUY	MP. NIRGUA	CM. NIRGUA	ESCUELA BASICA FRANCISCO JAVIER USTARIZ	4156	8	96	3356	1342	3260	3	20	2	1	1892	3356
EDO. YARACUY	MP. NIRGUA	CM. NIRGUA	ESCUELA ESTADAL GRADUADA NIEVES ENTRENA	1238	3	25	1025	670	1000	0	8	0	3	319	1025
EDO. YARACUY	MP. NIRGUA	CM. NIRGUA	ESCUELA RURAL LA CANDELARIA	380	1	7	298	223	291	0	1	0	0	67	298
EDO. YARACUY	MP. NIRGUA	CM. NIRGUA	CENTRO DE EDUCACION INICIAL BOLIVARIANO SIMONCITO POZO DE LA VACA	224	1	2	195	161	193	1	1	0	0	30	195
EDO. YARACUY	MP. NIRGUA	CM. NIRGUA	ESCUELA BASICA LA CHAPA	1855	4	37	1479	808	1442	0	9	1	1	623	1479
EDO. YARACUY	MP. NIRGUA	CM. NIRGUA	ESCUELA BOLIVARIANA EL CHORRO	175	1	4	140	125	136	0	0	1	0	10	140
EDO. YARACUY	MP. NIRGUA	CM. NIRGUA	ESCUELA RURAL SANTA ANA O LA JOSEFINA	184	1	2	123	74	121	0	2	0	0	45	123
EDO. YARACUY	MP. NIRGUA	CM. NIRGUA	ESCUELA RURAL SANTA LUCIA	172	1	1	119	100	118	0	0	0	0	18	119
EDO. YARACUY	MP. NIRGUA	CM. NIRGUA	ESCUELA INTEGRAL BOLIVARIANA GARCI GONZALEZ	100	1	3	92	64	89	0	1	1	0	23	92
EDO. YARACUY	MP. NIRGUA	PQ. SALOM	ESCUELA INTEGRAL BOLIVARIANA ARAGUATA	842	2	17	689	524	672	0	6	1	1	140	689
EDO. YARACUY	MP. NIRGUA	PQ. SALOM	ESCUELA INTEGRAL BOLIVARIANA MURACHI	1088	2	12	857	501	845	1	5	0	2	336	857
EDO. YARACUY	MP. NIRGUA	PQ. SALOM	ESCUELA INTEGRAL BOLIVARIANA CORUMBO	303	1	6	263	159	257	0	3	1	0	94	263
EDO. YARACUY	MP. NIRGUA	PQ. SALOM	ESCUELA CONCENTRADA LAS MARGARITAS	495	1	10	414	313	404	0	2	0	0	89	414
EDO. YARACUY	MP. NIRGUA	PQ. SALOM	ESCUELA INTEGRAL BOLIVARIANA TAYA	514	1	3	428	329	425	0	1	0	0	95	428
EDO. YARACUY	MP. NIRGUA	PQ. SALOM	ESCUELA INTEGRAL BOLIVARIANA LA HERRERA	358	1	4	296	208	292	0	0	0	0	84	296
EDO. YARACUY	MP. NIRGUA	PQ. SALOM	ESCUELA INTEGRAL BOLIVARIANA LAS LAGUNAS	1612	3	22	1217	733	1195	0	12	2	1	447	1217
EDO. YARACUY	MP. NIRGUA	PQ. SALOM	ESCUELA INTEGRAL BOLIVARIANA MADERA	646	2	5	506	361	501	0	1	0	0	139	506
EDO. YARACUY	MP. NIRGUA	PQ. SALOM	ESCUELA INTEGRAL BOLIVARIANA PEDRO MARIA SOSA	2136	4	35	1759	997	1724	0	5	3	0	719	1759
EDO. YARACUY	MP. NIRGUA	PQ. SALOM	UNIDAD EDUCATIVA FRAY MARCELINO DE SAN VICENTE	196	1	3	158	146	155	0	0	0	0	9	158
EDO. YARACUY	MP. NIRGUA	PQ. SALOM	ESCUELA INTEGRAL BOLIVARIANA LOS POTREROS	475	1	16	382	300	366	0	1	0	1	64	382
EDO. YARACUY	MP. NIRGUA	PQ. SALOM	ESCUELA RURAL QUIRIQUIRE	309	1	3	237	200	234	0	2	0	0	32	237
EDO. YARACUY	MP. NIRGUA	PQ. SALOM	ESCUELA RURAL SAN RAFAEL	175	1	1	124	58	123	0	0	0	0	65	124
EDO. YARACUY	MP. NIRGUA	PQ. SALOM	ESCUELA RURAL LAS PARCHAS	285	1	9	225	152	216	0	1	0	0	63	225
EDO. YARACUY	MP. NIRGUA	PQ. SALOM	ESCUELA INTEGRAL BOLIVARIANA LA TRINIDAD
EDO. YARACUY	MP. NIRGUA	PQ. TEMERLA	ESCUELA CONCENTRADA LAS VEGAS	185	1	3	120	93	117	0	1	0	0	23	120
EDO. YARACUY	MP. NIRGUA	PQ. TEMERLA	ESCUELA INTEGRAL BOLIVARIANA RAFAEL RANGEL	1083	2	20	838	624	818	0	3	0	1	190	838
EDO. YARACUY	MP. NIRGUA	PQ. TEMERLA	ESCUELA RURAL ESCONDIDO	174	1	6	143	94	137	0	0	0	0	43	143
EDO. YARACUY	MP. NIRGUA	PQ. TEMERLA	ESCUELA BASICA RIO GRANDE NER 300	79	1	0	70	67	70	0	0	0	0	3	70
EDO. YARACUY	MP. NIRGUA	PQ. TEMERLA	ESCUELA INTEGRAL BOLIVARIANA VALLECITO	141	1	2	125	113	123	0	0	0	0	10	125
EDO. YARACUY	MP. NIRGUA	PQ. TEMERLA	ESCUELA PRIMARIA  RURAL SANTA ROSA	259	1	4	224	181	220	0	2	0	0	37	224
EDO. YARACUY	MP. NIRGUA	PQ. TEMERLA	ESCUELA UNITARIA EL CAMBUR	50	1	1	40	28	39	0	1	0	0	10	40
EDO. YARACUY	MP. NIRGUA	PQ. TEMERLA	ESCUELA UNITARIA COCOTE	77	1	3	54	40	51	0	0	0	0	11	54
EDO. YARACUY	MP. LA TRINIDAD	CM. BORAURE	ESCUELA INTEGRAL BOLIVARIANA  DURUTE NER 177	143	1	1	129	82	128	0	0	0	0	46	129
EDO. YARACUY	MP. LA TRINIDAD	CM. BORAURE	ESCUELA INTEGRAL BOLIVARIANA GUARATIBANA	483	1	8	380	276	372	0	3	1	0	92	380
EDO. YARACUY	MP. LA TRINIDAD	CM. BORAURE	ESCUELA INTEGRAL BOLIVARIANA OBONTE	476	1	10	410	277	400	0	1	0	0	122	410
EDO. YARACUY	MP. LA TRINIDAD	CM. BORAURE	ESCUELA BASICA BUENA VISTA	1846	4	55	1569	851	1514	0	8	0	1	654	1569
EDO. YARACUY	MP. LA TRINIDAD	CM. BORAURE	CENTRO DE RECUPERACION NUTRICIONAL MELITON CAMBERO.	932	2	11	856	568	845	0	8	1	0	268	856
EDO. YARACUY	MP. LA TRINIDAD	CM. BORAURE	ESCUELA BASICA JOSE ANTONIO PAEZ	2181	4	41	1728	832	1687	0	5	1	2	847	1728
EDO. YARACUY	MP. LA TRINIDAD	CM. BORAURE	CENTRO DE EDUCACION INICIAL BOLIVARIANO SIMON RODRIGUEZ	363	1	12	339	214	327	0	2	0	0	111	339
EDO. YARACUY	MP. LA TRINIDAD	CM. BORAURE	ESCUELA INTEGRAL LA PAULA	63	1	2	56	52	54	0	0	0	0	2	56
EDO. YARACUY	MP. LA TRINIDAD	CM. BORAURE	ESCUELA INTEGRAL BOLIVARIANA OBONTICO	286	1	10	261	158	251	0	1	0	0	92	261
EDO. YARACUY	MP. LA TRINIDAD	CM. BORAURE	UNIDAD EDUCATIVA DOCTOR JOSE MARIA VARGAS	862	2	21	780	456	759	0	5	0	0	298	780
EDO. YARACUY	MP. LA TRINIDAD	CM. BORAURE	ESCUELA BASICA ELBA ROSA SANTANA	937	2	12	806	405	794	0	2	0	0	387	806
EDO. YARACUY	MP. LA TRINIDAD	CM. BORAURE	ESCUELA INTEGRAL BOLIVARIANA JOSE ANTONIO SOSA GUILLEN	2181	4	63	1814	911	1751	2	10	0	0	828	1814
EDO. YARACUY	MP. LA TRINIDAD	CM. BORAURE	CENTRO DE EDUCACION INICIAL BORAURE	365	1	7	304	171	297	0	1	0	0	125	304
EDO. YARACUY	MP. VEROES	CM. FARRIAR	ESCUELA INTEGRAL BOLIVARIANA LA HOYA	542	1	2	432	311	430	0	0	1	0	118	432
EDO. YARACUY	MP. VEROES	CM. FARRIAR	ESCUELA  INTEGRAL BOLIVARIANA  MERCEDES MORO DE FUENTES	738	2	16	598	447	582	1	3	0	0	131	598
EDO. YARACUY	MP. VEROES	CM. FARRIAR	ESCUELA INTEGRAL BOLIVARIANA JOSE JOAQUIN VEROES	418	1	6	368	310	362	0	1	0	0	51	368
EDO. YARACUY	MP. VEROES	CM. FARRIAR	UNIDAD EDUCATIVA  ABIGAIL LOZANO	1823	4	33	1386	1054	1353	0	6	0	0	293	1386
EDO. YARACUY	MP. VEROES	CM. FARRIAR	ESCUELA INTEGRAL BOLIVARIANA LOS CAÑIZOS	924	2	14	794	736	780	0	0	1	0	43	794
EDO. YARACUY	MP. VEROES	CM. FARRIAR	ESCUELA  INTEGRAL BOLIVARIANA LA PICA	662	2	29	557	463	528	0	2	1	0	62	557
EDO. YARACUY	MP. VEROES	CM. FARRIAR	ESCUELA BASICA VISTA ALEGRE	203	1	2	177	133	175	0	0	0	0	42	177
EDO. YARACUY	MP. VEROES	CM. FARRIAR	ESCUELA INTEGRAL BOLIVARIANA CARBONERO	646	2	9	491	395	482	0	2	0	1	84	491
EDO. YARACUY	MP. VEROES	CM. FARRIAR	ESCUELA INTEGRAL BOLIVARIANA GRAN MARISCAL DE AYACUCHO	1031	2	26	848	692	822	0	1	0	0	129	848
EDO. YARACUY	MP. VEROES	CM. FARRIAR	ESCUELA INTEGRAL BOLIVARIANA PALO QUEMAO	414	1	8	343	212	335	0	1	0	0	122	343
EDO. YARACUY	MP. VEROES	CM. FARRIAR	CENTRO DE EDUCACION INICIAL BOLIVARIANO ABIGAIL LOZANO	455	1	13	409	350	396	0	2	0	0	44	409
EDO. YARACUY	MP. VEROES	CM. FARRIAR	ESCUELA BOLIVARIANA KILOMETRO 26	111	1	1	88	79	87	0	0	0	0	8	88
EDO. YARACUY	MP. VEROES	CM. FARRIAR	ESCUELA INTEGRAL BOLIVARIANA PALMAREJO	842	2	25	688	595	663	0	9	0	0	59	688
EDO. YARACUY	MP. VEROES	PQ. EL GUAYABO	CENTROS DE EDUCACION INICIAL BOLIVARIANO EL GUAYABO	213	1	5	193	178	188	0	0	0	0	10	193
EDO. YARACUY	MP. VEROES	PQ. EL GUAYABO	ESCUELA   MIXTA GUABINITA	54	1	0	38	20	38	0	0	0	0	18	38
EDO. YARACUY	MP. VEROES	PQ. EL GUAYABO	ESCUELA  BASICA  GABRIEL MARIA  REYES ZUMETA.	1249	3	29	975	741	946	0	7	2	0	196	975
EDO. YARACUY	MP. VEROES	PQ. EL GUAYABO	ESCUELA INTEGRAL BOLIVARIANA EL TORITO	221	1	1	192	153	191	0	0	0	0	38	192
EDO. YARACUY	MP. VEROES	PQ. EL GUAYABO	ESCUELA CONCENTRADA PEÑAS DE TARIA	432	1	1	327	203	326	0	0	1	0	122	327
EDO. YARACUY	MP. VEROES	PQ. EL GUAYABO	ESCUELA BASICA  PEÑAS DE CABRIAS NER 036	92	1	5	77	66	72	0	0	0	0	6	77
EDO. YARACUY	MP. VEROES	PQ. EL GUAYABO	ESCUELA BASICA GENERAL CRUZ CARRILLO	794	2	22	658	509	636	0	6	0	0	121	658
EDO. YARACUY	MP. VEROES	PQ. EL GUAYABO	ESCUELA BASICA  RIO CHIQUITO NER 036
EDO. YARACUY	MP. VEROES	PQ. EL GUAYABO	CENTRO DE EDUCACION INICIAL   LA GRUTA NER 036	150	1	1	136	103	135	0	2	0	0	30	136
EDO. YARACUY	MP. VEROES	PQ. EL GUAYABO	ESCUELA INTEGRAL BOLIVARIANA ANTONIO JOSE DE SUCRE	471	1	6	375	258	369	0	2	0	0	109	375
EDO. YARACUY	MP. VEROES	PQ. EL GUAYABO	JARDIN DE INFANCIA BOLIVARIANO MORITA CARRILLO 2	252	1	3	229	187	226	0	3	0	0	36	229
EDO. YARACUY	MP. VEROES	PQ. EL GUAYABO	ESCUELA  INTEGRAL BOLIVARIANA LA LLANADA	211	1	1	173	147	172	0	0	0	0	25	173
EDO. YARACUY	MP. VEROES	PQ. EL GUAYABO	ESCUELA INTEGRAL BOLIVARIANA TULIPAN	205	1	5	184	158	179	0	0	0	0	21	184
EDO. YARACUY	MP. VEROES	PQ. EL GUAYABO	LICEO BOLIVARIANO FRANCISCO HERRERA VEGA	1764	3	54	1457	1112	1403	2	3	2	0	284	1457
EDO. YARACUY	MP. VEROES	PQ. EL GUAYABO	ESCUELA INTEGRAL BOLIVARIANA LA RAYA	738	2	14	613	442	599	0	1	0	0	156	613
EDO. YARACUY	MP. VEROES	PQ. EL GUAYABO	ESCUELA INTEGRAL BOLIVARIANA ANTONIO FIGUEROA	673	2	13	556	390	543	0	1	0	1	151	556
EDO. YARACUY	MP. VEROES	PQ. EL GUAYABO	ESCUELA INTEGRAL BOLIVARIANA BELLA VISTA	731	2	32	533	290	501	0	2	0	0	209	533
EDO. YARACUY	MP. VEROES	PQ. EL GUAYABO	ESCUELA INTEGRAL BOLIVARIANA MAPORITA	409	1	6	350	311	344	0	0	0	0	33	350
EDO. YARACUY	MP. VEROES	PQ. EL GUAYABO	ESUELA INTEGRAL BOLIVARIANA PEDRO JOSE PADILLA	450	1	7	338	223	331	0	0	0	1	107	338
EDO. YARACUY	MP. ARISTIDES BASTID	CM. SAN PABLO	ESCUELA BASICA CARRIZALITO	594	1	9	508	380	499	0	3	0	0	116	508
EDO. YARACUY	MP. ARISTIDES BASTID	CM. SAN PABLO	ESCUELA INTEGRAL BOLIVARIANA RAFAEL ANTONIO MUJICA	1234	3	31	1003	681	972	1	7	3	0	280	1003
EDO. YARACUY	MP. ARISTIDES BASTID	CM. SAN PABLO	CENTRO DE EDUCACION INICIAL BOLIVARIANO CARRIZALES	326	1	9	294	225	285	0	2	0	0	58	294
EDO. YARACUY	MP. ARISTIDES BASTID	CM. SAN PABLO	ESCUELA NACIONAL LA MATA	194	1	3	148	104	145	0	0	0	0	41	148
EDO. YARACUY	MP. ARISTIDES BASTID	CM. SAN PABLO	ESCUELA BASICA RURAL SABANA LARGA	540	1	7	420	310	413	0	1	1	0	101	420
EDO. YARACUY	MP. ARISTIDES BASTID	CM. SAN PABLO	CENTRO DE EDUCACION INICIAL ESTADAL SAN PABLO	278	1	4	258	177	254	0	2	0	0	75	258
EDO. YARACUY	MP. ARISTIDES BASTID	CM. SAN PABLO	LICEO BOLIVARIANO CREACION SAN PABLO	1708	3	28	1347	806	1319	1	9	0	0	503	1347
EDO. YARACUY	MP. ARISTIDES BASTID	CM. SAN PABLO	CENTRO DE EDUCACION INICIAL BOLIVARIANO LUISA DE MORALES	164	1	4	159	106	155	0	1	0	0	48	159
EDO. YARACUY	MP. ARISTIDES BASTID	CM. SAN PABLO	ESCUELA INTEGRAL BOLIVARIANA LA CUMBRE	56	1	1	47	45	46	0	0	0	0	1	47
EDO. YARACUY	MP. ARISTIDES BASTID	CM. SAN PABLO	ESCUELA INTEGRAL BOLIVARIANA CAMINO ATRAVESADO	269	1	4	245	165	241	0	2	0	0	74	245
EDO. YARACUY	MP. ARISTIDES BASTID	CM. SAN PABLO	GUARDERIA INFANTIL MARIA ANGELICA LUSINCHI	1065	2	21	878	520	857	0	3	1	0	333	878
EDO. YARACUY	MP. ARISTIDES BASTID	CM. SAN PABLO	ESCUELA INTEGRAL BOLIVARIANA EL DIVIDIVE	497	1	13	414	264	401	0	2	0	0	135	414
EDO. YARACUY	MP. ARISTIDES BASTID	CM. SAN PABLO	ESCUELA CONCENTRADA TARTAGAL	660	2	11	565	409	554	0	5	0	0	140	565
EDO. YARACUY	MP. ARISTIDES BASTID	CM. SAN PABLO	ESCUELA INTEGRAL BOLIVARIANA CAMUNARE	711	2	4	600	426	596	1	5	1	0	163	600
EDO. YARACUY	MP. ARISTIDES BASTID	CM. SAN PABLO	ESCUELA BASICA SAN PABLO	950	2	19	760	417	741	0	7	0	0	317	760
EDO. YARACUY	MP. ARISTIDES BASTID	CM. SAN PABLO	ESCUELA CONCENTRADA LA PICA	675	2	12	579	425	567	0	1	0	0	141	579
EDO. YARACUY	MP. ARISTIDES BASTID	CM. SAN PABLO	ESCUELA BASICA VICENTE EMILIO SOJO	751	2	22	621	443	599	0	3	0	0	153	621
EDO. YARACUY	MP. ARISTIDES BASTID	CM. SAN PABLO	ESCUELA BASICA LA CARRETERA	224	1	3	186	127	183	0	0	0	0	56	186
EDO. YARACUY	MP. ARISTIDES BASTID	CM. SAN PABLO	ESCUELA ESTADAL CONCENTRADA  LA GOTERA	934	2	22	756	454	734	0	6	0	0	274	756
EDO. YARACUY	MP. ARISTIDES BASTID	CM. SAN PABLO	ESCUELA BASICA LUISA DE MORALES	1911	4	44	1447	829	1403	1	7	0	2	564	1447
EDO. YARACUY	MP. ARISTIDES BASTID	CM. SAN PABLO	ESCUELA  BASICA  HIGUERON	87	1	2	78	73	76	0	0	0	0	3	78
EDO. YARACUY	MP. PE#A	PQ. SAN ANDRES	CENTRO DE EDUCACION INICIAL BOLIVARIANO REINALDO REYES	1234	3	26	994	545	968	1	7	0	0	415	994
EDO. YARACUY	MP. PE#A	PQ. SAN ANDRES	ESCUELA INTEGRAL BOLIVARIANA TACARIGUITA	138	1	2	129	96	127	0	1	0	0	30	129
EDO. YARACUY	MP. PE#A	PQ. SAN ANDRES	ESCUELA BASICA  LA ENSENADA	885	2	11	699	422	688	0	2	0	2	262	699
EDO. YARACUY	MP. PE#A	PQ. SAN ANDRES	ESCUELA BASICA  SABANA DE TIQUIRE NER 231	78	1	1	70	39	69	0	2	1	0	27	70
EDO. YARACUY	MP. PE#A	PQ. SAN ANDRES	ESCUELA BASICA  EL CARDON	463	1	21	365	298	344	0	0	1	0	45	365
EDO. YARACUY	MP. PE#A	PQ. SAN ANDRES	ESCUELA INTEGRAL  BOLIVARIANA REINALDO REYES	1762	3	28	1375	744	1347	0	18	4	1	580	1375
EDO. YARACUY	MP. PE#A	PQ. SAN ANDRES	ESCUELA BOLIVARIANA JORNADA COMPLETA TACARIGUA.	100	1	2	92	72	90	0	2	0	0	16	92
EDO. YARACUY	MP. PE#A	PQ. SAN ANDRES	ESCUELA INTEGRAL BOLIVARIANA CUJIZAL	597	1	10	459	330	449	0	1	0	0	118	459
EDO. YARACUY	MP. PE#A	PQ. SAN ANDRES	ESCUELA BASICA CONCENTRADA MIXTA LA MAPORITA. NER 231	369	1	8	309	213	301	0	1	0	0	87	309
EDO. YARACUY	MP. PE#A	CM. YARITAGUA	ESCUELA INTEGRAL  BOLIVARIANA  AGUA VIVA	353	1	4	242	190	238	1	3	2	0	42	242
EDO. YARACUY	MP. PE#A	CM. YARITAGUA	ESCUELA TECNICA ROBINSONIANA CARLOS JOSE MUJICA	2703	5	44	2210	1401	2166	2	11	4	0	748	2210
EDO. YARACUY	MP. PE#A	CM. YARITAGUA	CENTRO DE EDUCACION INICIAL BOLIVARIANO MARIA LUISA DE GARRIDO	157	1	2	149	127	147	0	0	0	0	20	149
EDO. YARACUY	MP. PE#A	CM. YARITAGUA	ESCUELA BASICA JUAN MIGUEL ROO	2372	5	33	1899	1242	1866	1	5	0	0	618	1899
EDO. YARACUY	MP. PE#A	CM. YARITAGUA	ESCUELA BASICA CARMEN FERNANDEZ DE LEONI	2759	5	67	2211	1516	2144	1	20	4	2	601	2211
EDO. YARACUY	MP. PE#A	CM. YARITAGUA	UNIDAD EDUCATIVA LAUREANO VILLANUEVA	2618	5	41	2142	1170	2101	0	14	3	1	913	2142
EDO. YARACUY	MP. PE#A	CM. YARITAGUA	ESCUELA NACIONAL ARENALES	265	1	8	240	216	232	0	3	0	0	13	240
EDO. YARACUY	MP. PE#A	CM. YARITAGUA	CENTRO DE EDUCACION INICIAL BOLIVARIANA JUAN MIGUEL ROO	333	1	5	308	222	303	0	2	0	0	79	308
EDO. YARACUY	MP. PE#A	CM. YARITAGUA	CENTRO DE DIOS AMOR DE CRISTO	126	1	5	113	72	108	0	0	0	0	36	113
EDO. YARACUY	MP. PE#A	CM. YARITAGUA	ESCUELA BASICA JESUS MILLAN	2402	5	58	1960	1042	1902	1	11	1	0	847	1960
EDO. YARACUY	MP. PE#A	CM. YARITAGUA	ESCUELA BASICA MATILDE LUCIA GONZALEZ	1572	3	25	1301	875	1276	0	10	1	0	390	1301
EDO. YARACUY	MP. PE#A	CM. YARITAGUA	UNIDAD EDUCATIVA NIRGUA	2078	4	41	1673	1058	1632	2	6	2	0	564	1673
EDO. YARACUY	MP. PE#A	CM. YARITAGUA	ESCUELA INTEGRAL BOLIVARIANA  ARENALES	455	1	7	410	351	403	1	2	0	0	49	410
EDO. YARACUY	MP. PE#A	CM. YARITAGUA	ESCUELA INTEGRAL BOLIVARIANA LAS ANIMAS NER 231	96	1	2	83	71	81	0	1	0	1	8	83
EDO. YARACUY	MP. PE#A	CM. YARITAGUA	CENTRO DE EDUCATION INICIAL BOLIVARIANO SIMONCITO MATILDE LUCIA GONZALEZ	204	1	1	191	140	190	0	1	0	0	49	191
EDO. YARACUY	MP. PE#A	CM. YARITAGUA	ESCUELA BASICA MARIA TERESA SANZ	1538	3	40	1304	769	1264	0	14	0	0	481	1304
EDO. YARACUY	MP. PE#A	CM. YARITAGUA	ESCUELA BASICA CONSUELO DE RODRIGUEZ	2534	5	41	2093	1021	2052	0	4	1	0	1026	2093
EDO. YARACUY	MP. PE#A	CM. YARITAGUA	CENTRO DE EDUCACION INICIAL BOLIVARIANO SABANITA	1386	3	49	1160	794	1111	0	12	1	0	304	1160
EDO. YARACUY	MP. PE#A	CM. YARITAGUA	CENTRO DE EDUCACION INICIAL  BOLIVARIANO MANUEL CEDEÑO.	1131	2	24	936	328	912	0	3	0	0	581	936
EDO. YARACUY	MP. PE#A	CM. YARITAGUA	ESCUELA INTEGRAL  BOLIVARIANA EL SALTO	475	1	7	371	254	364	0	1	0	2	107	371
EDO. YARACUY	MP. PE#A	CM. YARITAGUA	ESCUELA BASICA ROSARIO MONTERO DE MORON	1565	3	34	1285	885	1251	0	8	1	0	357	1285
EDO. YARACUY	MP. PE#A	CM. YARITAGUA	ESCUELA INTEGRAL BOLIVARIANA  YUMARITO	187	1	3	173	149	170	0	1	0	0	20	173
EDO. YARACUY	MP. PE#A	CM. YARITAGUA	ESCUELA BASICA ANTONIO PINTO SALINAS	791	2	17	585	418	568	0	6	2	0	142	585
EDO. YARACUY	MP. PE#A	CM. YARITAGUA	ESCUELA ESTATAL UNITARIA URIBEQUE	51	1	3	42	37	39	0	0	0	0	2	42
EDO. YARACUY	MP. PE#A	CM. YARITAGUA	ESCUELA BASICA JOSE ATANACIO GONZALEZ	1831	4	22	1458	1107	1436	0	7	1	1	320	1458
EDO. YARACUY	MP. PE#A	CM. YARITAGUA	ESCUELA BASICA  CAMBURITO. NER 231	87	1	0	79	74	79	0	2	0	0	3	79
EDO. YARACUY	MP. PE#A	CM. YARITAGUA	ESCUELA BASICA MANUEL CEDEÑO	2708	5	33	2226	849	2193	0	10	5	2	1327	2226
EDO. YARACUY	MP. PE#A	CM. YARITAGUA	CENTRO DE EDUCACION INICIAL BOLIVARIANO MARIA DOLORES MOSQUERA	723	2	24	626	508	602	0	1	0	0	93	626
EDO. YARACUY	MP. PE#A	CM. YARITAGUA	CENTRO DE EDUCACION INICIAL LOS ROSALES	1469	3	26	1277	914	1251	0	7	1	0	329	1277
EDO. YARACUY	MP. PE#A	CM. YARITAGUA	LICEO COCOROTE	2831	5	52	2242	1140	2190	1	11	2	1	1035	2242
EDO. YARACUY	MP. PE#A	CM. YARITAGUA	JARDIN DE INFANCIA YARITAGUA	942	2	10	765	428	755	0	2	0	0	325	765
EDO. YARACUY	MP. PE#A	CM. YARITAGUA	CENTRO DE ALIMENTACION EZEQUIEL ZAMORA	56	1	1	52	48	51	0	0	1	0	2	52
EDO. YARACUY	MP. PE#A	CM. YARITAGUA	ESCUELA CONCENTRADA LOS TUBOS	123	1	1	102	79	101	0	0	0	0	22	102
EDO. YARACUY	MP. PE#A	CM. YARITAGUA	ESCUELA INTEGRAL BOLIVARIANA PUEBLO NUEVO	323	1	4	294	234	290	0	0	0	1	55	294
EDO. YARACUY	MP. PE#A	CM. YARITAGUA	ESCUELA INTEGRAL BOLIVARIANA  BARRIO NUEVO	435	1	7	400	376	393	0	1	0	0	16	400
EDO. YARACUY	MP. PE#A	CM. YARITAGUA	ESCUELA BASICA TOTUMILLO HERMINIA FARIAS	2239	4	44	1797	1320	1753	0	10	1	0	422	1797
EDO. YARACUY	MP. PE#A	CM. YARITAGUA	ESCUELA BASICA YOCASTA DE CALISTRI	1047	2	15	932	517	917	0	3	0	0	397	932
EDO. YARACUY	MP. PE#A	CM. YARITAGUA	ESCUELA INTEGRAL  BOLIVARIANA GUAREMAL	419	1	5	330	289	325	0	2	0	1	33	330
EDO. YARACUY	MP. PE#A	CM. YARITAGUA	ESCUELA INTEGRAL BOLIVARIANA  EL POZON	341	1	4	294	222	290	0	4	1	1	62	294
EDO. YARACUY	MP. PE#A	CM. YARITAGUA	CENTRO DE EDUCACION INICIAL BOLIVARIANO JESUS MILLAN NUCLEO EL PEGON	422	1	5	351	318	346	0	0	0	0	28	351
EDO. YARACUY	MP. PE#A	CM. YARITAGUA	CENTRO DE EDUCACION INICIAL BOLIVARIANO JESUS MILLAN	1463	3	27	1209	705	1182	0	6	1	0	470	1209
EDO. YARACUY	MP. PE#A	CM. YARITAGUA	ESCUELA BASICA MARIA CLEMENTINA DE BONILLA	1132	2	33	862	671	829	0	3	0	0	155	862
EDO. YARACUY	MP. PE#A	CM. YARITAGUA	ESCUELA INTEGRAL BOLIVARIANA CAÑAVERAL	727	2	9	598	438	589	0	2	0	0	149	598
EDO. YARACUY	MP. PE#A	CM. YARITAGUA	JARDIN DE INFANCIA BOLIVARIANO LAUREANO VILLANUEVA	880	2	14	723	390	709	1	6	0	0	312	723
EDO. YARACUY	MP. PE#A	CM. YARITAGUA	ESCUELA BASICA AMERICA YUDITH IBARRA	2938	5	95	2397	1619	2302	0	10	0	2	671	2397
EDO. YARACUY	MP. PE#A	CM. YARITAGUA	COLEGIO SANTA LUCIA	2984	6	34	2568	880	2534	0	8	0	2	1644	2568
EDO. YARACUY	MP. PE#A	CM. YARITAGUA	CENTRO  INICIAL  BOLIVARIANO CAMINO NUEVO	807	2	17	721	487	704	1	3	0	0	213	721
EDO. YARACUY	MP. PE#A	CM. YARITAGUA	ESCUELA BASICA CORONEL JOSE VICENTE PEÑA	1341	3	19	1121	827	1102	2	9	2	0	262	1121
EDO. YARACUY	MP. PE#A	CM. YARITAGUA	ESCUELA INTEGRAL  BOLIVARIANA AGUA NEGRA	1411	3	18	1147	889	1129	0	5	1	0	234	1147
EDO. YARACUY	MP. SUCRE	CM. GUAMA	JARDIN DE INFANCIA JOSE TOMAS GONZALEZ	315	1	7	290	129	283	0	3	0	0	151	290
EDO. YARACUY	MP. SUCRE	CM. GUAMA	ESCUELA INTEGRAL BOLIVARIANA ANTONIO JOSE DE SUCRE	521	1	3	458	254	455	0	1	0	0	200	458
EDO. YARACUY	MP. SUCRE	CM. GUAMA	ESCUELA PRIMARIA CALLEJON DE QUIGUA	223	1	2	208	192	206	0	1	0	0	13	208
EDO. YARACUY	MP. SUCRE	CM. GUAMA	ESCUELA BASICA NICANORA TRAVIEZO	1604	3	43	1357	882	1314	0	5	1	1	425	1357
EDO. YARACUY	MP. SUCRE	CM. GUAMA	CENTRO DE EDUCACION INICIAL CONVENCIONAL DOCTOR PEDRO CORDIDO WONHSIDLER	997	2	32	811	294	779	0	10	1	1	473	811
EDO. YARACUY	MP. SUCRE	CM. GUAMA	ESCUELA BASICA DOCTOR PEDRO SATURNO CANELON	448	1	8	406	245	398	0	3	0	0	150	406
EDO. YARACUY	MP. SUCRE	CM. GUAMA	ESCUELA BASICA BOLIVARIANA JOSE TOMAS GONZALEZ	1702	3	32	1389	498	1357	1	10	0	0	848	1389
EDO. YARACUY	MP. SUCRE	CM. GUAMA	ESCUELA INTEGRAL BOLIVARIANA CONCEPCION DE CARVAJAL	1143	2	19	943	546	924	1	6	0	0	371	943
EDO. YARACUY	MP. SUCRE	CM. GUAMA	ESCUELA INTEGRAL BOLIVARIANA FRANCISCO CAMACHO	975	2	18	803	523	785	0	6	1	0	255	803
EDO. YARACUY	MP. SUCRE	CM. GUAMA	ESCUELA BASICA RURAL ISAIAS ANTONIO BLASCO	695	2	9	559	339	550	0	1	0	0	210	559
EDO. YARACUY	MP. SUCRE	CM. GUAMA	MINISTERIO DE AGRICULTURA Y TIERRAS. AREA SUCRE	712	2	10	673	425	663	2	2	1	0	233	673
EDO. YARACUY	MP. SUCRE	CM. GUAMA	ESCUELA PRIMARIA BOLIVARIANA  EL CEMENTERIO	713	2	13	646	376	633	0	6	0	1	250	646
EDO. YARACUY	MP. SUCRE	CM. GUAMA	ESCUELA CONCENTRADA MIXTA ESTATAL FALTRIQUERA	307	1	5	286	225	281	0	1	0	0	55	286
EDO. YARACUY	MP. SUCRE	CM. GUAMA	LICEO BOLIVARIANO CARMELO FERNANDEZ	1419	3	32	1228	606	1196	0	4	0	0	586	1228
EDO. YARACUY	MP. SUCRE	CM. GUAMA	ESCUELA CONCENTRADA MIXTA ESTADAL CAICARA	460	1	5	392	315	387	0	1	0	0	71	392
EDO. YARACUY	MP. SUCRE	CM. GUAMA	ESCUELA BASICA ALIDA CASULLO DE ZERPA	1377	3	35	1211	575	1176	0	7	0	0	594	1211
EDO. YARACUY	MP. SUCRE	CM. GUAMA	LICEO BOLIVARIANO MERCEDEZ CORDIDO	219	1	5	194	129	189	0	0	0	0	60	194
EDO. YARACUY	MP. SUCRE	CM. GUAMA	HOGAIN COMUNITARIO SONRRIENDO DE NUEVO	348	1	9	309	193	300	0	1	0	0	106	309
EDO. YARACUY	MP. URACHICHE	CM. URACHICHE	ESCUELA BASICA JACINTO GUTIERREZ COLL	1634	3	36	1318	708	1282	0	12	1	0	561	1318
EDO. YARACUY	MP. URACHICHE	CM. URACHICHE	CENTRO DE EDUCACION INICIAL BOLIVARIANO CURAZAO I	1217	3	24	969	764	945	0	6	0	1	174	969
EDO. YARACUY	MP. URACHICHE	CM. URACHICHE	ESCUELA BASICA NICOLASA GARCIA	1680	3	31	1391	1201	1360	0	7	1	1	150	1391
EDO. YARACUY	MP. URACHICHE	CM. URACHICHE	ESCUELA INTEGRAL BOLIVARIANA RIO ARRIBA	287	1	3	206	143	203	0	2	0	0	58	206
EDO. YARACUY	MP. URACHICHE	CM. URACHICHE	ESCUELA BASICA OMAR GARCIA	1032	2	26	852	531	826	0	4	0	0	291	852
EDO. YARACUY	MP. URACHICHE	CM. URACHICHE	ESCUELA INTEGRAL BOLIVARIANA AGUARUCA	526	1	10	428	293	418	1	2	0	0	122	428
EDO. YARACUY	MP. URACHICHE	CM. URACHICHE	ESCUELA INTEGRAL BOLIVARIANA EL COPEY	342	1	2	258	228	256	1	0	0	0	27	258
EDO. YARACUY	MP. URACHICHE	CM. URACHICHE	UNIDAD EDUCATIVA FEDERICO QUIROZ	737	2	31	631	412	600	0	1	0	0	187	631
EDO. YARACUY	MP. URACHICHE	CM. URACHICHE	GIMNACIO CUBIERTO URACHICHE	1057	2	13	884	517	871	0	4	0	0	350	884
EDO. YARACUY	MP. URACHICHE	CM. URACHICHE	JARDIN DE INFANCIA LAS PAVAS	98	1	1	87	78	86	0	1	0	0	7	87
EDO. YARACUY	MP. URACHICHE	CM. URACHICHE	ESCUELA BASICA  LAS VEGAS NER 134	161	1	4	157	151	153	0	0	0	0	2	157
EDO. YARACUY	MP. URACHICHE	CM. URACHICHE	CENTRO DE EDUCACION INCIAL URACHICHE	779	2	20	625	349	605	1	4	0	0	251	625
EDO. YARACUY	MP. URACHICHE	CM. URACHICHE	ESCUELA INTEGRAL BOLIVARIANA EL PICURE	331	1	19	298	192	279	0	0	0	0	87	298
EDO. YARACUY	MP. URACHICHE	CM. URACHICHE	ESCUELA BASICA ELBA SALESSI	1173	2	22	942	608	920	0	6	1	0	305	942
EDO. YARACUY	MP. URACHICHE	CM. URACHICHE	CENTRO DE EDUCACION INICIAL BOLIVARIANO SIMON BOLIVAR	1530	3	44	1211	721	1167	0	6	1	0	439	1211
EDO. YARACUY	MP. URACHICHE	CM. URACHICHE	CASA DE LOS NIÑOS LOS MANGUITOS	358	1	4	312	247	308	0	1	0	0	60	312
EDO. YARACUY	MP. URACHICHE	CM. URACHICHE	ESCUELA INTEGRAL BOLIVARIANA MANUELITA SAENZ	512	1	11	440	347	429	0	3	0	0	79	440
EDO. YARACUY	MP. URACHICHE	CM. URACHICHE	ESCUELA NACIONAL UNITARIA BUCARITO	103	1	1	93	89	92	0	0	0	0	3	93
EDO. YARACUY	MP. URACHICHE	CM. URACHICHE	ESCUELA INTEGRAL BOLIVARIANA BUENOS AIRES	347	1	3	267	251	264	1	0	0	0	12	267
EDO. YARACUY	MP. URACHICHE	CM. URACHICHE	ESCUELA PRIMARIA  EL JUNCO	148	1	4	127	113	123	0	0	1	0	9	127
EDO. YARACUY	MP. URACHICHE	CM. URACHICHE	ESCUELA BASICA LA VICTORIA	352	1	9	323	277	314	2	2	0	0	33	323
EDO. YARACUY	MP. BOLIVAR	CM. AROA	ESCUELA BASICA CHIVACURE	428	1	8	363	310	355	0	1	1	0	43	363
EDO. YARACUY	MP. BOLIVAR	CM. AROA	ESCUELA BASICA GUARATARO	126	1	1	105	95	104	0	0	0	0	9	105
EDO. YARACUY	MP. BOLIVAR	CM. AROA	ESCUELA INTEGRAL BOLIVARIANA QUEBRADA SECA	659	2	17	532	399	515	0	5	0	0	111	532
EDO. YARACUY	MP. BOLIVAR	CM. AROA	MULTIHOGAR ELOISA MASTRANGELO	470	1	7	396	224	389	0	2	0	0	163	396
EDO. YARACUY	MP. BOLIVAR	CM. AROA	ESCUELA BASICA EL ABRIGO	210	1	1	186	175	185	0	2	0	0	8	186
EDO. YARACUY	MP. BOLIVAR	CM. AROA	ESCUELA INTEGRAL BOLIVARIANA  CARARAPA
EDO. YARACUY	MP. BOLIVAR	CM. AROA	ESCUELA BASICA ESTATAL DIAMANTE II	164	1	5	134	120	129	0	0	0	0	9	134
EDO. YARACUY	MP. BOLIVAR	CM. AROA	CENTRO DE EDUCACION INICIAL BOLIVARIANO NATIVIDAD DE CORSO	1539	3	45	1323	835	1278	0	2	0	0	441	1323
EDO. YARACUY	MP. BOLIVAR	CM. AROA	ESCUELA BASICA JOSE MANUEL SISO MARTINEZ	1750	3	21	1466	795	1445	0	13	1	0	636	1466
EDO. YARACUY	MP. BOLIVAR	CM. AROA	ESCUELA CONCENTRADA EL REFUGIO	596	1	7	483	367	476	0	6	0	1	102	483
EDO. YARACUY	MP. BOLIVAR	CM. AROA	ESCUELA INTEGRAL BOLIVARIANA SAN JOSE	492	1	6	336	239	330	0	0	0	0	91	336
EDO. YARACUY	MP. BOLIVAR	CM. AROA	ESCUELA PRIMARIA  ATASCADERO	366	1	3	278	213	275	0	1	1	0	60	278
EDO. YARACUY	MP. BOLIVAR	CM. AROA	ESCUELA INTEGRAL BOLIVARIANA LOS ROSALES	435	1	2	361	218	359	0	1	0	0	140	361
EDO. YARACUY	MP. BOLIVAR	CM. AROA	ESCUELA INTEGRAL BOLIVARIANA LOS UREROS	497	1	3	438	243	435	0	0	0	0	192	438
EDO. YARACUY	MP. BOLIVAR	CM. AROA	CENTRO DE EDUCACION INICIAL AROA	1013	2	24	850	503	826	0	0	0	1	322	850
EDO. YARACUY	MP. BOLIVAR	CM. AROA	LICEO BOLIVARIANO SIMON BOLIVAR	889	2	21	753	417	732	0	3	0	0	312	753
EDO. YARACUY	MP. BOLIVAR	CM. AROA	ESCUELA BASICA NACIONAL GUAYABONAL	185	1	3	166	152	163	0	1	0	0	10	166
EDO. YARACUY	MP. BOLIVAR	CM. AROA	ESCUELA BASICA CONCENTRADA CAYURE	118	1	4	104	64	100	0	2	0	0	34	104
EDO. YARACUY	MP. BOLIVAR	CM. AROA	ESCUELA PRIMARIA  AGUA FRIA	324	1	3	214	114	211	0	1	0	0	96	214
EDO. YARACUY	MP. BOLIVAR	CM. AROA	ESCUELA BASICA UNITARIA LAGUNITA	162	1	3	144	123	141	0	1	0	0	17	144
EDO. YARACUY	MP. BOLIVAR	CM. AROA	ESCUELA UNITARIA PARDILLAL DE CUPA.	104	1	2	85	83	83	0	0	0	0	0	85
EDO. YARACUY	MP. BOLIVAR	CM. AROA	ESCUELA BASICA LOS VACOS	219	1	5	182	166	177	0	0	0	0	11	182
EDO. YARACUY	MP. BOLIVAR	CM. AROA	ESCUELA INTEGRAL BOLIVARIANA TIERRA FRIA	535	1	1	404	225	403	0	3	0	0	175	404
EDO. YARACUY	MP. BOLIVAR	CM. AROA	ESCUELA INTEGRAL BOLIVARIANA EL HACHA	478	1	3	381	280	378	0	1	0	1	96	381
EDO. YARACUY	MP. BOLIVAR	CM. AROA	CENTRO DE EDUCACION INICIAL LA MORA	492	1	16	449	271	433	0	2	0	0	160	449
EDO. YARACUY	MP. BOLIVAR	CM. AROA	ESCUELA BARLOVENTO	192	1	2	182	139	180	0	0	0	0	41	182
EDO. YARACUY	MP. BOLIVAR	CM. AROA	ESCUELA .BASICA JOSE JOAQUIN VEROES	1353	3	26	1088	641	1062	2	2	0	0	417	1088
EDO. YARACUY	MP. BOLIVAR	CM. AROA	ESCUELA BASICA ROSARIO DE MERCADEZ	816	2	16	660	558	644	2	2	0	0	82	660
EDO. YARACUY	MP. BOLIVAR	CM. AROA	ESCUELA PRIMARIA BOLIVARIANA EL CUPIDO	117	1	0	112	101	112	0	0	0	0	11	112
EDO. YARACUY	MP. BOLIVAR	CM. AROA	ESCUELA INTEGRAL BOLIVARIANA SANTA ANA	366	1	3	288	228	285	0	3	0	0	54	288
EDO. YARACUY	MP. BOLIVAR	CM. AROA	ESCUELA BASICA CARMELO FERNANDEZ	2172	4	50	1685	863	1635	1	11	2	0	758	1685
EDO. YARACUY	MP. BOLIVAR	CM. AROA	ESCUELA NACIONAL LOS CANELITOS	258	1	3	211	194	208	0	2	0	0	12	211
EDO. YARACUY	MP. BOLIVAR	CM. AROA	ESCUELA INTEGRAL BOLIVARIANA LA LUZ	629	2	17	481	306	464	0	4	0	0	154	481
EDO. YARACUY	MP. BOLIVAR	CM. AROA	ESCUELA INTEGRAL BOLIVARIANA KILOMETRO 58	410	1	9	333	192	324	1	0	1	0	130	333
EDO. YARACUY	MP. BOLIVAR	CM. AROA	ESCUELA  BASICA CUPA	91	1	2	81	66	79	0	1	0	0	12	81
EDO. YARACUY	MP. BOLIVAR	CM. AROA	ESCUELA INTEGRAL BOLIVARIANA LAS PLANETAS	126	1	0	110	103	110	0	0	0	0	7	110
EDO. YARACUY	MP. BOLIVAR	CM. AROA	ESCUELA TECNICA AGROPECUARIA MINAS DE AROA	1275	3	36	1029	524	993	1	4	0	0	464	1029
EDO. YARACUY	MP. BOLIVAR	CM. AROA	ESCUELA PRIMARIA GUSANILLAL.	312	1	6	250	177	244	0	1	0	0	66	250
EDO. YARACUY	MP. BOLIVAR	CM. AROA	ESCUELA BASICA CERRO NEGRO	376	1	7	289	175	282	0	1	0	0	106	289
EDO. YARACUY	MP. BRUZUAL	PQ. CAMPO ELIAS	ESCUELA INTEGRAL BOLIVARIANA COCUAIMA	386	1	6	314	231	308	0	0	0	0	77	314
EDO. YARACUY	MP. BRUZUAL	PQ. CAMPO ELIAS	ESCUELA BASICA JUAN VICENTE GONZALEZ	1328	3	27	1011	721	984	1	1	1	0	260	1011
EDO. YARACUY	MP. BRUZUAL	PQ. CAMPO ELIAS	ESCUELA BASICA RURAL SANTA ELENA NER 205	86	1	2	83	76	81	0	0	0	0	5	83
EDO. YARACUY	MP. BRUZUAL	PQ. CAMPO ELIAS	ESCUELA CONCENTRADA SAN RAMON	1197	2	29	927	579	898	0	4	0	0	315	927
EDO. YARACUY	MP. BRUZUAL	PQ. CAMPO ELIAS	ESCUELA INTEGRAL BOLIVARIANA POA POA	551	1	4	445	348	441	1	2	0	0	90	445
EDO. YARACUY	MP. BRUZUAL	PQ. CAMPO ELIAS	ESCUELA INTEGRAL BOLIVARIANA EL COPEY	224	1	1	205	192	204	1	2	0	0	9	205
EDO. YARACUY	MP. BRUZUAL	PQ. CAMPO ELIAS	ESCUELA INTEGRAL BOLIVARIANA ALTO DEL RIO	551	1	16	424	290	408	0	4	0	0	114	424
EDO. YARACUY	MP. BRUZUAL	PQ. CAMPO ELIAS	ESCUELA INTEGRAL BOLIVARIANA  LA LAGUNA	350	1	9	288	199	279	0	1	1	0	78	288
EDO. YARACUY	MP. BRUZUAL	PQ. CAMPO ELIAS	ESCUELA INTEGRAL BOLIVARIANA TETEIBA	391	1	6	332	209	326	1	2	1	2	111	332
EDO. YARACUY	MP. BRUZUAL	PQ. CAMPO ELIAS	ESCUELA INTEGRAL BOLIVARIANA PALO GRANDE	615	2	11	519	412	508	0	3	2	0	91	519
EDO. YARACUY	MP. BRUZUAL	PQ. CAMPO ELIAS	ESCUELA INTEGRAL BOLIVARIANA LA VIRGEN	996	2	14	833	662	819	0	2	1	0	154	833
EDO. YARACUY	MP. BRUZUAL	PQ. CAMPO ELIAS	CENTRO DE EDUCACION INICIAL JUAN VICENTE GONZALEZ	391	1	8	340	267	332	0	3	0	0	62	340
EDO. YARACUY	MP. BRUZUAL	PQ. CAMPO ELIAS	UNIDAD EDUCATIVA  CAMPO ELIAS	814	2	13	647	432	634	1	2	0	0	199	647
EDO. YARACUY	MP. BRUZUAL	PQ. CAMPO ELIAS	ESCUELA BASCA MARIO BRICEÑO IRAGORRI	907	2	15	750	643	735	0	3	0	0	89	750
EDO. YARACUY	MP. BRUZUAL	CM. CHIVACOA	JARDIN DE INFANCIA ESCALONA Y CALATAYUD	998	2	8	749	307	741	2	5	0	0	427	749
EDO. YARACUY	MP. BRUZUAL	CM. CHIVACOA	ESCUELA BASICA EL CALICHE	627	2	18	525	320	507	1	1	2	0	183	525
EDO. YARACUY	MP. BRUZUAL	CM. CHIVACOA	ESCUELA NUDE SANTA LUCIA	126	1	2	123	120	121	0	0	0	0	1	123
EDO. YARACUY	MP. BRUZUAL	CM. CHIVACOA	CENTRO DE EDUCACION INICIAL BOLIVARIANO EL ESTADIUM	1029	2	19	880	617	861	0	4	0	2	238	880
EDO. YARACUY	MP. BRUZUAL	CM. CHIVACOA	ESCUELA INTEGRAL BOLIVARIANA LAS MULITAS	224	1	4	158	101	154	0	2	1	0	50	158
EDO. YARACUY	MP. BRUZUAL	CM. CHIVACOA	ESCUELA BASICA RURAL GREGORIA DIAZ	1687	3	45	1380	989	1335	1	9	0	0	336	1380
EDO. YARACUY	MP. BRUZUAL	CM. CHIVACOA	UNIDAD EDUCATIVA COLEGIO SANTA MARIA	2393	4	26	2066	719	2040	1	13	1	2	1304	2066
EDO. YARACUY	MP. BRUZUAL	CM. CHIVACOA	CENTRO DE EDUCACION INICIAL INTEGRAL SIMONCITO CARLOS JOSE MUJICA	915	2	20	755	457	735	1	2	0	1	274	755
EDO. YARACUY	MP. BRUZUAL	CM. CHIVACOA	CENTRO DE EDUCACION INICIAL  BOLIVARIANO LA PEÑITA	1691	3	30	1392	914	1362	0	5	0	0	443	1392
EDO. YARACUY	MP. BRUZUAL	CM. CHIVACOA	ESCUELA BASICA LAS DELICIAS	104	1	1	88	75	87	0	2	0	0	10	88
EDO. YARACUY	MP. BRUZUAL	CM. CHIVACOA	ALDEA UNIVERSITARIA BOLIVARIANA MISION SUCRE	610	2	10	550	361	540	0	4	0	0	175	550
EDO. YARACUY	MP. BRUZUAL	CM. CHIVACOA	ESCUELA INTEGRAL BOLIVARIANA LA BARTOLA	815	2	12	686	527	674	0	2	0	0	145	686
EDO. YARACUY	MP. BRUZUAL	CM. CHIVACOA	ESCUELA INTEGRAL BOLIVARIANA CECILIA BAZAN DE  SEGURA	2370	4	51	1886	1225	1835	2	10	2	2	594	1886
EDO. YARACUY	MP. BRUZUAL	CM. CHIVACOA	ESCUELA CONCENTRADA LA CAÑERIA	1060	2	26	814	567	788	0	7	2	0	212	814
EDO. YARACUY	MP. BRUZUAL	CM. CHIVACOA	ESCUELA INTEGRAL BOLIVARIANA CUMARIPA	846	2	12	687	438	675	1	8	0	0	228	687
EDO. YARACUY	MP. BRUZUAL	CM. CHIVACOA	ESCUELA BASICA  MARIA LEONOR DE SALAS	1219	3	20	1041	770	1021	0	4	0	0	247	1041
EDO. YARACUY	MP. BRUZUAL	CM. CHIVACOA	ESCUELA INTEGRAL BOLIVARIANA LA LIBERTAD	1457	3	24	1237	906	1213	0	7	1	0	299	1237
EDO. YARACUY	MP. BRUZUAL	CM. CHIVACOA	ESCUELA INTEGRAL BOLIVARIANA LOS HORCONES	261	1	2	227	175	225	0	2	0	1	47	227
EDO. YARACUY	MP. BRUZUAL	CM. CHIVACOA	CENTRO DE EDUCACION INICIAL CECILIA BAZAN DE SEGURA	812	2	7	627	421	620	0	4	0	0	195	627
EDO. YARACUY	MP. BRUZUAL	CM. CHIVACOA	ESCUELA INTEGRAL BOLIVARIANA CATALINA DE BOLIVAR	2931	5	50	2363	1470	2313	1	15	3	2	822	2363
EDO. YARACUY	MP. BRUZUAL	CM. CHIVACOA	CENTRO DE EDUCACION INICIAL BOLIVARIANO PEGUAIMA	1144	2	36	937	677	901	0	3	1	0	220	937
EDO. YARACUY	MP. BRUZUAL	CM. CHIVACOA	UNIDAD EDUCATIVA CARLOS JOSE MUJICA	2828	5	43	2319	1413	2276	0	12	2	0	849	2319
EDO. YARACUY	MP. BRUZUAL	CM. CHIVACOA	ESCUELA BASICA TRIBU JIRAHARA	538	1	10	486	255	476	0	2	0	2	217	486
EDO. YARACUY	MP. BRUZUAL	CM. CHIVACOA	INSTITUTO DE EDUCACION ESPECIAL BOLIVARIANO CHIVACOA	625	2	17	571	375	554	3	2	0	1	173	571
EDO. YARACUY	MP. BRUZUAL	CM. CHIVACOA	LICEO BOLIVARIANO PADRE VICENTE	805	2	17	718	433	701	0	1	0	3	264	718
EDO. YARACUY	MP. BRUZUAL	CM. CHIVACOA	CASA DE LOS NINOS EL ARAGUANEY	192	1	3	181	144	178	0	2	0	0	32	181
EDO. YARACUY	MP. BRUZUAL	CM. CHIVACOA	ESCUELA INTEGRAL BOLIVARIANA ESCALONA Y CALATAYUD	2548	5	36	2092	900	2056	1	7	2	0	1146	2092
EDO. YARACUY	MP. BRUZUAL	CM. CHIVACOA	UNIDAD EDUCATIVA DOCTOR RAUL RAMOS GIMENEZ	1698	3	27	1361	896	1334	0	4	2	0	432	1361
EDO. YARACUY	MP. BRUZUAL	CM. CHIVACOA	CENTRO DE EDUCACION INICIAL FRANCOISE LABECA	1934	4	24	1647	756	1623	1	13	2	0	851	1647
EDO. YARACUY	MP. BRUZUAL	CM. CHIVACOA	ESCUELA BASICA SILA MOTA DE ROJAS	2131	4	43	1626	1098	1583	1	8	2	1	473	1626
EDO. YARACUY	CE. SAN FELIPE	CM. SAN FELIPE	ESCUELA BASICA CECILIO ACOSTA	2382	4	51	1862	752	1811	1	3	0	2	1053	1862
EDO. YARACUY	CE. SAN FELIPE	CM. SAN FELIPE	CENTRO DE EDUCACION INICIAL REPUBLICA DE NICARAGUA	1111	2	17	883	292	866	0	4	0	1	569	883
EDO. YARACUY	CE. SAN FELIPE	CM. SAN FELIPE	JARDIN DE INFANCIA JUAN JOSE DE MAYA	934	2	6	818	219	812	0	2	0	0	591	818
EDO. YARACUY	CE. SAN FELIPE	CM. SAN FELIPE	CENTRO DE EDUCACION INICIAL HIGUERON.	554	1	11	457	246	446	0	4	0	0	196	457
EDO. YARACUY	CE. SAN FELIPE	CM. SAN FELIPE	ESCUELA BASICA CECILIA MUJICA	1328	3	22	1114	293	1092	0	5	0	3	791	1114
EDO. YARACUY	CE. SAN FELIPE	CM. SAN FELIPE	ESCUELA INTEGRAL BOLIVARIANA LA MARROQUINA	611	2	11	485	310	474	1	2	1	0	160	485
EDO. YARACUY	CE. SAN FELIPE	CM. SAN FELIPE	ESCUELA BASICA SIMON TORRES	1254	3	39	1026	681	987	0	6	1	0	299	1026
EDO. YARACUY	CE. SAN FELIPE	CM. SAN FELIPE	CENTRO DE EDUCACION INICIAL BOLIVARIANO LAS TAPIAS II	1639	3	15	1400	1042	1385	1	12	2	0	328	1400
EDO. YARACUY	CE. SAN FELIPE	CM. SAN FELIPE	ESCUELA INTEGRAL BOLIVARIANA  EL COROZO	443	1	10	372	209	362	1	0	1	0	151	372
EDO. YARACUY	CE. SAN FELIPE	CM. SAN FELIPE	LICEO BOLIVARIANO JUAN JOSE DE MAYA	2501	5	31	2190	549	2159	0	7	1	1	1601	2190
EDO. YARACUY	CE. SAN FELIPE	CM. SAN FELIPE	CASA HOGAR  DOCTOR LUIS LIZARRAGA	523	1	8	416	181	408	0	1	0	1	225	416
EDO. YARACUY	CE. SAN FELIPE	CM. SAN FELIPE	UNIDAD EDUCATIVA TRINIDAD FIGUEIRA	878	2	26	761	268	735	0	6	0	0	461	761
EDO. YARACUY	CE. SAN FELIPE	CM. SAN FELIPE	ESCUELA CONCENTRADA YARACUY	991	2	33	828	531	795	0	10	2	0	252	828
EDO. YARACUY	CE. SAN FELIPE	CM. SAN FELIPE	ESCUELA BASICA CARMEN DE RAMIREZ	3214	6	83	2657	1542	2574	1	14	2	0	1015	2657
EDO. YARACUY	CE. SAN FELIPE	CM. SAN FELIPE	ESCUELA INTEGRAL BOLIVARIANA   ALBERTO RAVELL	2930	6	38	2425	782	2387	0	3	1	1	1600	2425
EDO. YARACUY	CE. SAN FELIPE	CM. SAN FELIPE	LICEO BOLIVARIANO ROMULO BETANCOURT	1497	3	14	1355	415	1341	0	2	2	1	921	1355
EDO. YARACUY	CE. SAN FELIPE	CM. SAN FELIPE	INSTITUTO NACIONAL DE TIERRAS	1986	4	45	1701	823	1656	0	11	1	0	821	1701
EDO. YARACUY	CE. SAN FELIPE	CM. SAN FELIPE	ESCUELA BASICA REPUBLICA DE NICARAGUA	2197	4	36	1766	537	1730	0	11	2	1	1179	1766
EDO. YARACUY	CE. SAN FELIPE	CM. SAN FELIPE	COMISIONADURIA GENERAL DE SALUD	1550	3	25	1299	401	1274	0	4	1	2	866	1299
EDO. YARACUY	CE. SAN FELIPE	CM. SAN FELIPE	LICEO BOLIVARIANO ARISTIDES ROJAS	498	1	6	441	161	435	0	3	1	0	270	441
EDO. YARACUY	CE. SAN FELIPE	CM. SAN FELIPE	JARDIN DE INFANCIA BOLIVARIANO HIGUERON II	916	2	13	784	430	771	0	8	0	0	333	784
EDO. YARACUY	CE. SAN FELIPE	CM. SAN FELIPE	CENTRO DE EDUCACION INICIAL BOLIVARIANO LAS TAPIAS I	790	2	16	667	485	651	0	1	0	1	164	667
EDO. YARACUY	CE. SAN FELIPE	CM. SAN FELIPE	CENTRO DE FORMACION SOCIAL  PABLO VI	1852	4	34	1498	515	1464	0	4	5	0	940	1498
EDO. YARACUY	CE. SAN FELIPE	CM. SAN FELIPE	ESCUELA TECNICA  ROBINSONIANA ROMULO GALLEGOS	2522	5	49	2150	587	2101	0	11	0	0	1503	2150
EDO. YARACUY	CE. SAN FELIPE	CM. SAN FELIPE	UNIDAD EDUCATIVA COLEGIO FRAY LUIS AMIGO	2492	5	17	2196	280	2179	0	7	0	2	1890	2196
EDO. YARACUY	CE. SAN FELIPE	CM. SAN FELIPE	INSTITUTO DE PREVICION Y ASISTENCIA SOCIAL DEL MINISTERIO DE EDUCACION IPASME	59	1	1	58	20	57	0	0	0	0	37	58
EDO. YARACUY	CE. SAN FELIPE	CM. SAN FELIPE	ESCUELA BASICA LA MOSCA	537	1	17	456	216	439	0	1	0	0	222	456
EDO. YARACUY	CE. SAN FELIPE	CM. SAN FELIPE	UNIDAD EDUCATIVA  PADRE DELGADO	1982	4	19	1630	622	1611	1	9	0	0	979	1630
EDO. YARACUY	CE. SAN FELIPE	CM. SAN FELIPE	CENTRO DE EDUCACION INICIAL BOLIVARIANO STTE CARLOS A. COLMENAREZ YANEZ	673	2	13	589	415	576	0	4	0	0	157	589
EDO. YARACUY	CE. SAN FELIPE	PQ. SAN JAVIER	JARDIN DE INFANCIA BOLIVARIANO TIUNA	1865	4	39	1506	995	1467	0	2	0	0	470	1506
EDO. YARACUY	CE. SAN FELIPE	PQ. SAN JAVIER	CENTRO DE EDUCACION INICIAL BOLIVARIANO RURAL ANDRES ELOY BLANCO	129	1	2	119	88	117	0	1	0	0	28	119
EDO. YARACUY	CE. SAN FELIPE	PQ. SAN JAVIER	ESCUELA BASICA GRACIELA DE GAMARRA	1172	2	23	898	583	875	0	9	1	1	281	898
EDO. YARACUY	CE. SAN FELIPE	PQ. SAN JAVIER	CENTRO DE EDUCACION INICIAL BOLIVARIANO RURAL ORASIL HERNANDEZ	32	1	1	27	17	26	0	1	0	0	8	27
EDO. YARACUY	CE. SAN FELIPE	PQ. SAN JAVIER	ESCUELA CONCENTRADA EL GUARATARO	669	2	19	528	343	509	1	4	0	0	161	528
EDO. YARACUY	CE. SAN FELIPE	PQ. SAN JAVIER	ESCUELA INTEGRAL BOLIVARIANA EL PEÑON	557	1	10	433	277	423	1	2	0	0	143	433
EDO. YARACUY	CE. SAN FELIPE	PQ. SAN JAVIER	CENTRO DE EDUCACION INICIAL BOLIVARIANO SIMONCITO EL PAUJI	1026	2	18	898	512	880	0	4	1	0	363	898
EDO. YARACUY	CE. SAN FELIPE	PQ. SAN JAVIER	ESCUELA BASICA ANDRES ELOY BLANCO	1139	2	12	920	614	908	1	5	1	0	287	920
EDO. YARACUY	CE. SAN FELIPE	PQ. SAN JAVIER	ESCUELA INTEGRAL BOLIVARIANA MARIN	1152	2	28	967	662	939	0	2	0	0	275	967
EDO. YARACUY	CE. SAN FELIPE	PQ. SAN JAVIER	ESCUELA BASICA HORASIL HERNANDEZ	1325	3	27	1118	683	1091	0	14	1	1	392	1118
EDO. YARACUY	CE. SAN FELIPE	PQ. SAN JAVIER	ESCUELA BASICA LINARES	74	1	0	60	49	60	0	0	0	0	11	60
EDO. YARACUY	CE. SAN FELIPE	PQ. ALBARICO	ESCUELA BASICA TEOTISTE DE GALLEGOS	1324	3	22	1079	776	1057	1	8	0	4	268	1079
EDO. YARACUY	CE. SAN FELIPE	PQ. ALBARICO	ESCUELA BASICA PABLO MENDOZA REYES	1600	3	23	1266	614	1243	0	8	0	2	619	1266
EDO. YARACUY	CE. SAN FELIPE	PQ. ALBARICO	UNIDAD EDUCATIVA TIUNA	1555	3	31	1004	549	973	3	11	0	0	410	1004
EDO. YARACUY	CE. SAN FELIPE	PQ. ALBARICO	CENTRO DE EDUCACION INICIAL BOLIVARIANO SAN GERONIMO	438	1	10	376	243	366	0	2	1	0	120	376
EDO. YARACUY	CE. SAN FELIPE	PQ. ALBARICO	LICEO BOLIVARIANO JOSE RAFAEL VILLAREAL	673	2	12	497	294	485	0	2	0	0	189	497
EDO. YARACUY	CE. SAN FELIPE	PQ. ALBARICO	ESCUELA BASICA EL CUBE	213	1	3	136	99	133	0	1	0	0	33	136
EDO. YARACUY	CE. SAN FELIPE	PQ. ALBARICO	CENTRO DE EDUCACION INICIAL BOLIVARIANO LA SEMBRADORA	572	1	14	507	317	493	0	8	0	0	168	507
EDO. YARACUY	CE. SAN FELIPE	PQ. ALBARICO	CENTRO DE EDUCACION INICIAL  MONTES DE ORO	1065	2	18	863	614	845	0	10	0	1	220	863
EDO. YARACUY	CE. SAN FELIPE	PQ. ALBARICO	ESCUELA BASICA APOLONIA PALAVICINI	1625	3	33	1305	733	1272	0	8	1	0	530	1305
EDO. YARACUY	CE. SAN FELIPE	PQ. ALBARICO	ESCUELA ESTADAL CONCENTRADA  NUMERO 167	392	1	7	332	210	325	0	2	0	0	113	332
EDO. YARACUY	CE. SAN FELIPE	PQ. ALBARICO	ESCUELA INTEGRAL BOLIVARIANA SAMUEL ROBINSON	748	2	24	609	449	585	0	1	2	0	133	609
EDO. YARACUY	CE. SAN FELIPE	PQ. ALBARICO	JARDIN DE INFANCIA JOSE GRAGORIO HERNANDEZ	346	1	6	311	210	305	0	1	0	1	93	311
EDO. YARACUY	CE. SAN FELIPE	PQ. ALBARICO	CENTRO DE EDUCACION INICIAL BOLIVARIANO YARACUY	1132	2	20	892	494	872	1	3	1	0	373	892
EDO. YARACUY	CE. SAN FELIPE	PQ. ALBARICO	ESCUELA BASICA.FERMIN ABDON RAMIREZ	682	2	15	539	347	524	0	1	1	0	175	539
EDO. YARACUY	CE. SAN FELIPE	PQ. ALBARICO	UNIDAD EDUCATIVA  YARACUY	2383	4	51	1871	1032	1820	0	9	0	0	779	1871
EDO. YARACUY	CE. SAN FELIPE	PQ. ALBARICO	CENTRO DE EDUCACION INICIAL BOLIVARIANO GENERAL ROGELIO FREYTEZ (MARINCITO)	45	1	1	45	34	44	0	0	0	0	10	45
EDO. YARACUY	CE. SAN FELIPE	PQ. ALBARICO	ESCUELA BASICA RAMON GUILLERMO ORELLANA	1368	3	21	1162	743	1141	0	9	0	1	388	1162
EDO. YARACUY	CE. SAN FELIPE	PQ. ALBARICO	ESCUELA BASICA KILOMETRO 21	143	1	3	131	110	128	0	1	0	0	17	131
EDO. YARACUY	CE. SAN FELIPE	PQ. ALBARICO	ESCUELA  INTEGRAL TESORERO	419	1	9	350	233	341	0	0	0	0	108	350
EDO. YARACUY	CE. SAN FELIPE	PQ. ALBARICO	CENTRO DE EDUCACION INICIAL BOLIVARIANO JUANA MARTI FUENTES	215	1	4	196	147	192	0	0	0	0	45	196
EDO. YARACUY	CE. SAN FELIPE	PQ. ALBARICO	ESCUELA BASICA ALICIA PIETRI DE CALDERA	1836	4	46	1442	1050	1396	0	14	3	0	329	1442
EDO. YARACUY	MP. MANUEL MONGE	CM. YUMARE	ESCUELA INTEGRAL BOLIVARIANA MANUELITO	577	1	3	469	375	466	0	1	0	0	90	469
EDO. YARACUY	MP. MANUEL MONGE	CM. YUMARE	ESCUELA BASICA ELIO FRANCISCO TOVAR PRADO	481	1	2	385	250	383	0	2	0	0	131	385
EDO. YARACUY	MP. MANUEL MONGE	CM. YUMARE	ESCUELA INTEGRAL BOLIVARIANA CARRETERA 18	205	1	2	177	163	175	0	0	1	0	11	177
EDO. YARACUY	MP. MANUEL MONGE	CM. YUMARE	ESCUELA INTEGRAL BOLIVARIANA CARRETERA LA 22	548	1	7	422	315	415	0	3	0	0	97	422
EDO. YARACUY	MP. MANUEL MONGE	CM. YUMARE	ESCUELA INTEGRAL BOLIVARIANA AROA	576	1	15	450	358	435	1	1	0	0	75	450
EDO. YARACUY	MP. MANUEL MONGE	CM. YUMARE	ESCUELA INTEGRAL BOLIVARIANA YUMARITO	498	1	7	402	348	395	0	1	0	0	46	402
EDO. YARACUY	MP. MANUEL MONGE	CM. YUMARE	CENTRO DE EDUCACION INICIAL SAN AMAYA NER 112	137	1	7	127	74	120	0	1	0	0	45	127
EDO. YARACUY	MP. MANUEL MONGE	CM. YUMARE	ESCUELA INTEGRAL BOLIVARIANA CARRETERA LA 8	924	2	21	782	594	761	0	6	0	0	161	782
EDO. YARACUY	MP. MANUEL MONGE	CM. YUMARE	ESCUELA BASICA MONSEÑOR BALDOMERO CILLERO	757	2	24	611	333	587	1	1	0	0	252	611
EDO. YARACUY	MP. MANUEL MONGE	CM. YUMARE	ESCUELA BASICA LOS LIRIOS	150	1	2	140	130	138	0	0	0	0	8	140
EDO. YARACUY	MP. MANUEL MONGE	CM. YUMARE	ESCUELA INTEGRAL BOLIVARIANA CARRETERA LA 38	414	1	0	325	274	325	0	1	0	0	50	325
EDO. YARACUY	MP. MANUEL MONGE	CM. YUMARE	ESCUELA INTEGRAL BOLIVARIANA CARRETERA 14	506	1	7	416	235	409	0	1	0	0	173	416
EDO. YARACUY	MP. MANUEL MONGE	CM. YUMARE	ESCUELA INTEGRAL BOLIVARIANA CARRTERA LA 32	290	1	7	217	168	210	0	0	1	0	41	217
EDO. YARACUY	MP. MANUEL MONGE	CM. YUMARE	ESCUELA INTEGRAL BOLIVARIANA PLACA DE CEDRO	119	1	3	91	82	88	0	0	1	0	5	91
EDO. YARACUY	MP. MANUEL MONGE	CM. YUMARE	ESCUELA INTEGRAL BOLIVARIANA KILOMETRO 39	600	1	6	489	367	483	0	0	0	1	115	489
EDO. YARACUY	MP. MANUEL MONGE	CM. YUMARE	ESCUELA INTEGRAL BOLIVARIANA KILOMETRO 63	141	1	1	120	107	119	0	0	0	0	12	120
EDO. YARACUY	MP. MANUEL MONGE	CM. YUMARE	ESCUELA BASICA TOMAS GIMENEZ.	2848	5	63	2315	1517	2252	3	10	1	2	719	2315
EDO. YARACUY	MP. MANUEL MONGE	CM. YUMARE	ESCUELA INTEGRAL BOLIVARIANA SIMON BOLIVAR	1259	3	29	1054	732	1025	2	4	0	0	287	1054
EDO. YARACUY	MP. MANUEL MONGE	CM. YUMARE	ESCUELA INTEGRAL BOLIVARIANA CARRETERA LA 13	463	1	6	403	286	397	0	1	1	0	109	403
EDO. YARACUY	MP. COCOROTE	CM. COCOROTE	ESCUELA INTEGRAL BOLIVARIANA LAS FLORES	874	2	10	630	314	620	0	1	0	0	305	630
EDO. YARACUY	MP. COCOROTE	CM. COCOROTE	ESCUELA INTEGRAL BOLIVARIANA LA HERMITA	500	1	9	411	197	402	0	3	0	1	201	411
EDO. YARACUY	MP. COCOROTE	CM. COCOROTE	ESCUELA BASICA BOLIVARIANA SAN GERONIMO	2132	4	64	1809	910	1745	1	9	0	1	824	1809
EDO. YARACUY	MP. COCOROTE	CM. COCOROTE	COMPLEJO DEPORTIVO PABLO EMILIO FERNANDEZ	509	1	11	402	208	391	0	3	1	0	179	402
EDO. YARACUY	MP. COCOROTE	CM. COCOROTE	LICEO BOLIVARIANO  JOSE GABRIEL ALVAREZ DE LUGO	942	2	25	775	460	750	0	3	0	0	287	775
EDO. YARACUY	MP. COCOROTE	CM. COCOROTE	ESCUELA BASICA GUAYUREBO NUCLEO ESCOLAR RURAL	946	2	17	762	387	745	1	3	1	0	353	762
EDO. YARACUY	MP. COCOROTE	CM. COCOROTE	CASA COMUNAL BARRIO LA LIBERTAD	202	1	3	182	101	179	0	3	0	0	75	182
EDO. YARACUY	MP. COCOROTE	CM. COCOROTE	INSTITUTO NACIONAL DE ATENCION Y SERVICIO SOCIAL (INASS)	473	1	13	408	255	395	1	2	0	0	137	408
EDO. YARACUY	MP. COCOROTE	CM. COCOROTE	CENTRO EDUCACION INICIAL BOLIVARIANO TOVAR Y TOVAR	1385	3	33	1113	421	1080	0	4	1	1	653	1113
EDO. YARACUY	MP. COCOROTE	CM. COCOROTE	LICEO BOLIVARIANO SANTA MARIA	1093	2	60	873	595	813	0	5	1	2	210	873
EDO. YARACUY	MP. COCOROTE	CM. COCOROTE	CENTRO DE EDUCACION INICIAL BOLIVARIANO  LA MORITA	641	2	8	523	314	515	1	5	1	0	194	523
EDO. YARACUY	MP. COCOROTE	CM. COCOROTE	CENTRO DE EDUCACION INICIAL BOLIVARIANO ELIGIO MARTINEZ	1132	2	29	973	417	944	0	2	0	0	525	973
EDO. YARACUY	MP. COCOROTE	CM. COCOROTE	CENTRO DE EDUCACION INICIAL BOLIVARIANO CARMEN EULALIA RIVERO DE VERASTEGUI	624	2	20	576	270	556	0	2	0	0	284	576
EDO. YARACUY	MP. COCOROTE	CM. COCOROTE	ESCUELA BASICA DOCTOR LEON TRUJILLO. III ETAPA	364	1	10	315	152	305	1	0	0	0	152	315
EDO. YARACUY	MP. COCOROTE	CM. COCOROTE	ESCUELA BASICA LEONOR BERNABO	2409	5	57	1992	915	1935	1	14	2	1	1002	1992
EDO. YARACUY	MP. COCOROTE	CM. COCOROTE	ESCUELA BASICA TOVAR Y TOVAR	2852	5	75	2270	824	2195	0	10	0	2	1359	2270
EDO. YARACUY	MP. COCOROTE	CM. COCOROTE	LICEO BOLIVARIANO DOCTOR RAFAEL CALDERA IZGUIRRE	2741	5	56	2215	1225	2159	1	10	1	1	921	2215
EDO. YARACUY	MP. COCOROTE	CM. COCOROTE	ESCUELA BASICA DOCTOR LEON TRUJILLO	3625	7	91	2980	1126	2889	0	16	2	3	1742	2980
EDO. YARACUY	MP. COCOROTE	CM. COCOROTE	ESCUELA BASICA PARQUE LEONOR BERNABO	1064	2	16	868	340	852	0	2	1	0	509	868
EDO. YARACUY	MP. COCOROTE	CM. COCOROTE	FUNDACION ESCUELA DANZAS COCOROTE	589	1	10	529	200	519	0	1	0	2	316	529
EDO. YARACUY	MP. COCOROTE	CM. COCOROTE	ESCUELA INTEGRAL BOLIVARIANA TACARTE	304	1	15	274	153	259	0	1	0	0	105	274
EDO. YARACUY	MP. COCOROTE	CM. COCOROTE	UNIDAD EDUCATIVA JAIME	471	1	14	403	248	389	0	1	0	0	140	403
EDO. YARACUY	MP. COCOROTE	CM. COCOROTE	ALDEA UNIVERSITARIA MISION SUCRE COCOROTE	1013	2	14	927	423	913	0	6	0	0	484	927
EDO. FALCON	MP. MAUROA	PQ. MENE DE MAUROA	ESCUELA BOLIVARIANA LOS TIGRESITOS	592	1	34	374	240	340	0	0	0	0	100	374
EDO. FALCON	MP. MAUROA	PQ. MENE DE MAUROA	ESCUELA BÁSICA ELIAS DAVID CURIEL	2154	4	53	1722	790	1669	1	6	1	0	871	1722
EDO. FALCON	MP. MAUROA	PQ. MENE DE MAUROA	ESCUELA BOLIVARIANA ANDRES ELOY BLANCO	626	2	12	571	405	559	0	5	0	0	149	571
EDO. FALCON	MP. MAUROA	PQ. MENE DE MAUROA	ESCUELA BOLIVARIANA LA GURUPA	293	1	4	232	180	228	0	2	0	0	46	232
EDO. FALCON	MP. MAUROA	PQ. MENE DE MAUROA	ESCUELA BASICA BOLIVARIANA LOS CORTIJOS	1743	3	35	1483	709	1448	1	6	2	1	729	1483
EDO. FALCON	MP. MAUROA	PQ. MENE DE MAUROA	ESCUELA BOLIVARIANA KILOMETRO 52	96	1	4	84	64	80	0	0	0	0	16	84
EDO. FALCON	MP. MAUROA	PQ. MENE DE MAUROA	UNIDAD EDUCATIVA VIRGINIA GIL DE HERMOSO	1313	3	24	1045	479	1021	0	9	2	0	531	1045
EDO. FALCON	MP. MAUROA	PQ. MENE DE MAUROA	ESCUELA BOLIVARIANA EL LAMEDERO
EDO. FALCON	MP. MAUROA	PQ. MENE DE MAUROA	ESCUELA ESTADAL BOLIVARIANA LA CEIBA	215	1	3	181	136	178	0	0	0	0	42	181
EDO. FALCON	MP. MAUROA	PQ. MENE DE MAUROA	ESCUELA BOLIVARIANA KILOMETRO 16	308	1	6	278	203	272	0	2	0	0	67	278
EDO. FALCON	MP. MAUROA	PQ. MENE DE MAUROA	ESCUELA BOLIVARIANA UVERITO	146	1	2	123	80	121	0	1	0	0	40	123
EDO. FALCON	MP. MAUROA	PQ. MENE DE MAUROA	ESCUELA ESTADAL UNITARIA CERRO ABAJO	71	1	0	67	46	67	1	1	0	0	19	67
EDO. FALCON	MP. MAUROA	PQ. MENE DE MAUROA	ESCUELA BOLIVARIANA RIO CHIQUITO	139	1	5	116	95	111	0	1	0	0	15	116
EDO. FALCON	MP. MAUROA	PQ. MENE DE MAUROA	CENTRO DE EDUCACION INICIAL  BOLIVARIANO ELIAS DAVID CURIEL	1759	3	31	1417	759	1386	1	8	2	0	616	1417
EDO. FALCON	MP. MAUROA	PQ. MENE DE MAUROA	ESCUELA BOLIVARIANA LA FORTALEZA	381	1	5	300	246	295	0	4	0	0	45	300
EDO. FALCON	MP. MAUROA	PQ. MENE DE MAUROA	ESCUELA PRIMARIA KM 6	714	2	12	574	353	562	0	6	2	0	201	574
EDO. FALCON	MP. MAUROA	PQ. MENE DE MAUROA	ESCUELA ESTADAL LA PUERTA NER 290	144	1	5	133	55	128	0	0	0	0	73	133
EDO. FALCON	MP. MAUROA	PQ. SAN FELIX	ESCUELA BOLIVARIANA CIVIRA	185	1	2	166	104	164	1	1	0	0	58	166
EDO. FALCON	MP. MAUROA	PQ. SAN FELIX	ESCUELA ESTADAL CORRALITO	574	1	2	420	267	418	0	4	0	0	147	420
EDO. FALCON	MP. MAUROA	PQ. SAN FELIX	ESCUELA BASICA ESTADAL EL LLANITO	106	1	2	98	72	96	0	1	0	0	23	98
EDO. FALCON	MP. MAUROA	PQ. SAN FELIX	UNIDAD EDUCATIVA VALMORES RODRÍGUEZ	520	1	3	386	197	383	0	6	0	0	180	386
EDO. FALCON	MP. MAUROA	PQ. CASIGUA	ESCUELA BASICA JOSÉ DE JESÚS JIMÉNEZ	524	1	13	408	271	395	0	1	0	0	123	408
EDO. FALCON	MP. MAUROA	PQ. CASIGUA	ESCUELA ESTADAL BOLIVARIANA PACHECO	111	1	2	105	99	103	0	0	0	0	4	105
EDO. FALCON	MP. MAUROA	PQ. CASIGUA	ESCUELA BOLIVARIANA CUARENTA PESOS	200	1	5	152	123	147	0	0	0	0	24	152
EDO. FALCON	MP. MAUROA	PQ. CASIGUA	ESCUELA BOLIVARIANA LAS CRUCESITAS	528	1	14	452	356	438	1	2	0	0	79	452
EDO. FALCON	MP. MAUROA	PQ. CASIGUA	ESCUELA ESTADAL BARRANCAS	285	1	7	224	180	217	1	3	0	0	33	224
EDO. FALCON	MP. MAUROA	PQ. CASIGUA	ESCUELA BOLIVARIANA CASIGUA	965	2	11	738	410	727	1	1	0	0	315	738
EDO. FALCON	MP. MAUROA	PQ. CASIGUA	ESCUELA ESTADAL BOLIVARIANA CELSA DE AÑEZ	655	2	17	514	298	497	0	0	0	0	199	514
EDO. FALCON	MP. MAUROA	PQ. CASIGUA	ESCUELA BOLIVARIANA AUDIO J. VEGA	397	1	8	319	270	311	0	1	0	0	40	319
EDO. FALCON	MP. MAUROA	PQ. CASIGUA	ESCUELA BOLIVARIANA LOS HATICOS	79	1	4	71	58	67	0	1	0	0	8	71
EDO. FALCON	MP. MAUROA	PQ. CASIGUA	ESCUELA BOLIVARIANA LAS CRUCES	124	1	0	112	62	112	0	1	0	0	49	112
EDO. FALCON	MP. MAUROA	PQ. CASIGUA	ESCUELA BOLIVARIANA EL CASETAL	331	1	14	297	203	283	0	0	0	0	80	297
EDO. FALCON	MP. MAUROA	PQ. CASIGUA	ESCUELA BOLIVARIANA LAS COCUIZAS	228	1	3	190	133	187	0	1	0	0	53	190
EDO. FALCON	MP. SUCRE	PQ. PECAYA	ESCUELA BOLIVARIANA TOROY NER 266	280	1	0	190	180	190	0	0	0	0	10	190
EDO. FALCON	MP. SUCRE	PQ. PECAYA	ESCUELA BOLIVARIANA QUEBRADA HONDA	76	1	0	68	68	68	0	0	0	0	0	68
EDO. FALCON	MP. SUCRE	PQ. PECAYA	ESCUELA BASICA NICOLAS CURIEL COUTINHO	765	2	5	540	377	535	0	0	0	0	158	540
EDO. FALCON	MP. SUCRE	PQ. PECAYA	ESCUELA BOLIVARIANA LAS VERAS NER 266	294	1	1	243	223	242	0	1	1	0	17	243
EDO. FALCON	MP. SUCRE	PQ. PECAYA	ESCUELA BASICA UNITARIA GUASIQUI NER 266	278	1	2	189	160	187	0	1	0	0	26	189
EDO. FALCON	MP. SUCRE	PQ. SUCRE	ESCUELA BOLIVARIANA MACUARE
EDO. FALCON	MP. SUCRE	PQ. SUCRE	ESCUELA BOLIVARIANA EL RIO	154	1	1	125	100	124	0	1	0	0	23	125
EDO. FALCON	MP. SUCRE	PQ. SUCRE	UNIDAD EDUCATIVA ANGEL MIGUEL QUEREMEL	1172	2	10	894	641	884	0	3	0	0	240	894
EDO. FALCON	MP. SUCRE	PQ. SUCRE	ESCUELA BASICA UNITARIA NER Nº 965.JUNCALITO	176	1	1	119	105	118	0	1	0	0	12	119
EDO. FALCON	MP. SUCRE	PQ. SUCRE	ESCUELA ESTADAL UNITARIA LA GOYA NER 263	72	1	1	60	45	59	0	0	0	0	14	60
EDO. FALCON	MP. SUCRE	PQ. SUCRE	ESCUELA BÁSICA BOLIVARIANA  EL HORCÓN	277	1	3	241	113	238	0	1	0	0	124	241
EDO. FALCON	MP. SUCRE	PQ. SUCRE	ESCUELA NACIONAL PALO PINTAO	378	1	4	317	274	313	0	0	0	0	39	317
EDO. FALCON	MP. SUCRE	PQ. SUCRE	ESCUELA BASICA BOLIVARIANA FELIX VALOIS LEAL	1644	3	17	1297	908	1280	1	10	2	0	359	1297
EDO. FALCON	MP. FALCON	PQ. PUEBLO NUEVO	ESCUELA BÁSICA ISOLINA DE GÓMEZ CASTRO	1262	3	12	981	726	969	0	8	0	0	235	981
EDO. FALCON	MP. FALCON	PQ. PUEBLO NUEVO	ESCUELA BOLIVARIANA GUACUIRA ARRIBA	290	1	5	269	214	264	0	1	0	0	49	269
EDO. FALCON	MP. FALCON	PQ. PUEBLO NUEVO	ESCUELA BASICA LOS POZOS	292	1	3	243	137	240	0	4	0	0	99	243
EDO. FALCON	MP. FALCON	PQ. PUEBLO NUEVO	ESCUELA BÁSICA BOLIVARIANA JUAN DE DIOS MONZÓN	1981	4	27	1628	915	1601	0	12	0	1	673	1628
EDO. FALCON	MP. FALCON	PQ. PUEBLO NUEVO	ESCUELA BASICA ESTADAL CAYERUA	397	1	4	316	223	312	0	2	0	0	87	316
EDO. FALCON	MP. FALCON	PQ. PUEBLO NUEVO	UNIDAD EDUCATIVA HECTOR M. PEÑA	1581	3	23	1266	672	1243	0	10	0	0	561	1266
EDO. FALCON	MP. FALCON	PQ. PUEBLO NUEVO	ESCUELA BÁSICA AZARO BUENA VARA	887	2	15	677	467	662	0	3	0	0	192	677
EDO. FALCON	MP. FALCON	PQ. PUEBLO NUEVO	ESCUELA BASICA BOLIVARIANA LA CIENAGA	266	1	2	246	144	244	0	1	0	0	99	246
EDO. FALCON	MP. FALCON	PQ. PUEBLO NUEVO	ESCUELA BÁSICA CERRO PELÓN	594	1	8	478	364	470	1	2	0	0	103	478
EDO. FALCON	MP. FALCON	PQ. PUEBLO NUEVO	ESCUELA BOLIVARIANA EL PIZARRAL	192	1	2	178	145	176	0	1	0	0	30	178
EDO. FALCON	MP. FALCON	PQ. PUEBLO NUEVO	ESCUELA BÁSICA BOLIVARIANA COTO PAUL	3234	6	49	2640	1400	2591	0	11	2	0	1178	2640
EDO. FALCON	MP. FALCON	PQ. PUEBLO NUEVO	ESCUELA NACIONAL SANTA CRUZ	580	1	14	421	251	407	0	3	1	0	152	421
EDO. FALCON	MP. FALCON	PQ. PUEBLO NUEVO	ESCUELA BASICA ESTADAL GUACUIRA ABAJO	481	1	10	387	273	377	1	3	1	0	99	387
EDO. FALCON	MP. FALCON	PQ. ADAURE	ESCUELA BASICA ADAURE	1447	3	21	1135	673	1114	0	9	0	0	432	1135
EDO. FALCON	MP. FALCON	PQ. ADAURE	ESCUELA BASICA ADAURE NORTE	190	1	4	172	138	168	1	0	0	0	29	172
EDO. FALCON	MP. FALCON	PQ. EL VINCULO	ESCUELA BASICA BOLIVARIANA CONSUELO NAVAS	1654	3	44	1273	681	1229	1	6	0	0	541	1273
EDO. FALCON	MP. FALCON	PQ. EL VINCULO	ESCUELA BASICA LAS CARMELITAS	302	1	7	247	229	240	0	0	0	0	11	247
EDO. FALCON	MP. FALCON	PQ. EL VINCULO	ESCUELA ESTADAL LAS CUMARAGUAS	506	1	4	410	286	406	0	1	3	0	116	410
EDO. FALCON	MP. FALCON	PQ. EL VINCULO	ESCUELA BOLIVARIANA PUERTO ESCONDIDO	96	1	0	85	34	85	0	0	1	0	50	85
EDO. FALCON	MP. FALCON	PQ. EL HATO	ESCUELA BOLIVARIANA LA IDEA	221	1	1	210	164	209	0	0	0	0	45	210
EDO. FALCON	MP. FALCON	PQ. EL HATO	ESCUELA BASICA BOLIVARIANA BATALLA DE JUNIN	1414	3	10	1096	784	1086	0	3	1	0	298	1096
EDO. FALCON	MP. FALCON	PQ. MORUY	ESCUELA BASICA YABUQUIVA	1083	2	25	900	493	875	0	6	2	0	374	900
EDO. FALCON	MP. FALCON	PQ. MORUY	ESCUELA BASICA BOLIVARIANA BARUNU	554	1	4	413	312	409	1	2	0	0	94	413
EDO. FALCON	MP. FALCON	PQ. MORUY	CENTRO DE EDUCACION INCIAL SIMONCITO LA BOMBA	201	1	2	189	172	187	0	0	0	0	15	189
EDO. FALCON	MP. FALCON	PQ. MORUY	ESCUELA BASICA EL MAMONAL NER 150	180	1	4	178	82	174	0	0	0	1	91	178
EDO. FALCON	MP. FALCON	PQ. MORUY	ESCUELA BASICA BOLIVARIANA GUACUREBO	316	1	8	298	240	290	0	4	1	0	45	298
EDO. FALCON	MP. FALCON	PQ. MORUY	ESCUELA BASICA BOLIVARIANA MORUY	2435	5	52	2052	1322	2000	0	11	0	0	667	2052
EDO. FALCON	MP. FALCON	PQ. MORUY	ESCUELA BOLIVARIANA MIRABA	341	1	6	270	221	264	0	0	0	0	43	270
EDO. FALCON	MP. FALCON	PQ. MORUY	ESCUELA BOLIVARIANA GISEBO	207	1	6	178	133	172	0	0	0	0	39	178
EDO. FALCON	MP. FALCON	PQ. BARAIVED	ESCUELA BASICA CAMUNARE	283	1	1	219	148	218	0	0	1	0	69	219
EDO. FALCON	MP. FALCON	PQ. BARAIVED	ESCUELA BASICA MIRACA	723	2	15	624	414	609	0	5	0	1	189	624
EDO. FALCON	MP. FALCON	PQ. BARAIVED	ESCUELA BÁSICA BOLIVARIANA MANUEL C. MOLINA	935	2	20	765	495	745	0	5	1	0	244	765
EDO. FALCON	MP. FALCON	PQ. BARAIVED	UNIDAD EDUCATIVA BARAIVED	897	2	5	764	449	759	0	7	0	0	303	764
EDO. FALCON	MP. FALCON	PQ. ADICORA	ESCUELA BASICA ESTADAL UNITARIA TIRAYA	133	1	2	119	89	117	0	2	0	0	26	119
EDO. FALCON	MP. FALCON	PQ. ADICORA	ESCUELA BOLIVARIANA CHARAIMA	825	2	16	663	461	647	0	7	0	0	179	663
EDO. FALCON	MP. FALCON	PQ. ADICORA	ESCUELA BASICA CRUZ DEL VALLE RODRIGUEZ	892	2	14	735	528	721	0	3	0	0	190	735
EDO. FALCON	MP. FALCON	PQ. ADICORA	ESCUELA ESTADAL EL SUPI	513	1	16	404	222	388	0	3	0	0	163	404
EDO. FALCON	MP. FALCON	PQ. ADICORA	ESCUELA BOLIVARIANA SAN PEDRO	295	1	8	218	161	210	1	1	0	0	47	218
EDO. FALCON	MP. FALCON	PQ. ADICORA	CASA COMUNAL BUCHUACO	150	1	2	139	103	137	0	1	1	0	32	139
EDO. FALCON	MP. FALCON	PQ. ADICORA	ESCUELA BASICA BOLIVARIANA ADICORA	1548	3	20	1234	650	1214	0	3	0	1	560	1234
EDO. FALCON	MP. FALCON	PQ. JADACAQUIVA	ESCUELA BASICA GUAYACANAL	135	1	2	121	75	119	0	0	0	0	44	121
EDO. FALCON	MP. FALCON	PQ. JADACAQUIVA	ESCUELA BOLIVARIANA LA TRINIDAD	138	1	1	131	105	130	0	0	0	0	25	131
EDO. FALCON	MP. FALCON	PQ. JADACAQUIVA	ESCUELA ESTADAL SAN VICENTE	677	2	12	540	342	528	0	1	0	0	185	540
EDO. FALCON	MP. FALCON	PQ. JADACAQUIVA	ESCUELA ESTADAL LAS MARGARITAS	383	1	5	318	185	313	0	2	0	0	126	318
EDO. FALCON	MP. FALCON	PQ. JADACAQUIVA	ESCUELA BOLIVARIANA GUAIDABACOA	267	1	6	205	131	199	1	1	1	1	64	205
EDO. FALCON	MP. FALCON	PQ. JADACAQUIVA	ESCUELA BASICA BOLIVARIANA JADACAQUIVA	1340	3	14	1056	607	1042	2	6	0	0	427	1056
EDO. FALCON	MP. FALCON	PQ. JADACAQUIVA	ESCUELA BOLIVARIANA AMARAYA	139	1	2	121	17	119	0	3	0	0	99	121
EDO. FALCON	MP. FALCON	PQ. JADACAQUIVA	ESCUELA BOLIVARIANA SAN PEDRO	131	1	1	128	89	127	0	0	0	0	38	128
EDO. FALCON	MP. FALCON	PQ. BUENA VISTA	ESCUELA BOLIVARIANA LA PITAHAYA	238	1	1	229	174	228	0	0	0	0	54	229
EDO. FALCON	MP. FALCON	PQ. BUENA VISTA	ESCUELA BASICA MAICARA	472	1	5	369	272	364	0	1	0	0	91	369
EDO. FALCON	MP. FALCON	PQ. BUENA VISTA	ESCUELA ESTADAL MATIVIDIRO	436	1	2	384	282	382	0	3	0	0	97	384
EDO. FALCON	MP. FALCON	PQ. BUENA VISTA	ESCUELA BÁSICA BOLIVARIANA MANUELA WEFFER DE ROMERO	1987	4	36	1643	891	1607	0	6	0	2	708	1643
EDO. FALCON	MP. MONS. ITURRIZA	PQ. BOCA DE TOCUYO	ESCUELA BOLIVARIANA  MANUEL MOLINA HERNANDEZ	1421	3	18	1139	611	1121	0	5	0	0	505	1139
EDO. FALCON	MP. MONS. ITURRIZA	PQ. CHICHIRIVICHE	ESCUELA PRIMERA BOLIVARIANA FLAMENCO	1291	3	38	929	553	891	0	3	0	0	335	929
EDO. FALCON	MP. MONS. ITURRIZA	PQ. CHICHIRIVICHE	CENTRO EDUCACION INICIAL CELESTE	323	1	7	252	107	245	0	2	0	0	136	252
EDO. FALCON	MP. MONS. ITURRIZA	PQ. CHICHIRIVICHE	ESCUELA PRIMARIA  VIRGEN DEL VALLE	1407	3	31	1055	425	1024	0	6	0	0	593	1055
EDO. FALCON	MP. MONS. ITURRIZA	PQ. CHICHIRIVICHE	LICEO BOLIVARIANO RAMON YANEZ	1694	3	23	1281	517	1258	1	5	0	0	735	1281
EDO. FALCON	MP. MONS. ITURRIZA	PQ. CHICHIRIVICHE	CENTRO DE EDUCACIÓN INICIAL POLITA DE LIMA	1745	3	30	1305	539	1275	2	8	1	0	725	1305
EDO. FALCON	MP. MONS. ITURRIZA	PQ. TOCUYO DE LA COSTA	ESCUELA BOLIVARIANA TIBANA NER 123.	220	1	9	191	150	182	0	0	0	0	32	191
EDO. FALCON	MP. MONS. ITURRIZA	PQ. TOCUYO DE LA COSTA	ESCUELA BÁSICA AVECINDA PIÑA	1150	2	16	908	562	892	0	4	0	0	326	908
EDO. FALCON	MP. MONS. ITURRIZA	PQ. TOCUYO DE LA COSTA	ESCUELA PRIMARIA BOLIVARIANA SANTA ROSA	159	1	5	129	112	124	0	0	1	0	11	129
EDO. FALCON	MP. MONS. ITURRIZA	PQ. TOCUYO DE LA COSTA	UNIVERSIDAD EXPERIMENTAL FRANCISCO DE MIRANDA	555	1	12	434	299	422	0	1	0	0	122	434
EDO. FALCON	MP. MONS. ITURRIZA	PQ. TOCUYO DE LA COSTA	ESCUELA BOLIVARIANA JOSE MARIA GIL	1423	3	16	1095	626	1079	0	6	0	0	447	1095
EDO. FALCON	MP. MONS. ITURRIZA	PQ. TOCUYO DE LA COSTA	ESCUELA PRIMARIA  BOLIVARIANA SANARE ABAJO	563	1	18	412	280	394	0	1	0	0	113	412
EDO. FALCON	MP. MONS. ITURRIZA	PQ. TOCUYO DE LA COSTA	LICEO BOLIVARIANO  JACINTO REGINO PACHANO	1573	3	21	1260	771	1239	0	2	0	0	466	1260
EDO. FALCON	MP. MONS. ITURRIZA	PQ. TOCUYO DE LA COSTA	ESCUELA PRIMARIA BOLIVARIANA EL BLANQUILLO	159	1	1	119	110	118	0	0	0	0	8	119
EDO. FALCON	MP. MONS. ITURRIZA	PQ. TOCUYO DE LA COSTA	ESCUELA PRIMARIA BOLIVARIANA SAN JOSE DE SANARE	162	1	1	148	138	147	0	0	0	0	9	148
EDO. FALCON	MP. MONS. ITURRIZA	PQ. TOCUYO DE LA COSTA	ESCUELA BASICA EL ALTO DE LA ALEGRIA	490	1	15	309	221	294	0	1	0	0	72	309
EDO. FALCON	MP. TOCOPERO	CM. TOCOPERO	ESCUELA BOLIVARIANA ESTADAL CIENEGA LEJOS	896	2	18	749	570	731	1	3	0	0	157	749
EDO. FALCON	MP. TOCOPERO	CM. TOCOPERO	ESCUELA ESTADAL JOSE ISIDRO VIVAS	325	1	4	253	181	249	0	1	0	0	67	253
EDO. FALCON	MP. TOCOPERO	CM. TOCOPERO	CENTRO DE EDUCACION INICIAL CARMEN DE GOMEZ	405	1	12	340	236	328	0	0	0	0	92	340
EDO. FALCON	MP. TOCOPERO	CM. TOCOPERO	ESCUELA BOLIVARIANA NACIONAL PUENTE RICOA	480	1	12	357	285	345	0	1	0	0	59	357
EDO. FALCON	MP. TOCOPERO	CM. TOCOPERO	ALDEA BOLIVARIANA UNIVERSITARIA TOCOPERO	1643	3	35	1262	727	1227	0	5	0	0	495	1262
EDO. FALCON	MP. TOCOPERO	CM. TOCOPERO	ESCUELA BOLIVARIANA ESTADAL SANTA ROSA	1162	2	21	962	765	941	0	3	0	0	173	962
EDO. FALCON	MP. TOCOPERO	CM. TOCOPERO	ESCUELA BOLIVARIANA ESTADAL EL CABALLO	431	1	11	316	279	305	0	0	0	0	26	316
EDO. FALCON	MP. TOCOPERO	CM. TOCOPERO	ESCUELA BOLIVARIANA EL PERÚ NER 192	237	1	7	198	176	191	0	1	0	0	14	198
EDO. FALCON	MP. TOCOPERO	CM. TOCOPERO	ESCUELA BASICA BOLIVARIANA SANTO TOMAS	316	1	8	286	214	278	0	2	0	0	62	286
EDO. FALCON	MP. SILVA	PQ. BOCA DE AROA	ESCUELA BOLIVARIANA ANSELMITO	190	1	11	102	72	91	0	1	0	0	18	102
EDO. FALCON	MP. SILVA	PQ. BOCA DE AROA	ESCUELA BÁSICA KILOMETRO 26. NER 001	47	1	0	10	7	10	0	0	0	0	3	10
EDO. FALCON	MP. SILVA	PQ. BOCA DE AROA	ESCUELA PRIMARIA BOLIVARIANA PRÓSPERO AGUSTÍN OCANDO	1599	3	44	1089	680	1045	0	4	1	0	360	1089
EDO. FALCON	MP. SILVA	PQ. BOCA DE AROA	ESCUELA BOLIVARIANA JOSE RAMON YEPEZ	1843	4	42	1250	668	1208	1	5	1	0	533	1250
EDO. FALCON	MP. SILVA	PQ. BOCA DE AROA	ESCUELA DE EDUCACION INICIAL SIMONCITO JOSE RAMON YEPEZ	208	1	9	176	118	167	0	1	0	0	48	176
EDO. FALCON	MP. SILVA	PQ. BOCA DE AROA	ESCUELA ESTADAL BARRIO VERDE	255	1	5	192	156	187	1	1	1	0	28	192
EDO. FALCON	MP. SILVA	PQ. BOCA DE AROA	CENTRO DE EDUCACION INICIAL LAS DELICIAS	294	1	2	206	151	204	0	1	0	0	52	206
EDO. FALCON	MP. SILVA	PQ. BOCA DE AROA	JARDIN DE INFANCIA BARRIO CARTON	295	1	8	199	139	191	0	2	0	0	50	199
EDO. FALCON	MP. SILVA	PQ. TUCACAS	ESCUELA BOLIVARIANA SANARE ARRIBA	1048	2	17	665	462	648	0	6	0	0	180	665
EDO. FALCON	MP. SILVA	PQ. TUCACAS	ESCUELA BOLIVARIANA SANTA BARBARA NER 215	492	1	7	288	181	281	0	3	2	0	95	288
EDO. FALCON	MP. SILVA	PQ. TUCACAS	ESCUELA PRIMARIA ESTADAL ARMANDO SCHWARCK ANGLADE	671	2	10	466	321	456	0	6	1	0	128	466
EDO. FALCON	MP. SILVA	PQ. TUCACAS	CENTRO DE EDUCACION INICIAL FELIPE ESTEVES	1745	3	34	1256	444	1222	0	9	2	0	767	1256
EDO. FALCON	MP. SILVA	PQ. TUCACAS	ESCUELA DE EDUCACION INICIAL SIMONCITO ALICIA PIETRI DE CALDERA	627	2	21	438	213	417	0	1	0	0	203	438
EDO. FALCON	MP. SILVA	PQ. TUCACAS	LICEO BOLIVARIANO JOSE LEONARDO CHIRINOS	1493	3	35	989	365	954	1	7	2	1	578	989
EDO. FALCON	MP. SILVA	PQ. TUCACAS	CENTRO DE EDUCACION INICIAL RURAL SANARE ARRIBA	357	1	16	275	219	259	0	1	0	0	39	275
EDO. FALCON	MP. SILVA	PQ. TUCACAS	ESCUELA BASICA MUNICIPAL 03 TUCACAS	622	2	5	409	237	404	0	0	0	0	167	409
EDO. FALCON	MP. SILVA	PQ. TUCACAS	ESCUELA PRIMARIA BOLIVARIANA FELIPE ESTEVES	2680	5	48	1889	779	1841	0	10	1	1	1050	1889
EDO. FALCON	MP. SILVA	PQ. TUCACAS	ESCUELA BASICA ESTADAL LAS LAPAS NER 215	821	2	14	502	361	488	0	5	0	0	122	502
EDO. FALCON	MP. SILVA	PQ. TUCACAS	ESCUELA BOLIVARIANA FELIPITO NER 215	531	1	4	358	240	354	1	1	0	0	112	358
EDO. FALCON	MP. SILVA	PQ. TUCACAS	ESCUELA BOLIVARIANA CAÑO LEÓN NER 123	445	1	11	276	149	265	0	5	0	0	111	276
EDO. FALCON	MP. SILVA	PQ. TUCACAS	ESCUELA BOLIVARIANA LIZARDO NER 123	629	2	21	427	121	406	0	2	0	0	283	427
EDO. FALCON	MP. SILVA	PQ. TUCACAS	ESCUELA BASICA BOLIVARIANA LOS CORALES	530	1	12	375	273	363	0	1	1	0	88	375
EDO. FALCON	MP. SILVA	PQ. TUCACAS	ESCUELA BOLIVARIANA BETTY DE HERRERA	1905	4	33	1279	577	1246	0	9	1	0	659	1279
EDO. FALCON	MP. SILVA	PQ. TUCACAS	ESCUELA BASICA BUENA VISTA NER 123	405	1	1	267	208	266	0	2	0	0	56	267
EDO. FALCON	MP. SILVA	PQ. TUCACAS	ESCUELA PRIMARIA RITA DE VALERY	1695	3	34	1267	439	1233	0	3	0	1	790	1267
EDO. FALCON	MP. COLINA	PQ. MACORUCA	ESCUELA PRIMARIA BOLIVARIANA MARÍA ANASTASIA PERÓN	1262	3	19	830	609	811	0	5	0	0	197	830
EDO. FALCON	MP. COLINA	PQ. LAS CALDERAS	ESCUELA  BOLIVARIANA DON RÓMULO GALLEGOS	3836	7	40	3245	1586	3205	1	23	1	2	1592	3245
EDO. FALCON	MP. COLINA	PQ. LA VELA DE CORO	LICEO BOLIVARIANO ANTONIO DOLORES RAMONES	3416	6	47	2786	1561	2739	0	19	0	0	1159	2786
EDO. FALCON	MP. COLINA	PQ. LA VELA DE CORO	ESCUELA BOLIVARIANA BUTARE	303	1	3	243	207	240	0	3	0	0	30	243
EDO. FALCON	MP. COLINA	PQ. LA VELA DE CORO	ESCUELA BASICA PRIMARIA EMILIA ROSA MOLINA	3048	6	44	2470	1074	2426	0	9	1	0	1342	2470
EDO. FALCON	MP. COLINA	PQ. LA VELA DE CORO	ESCUELA BÁSICA BOLIVARIANA SABANA LARGA	2158	4	34	1766	912	1732	0	8	0	2	810	1766
EDO. FALCON	MP. COLINA	PQ. LA VELA DE CORO	ESCUELA PRIMARIA BOLIVARIANA CARLOS U. PENSO	2240	4	36	1851	1251	1815	0	8	0	0	556	1851
EDO. FALCON	MP. COLINA	PQ. LA VELA DE CORO	ESCUELA PRIMARIA BOLIVARIANA LAS VENTOSAS	332	1	8	285	208	277	0	3	0	0	66	285
EDO. FALCON	MP. COLINA	PQ. LA VELA DE CORO	ESCUELA BÁSICA BOLIVARIANA JOSÉ R. ALVAREZ	1305	3	20	1102	809	1082	0	6	0	0	267	1102
EDO. FALCON	MP. COLINA	PQ. LA VELA DE CORO	LICEO BOLIVARIANO HAYDEE CALLES DE MEDINA	2443	5	35	1990	1387	1955	1	10	1	0	556	1990
EDO. FALCON	MP. COLINA	PQ. LA VELA DE CORO	LICEO BOLIVARIANO JUAN CRISOSTOMO FALCÓN	2816	5	43	2220	1234	2177	0	9	0	0	934	2220
EDO. FALCON	MP. COLINA	PQ. LA VELA DE CORO	ESCUELA BASICA BOLIVARIANA TARATARA	986	2	15	784	532	769	0	10	0	0	227	784
EDO. FALCON	MP. COLINA	PQ. LA VELA DE CORO	ESCUELA PRIMARIA BOLIVARIANA SALVADOR CURIEL LA AGUADA
EDO. FALCON	MP. COLINA	PQ. ACURIGUA	ESCUELA PRIMARIA BOLIVARIANA LAS DOS BOCAS	596	1	13	484	325	471	0	1	0	0	145	484
EDO. FALCON	MP. COLINA	PQ. ACURIGUA	ESCUELA PRIMARIA BOLIVARIANA ACURIGUA	338	1	5	245	155	240	0	1	1	0	83	245
EDO. FALCON	MP. COLINA	PQ. ACURIGUA	ESCUELA PRIMARIA BOLIVARIANA EL PASO DE ACURIGUA	430	1	5	360	200	355	0	1	0	0	154	360
EDO. FALCON	MP. COLINA	PQ. GUAIBACOA	ESCUELA BÁSICA BOLIVARIANA GUAIBACOA	634	2	7	498	274	491	0	2	0	0	215	498
EDO. FALCON	MP. FEDERACION	PQ. MAPARARI	ESCUELA NACIONAL CAMBULLON	233	1	5	173	126	168	0	1	0	0	41	173
EDO. FALCON	MP. FEDERACION	PQ. MAPARARI	ESCUELA ESTADAL PARACOTO	212	1	4	145	135	141	0	1	0	0	5	145
EDO. FALCON	MP. FEDERACION	PQ. MAPARARI	ESCUELA ESTADAL EL ROBLE	432	1	9	334	221	325	0	4	0	0	100	334
EDO. FALCON	MP. FEDERACION	PQ. MAPARARI	ESCUELA ESTADAL DUVISI	283	1	4	212	150	208	0	0	2	0	56	212
EDO. FALCON	MP. FEDERACION	PQ. MAPARARI	ESCUELA BASICA EL DOCORAL	80	1	2	70	61	68	0	0	0	0	7	70
EDO. FALCON	MP. FEDERACION	PQ. MAPARARI	ESCUELA PRIMARIA BELLA  VISTA	202	1	4	120	76	116	0	2	0	0	38	120
EDO. FALCON	MP. FEDERACION	PQ. MAPARARI	ESCUELA BOLIVARIANA  SAN PEDRO	182	1	3	142	114	139	0	0	0	0	25	142
EDO. FALCON	MP. FEDERACION	PQ. MAPARARI	ESCUELA BÁSICA BOLIVARIANA MAXIMILIANO ITURBE	1780	3	42	1304	677	1262	1	3	1	0	580	1304
EDO. FALCON	MP. FEDERACION	PQ. MAPARARI	ESCUELA ESTADAL LA GARZA	252	1	2	185	149	183	0	1	0	0	33	185
EDO. FALCON	MP. FEDERACION	PQ. MAPARARI	ESCUELA PRIMARIA  EL TURAL	669	2	34	498	360	464	0	2	1	0	101	498
EDO. FALCON	MP. FEDERACION	PQ. MAPARARI	ESCUELA BASICA BOLIVARIANA LA PLAZA	327	1	9	296	251	287	0	3	1	0	32	296
EDO. FALCON	MP. FEDERACION	PQ. AGUA LARGA	UNIDAD EDUCATIVA RAFAELA P. DE SIERRA	707	2	12	525	379	513	0	4	0	0	130	525
EDO. FALCON	MP. FEDERACION	PQ. AGUA LARGA	ESCUELA BASICA CIRO JOSE MALDONADO	721	2	8	536	391	528	0	5	0	0	132	536
EDO. FALCON	MP. FEDERACION	PQ. AGUA LARGA	ESCUELA ESTADAL JUAN GIL	121	1	2	78	39	76	0	1	0	0	36	78
EDO. FALCON	MP. FEDERACION	PQ. AGUA LARGA	ESCUELA BÁSICA ESTADAL MAPORAL ARRIBA	138	1	2	133	94	131	0	0	0	0	37	133
EDO. FALCON	MP. FEDERACION	PQ. AGUA LARGA	ESCUELA BASICA BOLIVARIANA ARAJU	145	1	1	126	120	125	0	0	0	0	5	126
EDO. FALCON	MP. FEDERACION	PQ. AGUA LARGA	ESCUELA ESTADAL NAFIA	145	1	2	104	78	102	0	0	0	0	24	104
EDO. FALCON	MP. FEDERACION	PQ. AGUA LARGA	ESCUELA ESTADAL TAPAROY	169	1	1	111	102	110	1	1	0	0	6	111
EDO. FALCON	MP. FEDERACION	PQ. AGUA LARGA	ESCUELA ESTADAL UNITARIA EL BALCON	92	1	0	80	74	80	0	1	0	0	5	80
EDO. FALCON	MP. FEDERACION	PQ. CHURUGUARA	ESCUELA BOLIVARIANA  POZO LARGO	239	1	7	160	132	153	1	1	0	0	19	160
EDO. FALCON	MP. FEDERACION	PQ. CHURUGUARA	ESCUELA BOLIVARIANA  LOS RALONES	216	1	5	116	68	111	1	1	0	0	41	116
EDO. FALCON	MP. FEDERACION	PQ. CHURUGUARA	ESCUELA BASICA OCTAVIO R. PETIT	1178	2	14	996	433	982	0	3	1	0	545	996
EDO. FALCON	MP. FEDERACION	PQ. CHURUGUARA	ESCUELA BOLIVARIANA  EL CACURO	485	1	10	355	252	345	1	0	0	0	92	355
EDO. FALCON	MP. FEDERACION	PQ. CHURUGUARA	ESCUELA CONCENTRADA EL PARAMITO	127	1	1	104	93	103	0	1	0	0	9	104
EDO. FALCON	MP. FEDERACION	PQ. CHURUGUARA	ESCUELA ESTADAL  POZO REDONDO	382	1	6	276	188	270	0	1	0	0	81	276
EDO. FALCON	MP. FEDERACION	PQ. CHURUGUARA	ESCUELA BÁSICA BOLIVARIANA CHURUGUARA	2402	5	31	1921	1038	1890	0	9	2	0	841	1921
EDO. FALCON	MP. FEDERACION	PQ. CHURUGUARA	ESCUELA BÁSICA BOLIVARIANA PADRE ALDANA	3074	6	59	2327	981	2268	2	13	3	2	1267	2327
EDO. FALCON	MP. FEDERACION	PQ. CHURUGUARA	ESCUELA BASICA LAS COLINAS	158	1	1	79	42	78	0	0	0	0	36	79
EDO. FALCON	MP. FEDERACION	PQ. CHURUGUARA	ESCUELA BASICA BOLIVARIANA LA SABANITA	352	1	10	326	236	316	0	2	0	0	78	326
EDO. FALCON	MP. FEDERACION	PQ. CHURUGUARA	UNIDAD EDUCATIVA COLEGIO SAN GABRIEL	733	2	13	667	247	654	1	2	0	1	403	667
EDO. FALCON	MP. FEDERACION	PQ. CHURUGUARA	ESCUELA NACIONAL CONCENTRADA LA TUNITA	52	1	0	45	44	45	0	0	0	0	1	45
EDO. FALCON	MP. FEDERACION	PQ. CHURUGUARA	ESCUELA BASICA LIBERTADOR SIMON BOLIVAR	1225	3	28	996	564	968	0	6	1	1	396	996
EDO. FALCON	MP. FEDERACION	PQ. EL PAUJI	COMPLEJO EDUCATIVO BOLIVARIANO BARRIO NUEVO	744	2	15	572	497	557	0	1	2	0	57	572
EDO. FALCON	MP. FEDERACION	PQ. EL PAUJI	ESCUELA BASICA BOLIVARIANA MAPARA	350	1	13	305	240	292	0	3	0	0	49	305
EDO. FALCON	MP. FEDERACION	PQ. EL PAUJI	ESCUELA DOLORES ALVAREZ	1264	3	16	919	638	903	0	3	0	0	262	919
EDO. FALCON	MP. FEDERACION	PQ. INDEPENDENCIA	ESCUELA ESTADAL SURUY	226	1	4	168	89	164	0	3	0	0	72	168
EDO. FALCON	MP. FEDERACION	PQ. INDEPENDENCIA	ESCUELA ESTADAL GUARABAL	178	1	2	157	134	155	0	0	0	0	21	157
EDO. FALCON	MP. FEDERACION	PQ. INDEPENDENCIA	ESCUELA ESTADAL TUPI	222	1	1	157	73	156	0	2	1	0	80	157
EDO. FALCON	MP. FEDERACION	PQ. INDEPENDENCIA	ESCUELA ESTADAL EL RELOJ	108	1	2	84	70	82	0	0	0	0	12	84
EDO. FALCON	MP. LOS TAQUES	PQ. LOS TAQUES	ESCUELA BÁSICA BOLIVARIANA AMUAY	2557	5	47	2126	1358	2079	1	16	0	0	704	2126
EDO. FALCON	MP. LOS TAQUES	PQ. LOS TAQUES	ESCUELA BÁSICA BOLIVARIANA EL HOYITO	532	1	7	432	295	425	0	3	0	0	127	432
EDO. FALCON	MP. LOS TAQUES	PQ. LOS TAQUES	ESCUELA BÁSICA BOLIVARIANA CUMUJACOA	449	1	11	384	222	373	0	3	0	0	148	384
EDO. FALCON	MP. LOS TAQUES	PQ. LOS TAQUES	CENTRO DE EDUCACIÓN INICIAL LOS TAQUES	1927	4	47	1575	882	1528	0	5	1	0	640	1575
EDO. FALCON	MP. LOS TAQUES	PQ. LOS TAQUES	ESCUELA BÁSICA BOLIVARIANA JAYANA	1319	3	19	1111	777	1092	0	11	1	0	303	1111
EDO. FALCON	MP. LOS TAQUES	PQ. LOS TAQUES	ESCUELA BÁSICA BOLIVARIANA TACAL	580	1	9	444	329	435	0	2	1	0	103	444
EDO. FALCON	MP. LOS TAQUES	PQ. LOS TAQUES	ESCUELA BOLIVARIANA GUANADITO	1493	3	23	1289	635	1266	0	5	0	1	625	1289
EDO. FALCON	MP. LOS TAQUES	PQ. LOS TAQUES	ESCUELA BÁSICA LOS TAQUES	3043	6	77	2533	1418	2456	1	11	1	0	1025	2533
EDO. FALCON	MP. LOS TAQUES	PQ. LOS TAQUES	ESCUELA BÁSICA JOSÉ ANTONIO VELASCO	2417	5	53	1960	1338	1907	1	17	0	0	551	1960
EDO. FALCON	MP. LOS TAQUES	PQ. LOS TAQUES	ESCUELA BÁSICA NACIONAL EL OASIS	1742	3	31	1540	1198	1509	0	6	0	1	304	1540
EDO. FALCON	MP. LOS TAQUES	PQ. JUDIBANA	ESCUELA BÁSICA BOLIVARIANA CREOLANDIA	3731	7	68	3064	2141	2996	1	17	1	0	836	3064
EDO. FALCON	MP. LOS TAQUES	PQ. JUDIBANA	ESCUELA BÁSICA BOLIVARIANA DON RÓMULO BETANCOURT	3704	7	64	3156	2344	3092	1	15	0	1	731	3156
EDO. FALCON	MP. LOS TAQUES	PQ. JUDIBANA	COMPLEJO EDUCATIVO AUTONOMO SIMON BOLIVAR	4073	8	30	3493	1230	3463	0	11	1	2	2219	3493
EDO. FALCON	MP. LOS TAQUES	PQ. JUDIBANA	ESCUELA BASICA BOLIVARIANA 4 DE FEBRERO	2084	4	43	1667	1250	1624	0	11	0	3	360	1667
EDO. FALCON	MP. LOS TAQUES	PQ. JUDIBANA	UNIDAD EDUCATIVA DON BOSCO	2539	5	34	2183	674	2149	0	12	0	1	1462	2183
EDO. FALCON	MP. CARIRUBANA	PQ. NORTE	ESCUELA BASICA CAJA DE AGUA	3442	6	37	2926	1631	2889	0	24	0	0	1234	2926
EDO. FALCON	MP. CARIRUBANA	PQ. NORTE	CENTRO DE EDUCACION INICIAL ANTONIO JOSE DE SUCRE	886	2	7	810	591	803	0	4	0	0	208	810
EDO. FALCON	MP. CARIRUBANA	PQ. NORTE	C.E.I OLGA RODRIGUEZ DE CURIEL	547	1	6	483	344	477	0	1	0	0	132	483
EDO. FALCON	MP. CARIRUBANA	PQ. NORTE	CENTRO DE CAPACITACION INTEGRAL JESUS DE NAZARETH	524	1	4	464	404	460	0	1	0	0	55	464
EDO. FALCON	MP. CARIRUBANA	PQ. NORTE	ESCUELA BOLIVARIANA SIMÓN RODRÍGUEZ	1448	3	18	1137	845	1119	0	5	1	0	268	1137
EDO. FALCON	MP. CARIRUBANA	PQ. NORTE	UNIDAD EDUCATIVA INSTITUTO PARAGUANA	1729	3	43	1510	820	1467	0	10	1	0	636	1510
EDO. FALCON	MP. CARIRUBANA	PQ. NORTE	ESCUELA BOLIVARIANA EZEQUIEL ZAMORA	1427	3	18	1277	944	1259	0	7	0	0	308	1277
EDO. FALCON	MP. CARIRUBANA	PQ. NORTE	COMPLEJO SOCIOCULTURAL SANTA ROSALIA	427	1	1	366	290	365	0	1	0	0	74	366
EDO. FALCON	MP. CARIRUBANA	PQ. NORTE	ESCUELA BÁSICA ANTIGUO AEROPUERTO	3039	6	37	2586	1551	2549	0	18	0	1	979	2586
EDO. FALCON	MP. CARIRUBANA	PQ. NORTE	INSTITUTO SOCIALISTA DE PESCA Y ACUICULTURA	1028	2	27	733	444	706	0	4	0	1	257	733
EDO. FALCON	MP. CARIRUBANA	PQ. NORTE	ESCUELA BOLIVARIANA JOSEFA VICTORIANA RIERA	2480	5	31	1960	1363	1929	0	9	0	1	556	1960
EDO. FALCON	MP. CARIRUBANA	PQ. NORTE	CENTRO DE EDUCACION INICIAL UNIÓN	1661	3	31	1436	1219	1405	0	2	0	0	184	1436
EDO. FALCON	MP. CARIRUBANA	PQ. NORTE	ESCUELA BASICA BOLIVARIANA ESTEBAN SMITH MONZON	3796	7	62	3091	2035	3029	1	17	2	1	973	3091
EDO. FALCON	MP. CARIRUBANA	PQ. NORTE	ESCUELA BASICA ALEJANDRO IBARRA	2948	5	35	2367	1131	2332	1	7	1	0	1192	2367
EDO. FALCON	MP. CARIRUBANA	PQ. NORTE	SALON DE USOS MULTIPLES INGENIERO CARLOS MILANO	200	1	5	189	134	184	0	1	0	0	49	189
EDO. FALCON	MP. CARIRUBANA	PQ. NORTE	INSTITUTO DE PREVISIÓN Y ASISTENCIA SOCIAL DEL MINISTERIO DE EDUCACION. IPASME	2377	5	30	1934	890	1904	0	8	4	1	1001	1934
EDO. FALCON	MP. CARIRUBANA	PQ. NORTE	UNIDAD EDUCATIVA CARLOS DIEZ DEL CIERVO	5785	11	84	4847	2794	4763	1	39	1	3	1925	4847
EDO. FALCON	MP. CARIRUBANA	PQ. SANTA ANA	ESCUELA BOLIVARIANA MACHORUCA	378	1	3	308	232	305	0	2	0	1	70	308
EDO. FALCON	MP. CARIRUBANA	PQ. SANTA ANA	ESCUELA BOLIVARIANA CASETO	585	1	5	483	381	478	0	3	0	0	94	483
EDO. FALCON	MP. CARIRUBANA	PQ. SANTA ANA	ESCUELA BOLIVARIANA POLITA D' LIMA	2706	5	69	2196	1571	2127	0	16	0	1	539	2196
EDO. FALCON	MP. CARIRUBANA	PQ. SANTA ANA	ESCUELA BASICA BOLIVARIANA PUENTE DEL CAYUDE	301	1	2	284	254	282	0	0	0	0	28	284
EDO. FALCON	MP. CARIRUBANA	PQ. SANTA ANA	ESCUELA BOLIVARIANA NARCISO ANTONIO GARCIA	2599	5	42	2182	1169	2140	0	12	1	0	958	2182
EDO. FALCON	MP. CARIRUBANA	PQ. SANTA ANA	ESCUELA BOLIVARIANA EL TAQUE	246	1	5	226	152	221	0	0	0	0	69	226
EDO. FALCON	MP. CARIRUBANA	PQ. SANTA ANA	LICEO BOLIVARIANO TACUATO	246	1	2	229	195	227	0	4	0	0	28	229
EDO. FALCON	MP. CARIRUBANA	PQ. SANTA ANA	ESCUELA BOLIVARIANA LA RINCONADA	463	1	6	422	329	416	0	2	0	0	85	422
EDO. FALCON	MP. CARIRUBANA	PQ. SANTA ANA	ESCUELA BOLIVARIANA MAITIRUMA	362	1	4	295	214	291	0	2	0	1	74	295
EDO. FALCON	MP. CARIRUBANA	PQ. SANTA ANA	ESCUELA BOLIVARIANA MISARAY	335	1	3	269	178	266	0	5	0	0	83	269
EDO. FALCON	MP. CARIRUBANA	PQ. SANTA ANA	ESCUELA BOLIVARIANA EL CERRITO	272	1	3	206	159	203	0	0	0	0	44	206
EDO. FALCON	MP. CARIRUBANA	PQ. SANTA ANA	ESCUELA BOLIVARIANA DABADUVARE	60	1	2	58	44	56	0	1	0	0	11	58
EDO. FALCON	MP. CARIRUBANA	PQ. SANTA ANA	ESCUELA BOLIVARIANA CERRO ATRAVESADO	151	1	2	148	135	146	0	1	0	0	10	148
EDO. FALCON	MP. CARIRUBANA	PQ. SANTA ANA	ESCUELA BOLIVARIANA VÍA SANTA ANA	2314	4	41	1920	1518	1879	0	10	2	0	349	1920
EDO. FALCON	MP. CARIRUBANA	PQ. CARIRUBANA	ESCUELA TECNICA ROBINSONIANA COMERCIAL PUNTO FIJO	2888	5	27	2190	911	2163	1	8	0	2	1241	2190
EDO. FALCON	MP. CARIRUBANA	PQ. CARIRUBANA	LICEO BOLIVARIANO JOSÉ LADISLAO ANDARA	3485	7	58	2826	1751	2768	1	22	3	2	989	2826
EDO. FALCON	MP. CARIRUBANA	PQ. CARIRUBANA	UNIDAD EDUCATIVA ITALO VENEZOLANO CRISTO REY	290	1	1	254	88	253	1	0	0	0	164	254
EDO. FALCON	MP. CARIRUBANA	PQ. CARIRUBANA	ESCUELA BOLIVARIANA MENE GRANDE	3827	7	81	2960	1540	2879	2	12	1	0	1324	2960
EDO. FALCON	MP. CARIRUBANA	PQ. CARIRUBANA	INSTITUTO DE EDUCACION ESPECIAL LUZ Y HOGAR	1443	3	22	1251	471	1229	0	5	0	2	751	1251
EDO. FALCON	MP. CARIRUBANA	PQ. CARIRUBANA	ESCUELA BÁSICA MANUELA AULAR DE HERNANDEZ	2043	4	22	1628	1012	1606	0	11	1	0	582	1628
EDO. FALCON	MP. CARIRUBANA	PQ. CARIRUBANA	CENTRO DE EDUCACION INICIAL DOÑA CARMEN VALVERDE	1339	3	32	1103	611	1071	0	6	1	0	453	1103
EDO. FALCON	MP. CARIRUBANA	PQ. CARIRUBANA	UNIDAD EDUCATIVA NAZARETH FE Y ALEGRIA	3587	7	50	2950	1611	2900	5	14	2	6	1262	2950
EDO. FALCON	MP. CARIRUBANA	PQ. CARIRUBANA	ESCUELA BOLIVARIANA HECTOR M. PEÑA	3148	6	57	2514	1912	2457	1	17	1	2	524	2514
EDO. FALCON	MP. CARIRUBANA	PQ. CARIRUBANA	ESCUELA BASICA PUNTO FIJO	3174	6	48	2510	1181	2462	1	20	1	0	1259	2510
EDO. FALCON	MP. CARIRUBANA	PQ. CARIRUBANA	CENTRO DE EDUCACION INTEGRAL RESURRECCION	2560	5	53	2148	1378	2095	0	11	0	2	704	2148
EDO. FALCON	MP. CARIRUBANA	PQ. CARIRUBANA	ESCUELA BOLIVARIANA DELTA AMACURO	4211	8	63	3403	1603	3340	2	14	4	2	1715	3403
EDO. FALCON	MP. CARIRUBANA	PQ. CARIRUBANA	CENTRO DE EDUCACION INICIAL ANDRES ELOY BLANCO	1208	3	14	909	602	895	1	7	0	0	285	909
EDO. FALCON	MP. CARIRUBANA	PQ. CARIRUBANA	UNIDAD EDUCATIVA SAN FRANCISCO JAVIER	3306	6	53	2683	1414	2630	0	9	1	2	1204	2683
EDO. FALCON	MP. CARIRUBANA	PQ. CARIRUBANA	ESCUELA TÉCNICA ROBINSONIANA INDUSTRIAL GENERALÍSIMO FRANCISCO DE MIRANDA	2129	4	22	1681	696	1659	0	10	1	0	952	1681
EDO. FALCON	MP. CARIRUBANA	PQ. CARIRUBANA	ESCUELA BÁSICA VICTOR LINO GÓMEZ	3976	7	77	3190	2046	3113	1	19	0	2	1045	3190
EDO. FALCON	MP. CARIRUBANA	PQ. CARIRUBANA	LICEO BOLIVARIANO RAFAEL SANCHEZ LOPEZ	1661	3	27	1369	1113	1342	1	4	0	0	224	1369
EDO. FALCON	MP. CARIRUBANA	PQ. CARIRUBANA	COMPLEJO EDUCATIVO JOSEFA CAMEJO	685	2	12	606	435	594	0	7	0	0	152	606
EDO. FALCON	MP. CARIRUBANA	PQ. CARIRUBANA	UNIDAD EDUCATIVA NICOLASA MEDINA DE ZAVALA	1735	3	24	1384	846	1360	0	6	0	0	508	1384
EDO. FALCON	MP. CARIRUBANA	PQ. CARIRUBANA	ESCUELA HOGAR T F PEDRO GONZALEZ RUIZ	199	1	6	188	160	182	0	1	0	0	21	188
EDO. FALCON	MP. CARIRUBANA	PQ. CARIRUBANA	ESCUELA BOLIVARIANA VICTOR RAUL SOTO	2186	4	37	1723	802	1686	1	7	1	0	875	1723
EDO. FALCON	MP. CARIRUBANA	PQ. CARIRUBANA	UNIDAD EDUCATIVA MARIANO DE TALAVERA	2655	5	57	2276	1034	2219	1	15	0	2	1167	2276
EDO. FALCON	MP. CARIRUBANA	PQ. CARIRUBANA	ESCUELA BOLIVARIANA CASA SAGRADA FAMILIA	607	2	20	536	407	516	0	6	0	0	103	536
EDO. FALCON	MP. CARIRUBANA	PQ. CARIRUBANA	ESCUELA PRIMARIA NACIONAL ANDRÉS ELOY BLANCO	3004	6	56	2395	1584	2339	1	9	0	1	744	2395
EDO. FALCON	MP. CARIRUBANA	PQ. CARIRUBANA	ESCUELA BASICA SANTA ELENA	1400	3	29	1209	760	1180	0	7	0	1	412	1209
EDO. FALCON	MP. CARIRUBANA	PQ. CARIRUBANA	ESCUELA BOLIVARIANA BENEDICTO MARMOL	3070	6	58	2760	1118	2702	0	9	0	1	1574	2760
EDO. FALCON	MP. CARIRUBANA	PQ. CARIRUBANA	ESCUELA BOLIVARIANA LAS ADJUNTAS	2572	5	35	2226	1480	2191	1	17	0	0	693	2226
EDO. FALCON	MP. CARIRUBANA	PQ. CARIRUBANA	ESCUELA BASICA 23 DE ENERO	2284	4	17	1839	1116	1822	2	16	1	1	686	1839
EDO. FALCON	MP. CARIRUBANA	PQ. CARIRUBANA	ESCUELA BOLIVARIANA PARAGUANÁ	3310	6	58	2921	1057	2863	0	5	3	0	1798	2921
EDO. FALCON	MP. CARIRUBANA	PQ. PUNTA CARDON	ESCUELA BOLIVARIANA AURA MEDINA DE VENTURA	2515	5	79	2108	1295	2029	0	13	4	0	717	2108
EDO. FALCON	MP. CARIRUBANA	PQ. PUNTA CARDON	UNIDAD EDUCATIVA AUTONOMO NICOLAS CURIEL COUTHINO	3636	7	48	3076	1147	3028	0	11	1	3	1866	3076
EDO. FALCON	MP. CARIRUBANA	PQ. PUNTA CARDON	CENTRO DE EDUCACION INICIAL CIUDAD FEDERACION	452	1	12	417	347	405	0	3	0	0	55	417
EDO. FALCON	MP. CARIRUBANA	PQ. PUNTA CARDON	LICEO BOLIVARIANO ALEJANDRO PETION	3907	7	72	3265	2092	3193	0	20	3	2	1076	3265
EDO. FALCON	MP. CARIRUBANA	PQ. PUNTA CARDON	INSTITUTO CARDON	3891	7	26	3429	935	3403	0	13	1	1	2453	3429
EDO. FALCON	MP. CARIRUBANA	PQ. PUNTA CARDON	ESCUELA BASICA BOLIVARIANA LA TRINIDAD	761	2	7	579	402	572	0	4	0	2	164	579
EDO. FALCON	MP. CARIRUBANA	PQ. PUNTA CARDON	ESCUELA BOLIVARIANA ANTONIO EVARISTO ARCAYA	525	1	4	470	372	466	0	1	1	0	92	470
EDO. FALCON	MP. CARIRUBANA	PQ. PUNTA CARDON	ESCUELA BOLIVARIANA PUNTA CARDÓN ANEXO	2392	5	55	1965	1286	1910	0	8	0	1	615	1965
EDO. FALCON	MP. CARIRUBANA	PQ. PUNTA CARDON	UNIVERSIDAD NACIONAL ABIERTA U.N.A	1709	3	14	1493	425	1479	0	8	1	2	1043	1493
EDO. FALCON	MP. CARIRUBANA	PQ. PUNTA CARDON	ESCUELA BASICA BOLIVARIANA ANDRES BELLO	2273	4	46	1970	1546	1924	0	7	1	1	369	1970
EDO. FALCON	MP. CARIRUBANA	PQ. PUNTA CARDON	ESCUELA BÁSICA INES FUGUET DE PEÑA	1623	3	23	1443	615	1420	0	10	1	2	792	1443
EDO. FALCON	MP. CARIRUBANA	PQ. PUNTA CARDON	ESCUELA BASICA SANTIAGO M. DAVALILLO	3282	6	43	2702	1701	2659	0	8	2	3	945	2702
EDO. FALCON	MP. CARIRUBANA	PQ. PUNTA CARDON	LICEO BOLIVARIANO MAESTRO GALLEGOS	3142	6	74	2737	1895	2663	0	20	1	0	747	2737
EDO. FALCON	MP. CARIRUBANA	PQ. PUNTA CARDON	CENTRO DE FORMACION INDUSTRIAL INCE PUNTO FIJO	1584	3	39	1306	802	1267	0	7	2	1	455	1306
EDO. FALCON	MP. CARIRUBANA	PQ. PUNTA CARDON	CENTRO DE EDUCACIÓN INICIAL SANTIAGO DAVALILLO	1605	3	26	1290	759	1264	1	10	3	0	491	1290
EDO. FALCON	MP. CARIRUBANA	PQ. PUNTA CARDON	UNIVERSIDAD BOLIVARIANA DE VENEZUELA	1255	3	19	1134	569	1115	0	6	1	2	537	1134
EDO. FALCON	MP. CARIRUBANA	PQ. PUNTA CARDON	CENTRO DE ATENCION INTEGRAL PARA PERSONAS CON AUTISMO	2247	4	38	1978	1327	1940	0	14	1	3	595	1978
EDO. FALCON	MP. CARIRUBANA	PQ. PUNTA CARDON	ESCUELA BOLIVARIANA LOS ROSALES	1496	3	30	1241	1072	1211	0	4	1	2	132	1241
EDO. FALCON	MP. CARIRUBANA	PQ. PUNTA CARDON	ESCUELA BÁSICA ALICIA TREMONT DE MEDINA	2867	5	65	2390	1602	2325	0	11	1	0	711	2390
EDO. FALCON	MP. CARIRUBANA	PQ. PUNTA CARDON	INSTITUTO JUAN XXIII LOS TURPIALES	2726	5	33	2297	401	2264	0	7	0	2	1854	2297
EDO. FALCON	MP. CARIRUBANA	PQ. PUNTA CARDON	CENTRO DE EDUCACION INICIAL 23 DE ENERO	532	1	8	493	348	485	0	2	1	0	134	493
EDO. FALCON	MP. DABAJURO	CM. DABAJURO	ESCUELA BASICA LAS JAGUAS	199	1	3	164	123	161	0	1	0	0	37	164
EDO. FALCON	MP. DABAJURO	CM. DABAJURO	ESCUELA BASICA BOLIVARIANA EL BUCHAL NER 122	597	1	6	444	225	438	0	2	0	0	211	444
EDO. FALCON	MP. DABAJURO	CM. DABAJURO	ESCUELA BASICA ROGELIO ESPINOZA	527	1	5	422	214	417	0	3	0	1	199	422
EDO. FALCON	MP. DABAJURO	CM. DABAJURO	ESCUELA PRIMARIA BOLIVARIANA LA SEÑORA	320	1	3	213	186	210	0	0	0	0	24	213
EDO. FALCON	MP. DABAJURO	CM. DABAJURO	ESCUELA BASICA BOLIVARIANA JACINTO R. PACHANO	2826	5	70	2293	1260	2223	0	12	0	1	950	2293
EDO. FALCON	MP. DABAJURO	CM. DABAJURO	ESCUELA BÁSICA POTRERITO
EDO. FALCON	MP. DABAJURO	CM. DABAJURO	ESCUELA NACIONAL LA BARISIGUAS	626	2	4	504	274	500	0	4	0	0	222	504
EDO. FALCON	MP. DABAJURO	CM. DABAJURO	ESCUELA PRIMARIA BOLIVARIANA SOUBLETTE	2156	4	46	1801	956	1755	0	6	1	0	792	1801
EDO. FALCON	MP. DABAJURO	CM. DABAJURO	ESCUELA ESTADAL LAS FLORES	74	1	0	47	11	47	0	0	0	0	36	47
EDO. FALCON	MP. DABAJURO	CM. DABAJURO	ESCUELA BASICA BOLIVARIANA INES OBERTO DE REYES	1028	2	20	834	446	814	1	5	0	0	362	834
EDO. FALCON	MP. DABAJURO	CM. DABAJURO	ESCUELA BASICA BOLIVARIANA LAS DELICIAS	609	2	8	510	383	502	0	1	0	0	118	510
EDO. FALCON	MP. DABAJURO	CM. DABAJURO	ESCUELA BASICA BOLIVARIANA GUILLERMO DE LEON	2642	5	48	2036	1016	1988	0	11	1	1	959	2036
EDO. FALCON	MP. DABAJURO	CM. DABAJURO	UNIDAD EDUCATIVA ANGEL DOLORES COLMAN	1816	4	29	1455	708	1426	0	12	1	0	705	1455
EDO. FALCON	MP. DABAJURO	CM. DABAJURO	ESCUELA PRIMARIA BOLIVARIANA  TUPURITO	405	1	2	307	218	305	0	3	1	0	83	307
EDO. FALCON	MP. CACIQUE MANAURE	CM. YARACAL	ESCUELA BASICA BOLIVARIANA CAMPECHE NUEVO	479	1	6	363	175	357	0	5	0	0	177	363
EDO. FALCON	MP. CACIQUE MANAURE	CM. YARACAL	LICEO BOLIVARIANO YARACAL	1279	3	38	982	558	944	0	3	0	0	383	982
EDO. FALCON	MP. CACIQUE MANAURE	CM. YARACAL	ESCUELA BASICA BOLIVARIANA ALTAMIRA	1488	3	33	1184	652	1151	0	1	0	0	498	1184
EDO. FALCON	MP. CACIQUE MANAURE	CM. YARACAL	ESCUELA BASICA BOLIVARIANA YARACAL	2316	4	78	1781	989	1703	0	5	1	0	708	1781
EDO. FALCON	MP. CACIQUE MANAURE	CM. YARACAL	ESCUELA BOLIVARIANA EL CAIMAN	285	1	13	238	157	225	0	0	0	0	68	238
EDO. FALCON	MP. CACIQUE MANAURE	CM. YARACAL	ESCUELA BASICA BOLIVARIANA MARIA EUGENIA TOYO	2202	4	76	1770	1046	1694	0	16	1	1	630	1770
EDO. FALCON	MP. JACURA	PQ. ARAURIMA	ESCUELA BOLIVARIANA RIECITO. NER 373	320	1	10	255	186	245	0	2	0	0	57	255
EDO. FALCON	MP. JACURA	PQ. ARAURIMA	ESCUELA ESTADAL EL ENEA	294	1	7	228	160	221	0	0	0	0	61	228
EDO. FALCON	MP. JACURA	PQ. ARAURIMA	ESCUELA BASICA BOLIVARIANA MARIANO PICON SALAS	1407	3	11	1123	695	1112	0	5	0	1	411	1123
EDO. FALCON	MP. JACURA	PQ. ARAURIMA	ESCUELA BASICA BOLIVARIANA MIXTA BACHACAL	312	1	6	203	130	197	0	2	0	0	65	203
EDO. FALCON	MP. JACURA	PQ. ARAURIMA	ESCUELA BÁSICA COGOLLAL NER 373	176	1	4	143	103	139	0	1	0	0	35	143
EDO. FALCON	MP. JACURA	PQ. JACURA	ESCUELA BOLIVARIANA   CUEPARO	973	2	7	663	542	656	0	1	0	0	113	663
EDO. FALCON	MP. JACURA	PQ. JACURA	ESCUELA BOLIVARIANA PUEBLO NUEVO	1042	2	15	804	523	789	1	11	0	2	252	804
EDO. FALCON	MP. JACURA	PQ. JACURA	ESCUELA BASICA BOLIVARIANA ESTADAL DANIEL NAVEA	983	2	12	628	339	616	0	4	1	0	272	628
EDO. FALCON	MP. JACURA	PQ. JACURA	ESCUELA BASICA  BUENA VISTA	281	1	2	190	161	188	0	1	0	0	26	190
EDO. FALCON	MP. JACURA	PQ. JACURA	ESCUELA BOLIVARIANA MARIA LUGO DE VELASQUEZ	241	1	3	212	191	209	0	1	0	0	17	212
EDO. FALCON	MP. JACURA	PQ. JACURA	ESCUELA BOLIVARIANA ANDRES BELLO	864	2	13	654	330	641	0	7	0	0	304	654
EDO. FALCON	MP. JACURA	PQ. JACURA	ESCUELA BÁSICA AGUSTIN CORDERO MECOCAL	181	1	2	144	120	142	0	0	0	0	22	144
EDO. FALCON	MP. JACURA	PQ. AGUA LINDA	ESCUELA BOLIVARIANA  AGUA LINDA	586	1	20	402	282	382	0	4	0	0	96	402
EDO. FALCON	MP. JACURA	PQ. AGUA LINDA	ESCUELA NACIONAL TACAMIRE	185	1	3	105	80	102	0	0	0	0	22	105
EDO. FALCON	MP. JACURA	PQ. AGUA LINDA	ESCUELA BASICA CAOBAL	99	1	3	78	69	75	0	0	0	0	6	78
EDO. FALCON	MP. JACURA	PQ. AGUA LINDA	ESCUELA ESTADAL LA MONTAÑA	437	1	2	266	222	264	0	1	0	0	41	266
EDO. FALCON	MP. JACURA	PQ. AGUA LINDA	ESCUELA BOLIVARIANA PALMASOLA NER 374	80	1	1	58	45	57	0	0	0	0	12	58
EDO. FALCON	MP. PALMA SOLA	CM. PALMA SOLA	ESCUELA INICIAL KILOMETRO 22	182	1	4	173	150	169	0	0	0	0	19	173
EDO. FALCON	MP. PALMA SOLA	CM. PALMA SOLA	ESCUELA BASICA BOLIVARIANA ZONA C	608	2	9	477	393	468	1	2	0	1	71	477
EDO. FALCON	MP. PALMA SOLA	CM. PALMA SOLA	PREESCOLAR PASTOR PEÑA	140	1	0	127	113	127	0	0	0	0	14	127
EDO. FALCON	MP. PALMA SOLA	CM. PALMA SOLA	ESCUELA ESTADAL NUMERO 472	409	1	5	300	261	295	0	1	0	0	33	300
EDO. FALCON	MP. PALMA SOLA	CM. PALMA SOLA	ESCUELA INTEGRAL BOLIVARIANA SUSANA MEDINA DE DORANTE	1419	3	16	1139	871	1123	0	7	1	0	244	1139
EDO. FALCON	MP. PALMA SOLA	CM. PALMA SOLA	ESCUELA BASICA KILOMETRO 10	185	1	1	152	137	151	0	1	0	0	13	152
EDO. FALCON	MP. PALMA SOLA	CM. PALMA SOLA	ESCUELA DE EDUCACION INICIAL KILOMETRO 34	130	1	3	102	92	99	0	0	0	0	7	102
EDO. FALCON	MP. PALMA SOLA	CM. PALMA SOLA	ESCUELA DE EDUCACION INICIAL KILOMETRO 14	139	1	2	126	107	124	0	1	0	0	16	126
EDO. FALCON	MP. PALMA SOLA	CM. PALMA SOLA	ESCUELA BASICA POBLADO KILOMETRO 28	367	1	1	285	221	284	0	1	0	0	62	285
EDO. FALCON	MP. PALMA SOLA	CM. PALMA SOLA	CENTRO DE EDUCACION INICIAL MI LINDO HOGAR	175	1	5	153	137	148	0	1	1	0	9	153
EDO. FALCON	MP. ACOSTA	PQ. LA PASTORA	ESCUELA BASICA BOLIVARIANA AGUIDE	584	1	3	422	277	419	0	3	0	0	139	422
EDO. FALCON	MP. ACOSTA	PQ. LA PASTORA	ESCUELA BASICA VIENTO SUAVE	139	1	3	122	111	119	0	1	0	0	7	122
EDO. FALCON	MP. ACOSTA	PQ. LA PASTORA	ESCUELA BASICA BOLIVARIANA EL CANTON	350	1	8	256	152	248	0	1	0	0	95	256
EDO. FALCON	MP. ACOSTA	PQ. LA PASTORA	ESCUELA BOLIVARIANA EL CARMEN	97	1	0	91	80	91	1	1	0	0	9	91
EDO. FALCON	MP. ACOSTA	PQ. LA PASTORA	ESCUELA BASICA EL CAYUDE	370	1	2	270	236	268	0	0	0	0	32	270
EDO. FALCON	MP. ACOSTA	PQ. LA PASTORA	ESCUELA BOLIVARIANA HICACAL	143	1	0	114	70	114	1	0	0	0	43	114
EDO. FALCON	MP. ACOSTA	PQ. LA PASTORA	ESCUELA BOLIVARIANA SANTA ANA	101	1	4	91	71	87	0	0	0	0	16	91
EDO. FALCON	MP. ACOSTA	PQ. LA PASTORA	UNIDAD EDUCATIVA LA PASTORA	707	2	11	499	345	488	0	5	2	1	135	499
EDO. FALCON	MP. ACOSTA	PQ. LIBERTADOR	ESCUELA BASICA SAN LORENZO	759	2	19	570	285	551	0	2	0	0	264	570
EDO. FALCON	MP. ACOSTA	PQ. SAN JUAN DE LOS CAYOS	ESCUELA BASICA BOLIVARIANA BOCA DE TOCUYO	710	2	12	573	326	561	0	1	1	0	233	573
EDO. FALCON	MP. ACOSTA	PQ. SAN JUAN DE LOS CAYOS	ESCUELA BOLIVARIANA LAS MALVINAS	599	1	8	449	272	441	0	2	1	0	166	449
EDO. FALCON	MP. ACOSTA	PQ. SAN JUAN DE LOS CAYOS	ESCUELA BASICA BOLIVARIANA PEDRO CASTRO UGARTE	2432	5	30	1918	829	1888	0	6	0	1	1052	1918
EDO. FALCON	MP. ACOSTA	PQ. SAN JUAN DE LOS CAYOS	ESCUELA BASICA NUCLEO ESCOLAR RURAL 123 LA VILLA	192	1	3	159	111	156	1	1	0	0	43	159
EDO. FALCON	MP. ACOSTA	PQ. SAN JUAN DE LOS CAYOS	UNIDAD EDUCATIVA HILARIA ARENAS	1745	3	50	1304	680	1254	0	5	0	0	569	1304
EDO. FALCON	MP. ACOSTA	PQ. SAN JUAN DE LOS CAYOS	ESCUELA BASICA BOLIVARIANA LOS TAPAROS	456	1	5	357	217	352	0	6	0	0	129	357
EDO. FALCON	MP. ACOSTA	PQ. SAN JUAN DE LOS CAYOS	ESCUELA BÁSICA EL CERRITO	184	1	1	130	88	129	0	1	0	0	40	130
EDO. FALCON	MP. ACOSTA	PQ. CAPADARE	ESCUELA RURAL AGUA BLANCA	165	1	0	144	139	144	0	0	0	0	5	144
EDO. FALCON	MP. ACOSTA	PQ. CAPADARE	ESCUELA BASICA LA PALOMA	244	1	1	194	167	193	0	0	0	0	26	194
EDO. FALCON	MP. ACOSTA	PQ. CAPADARE	ESCUELA BOLIVARIANA SAN JUANCITO	293	1	6	242	127	236	0	0	0	0	109	242
EDO. FALCON	MP. ACOSTA	PQ. CAPADARE	ESCUELA BASICA QUEBRADA HONDA	565	1	6	431	222	425	0	2	0	0	201	431
EDO. FALCON	MP. ACOSTA	PQ. CAPADARE	ESCUELA BÁSICA BOLIVARIANA CAMACHIMA	965	2	11	691	595	680	0	0	0	0	85	691
EDO. FALCON	MP. ACOSTA	PQ. CAPADARE	ESCUE LA BASICA BOLIVARIANA SANTA CRUZ DE CAPADARE	504	1	7	361	252	354	0	0	0	0	102	361
EDO. FALCON	MP. ACOSTA	PQ. CAPADARE	ESCUELA BÁSICA SANTA ROSA	504	1	18	382	228	364	0	3	0	0	133	382
EDO. FALCON	MP. ACOSTA	PQ. CAPADARE	UNIDAD EDUCATIVA CAPADARE	1739	3	22	1249	627	1227	1	6	1	0	592	1249
EDO. FALCON	MP. DEMOCRACIA	PQ. AVARIA	ESCUELA PRIMARIA BOLIVARIANA LA GUINEA	53	1	2	50	45	48	0	1	0	0	2	50
EDO. FALCON	MP. DEMOCRACIA	PQ. AVARIA	ESCUELA BÁSICA ESTADAL PAÑO BLANCO	194	1	1	154	75	153	0	4	0	0	74	154
EDO. FALCON	MP. DEMOCRACIA	PQ. AVARIA	ESCUELA BASICA ESTADAL LA CAMPANA	273	1	1	182	164	181	0	0	0	0	17	182
EDO. FALCON	MP. DEMOCRACIA	PQ. AVARIA	ESCUELA BASICA TUPURE
EDO. FALCON	MP. DEMOCRACIA	PQ. AVARIA	ESCUELA PRIMARIA BOLIVARIANA LA OPINION
EDO. FALCON	MP. DEMOCRACIA	PQ. AVARIA	ESCUELA PRIMARIA BOLIVARIANA AGUA LINDA	127	1	0	85	76	85	0	0	0	0	9	85
EDO. FALCON	MP. DEMOCRACIA	PQ. PURURECHE	ESCUELA BASICA BOLIVARIANA PURURECHE	552	1	7	436	243	429	0	1	0	0	185	436
EDO. FALCON	MP. DEMOCRACIA	PQ. PURURECHE	ESCUELA PRIMARIA EL TIGRE	76	1	0	69	56	69	0	0	0	0	13	69
EDO. FALCON	MP. DEMOCRACIA	PQ. PURURECHE	ESCUELA BOLIVARIANA LAS CORRALEJAS	119	1	0	105	98	105	0	0	0	0	7	105
EDO. FALCON	MP. DEMOCRACIA	PQ. PURURECHE	ESCUELA PRIMARIA BOLIVARIANA EL MAMON	104	1	2	88	76	86	0	0	0	0	10	88
EDO. FALCON	MP. DEMOCRACIA	PQ. PURURECHE	ESCUELA PRIMARIA BOLIVARIANA LA SOMBRA
EDO. FALCON	MP. DEMOCRACIA	PQ. PURURECHE	ESCUELA BOLIVARIANA EL JOBITO	101	1	2	87	83	85	0	0	0	0	2	87
EDO. FALCON	MP. DEMOCRACIA	PQ. PIEDRA GRANDE	ESCUELA RURAL EXPERIMENTAL BASICA PIEDRA GRANDE	514	1	7	355	197	348	0	2	0	0	149	355
EDO. FALCON	MP. DEMOCRACIA	PQ. PIEDRA GRANDE	ESCUELA PRIMARIA BOLIVARIANA EL YABITO	98	1	0	86	85	86	0	0	0	0	1	86
EDO. FALCON	MP. DEMOCRACIA	PQ. PIEDRA GRANDE	ESCUELA PRIMARIA BOLIVARIANA EL RASTROJO	203	1	0	142	118	142	0	3	0	0	21	142
EDO. FALCON	MP. DEMOCRACIA	PQ. AGUA CLARA	ESCUELA BASICA AGUA CLARA	288	1	3	214	112	211	0	2	0	0	97	214
EDO. FALCON	MP. DEMOCRACIA	PQ. PEDREGAL	ESCUELA BOLIVARIANA PASO DE CORO	35	1	1	33	26	32	0	1	0	0	5	33
EDO. FALCON	MP. DEMOCRACIA	PQ. PEDREGAL	UNIDAD EDUCATIVA CARMEN FUGUET	798	2	12	687	462	675	0	3	0	0	210	687
EDO. FALCON	MP. DEMOCRACIA	PQ. PEDREGAL	ESCUELA PRIMARIA EL JEBE N 118	298	1	4	219	141	215	0	1	0	0	73	219
EDO. FALCON	MP. DEMOCRACIA	PQ. PEDREGAL	ESCUELA PRIMARIA ESTADAL CABEZA DE TORO	86	1	0	85	79	85	0	0	0	0	6	85
EDO. FALCON	MP. DEMOCRACIA	PQ. PEDREGAL	ESCUELA PRIMARIA ESTADAL LA SOLEDAD NER 285	484	1	3	345	230	342	1	0	0	0	111	345
EDO. FALCON	MP. DEMOCRACIA	PQ. PEDREGAL	ESCUELA ESTADAL YABALITO
EDO. FALCON	MP. DEMOCRACIA	PQ. PEDREGAL	ESCUELA BOLIVARIANA LOS BARRANCOS	163	1	4	145	79	141	0	3	0	0	59	145
EDO. FALCON	MP. DEMOCRACIA	PQ. PEDREGAL	ESCUELA BASICA BOLIVARIANA FABIO MANUEL CHIRINOS	1561	3	21	1237	731	1216	1	9	0	0	475	1237
EDO. FALCON	MP. DEMOCRACIA	PQ. PEDREGAL	ESCUELA PRIMARIA BOLIVARIANA LAS CRUCES	254	1	7	231	130	224	0	0	0	0	94	231
EDO. FALCON	MP. DEMOCRACIA	PQ. PEDREGAL	ESCUELA BASICA LAS VERITAS	328	1	1	229	138	228	0	1	0	0	89	229
EDO. FALCON	MP. DEMOCRACIA	PQ. PEDREGAL	ESCUELA PRIMARIA ESTADAL N 261 EL YABO	211	1	7	186	145	179	0	1	1	0	32	186
EDO. FALCON	MP. DEMOCRACIA	PQ. PEDREGAL	ESCUELA BASICA BOLIVARIANA EL DERRAME	697	2	5	548	329	543	0	0	0	1	213	548
EDO. FALCON	MP. DEMOCRACIA	PQ. PEDREGAL	ESCUELA PRIMARIA BOLIVARIANA ROJAS	57	1	2	50	47	48	0	0	0	0	1	50
EDO. FALCON	MP. DEMOCRACIA	PQ. PEDREGAL	ESCUELA PRIMARIA SAN JOSE	66	1	2	59	51	57	0	2	0	0	4	59
EDO. FALCON	MP. ZAMORA	PQ. ZAZARIDA	ESCUELA BASICA BOLIVARIANA COROZALITO	167	1	1	130	115	129	0	0	0	0	14	130
EDO. FALCON	MP. ZAMORA	PQ. ZAZARIDA	ESCUELA ESTADAL EL GUANABANO	236	1	3	151	139	148	0	0	0	0	9	151
EDO. FALCON	MP. ZAMORA	PQ. ZAZARIDA	ESCUELA BÁSICA LOS TABLONES	273	1	2	195	174	193	0	0	0	0	19	195
EDO. FALCON	MP. ZAMORA	PQ. ZAZARIDA	ESCUELA ESTADAL ZAZÁRIDA	243	1	1	136	111	135	1	0	0	0	23	136
EDO. FALCON	MP. ZAMORA	PQ. ZAZARIDA	ESCUELA BASICA BOLIVARIANA LA CUCHILLA	109	1	0	90	88	90	0	0	0	0	2	90
EDO. FALCON	MP. ZAMORA	PQ. PUERTO CUMAREBO	ESCUELA BÁSICA PLAYA BLANCA	324	1	4	283	198	279	0	1	0	0	80	283
EDO. FALCON	MP. ZAMORA	PQ. PUERTO CUMAREBO	ESCUELA ESTADAL QUEBRADA DE HUTTEN	1002	2	13	784	545	771	3	8	0	0	215	784
EDO. FALCON	MP. ZAMORA	PQ. PUERTO CUMAREBO	ESCUELA BASICA BOLIVARIANA PUENTE DE PIEDRA	160	1	1	137	123	136	0	1	0	0	12	137
EDO. FALCON	MP. ZAMORA	PQ. PUERTO CUMAREBO	CENTRO DE EDUCACION INICIAL MANUEL VICENTE CUERVO	2264	4	25	1831	944	1806	0	10	0	1	851	1831
EDO. FALCON	MP. ZAMORA	PQ. PUERTO CUMAREBO	ESCUELA BÁSICA NACIONAL LOS OLIVOS	259	1	6	216	189	210	0	0	0	0	21	216
EDO. FALCON	MP. ZAMORA	PQ. PUERTO CUMAREBO	UNIDAD EDUCATIVA MANUEL VICENTE CUERVO	2998	6	53	2363	1306	2310	0	15	1	1	987	2363
EDO. FALCON	MP. ZAMORA	PQ. PUERTO CUMAREBO	ESCUELA BASICA EL CALVARIO	44	1	3	42	31	39	0	0	0	0	8	42
EDO. FALCON	MP. ZAMORA	PQ. PUERTO CUMAREBO	ESCUELA BASICA LA ENSENADA	88	1	0	68	43	68	0	1	0	0	24	68
EDO. FALCON	MP. ZAMORA	PQ. PUERTO CUMAREBO	ESCUELA ESTADAL SAN PEDRO	399	1	3	335	156	332	0	4	0	0	172	335
EDO. FALCON	MP. ZAMORA	PQ. PUERTO CUMAREBO	INSTITUTO EDUCACION ESPECIAL EZEQUIEL ZAMORA	2153	4	28	1655	814	1627	0	10	1	0	802	1655
EDO. FALCON	MP. ZAMORA	PQ. PUERTO CUMAREBO	ESCUELA ESTADAL BARIQUI	471	1	6	371	228	365	0	2	0	0	135	371
EDO. FALCON	MP. ZAMORA	PQ. PUERTO CUMAREBO	ESCUELA BÁSICA BOLIVARIANA LA CAÑADA	1197	3	17	1017	640	1000	0	6	1	1	352	1017
EDO. FALCON	MP. ZAMORA	PQ. PUERTO CUMAREBO	ESCUELA BÁSICA BOLIVARIANA PADRE ROMÁN	3041	6	21	2368	1291	2347	1	20	0	1	1034	2368
EDO. FALCON	MP. ZAMORA	PQ. PUERTO CUMAREBO	ESCUELA DE EDUCACION INICIAL NACIONAL SIMONCITO MARGARITA CUERVO DE REYES	215	1	2	190	146	188	0	2	0	0	40	190
EDO. FALCON	MP. ZAMORA	PQ. PUERTO CUMAREBO	ESCUELA ESTADAL SAN RAFAEL	338	1	4	223	147	219	0	0	0	0	72	223
EDO. FALCON	MP. ZAMORA	PQ. PUERTO CUMAREBO	ESCUELA ESTADAL LA TRINIDAD	339	1	4	242	146	238	1	4	0	1	86	242
EDO. FALCON	MP. ZAMORA	PQ. PUERTO CUMAREBO	UNIDAD EDUCATIVA EZEQUIEL ZAMORA	1848	4	21	1468	847	1447	0	13	0	0	587	1468
EDO. FALCON	MP. ZAMORA	PQ. LA SOLEDAD	ESCUELA BOLIVARIANA SOLEDAD ARRIBA	76	1	2	70	50	68	0	0	0	0	18	70
EDO. FALCON	MP. ZAMORA	PQ. LA SOLEDAD	ESCUELA BOLIVARIANA LA CIENEGUITA	94	1	4	87	69	83	0	4	0	2	8	87
EDO. FALCON	MP. ZAMORA	PQ. LA SOLEDAD	ESCUELA ESTADAL LA SOLEDAD	455	1	3	332	199	329	0	1	0	0	129	332
EDO. FALCON	MP. ZAMORA	PQ. LA SOLEDAD	ESCUELA BOLIVARIANA MONTANITA	80	1	2	76	70	74	0	0	0	0	4	76
EDO. FALCON	MP. ZAMORA	PQ. LA SOLEDAD	GRUPO ESCOLAR DOMINGO C COUTINHO	803	2	13	595	425	582	0	0	0	0	157	595
EDO. FALCON	MP. ZAMORA	PQ. LA CIENAGA	ESCUELA BASICA ALBERTO RAVELL	1117	2	16	932	509	916	0	2	0	0	405	932
EDO. FALCON	MP. ZAMORA	PQ. PUEBLO CUMAREBO	ESCUELA BASICA CUMAREBITO	236	1	1	185	132	184	0	3	0	0	49	185
EDO. FALCON	MP. ZAMORA	PQ. PUEBLO CUMAREBO	COMPLEJO EDUCATIVO INSTITUTO AGROPECUARIO FE Y ALEGRÍA	183	1	3	118	100	115	0	0	0	0	15	118
EDO. FALCON	MP. ZAMORA	PQ. PUEBLO CUMAREBO	ESCUELA BASICA BOLIVARIANA SAN VICENTE	256	1	1	176	136	175	1	1	0	0	37	176
EDO. FALCON	MP. ZAMORA	PQ. PUEBLO CUMAREBO	CEIERB 325 SAN MIGUEL	68	1	0	65	60	65	0	0	0	0	5	65
EDO. FALCON	MP. ZAMORA	PQ. PUEBLO CUMAREBO	ESCUELA ESTADAL SAN FRANCISCO	359	1	0	284	211	284	0	1	0	0	72	284
EDO. FALCON	MP. ZAMORA	PQ. PUEBLO CUMAREBO	ESCUELA BOLIVARIANA SAN NICOLAS	197	1	2	144	103	142	0	0	0	0	39	144
EDO. FALCON	MP. ZAMORA	PQ. PUEBLO CUMAREBO	COMPLEJO EDUCATIVO HERCILIA HENRIQUEZ DE EIZAGA	657	2	5	537	357	532	0	3	0	0	172	537
EDO. FALCON	MP. UNION	PQ. EL CHARAL	ESCUELA NACIONAL EL TIGRITO	285	1	2	197	140	195	0	1	0	1	53	197
EDO. FALCON	MP. UNION	PQ. EL CHARAL	ESCUELA BASICA LA CARPA NUCLEO ESCOLAR RURAL 727	119	1	3	98	68	95	0	1	1	0	25	98
EDO. FALCON	MP. UNION	PQ. EL CHARAL	ESCUELA BASICA BOLIVARIANA EL CHARAL	833	2	9	608	392	599	0	9	0	0	198	608
EDO. FALCON	MP. UNION	PQ. EL CHARAL	ESCUELA BASICA LA CARRETERA	118	1	3	82	73	79	0	1	0	0	5	82
EDO. FALCON	MP. UNION	PQ. EL CHARAL	ESCUELA BÁSICA ELDA ROSA LÓPEZ	685	2	1	518	429	517	0	1	0	0	87	518
EDO. FALCON	MP. UNION	PQ. EL CHARAL	ESCUELA BASICA EL CAIPAL	96	1	1	83	56	82	0	2	0	0	24	83
EDO. FALCON	MP. UNION	PQ. EL CHARAL	ESCUELA BOLIVARIANA VILLA DE ORO	240	1	2	184	155	182	0	0	1	0	26	184
EDO. FALCON	MP. UNION	PQ. EL CHARAL	ESCUELA BASICA SAN GABRIEL	514	1	5	338	229	333	0	3	1	0	100	338
EDO. FALCON	MP. UNION	PQ. EL CHARAL	ESCUELA BOLIVARIANA  EL TORITO	459	1	3	322	279	319	0	4	0	0	36	322
EDO. FALCON	MP. UNION	PQ. EL CHARAL	ESCUELA BASICA LOS RIEGOS	83	1	0	49	36	49	0	0	0	0	13	49
EDO. FALCON	MP. UNION	PQ. STA.CRUZ DE BUCARAL	ESCUELA NACIONAL QUEBRADA SECA	107	1	0	63	50	63	0	0	0	0	13	63
EDO. FALCON	MP. UNION	PQ. STA.CRUZ DE BUCARAL	ESCUELA BASICA BOLIVARIANA LA SABANA	181	1	2	156	124	154	0	1	0	0	29	156
EDO. FALCON	MP. UNION	PQ. STA.CRUZ DE BUCARAL	CENTRO DE EDUCACIÓN INICIAL BOLIVARIANO DOMINGO COUTINHO	743	2	10	535	257	525	1	0	0	0	267	535
EDO. FALCON	MP. UNION	PQ. STA.CRUZ DE BUCARAL	ESCUELA BASICA 23 DE ENERO	236	1	4	187	120	183	0	0	1	0	62	187
EDO. FALCON	MP. UNION	PQ. STA.CRUZ DE BUCARAL	ESCUELA BOLIVARIANA EL VESUBIO	190	1	1	133	113	132	0	0	0	0	19	133
EDO. FALCON	MP. UNION	PQ. STA.CRUZ DE BUCARAL	ESCUELA BASICA BOLIVARIANA AREGUITO NER 014	519	1	6	412	301	406	0	3	0	0	102	412
EDO. FALCON	MP. UNION	PQ. STA.CRUZ DE BUCARAL	ESCUELA BASICA LA FLORIDA	125	1	0	99	86	99	0	0	0	0	13	99
EDO. FALCON	MP. UNION	PQ. STA.CRUZ DE BUCARAL	ESCUELA BOLIVARIANA  EL CLAVELITO	152	1	0	134	127	134	0	1	0	0	6	134
EDO. FALCON	MP. UNION	PQ. STA.CRUZ DE BUCARAL	ESCUELA BASICA BOLIVARIANA LA DANTA	376	1	10	314	193	304	0	2	0	0	109	314
EDO. FALCON	MP. UNION	PQ. STA.CRUZ DE BUCARAL	ESCUELA BÁSICA BOLIVARIANA DOMINGO C. COUTINHO	1403	3	19	1002	470	983	0	3	1	0	509	1002
EDO. FALCON	MP. UNION	PQ. STA.CRUZ DE BUCARAL	ESCUELA BOLIVARIANA LA ALEGRIA	330	1	8	269	207	261	0	6	0	0	48	269
EDO. FALCON	MP. UNION	PQ. STA.CRUZ DE BUCARAL	UNIDAD EDUCATIVA 28 DE FEBRERO	1059	2	21	796	369	775	0	7	1	0	398	796
EDO. FALCON	MP. UNION	PQ. LAS VEGAS DEL TUY	ESCUELA BASICA UNITARIA VILORIA	180	1	0	152	111	152	0	0	0	0	41	152
EDO. FALCON	MP. UNION	PQ. LAS VEGAS DEL TUY	ESCUELA BASICA NACIONAL CAMPO SOLO	155	1	2	138	130	136	0	0	0	0	6	138
EDO. FALCON	MP. UNION	PQ. LAS VEGAS DEL TUY	ESCUELA NACIONAL LOS COGOLLALES	205	1	2	150	127	148	0	0	0	0	21	150
EDO. FALCON	MP. UNION	PQ. LAS VEGAS DEL TUY	ESCUELA BASICA BOLIVARIANA NACIONAL TAPATAPA	333	1	5	267	202	262	0	3	0	0	57	267
EDO. FALCON	MP. UNION	PQ. LAS VEGAS DEL TUY	ESCUELA BOLIVARIANA ESTADAL LAS VEGAS DEL TUY	954	2	23	750	541	727	0	2	1	0	183	750
EDO. FALCON	MP. UNION	PQ. LAS VEGAS DEL TUY	ESCUELA ESTADAL MONTERREY	189	1	1	132	114	131	0	1	0	0	16	132
EDO. FALCON	MP. URUMACO	PQ. URUMACO	ESCUELA BOLIVARIANA CASCAJAL	157	1	3	139	101	136	1	0	0	0	34	139
EDO. FALCON	MP. URUMACO	PQ. URUMACO	LICEO NACIONAL URUMACO	454	1	11	401	293	390	0	2	0	0	95	401
EDO. FALCON	MP. URUMACO	PQ. URUMACO	ESCUELA BASICA ESTADAL EL CORUBO	146	1	4	129	86	125	0	0	0	0	39	129
EDO. FALCON	MP. URUMACO	PQ. URUMACO	ESCUELA BASICA BOLIVARIANA NACIONAL LLANO GRANDE	846	2	13	721	420	708	0	1	0	0	287	721
EDO. FALCON	MP. URUMACO	PQ. URUMACO	ESCUELA BASICA BOLIVARIANA EL CUJI	553	1	13	467	350	454	0	0	0	0	104	467
EDO. FALCON	MP. URUMACO	PQ. URUMACO	CENTRO DE EDUCACION INICIAL LA CURVA	82	1	1	80	38	79	0	0	0	0	41	80
EDO. FALCON	MP. URUMACO	PQ. URUMACO	ESCUELA BASICA NACIONAL CODORE AFUERA
EDO. FALCON	MP. URUMACO	PQ. URUMACO	ESCUELA BASICA BOLIVARIANA JOSE ENCARNACION LOPEZ	1816	4	31	1470	730	1439	0	8	0	0	701	1470
EDO. FALCON	MP. URUMACO	PQ. URUMACO	ESCUELA  ESTADAL BOLIVARIANA  EL SOLITARIO	391	1	4	309	186	305	0	0	0	0	119	309
EDO. FALCON	MP. URUMACO	PQ. BRUZUAL	ESCUELA BÁSICA ESTADAL SANJONCITO NER 703	123	1	0	114	67	114	0	0	0	0	47	114
EDO. FALCON	MP. URUMACO	PQ. BRUZUAL	ESCUELA UNITARIA PLAYA BONITA	123	1	0	93	62	93	0	1	0	0	30	93
EDO. FALCON	MP. URUMACO	PQ. BRUZUAL	ESCUELA BOLIVARIANA NACIONAL SAN JOSE DE BRUZUAL	176	1	3	131	99	128	0	0	0	0	29	131
EDO. FALCON	MP. URUMACO	PQ. BRUZUAL	ESCUELA  BOLIVARIANA MIDE	468	1	5	412	262	407	0	3	0	0	142	412
EDO. FALCON	MP. URUMACO	PQ. BRUZUAL	ESCUELA NACIONAL CABURITO	263	1	1	197	114	196	0	0	0	0	82	197
EDO. FALCON	MP. URUMACO	PQ. BRUZUAL	ESCUELA BOLIVARIANA EL SALADILLO	101	1	1	89	86	88	0	0	1	0	1	89
EDO. FALCON	MP. URUMACO	PQ. BRUZUAL	ESCUELA ESTADAL LA MESETA	358	1	2	301	192	299	0	1	0	0	106	301
EDO. FALCON	MP. URUMACO	PQ. BRUZUAL	ESCUELA BASICA NACIONAL 3823 LA FRAGUITA	231	1	3	187	125	184	0	0	0	0	59	187
EDO. FALCON	MP. URUMACO	PQ. BRUZUAL	ESCUELA BOLIVARIANA SUEY	189	1	1	164	156	163	0	1	0	0	6	164
EDO. FALCON	MP. PETIT	PQ. COLINA	ESCUELA BASICA NACIONAL SAN NICOLAS Nº 271	325	1	4	224	163	220	0	0	0	0	57	224
EDO. FALCON	MP. PETIT	PQ. COLINA	ESCUELA BOLIVARIANA LA MONTANITA	93	1	1	74	69	73	0	0	0	0	4	74
EDO. FALCON	MP. PETIT	PQ. COLINA	ESCUELA DE EDUCACION PRIMARIA SAN AGUSTIN	145	1	2	112	106	110	0	0	0	0	4	112
EDO. FALCON	MP. PETIT	PQ. COLINA	UNIDAD EDUCATIVA AGUSTIN GARCIA	1161	2	26	813	609	787	0	4	2	0	172	813
EDO. FALCON	MP. PETIT	PQ. COLINA	ESCUELA NACIONAL PRIMARIA  LAS TRES MARIA	242	1	3	159	149	156	0	0	0	0	7	159
EDO. FALCON	MP. PETIT	PQ. COLINA	ESCUELA BASICA NACIONAL  LAS FILAS NER 418	144	1	1	86	69	85	0	1	0	0	15	86
EDO. FALCON	MP. PETIT	PQ. COLINA	ESCUELA BASICA NACIONAL SAN PABLO NER 418	336	1	4	238	217	234	0	0	0	0	17	238
EDO. FALCON	MP. PETIT	PQ. CABURE	ESCUELA BASICA BOLIVARIANA SAN HILARIO	358	1	0	299	248	299	1	1	0	0	49	299
EDO. FALCON	MP. PETIT	PQ. CABURE	ESCUELA BASICA ESTADAL BOLIVARIANA EL RAMONAL	725	2	17	526	363	509	0	0	0	0	146	526
EDO. FALCON	MP. PETIT	PQ. CABURE	ESCUELA BASICA BOLIVARIANA COLOMBIA	116	1	2	98	68	96	0	1	0	0	27	98
EDO. FALCON	MP. PETIT	PQ. CABURE	ESCUELA ESTADAL SANTA JUANA	284	1	4	239	173	235	0	0	0	0	62	239
EDO. FALCON	MP. PETIT	PQ. CABURE	ESCUELA BASICA NACIONAL POZO NEGRO	165	1	4	103	68	99	0	3	0	0	28	103
EDO. FALCON	MP. PETIT	PQ. CABURE	ESCUELA BASICA BOLIVARIANA MANUEL ANTONIO GARCIA	2525	5	45	1983	1323	1938	0	13	1	0	601	1983
EDO. FALCON	MP. PETIT	PQ. CABURE	ESCUELA BASICA ESTADAL SANTA ROSA	224	1	5	161	110	156	0	5	2	1	38	161
EDO. FALCON	MP. PETIT	PQ. CABURE	CENTRO DE EDUCACION INICIAL LA DESPEDIDA	195	1	3	156	122	153	0	2	0	0	29	156
EDO. FALCON	MP. PETIT	PQ. CABURE	ESCUELA BASICA JUAN DOMINGO	144	1	1	113	78	112	0	0	0	0	34	113
EDO. FALCON	MP. PETIT	PQ. CABURE	ESCUELA BASICA ESTADAL MURUCUSA	489	1	2	372	231	370	0	2	0	0	137	372
EDO. FALCON	MP. PETIT	PQ. CABURE	ESCUELA BASICA BOLIVARIANA LAS PUENTES	448	1	2	329	265	327	0	0	1	0	61	329
EDO. FALCON	MP. PETIT	PQ. CURIMAGUA	ESCUELA BOLIVARIANA SAN LORENZO	78	1	2	61	47	59	0	1	0	0	11	61
EDO. FALCON	MP. PETIT	PQ. CURIMAGUA	ESCUELA BASICA BOLIVARIANA MACANILLAS	319	1	9	269	247	260	0	0	0	0	13	269
EDO. FALCON	MP. PETIT	PQ. CURIMAGUA	ESCUELA BOLIVARIANA JOSE LEONARDO CHIRINOS	580	1	9	418	288	409	0	1	1	1	118	418
EDO. FALCON	MP. PETIT	PQ. CURIMAGUA	ESCUELA NACIONAL TRAPICHITO	309	1	11	248	183	237	0	2	0	0	52	248
EDO. FALCON	MP. PETIT	PQ. CURIMAGUA	ESCUELA BASICA ESTADAL  SANTA LUCIA	190	1	2	129	121	127	0	0	0	0	6	129
EDO. FALCON	MP. PETIT	PQ. CURIMAGUA	UNIDAD EDUCATIVA PEDRO PABLO RODRIGUEZ	626	2	13	436	252	423	0	3	0	0	168	436
EDO. FALCON	MP. PIRITU	PQ. PIRITU	ESCUELA BOLIVARIANA LA MADERA	125	1	1	97	84	96	0	0	0	0	12	97
EDO. FALCON	MP. PIRITU	PQ. PIRITU	ESCUELA BOLIVARIANA EL TUTANAL	144	1	1	132	119	131	0	0	0	0	12	132
EDO. FALCON	MP. PIRITU	PQ. PIRITU	ESCUELA BÁSICA BOLIVARIANA JESÚS SEMPRUM	1625	3	43	1206	761	1163	0	10	0	0	392	1206
EDO. FALCON	MP. PIRITU	PQ. PIRITU	UNIDAD EDUCATIVA ESTADAL SAN JOSE DE PIRITU	375	1	8	285	228	277	0	1	0	0	48	285
EDO. FALCON	MP. PIRITU	PQ. PIRITU	ESCUELA NACIONAL LA MONTAÑITA	308	1	5	203	172	198	0	0	0	0	26	203
EDO. FALCON	MP. PIRITU	PQ. PIRITU	ESCUELA ESTADAL MONTAÑA DE HUEQUE	227	1	5	168	122	163	2	1	0	0	38	168
EDO. FALCON	MP. PIRITU	PQ. PIRITU	ESCUELA ESTADAL CHIMPIRE	502	1	5	362	237	357	0	6	0	0	114	362
EDO. FALCON	MP. PIRITU	PQ. PIRITU	ESCUELA ESTADAL SABANAS ALTAS	346	1	3	241	199	238	0	0	0	0	39	241
EDO. FALCON	MP. PIRITU	PQ. PIRITU	ESCUELA BOLIVARIANA MOTURO	104	1	1	99	98	98	0	0	0	0	0	99
EDO. FALCON	MP. PIRITU	PQ. PIRITU	UNIDAD EDUCATIVA ESTADAL HUEQUITO	214	1	4	135	102	131	0	2	0	0	27	135
EDO. FALCON	MP. PIRITU	PQ. PIRITU	ESCUELA BOLIVARIANA GUASIMAL	301	1	5	202	149	197	0	3	1	0	44	202
EDO. FALCON	MP. PIRITU	PQ. PIRITU	ESCUELA BOLIVARIANA VIZCAINO	244	1	7	208	170	201	0	2	0	0	29	208
EDO. FALCON	MP. PIRITU	PQ. PIRITU	ESCUELA BASICA BOLIVARIANA EL MECOCO	207	1	5	167	129	162	0	0	2	0	31	167
EDO. FALCON	MP. PIRITU	PQ. PIRITU	ESCUELA ESTADAL VIANA	209	1	5	147	116	142	0	0	0	0	26	147
EDO. FALCON	MP. PIRITU	PQ. PIRITU	ESCUELA BÁSICA BOLIVARIANA MIGUEL ANGEL JORDAN	1133	2	16	806	546	790	0	10	0	0	234	806
EDO. FALCON	MP. PIRITU	PQ. PIRITU	ESCUELA BASICA ACATUTO	177	1	2	115	104	113	0	2	0	0	7	115
EDO. FALCON	MP. PIRITU	PQ. PIRITU	ESCUELA BASICA TAGUAQUI	289	1	10	217	151	207	0	1	0	0	55	217
EDO. FALCON	MP. PIRITU	PQ. SAN JOSE DE LA COSTA	ESCUELA ESTADAL EL CURARI	305	1	5	220	153	215	0	1	0	0	61	220
EDO. FALCON	MP. PIRITU	PQ. SAN JOSE DE LA COSTA	ESCUELA ESTADAL SAN JOSE DE LA COSTA	505	1	12	371	298	359	0	2	3	1	55	371
EDO. FALCON	MP. PIRITU	PQ. SAN JOSE DE LA COSTA	ESCUELA BASICA BOLIVARIANA NACIONAL EL ENCANTO	130	1	1	102	87	101	0	1	0	0	13	102
EDO. FALCON	MP. PIRITU	PQ. SAN JOSE DE LA COSTA	ESCUELA ESTADAL EL PALMAR Nº187	96	1	4	87	66	83	0	0	0	0	17	87
EDO. FALCON	MP. PIRITU	PQ. SAN JOSE DE LA COSTA	ESCUELA ESTADAL EL ARAGUAN	238	1	5	175	93	170	0	2	0	0	75	175
EDO. FALCON	MP. PIRITU	PQ. SAN JOSE DE LA COSTA	ESCUELA BASICA LA PIEDRA	425	1	2	341	309	339	0	1	0	0	29	341
EDO. FALCON	MP. PIRITU	PQ. SAN JOSE DE LA COSTA	ESCUELA ESTADAL SANTA ROSA SAUCA	314	1	8	240	180	232	0	0	0	0	52	240
EDO. FALCON	MP. PIRITU	PQ. SAN JOSE DE LA COSTA	ESCUELA ESTADAL CAMPECHANO	276	1	9	210	159	201	0	1	0	0	41	210
EDO. FALCON	MP. PIRITU	PQ. SAN JOSE DE LA COSTA	ESCUELA ESTADAL EL YSIDRO	303	1	4	211	90	207	0	1	0	1	115	211
EDO. FALCON	MP. SAN FRANCISCO	CM. MIRIMIRE	ESCUELA BÁSICA BOLIVARIANA LA GUACHARACA	430	1	4	295	205	291	0	0	0	1	85	295
EDO. FALCON	MP. SAN FRANCISCO	CM. MIRIMIRE	ESCUELA BÁSICA BOLIVARIANA EL CRISTO	804	2	13	635	475	622	0	1	0	0	146	635
EDO. FALCON	MP. SAN FRANCISCO	CM. MIRIMIRE	ESCUELA BÁSICA BELÉN	215	1	5	159	114	154	0	1	0	0	39	159
EDO. FALCON	MP. SAN FRANCISCO	CM. MIRIMIRE	ESCUELA BÁSICA BOLIVARIANA LA PALMITA	773	2	9	535	372	526	0	4	1	0	149	535
EDO. FALCON	MP. SAN FRANCISCO	CM. MIRIMIRE	ESCUELA BÁSICA BOLIVARIANA EL GUAY	486	1	6	356	199	350	0	1	0	0	150	356
EDO. FALCON	MP. SAN FRANCISCO	CM. MIRIMIRE	ESCUELA BASICA BOLIVARIANA MIRIMIRITO	476	1	4	398	342	394	1	1	0	0	50	398
EDO. FALCON	MP. SAN FRANCISCO	CM. MIRIMIRE	ESCUELA BASICA BOLIVARIANA LA ARENA	88	1	1	74	64	73	0	1	1	0	7	74
EDO. FALCON	MP. SAN FRANCISCO	CM. MIRIMIRE	ESCUELA BÁSICA BOLIVARIANA DOMINGUEZ ACOSTA	1745	3	22	1288	653	1266	0	4	0	0	609	1288
EDO. FALCON	MP. SAN FRANCISCO	CM. MIRIMIRE	ESCUELA BÁSICA CAMPO ALEGRE	307	1	5	223	176	218	0	0	0	0	42	223
EDO. FALCON	MP. SAN FRANCISCO	CM. MIRIMIRE	LICEO BOLIVARIANO MIRIMIRE	1242	3	29	995	507	966	1	2	0	1	455	995
EDO. FALCON	MP. SAN FRANCISCO	CM. MIRIMIRE	ESCUELA BÁSICA BOLIVARIANA EL CAIDI	1178	2	11	889	699	878	0	3	0	0	176	889
EDO. FALCON	MP. SAN FRANCISCO	CM. MIRIMIRE	ESCUELA BASICA RURAL EL URUY	159	1	6	141	118	135	0	0	0	0	17	141
EDO. FALCON	MP. SAN FRANCISCO	CM. MIRIMIRE	ESCUELA BOLIVARIANA ESTADAL SAN JOSÉ DEL CUBE	716	2	3	546	364	543	0	6	0	0	173	546
EDO. FALCON	MP. SAN FRANCISCO	CM. MIRIMIRE	ESCUELA BASICA BOLIVARIANA ARAGUI	399	1	4	297	220	293	0	2	0	0	71	297
EDO. FALCON	MP. SAN FRANCISCO	CM. MIRIMIRE	ESCUELA BÁSICA BOLIVARIANA CURARICITO	201	1	0	130	95	130	1	0	0	0	34	130
EDO. FALCON	MP. BOLIVAR	PQ. SAN LUIS	ESCUELA BASICA BOLIVARIANA LAS VEGAS DE CARIAGUITA	233	1	3	191	124	188	0	0	1	0	63	191
EDO. FALCON	MP. BOLIVAR	PQ. SAN LUIS	ESCUELA ESTADAL LAS MASAS	244	1	4	198	81	194	0	1	2	0	110	198
EDO. FALCON	MP. BOLIVAR	PQ. SAN LUIS	ESCUELA BASICA BOLIVARIANA DIMAS SEGOVIA	1530	3	27	1291	776	1264	0	10	0	1	477	1291
EDO. FALCON	MP. BOLIVAR	PQ. SAN LUIS	ESCUELA BASICA ESTADAL NO 574 MACUCA	48	1	3	46	40	43	0	0	0	0	3	46
EDO. FALCON	MP. BOLIVAR	PQ. SAN LUIS	ESCUELA ESTADAL EL BUCO	173	1	4	140	107	136	0	0	0	1	28	140
EDO. FALCON	MP. BOLIVAR	PQ. SAN LUIS	ESCUELA ESTADAL EL DESENGAÑO	175	1	2	135	118	133	0	2	0	0	13	135
EDO. FALCON	MP. BOLIVAR	PQ. SAN LUIS	ESCUELA BASICA QUITARAGUA	296	1	3	253	160	250	0	3	0	1	86	253
EDO. FALCON	MP. BOLIVAR	PQ. SAN LUIS	ESCUELA ESTADAL ZAZARIDA	159	1	1	117	110	116	0	0	0	0	6	117
EDO. FALCON	MP. BOLIVAR	PQ. SAN LUIS	ESCUELA ESTADAL EL PARAMITO	68	1	0	66	57	66	0	0	0	0	9	66
EDO. FALCON	MP. BOLIVAR	PQ. SAN LUIS	CENTRO DE LIBRE ESCOLARIDAD LA GUARABITA	135	1	3	127	97	124	0	1	0	0	26	127
EDO. FALCON	MP. BOLIVAR	PQ. SAN LUIS	ESCUELA ESTADAL LAS GUARABAS	198	1	1	152	111	151	0	2	0	0	38	152
EDO. FALCON	MP. BOLIVAR	PQ. SAN LUIS	ESCUELA ESTADAL LA CIENAGA	226	1	6	184	120	178	0	1	0	0	57	184
EDO. FALCON	MP. BOLIVAR	PQ. SAN LUIS	ESCUELA BASICA ZARAGOZA	211	1	5	156	123	151	0	2	0	1	25	156
EDO. FALCON	MP. BOLIVAR	PQ. ARACUA	ESCUELA BASICA OLIMPIA LOPEZ DE MORON	1461	3	21	1144	740	1123	0	3	0	0	380	1144
EDO. FALCON	MP. BOLIVAR	PQ. ARACUA	ESCUELA ESTADAL LA SABANA DE MALDONADO	273	1	2	222	207	220	1	1	0	0	11	222
EDO. FALCON	MP. BOLIVAR	PQ. ARACUA	ESCUELA ESTADAL LAS GUARABITAS	316	1	6	247	205	241	0	2	0	0	34	247
EDO. FALCON	MP. BOLIVAR	PQ. LA PE#A	UNIDAD EDUCATIVA LA PEÑA	816	2	10	681	492	671	0	5	0	0	174	681
EDO. FALCON	MP. BOLIVAR	PQ. LA PE#A	ESCUELA BASICA NACIONAL CARRIZALITO	353	1	15	281	208	266	0	0	1	1	56	281
EDO. FALCON	MP. BOLIVAR	PQ. LA PE#A	ESCUELA BASICA NACIONAL EL MAMON	363	1	4	299	249	295	0	1	0	0	45	299
EDO. FALCON	MP. BUCHIVACOA	PQ. ZAZARIDA	ESCUELA BASICA ZAZARIDA	1523	3	9	1205	945	1196	0	6	0	0	245	1205
EDO. FALCON	MP. BUCHIVACOA	PQ. ZAZARIDA	ESCUELA BOLIVARIANA CUAJARACUME	46	1	1	43	38	42	0	0	0	0	4	43
EDO. FALCON	MP. BUCHIVACOA	PQ. ZAZARIDA	ESCUELA PRIMARIA CURUQUEBO	365	1	8	307	250	299	0	1	0	0	48	307
EDO. FALCON	MP. BUCHIVACOA	PQ. ZAZARIDA	ESCUELA PRIMARIA BOLIVARIANA VILLA BOLIVIA	632	2	9	516	467	507	0	3	0	0	37	516
EDO. FALCON	MP. BUCHIVACOA	PQ. ZAZARIDA	ESCUELA BOLIVARIANA EL LLANITO	633	2	13	441	259	428	0	2	0	1	166	441
EDO. FALCON	MP. BUCHIVACOA	PQ. ZAZARIDA	ESCUELA PRIMARIA TARANA	534	1	13	439	361	426	0	2	0	0	63	439
EDO. FALCON	MP. BUCHIVACOA	PQ. ZAZARIDA	ESCUELA NACIONAL MATICA DE YABO	83	1	1	68	51	67	0	2	0	0	14	68
EDO. FALCON	MP. BUCHIVACOA	PQ. ZAZARIDA	ESCUELA PRIMARIA  NUEVO CAMPO	223	1	4	191	162	187	0	1	2	0	22	191
EDO. FALCON	MP. BUCHIVACOA	PQ. BOROJO	ESCUELA  BOLIVARIANA JUAN A. MIQUILENA	786	2	5	645	296	640	0	1	0	0	343	645
EDO. FALCON	MP. BUCHIVACOA	PQ. BOROJO	ESCUELA PRIMARIA NACIONAL SANTA MARIA	505	1	7	408	231	401	0	2	0	0	168	408
EDO. FALCON	MP. BUCHIVACOA	PQ. BOROJO	ESCUELA BOLIVARIANA EL CALADO	301	1	3	239	159	236	0	1	0	0	76	239
EDO. FALCON	MP. BUCHIVACOA	PQ. BOROJO	ESCUELA BOLIVARIANA LA MARIPOSA	57	1	0	52	45	52	0	2	0	0	5	52
EDO. FALCON	MP. BUCHIVACOA	PQ. GUAJIRO	ESCUELA BOLIVARIANA COTOPERIZ	163	1	3	139	65	136	0	1	0	0	70	139
EDO. FALCON	MP. BUCHIVACOA	PQ. GUAJIRO	ESCUELA BOLIVARIANA EL GUAJIRO	952	2	16	729	444	713	0	2	0	2	265	729
EDO. FALCON	MP. BUCHIVACOA	PQ. GUAJIRO	ESCUELA BOLIVARIANA  RIO AMARILLO. NER 480	447	1	1	312	183	311	0	3	1	1	123	312
EDO. FALCON	MP. BUCHIVACOA	PQ. GUAJIRO	ESCUELA BOLIVARIANA  EL SINDICATO	127	1	2	94	22	92	0	1	0	0	69	94
EDO. FALCON	MP. BUCHIVACOA	PQ. SEQUE	ESCUELA BOLIVARIANA LA PEÑITA	247	1	0	201	174	201	0	1	1	0	25	201
EDO. FALCON	MP. BUCHIVACOA	PQ. SEQUE	UNIDAD EDUCATIVA NACIONAL SAN JOSE DE SEQUE	611	2	13	493	248	480	0	3	0	1	228	493
EDO. FALCON	MP. BUCHIVACOA	PQ. SEQUE	ESCUELA BOLIVARIANA LAS CABRERAS	203	1	2	164	109	162	0	0	0	0	53	164
EDO. FALCON	MP. BUCHIVACOA	PQ. SEQUE	ESCUELA PRIMARIA BOLIVARIANA EL TAPARITO	218	1	7	188	120	181	1	1	0	0	59	188
EDO. FALCON	MP. BUCHIVACOA	PQ. SEQUE	MULTIHOGAR JUAN CARLOS	502	1	10	374	211	364	0	2	0	0	151	374
EDO. FALCON	MP. BUCHIVACOA	PQ. SEQUE	ESCUELA PRIMARIA NACIONAL EL COPEI	211	1	1	171	102	170	0	1	0	0	67	171
EDO. FALCON	MP. BUCHIVACOA	PQ. CAPATARIDA	ESCUELA PRIMARIA EL LAGUNERO	308	1	6	241	175	235	0	2	0	0	58	241
EDO. FALCON	MP. BUCHIVACOA	PQ. CAPATARIDA	ESCUELA BASICA BOLIVARIANA LEONIDAS BERMUDEZ	2721	5	41	2243	1108	2202	0	7	0	1	1086	2243
EDO. FALCON	MP. BUCHIVACOA	PQ. CAPATARIDA	ESCUELA BASICA ESTADAL SANTA ROSA	588	1	14	488	311	474	0	3	0	1	159	488
EDO. FALCON	MP. BUCHIVACOA	PQ. CAPATARIDA	ESCUELA BASICA PUERTO GUTIERREZ	444	1	3	379	235	376	0	1	0	0	140	379
EDO. FALCON	MP. BUCHIVACOA	PQ. CAPATARIDA	ESCUELA PRIMARIA BOLIVARIANA SAN ISIDRO	823	2	8	682	447	674	0	5	0	1	221	682
EDO. FALCON	MP. BUCHIVACOA	PQ. CAPATARIDA	ESCUELA BASICA ESTADAL LOS CERRITOS	264	1	3	235	127	232	0	3	0	0	102	235
EDO. FALCON	MP. BUCHIVACOA	PQ. CAPATARIDA	ESCUELA BASICA PEDRO MARIA ZAVALA G.	937	2	25	754	469	729	0	7	0	0	253	754
EDO. FALCON	MP. BUCHIVACOA	PQ. BARIRO	ESCUELA BASICA EL SALADILLO	334	1	4	217	106	213	0	1	0	0	106	217
EDO. FALCON	MP. BUCHIVACOA	PQ. BARIRO	LICEO NACIONAL BARIRO	428	1	9	327	191	318	0	0	0	0	127	327
EDO. FALCON	MP. BUCHIVACOA	PQ. BARIRO	ESCUELA PRIMARIA ALEXIS DELGADO	1470	3	34	1138	496	1104	0	7	2	0	599	1138
EDO. FALCON	CE. MIRANDA	PQ. RIO SECO	ESCUELA BOLIVARIANA YOLANDA FUGUET DE MEDINA	1258	3	19	1039	783	1020	1	4	0	0	232	1039
EDO. FALCON	CE. MIRANDA	PQ. RIO SECO	ESCUELA BASICA ESTADAL CABECERA	811	2	18	662	461	644	1	7	1	0	174	662
EDO. FALCON	CE. MIRANDA	PQ. SAN ANTONIO	ESCUELA BASICA MIXTA EL JEBE VIEJO	2033	4	40	1494	1158	1454	1	7	2	1	285	1494
EDO. FALCON	CE. MIRANDA	PQ. SAN ANTONIO	COMPLEJO EDUCATIVO VIRGINIA GIL DE HERMOSO	2468	5	39	2146	991	2107	0	5	1	2	1108	2146
EDO. FALCON	CE. MIRANDA	PQ. SAN ANTONIO	ESCUELA BASICA 5 DE JULIO	1671	3	40	1232	773	1192	1	6	1	0	411	1232
EDO. FALCON	CE. MIRANDA	PQ. SAN ANTONIO	MULTI HOGAR XIV NIÑO HOGAR FETRA FALCON	2199	4	40	1980	856	1940	0	7	4	0	1073	1980
EDO. FALCON	CE. MIRANDA	PQ. SAN ANTONIO	CENTRO DE EDUCACION INICIAL BOLIVARIANO AÑO INTERNACIONAL DEL NIÑO	1145	2	9	970	496	961	1	9	0	0	455	970
EDO. FALCON	CE. MIRANDA	PQ. SAN ANTONIO	COMPLEJO EDUCATIVO SIMON RODRIGUEZ	3720	7	75	3130	1666	3055	1	20	0	3	1365	3130
EDO. FALCON	CE. MIRANDA	PQ. SAN ANTONIO	ESCUELA DE EDUACION INICIAL GENERALISIMO FRANCISCO DE MIRANDA II	280	1	14	252	198	238	0	0	0	0	40	252
EDO. FALCON	CE. MIRANDA	PQ. SAN ANTONIO	ESCUELA TECNICA COMERCIAL PEDRO CURIEL RAMÍREZ	2262	4	21	1894	717	1873	0	7	1	1	1147	1894
EDO. FALCON	CE. MIRANDA	PQ. SAN ANTONIO	C.E.I SIMONCITO DOÑA LULA DE PARRA LEON	472	1	12	413	239	401	0	7	0	0	155	413
EDO. FALCON	CE. MIRANDA	PQ. SAN ANTONIO	ESCUELA BASICA BOLIVARIANA MIGUEL LOPEZ GARCIA	3739	7	89	2927	1820	2838	1	26	2	2	987	2927
EDO. FALCON	CE. MIRANDA	PQ. SAN ANTONIO	C.E.I. SIMONCITO ROMULO GALLEGOS	626	2	8	563	365	555	1	4	0	0	185	563
EDO. FALCON	CE. MIRANDA	PQ. SAN ANTONIO	COMPLEJO EDUCATIVO MONSEÑOR LUCAS GUILLERMO CASTILLO	2132	4	31	1816	920	1785	0	11	1	1	852	1816
EDO. FALCON	CE. MIRANDA	PQ. SAN ANTONIO	CENTRO DE EDUCACION INICIAL JOSEFA CAMEJO TALAVERA	530	1	3	474	373	471	0	3	0	0	95	474
EDO. FALCON	CE. MIRANDA	PQ. SAN ANTONIO	ESCUELA BASICA REGINA PIA DE ANDARA	3434	6	52	2634	1962	2582	3	24	3	4	586	2634
EDO. FALCON	CE. MIRANDA	PQ. SAN ANTONIO	ESCUELA DE EDUCACION INICIAL JUAN CRISOSTOMO FALCON	397	1	9	350	119	341	0	2	0	0	220	350
EDO. FALCON	CE. MIRANDA	PQ. SAN ANTONIO	LICEO BOLIVARIANO RAUL RUIZ RODRIGUEZ	1786	3	51	1430	930	1379	0	5	1	0	443	1430
EDO. FALCON	CE. MIRANDA	PQ. SAN ANTONIO	ESCUELA BASICA BOLIVARIANA LAS EUGENIAS	855	2	22	762	418	740	2	6	1	1	312	762
EDO. FALCON	CE. MIRANDA	PQ. SAN ANTONIO	ESCUELA BÁSICA LUCAS ADAMES	2708	5	49	2028	1247	1979	1	15	2	1	713	2028
EDO. FALCON	CE. MIRANDA	PQ. SAN ANTONIO	UNIDAD EDUCATIVA ALBERTO FURZAN	2123	4	41	1747	1145	1706	0	21	0	0	540	1747
EDO. FALCON	CE. MIRANDA	PQ. SAN ANTONIO	ESCUELA BASICA BOLIVARIANA EL RECREO	1353	3	20	1086	880	1066	0	5	0	0	181	1086
EDO. FALCON	CE. MIRANDA	PQ. SAN ANTONIO	ESCUELA ESTADAL LOS PEROZOS	961	2	14	802	567	788	0	4	1	0	216	802
EDO. FALCON	CE. MIRANDA	PQ. SAN ANTONIO	CENTRO DE EDUCACION INICIAL  LUCAS GUILLERMO CASTILLO	965	2	5	802	304	797	0	3	0	0	490	802
EDO. FALCON	CE. MIRANDA	PQ. SAN ANTONIO	CENTRO DE EDUCACION INICIAL MIGUEL LOPEZ GARCIA	1277	3	27	1039	672	1012	1	4	0	0	335	1039
EDO. FALCON	CE. MIRANDA	PQ. SAN ANTONIO	CENTRO DE EDUCACION INICIAL CAPULLITO	663	2	15	606	331	591	0	4	0	0	256	606
EDO. FALCON	CE. MIRANDA	PQ. SAN ANTONIO	ESCUELA BOLIVARIANA CAPITAN ANTONIO RICAURTE	241	1	4	216	139	212	0	3	0	0	70	216
EDO. FALCON	CE. MIRANDA	PQ. SAN ANTONIO	UNID EDUC CASA HOGAR NUESTRA SRA DE COROMOTO	1534	3	9	1238	431	1229	1	4	2	1	790	1238
EDO. FALCON	CE. MIRANDA	PQ. SAN ANTONIO	ESCUELA BOLIVARIANA ESTADAL JULIO CESAR PARRA	963	2	20	789	593	769	0	6	1	1	168	789
EDO. FALCON	CE. MIRANDA	PQ. SAN ANTONIO	CENTRO DE EDUCACION INICIAL LUCAS ADAMES	2547	5	29	2018	1240	1989	1	16	1	0	731	2018
EDO. FALCON	CE. MIRANDA	PQ. SAN ANTONIO	ESCUELA PRIMARIA BOLIVARIANA GEORGINA DE ARIAS	2449	5	51	1950	1404	1899	3	18	3	0	471	1950
EDO. FALCON	CE. MIRANDA	PQ. SAN ANTONIO	ESCUELA BÁSICA LOS MÉDANOS	2916	5	53	2191	1484	2138	0	15	1	2	636	2191
EDO. FALCON	CE. MIRANDA	PQ. SAN ANTONIO	COMUNIDAD PENITENCIARIA DE CORO	298	1	4	181	155	177	0	1	0	0	21	181
EDO. FALCON	CE. MIRANDA	PQ. SAN ANTONIO	LICEO BOLIVARIANO ESTEBAN SMITH MONSON	1971	4	19	1590	494	1571	1	9	1	1	1065	1590
EDO. FALCON	CE. MIRANDA	PQ. SAN ANTONIO	UNIDAD EDUCATIVA SIMON BOLIVAR	2512	5	41	2103	862	2062	0	14	0	1	1185	2103
EDO. FALCON	CE. MIRANDA	PQ. SAN ANTONIO	ESCUELA BASICA BOLIVARIANA JUAN CRISOSTOMO FALCÒN	3361	6	56	2697	1084	2641	3	20	1	2	1531	2697
EDO. FALCON	CE. MIRANDA	PQ. SAN ANTONIO	ESCUELA BASICA BOLIVARIANA LA URBINA	333	1	7	289	226	282	0	4	0	0	52	289
EDO. FALCON	CE. MIRANDA	PQ. SAN ANTONIO	CENTRO DE EDUCACION INICIAL SIMON BOLIVAR	2514	5	48	2199	916	2151	3	9	1	1	1221	2199
EDO. FALCON	CE. MIRANDA	PQ. SAN ANTONIO	ESCUELA BOLIVARIANA SAN ANTONIO	3034	6	58	2421	1464	2363	1	16	3	0	879	2421
EDO. FALCON	CE. MIRANDA	PQ. SAN ANTONIO	ESCUELA DE EDUCACION INICIAL SIMONCITO LOS MEDANOS	1065	2	16	811	509	795	0	6	1	0	279	811
EDO. FALCON	CE. MIRANDA	PQ. SAN ANTONIO	ESCUELA BASICA VELITA II	3777	7	68	3197	2106	3129	1	15	1	2	1004	3197
EDO. FALCON	CE. MIRANDA	PQ. SAN ANTONIO	LICEO BOLIVARIANO CARLOS MARTINEZ BUENO	615	2	3	566	323	563	0	5	1	0	234	566
EDO. FALCON	CE. MIRANDA	PQ. MITARE	LICEO BOLIVARIANO MITARE	1284	3	17	987	564	970	0	6	1	0	399	987
EDO. FALCON	CE. MIRANDA	PQ. SABANETA	ESCUELA BASICA ESTADAL  CARAZAO	543	1	8	444	265	436	0	3	0	0	168	444
EDO. FALCON	CE. MIRANDA	PQ. SABANETA	ESCUELA PRIMARIA BOLIVARIANA BARRIALITO	178	1	3	145	131	142	0	0	1	0	10	145
EDO. FALCON	CE. MIRANDA	PQ. SABANETA	ESCUELA BASICA BOLIVARIANA MIGUEL ARMAS ADAMES	1498	3	29	1184	763	1155	0	6	0	1	385	1184
EDO. FALCON	CE. MIRANDA	PQ. SABANETA	ESCUELA BASICA ESTADAL  CHUCHURE	186	1	0	125	75	125	0	0	0	0	50	125
EDO. FALCON	CE. MIRANDA	PQ. SABANETA	ESCUELA BASICA UNITARIA SAN ANTONIO	74	1	0	72	70	72	0	0	0	0	2	72
EDO. FALCON	CE. MIRANDA	PQ. SABANETA	ESCUELA BASICA BOLIVRIANA SANTA RITA	620	2	11	475	316	464	0	0	1	0	147	475
EDO. FALCON	CE. MIRANDA	PQ. SABANETA	ESCUELA BOLIVARIANA PIEDRAS VOLTEADA	197	1	2	138	94	136	0	0	0	0	42	138
EDO. FALCON	CE. MIRANDA	PQ. GUZMAN GUILLERMO	ESCUELA BASICA BOLIVARIANA SIBURUA	383	1	2	264	161	262	0	2	0	1	98	264
EDO. FALCON	CE. MIRANDA	PQ. GUZMAN GUILLERMO	ESCUELA BASICA BOLIVARIANA AQUILES JOSE ROMERO	1033	2	22	776	578	754	0	4	0	0	172	776
EDO. FALCON	CE. MIRANDA	PQ. GUZMAN GUILLERMO	ESCUELA BASICA BOLIVARIANA QUIRAGUA	236	1	4	142	122	138	0	1	0	0	15	142
EDO. FALCON	CE. MIRANDA	PQ. GUZMAN GUILLERMO	ESCUELA BASICA NACIONAL BOLIVARIANA MACUQUITA	155	1	2	102	86	100	0	1	0	0	13	102
EDO. FALCON	CE. MIRANDA	PQ. GUZMAN GUILLERMO	ESCUELA ESTADAL BOLIVARIANA LOS QUEMADOS	182	1	2	174	170	172	0	0	0	0	2	174
EDO. FALCON	CE. MIRANDA	PQ. GUZMAN GUILLERMO	ESCUELA BASICA NACIONAL BOLIVARIANA BEJUQUERO	508	1	7	379	305	372	2	0	2	0	63	379
EDO. FALCON	CE. MIRANDA	PQ. GUZMAN GUILLERMO	ESCUELA BASICA BOLIVARIANA LA NEGRITA	639	2	9	487	262	478	0	9	0	0	207	487
EDO. FALCON	CE. MIRANDA	PQ. GUZMAN GUILLERMO	ESCUELA BASICA BOLIVARIANA SANTA MARIA DE LA CHAPA	199	1	7	159	99	152	0	1	1	0	51	159
EDO. FALCON	CE. MIRANDA	PQ. GUZMAN GUILLERMO	ESCUELA BASICA NACIONAL BOLIVARIANA. ARENALES	489	1	4	403	323	399	0	6	0	1	69	403
EDO. FALCON	CE. MIRANDA	PQ. GUZMAN GUILLERMO	ESCUELA BASICA BOLIVARIANA JUAN RAMON LUGO	465	1	4	310	204	306	0	1	0	0	101	310
EDO. FALCON	CE. MIRANDA	PQ. GUZMAN GUILLERMO	ESCUELA BASICA ESTADAL LOS POZOS, NUCLEO ESCOLAR RURAL 189	318	1	7	290	194	283	0	2	0	0	87	290
EDO. FALCON	CE. MIRANDA	PQ. GUZMAN GUILLERMO	CENTRO DE EDUCACION INICIAL SIBURUA	222	1	7	195	129	188	1	1	0	0	57	195
EDO. FALCON	CE. MIRANDA	PQ. SANTA ANA	COMPLEJO EDUCATIVO PESTALOZZI	3752	7	66	3072	1432	3006	1	21	3	2	1547	3072
EDO. FALCON	CE. MIRANDA	PQ. SANTA ANA	UNIDAD EDUCATIVA LICEO CECILIO ACOSTA	3266	6	33	2497	896	2464	0	18	1	0	1549	2497
EDO. FALCON	CE. MIRANDA	PQ. SANTA ANA	ESCUELA SIMONCITO ANDRES BELLO	1050	2	23	888	556	865	0	6	1	0	302	888
EDO. FALCON	CE. MIRANDA	PQ. SANTA ANA	ESCUELA DE EDUCACION INICIAL SIMONCITO MONSEÑOR ITURRIZA	1522	3	35	1240	649	1205	0	7	0	0	549	1240
EDO. FALCON	CE. MIRANDA	PQ. SANTA ANA	ESCUELA BOLIVARIANA DIEGO LEON ZUNIAGA	2682	5	66	2192	1177	2126	2	15	0	1	931	2192
EDO. FALCON	CE. MIRANDA	PQ. SANTA ANA	ESCUELA TECNICA ROBINSONIANA CORO	1947	4	41	1564	765	1523	0	8	1	1	748	1564
EDO. FALCON	CE. MIRANDA	PQ. SANTA ANA	ESCUELA DE EDUCACION INICIAL  DE LA FUERZA ARMADA POLICIAL	429	1	8	370	269	362	0	1	1	0	91	370
EDO. FALCON	CE. MIRANDA	PQ. SANTA ANA	ESCUELA DE EDUCACION INICIAL MENCA DE LEONIS	682	2	8	595	249	587	0	3	0	0	335	595
EDO. FALCON	CE. MIRANDA	PQ. SANTA ANA	ESCUELA DE EDUCACION INICIAL JOSEFIN LEIDENZ	1249	3	15	1089	422	1074	0	8	0	1	643	1089
EDO. FALCON	CE. MIRANDA	PQ. SANTA ANA	INTERNADO JUDICIAL DE CORO	402	1	4	93	62	89	0	3	0	0	24	93
EDO. FALCON	CE. MIRANDA	PQ. SANTA ANA	ESCUELA TECNICA INDUSTRIAL MADRE MAZZARELLO	374	1	4	326	132	322	0	1	1	0	188	326
EDO. FALCON	CE. MIRANDA	PQ. SAN GABRIEL	CENTRO DE EDUCACION INICIAL SIMONCITO CESAR AUGUSTO AGREDA	796	2	11	675	317	664	0	4	0	0	343	675
EDO. FALCON	CE. MIRANDA	PQ. SAN GABRIEL	CENTRO DE EDUCACION INICIAL SIMONCITO  MADRE EMILIA DE SAN JOSE	1938	4	46	1586	923	1540	1	13	0	1	602	1586
EDO. FALCON	CE. MIRANDA	PQ. SAN GABRIEL	CENTRO DE EDUCACION INICIAL SIMONCITO EL CARDONCITO	298	1	4	252	173	248	0	3	0	0	72	252
EDO. FALCON	CE. MIRANDA	PQ. SAN GABRIEL	CENTRO DE EDUCACION INICIAL CIUDAD DE CORO	1479	3	7	1153	404	1146	0	3	1	0	738	1153
EDO. FALCON	CE. MIRANDA	PQ. SAN GABRIEL	UNIDAD GERIATRICA DR JOSE D BEAUJON	1840	4	14	1603	379	1589	0	5	0	0	1205	1603
EDO. FALCON	CE. MIRANDA	PQ. SAN GABRIEL	ESCUELA BASICA CESAR ARTEAGA CASTRO	1142	2	18	925	256	907	1	5	1	0	644	925
EDO. FALCON	CE. MIRANDA	PQ. SAN GABRIEL	ESCUELA DE EDUCACION INICIAL SAN BOSCO	1649	3	25	1316	561	1291	0	4	0	1	725	1316
EDO. FALCON	CE. MIRANDA	PQ. SAN GABRIEL	ESCUELA BASICA BOLIVARIANA CARMEN DE TOVAR	3126	6	54	2540	940	2486	0	13	1	1	1531	2540
EDO. FALCON	CE. MIRANDA	PQ. SAN GABRIEL	CENTRO PRE ESCOLAR ASISTENCIAL DIVINO NIÑO	2689	5	32	2351	1002	2319	0	15	0	1	1301	2351
EDO. FALCON	CE. MIRANDA	PQ. SAN GABRIEL	ESCUELA PREVOCACIONAL FRANCISCO DE MIRANDA	1143	2	20	901	337	881	0	3	0	1	540	901
EDO. FALCON	CE. MIRANDA	PQ. SAN GABRIEL	CENTRO DE EDUCACION INICIAL 5 DE JULIO	720	2	11	609	416	598	0	4	1	0	177	609
EDO. FALCON	CE. MIRANDA	PQ. SAN GABRIEL	UNIDAD EDUCATIVA INSTITUTO MIGUEL ANGEL	993	2	11	833	282	822	0	3	1	0	536	833
EDO. FALCON	CE. MIRANDA	PQ. SAN GABRIEL	ESCUELA DE EDUCACION INICIAL BOBARE	778	2	11	668	329	657	0	3	0	0	325	668
EDO. FALCON	CE. MIRANDA	PQ. SAN GABRIEL	UNIDAD EDUCATIVA LUCRECIA DE GUARDIA	1932	4	20	1661	416	1641	1	1	1	1	1221	1661
EDO. FALCON	CE. MIRANDA	PQ. SAN GABRIEL	ESCUELA BÁSICA CASTULO MARMOL FERRER	2135	4	30	1790	651	1760	1	15	0	0	1093	1790
EDO. FALCON	CE. MIRANDA	PQ. SAN GABRIEL	LICEO BOLIVARIANO CESAR AUGUSTO AGREDA	4441	8	68	3508	1423	3440	3	29	1	1	1983	3508
EDO. FALCON	CE. MIRANDA	PQ. SAN GABRIEL	UNIDAD EDUCATIVA INSTITUTO JESUS EL NAZARENO	853	2	10	766	358	756	1	1	1	0	395	766
EDO. FALCON	CE. MIRANDA	PQ. SAN GABRIEL	ESCUELA BASICA BOLIVARIANA CIUDAD DE CORO	2338	4	30	1900	727	1870	0	11	0	1	1131	1900
EDO. FALCON	CE. MIRANDA	PQ. SAN GABRIEL	ESCUELA TECNICA INDUSTRIAL ROBINSONIANA CORO  EXTENSION SAN JOSE	3947	7	109	3197	1879	3088	0	20	0	2	1187	3197
EDO. FALCON	CE. MIRANDA	PQ. SAN GABRIEL	UNIDAD BASICA RAFAEL CALLES SIERRA	3610	7	49	3017	1162	2968	1	14	1	2	1788	3017
DTTO. CAPITAL	CE. BLVNO LIBERTADOR	PQ. LA PASTORA	ESCUELA BÁSICA NACIONAL BOLIVARIANA LEÓN TRUJILLO	941	2	19	793	555	774	0	0	0	1	218	793
DTTO. CAPITAL	CE. BLVNO LIBERTADOR	PQ. LA PASTORA	UNIDAD EDUCATIVA NACIONAL BOLIVARIANA REPUBLICA DE BOLIVIA	2943	5	44	2278	1147	2234	1	17	3	4	1062	2278
DTTO. CAPITAL	CE. BLVNO LIBERTADOR	PQ. LA PASTORA	ESCUELA BÁSICA NACIONAL PARROQUIA LA PASTORA	1136	2	13	926	513	913	0	6	1	1	392	926
DTTO. CAPITAL	CE. BLVNO LIBERTADOR	PQ. LA PASTORA	UNIDAD EDUCATIVA NACIONAL CANAIMA	255	1	5	204	157	199	0	1	1	0	40	204
DTTO. CAPITAL	CE. BLVNO LIBERTADOR	PQ. LA PASTORA	UNIDAD EDUCATIVA PRIVADA MONSEÑOR CASTILLO	906	2	16	782	314	766	0	3	3	2	444	782
DTTO. CAPITAL	CE. BLVNO LIBERTADOR	PQ. LA PASTORA	UNIDAD EDUCATIVA LICEO BOLIVARIANO AGUSTÍN AVELEDO	4127	8	55	3237	1534	3182	1	11	1	0	1635	3237
DTTO. CAPITAL	CE. BLVNO LIBERTADOR	PQ. LA PASTORA	MODULO BARRIO ADENTRO UNION Y FUERZA	404	1	6	335	279	329	0	0	0	1	49	335
DTTO. CAPITAL	CE. BLVNO LIBERTADOR	PQ. LA PASTORA	ASOCIACION CIVIL COMUNITARIAA LA DIVINA PASTORA	145	1	1	111	74	110	0	1	0	0	35	111
DTTO. CAPITAL	CE. BLVNO LIBERTADOR	PQ. LA PASTORA	ESCUELA BÁSICA PRIVADA COLEGIO SAN FRANCISCO JAVIER	1552	3	12	1240	567	1228	0	5	1	1	654	1240
DTTO. CAPITAL	CE. BLVNO LIBERTADOR	PQ. LA PASTORA	CENTRO MUNICIPAL DE ATENCIÓN INTEGRAL (CMAI) LA PASTORA	230	1	6	191	136	185	0	0	0	0	49	191
DTTO. CAPITAL	CE. BLVNO LIBERTADOR	PQ. LA PASTORA	UNIDAD EDUCATIVA PRIVADA COLEGIO AGUSTINIANO SAN JUDAS TADEO	3644	7	47	3008	1445	2961	0	19	2	4	1491	3008
DTTO. CAPITAL	CE. BLVNO LIBERTADOR	PQ. LA PASTORA	PRE ESCOLAR MANUEL CABRÉ	1008	2	9	823	387	814	0	1	0	1	425	823
DTTO. CAPITAL	CE. BLVNO LIBERTADOR	PQ. LA PASTORA	UNIDAD EDUCATIVA NACIONAL BOLIVARIANA JOSÉ IGNACIO PAZ CASTILLO	1564	3	21	1230	603	1209	0	5	1	2	598	1230
DTTO. CAPITAL	CE. BLVNO LIBERTADOR	PQ. LA PASTORA	UNIDAD EDUCATIVA NACIONAL BOLIVARIANA 5 DE JULIO	1852	4	26	1431	625	1405	1	9	1	1	768	1431
DTTO. CAPITAL	CE. BLVNO LIBERTADOR	PQ. LA PASTORA	ANTIGUO IPOSTEL	256	1	2	224	166	222	1	0	0	0	55	224
DTTO. CAPITAL	CE. BLVNO LIBERTADOR	PQ. LA PASTORA	UNIDAD EDUCATIVA DISTRITAL BOLIVARIANA JUAN BAUTISTA ALBERDI	4313	8	48	3434	2109	3386	0	13	0	3	1261	3434
DTTO. CAPITAL	CE. BLVNO LIBERTADOR	PQ. LA PASTORA	MATERNAL MANUEL CABRÉ	610	2	5	506	207	501	0	1	0	0	293	506
DTTO. CAPITAL	CE. BLVNO LIBERTADOR	PQ. LA PASTORA	UNIDAD EDUCATIVA SAN FRANCISCO JAVIER	3548	6	52	2923	1424	2871	0	18	1	5	1423	2923
DTTO. CAPITAL	CE. BLVNO LIBERTADOR	PQ. LA PASTORA	UNIDAD EDUCATIVA DISTRITAL JOSÉ GIL FORTUL	2108	4	29	1672	745	1643	1	4	1	1	891	1672
DTTO. CAPITAL	CE. BLVNO LIBERTADOR	PQ. LA PASTORA	LICEO BOLIVARIANO PERÚ DE LA CROIX	3308	6	31	2774	1492	2743	1	18	4	4	1224	2774
DTTO. CAPITAL	CE. BLVNO LIBERTADOR	PQ. LA PASTORA	GRAN FRATERNIDAD UNIVERSAL. FUNDACIÓN DOCTOR SERGE RAYNAUO DE LA FERRIERE	1133	2	16	910	425	894	0	4	1	1	463	910
DTTO. CAPITAL	CE. BLVNO LIBERTADOR	PQ. LA PASTORA	UNIDAD EDUCATIVA DISTRITAL  ENRIQUE CHAUMER	4232	8	56	3370	1943	3314	3	12	1	4	1351	3370
DTTO. CAPITAL	CE. BLVNO LIBERTADOR	PQ. LA PASTORA	CENTRO PRE ESCOLAR ARTURO MICHELENA I	425	1	6	389	251	383	1	1	0	0	130	389
DTTO. CAPITAL	CE. BLVNO LIBERTADOR	PQ. LA PASTORA	PREESCOLAR ASISTENCIAL PROCER PEDRO CAMEJO	456	1	4	411	280	407	0	0	0	0	127	411
DTTO. CAPITAL	CE. BLVNO LIBERTADOR	PQ. LA PASTORA	CENTRO DE SALUD INTEGRAL DOCTOR JOSÉ IZQUIERDO	1374	3	13	1087	592	1074	0	4	1	0	477	1087
DTTO. CAPITAL	CE. BLVNO LIBERTADOR	PQ. LA PASTORA	AMBULATORIO NORTE	765	2	25	578	241	553	0	3	0	1	308	578
DTTO. CAPITAL	CE. BLVNO LIBERTADOR	PQ. LA PASTORA	LICEO BOLIVARIANO LINO GALLARDO	3376	6	75	2753	1463	2678	0	9	1	4	1201	2753
DTTO. CAPITAL	CE. BLVNO LIBERTADOR	PQ. LA PASTORA	UNIDAD EDUCATIVA PARROQUIAL NUESTRA SEÑORA DE COROMOTO	618	2	14	510	195	496	1	4	1	1	294	510
DTTO. CAPITAL	CE. BLVNO LIBERTADOR	PQ. LA PASTORA	UNIDAD EDUCATIVA PRIVADA COLEGIO MODERNO	2602	5	23	2203	1039	2180	0	11	1	2	1127	2203
DTTO. CAPITAL	CE. BLVNO LIBERTADOR	PQ. LA PASTORA	ESCUELA NACIOANL BASICA EL POLVORIN	193	1	5	172	112	167	0	1	0	0	54	172
DTTO. CAPITAL	CE. BLVNO LIBERTADOR	PQ. LA PASTORA	UNIDAD EDUCATIVA DISTRITAL RIBAS	985	2	19	760	363	741	0	4	0	2	372	760
DTTO. CAPITAL	CE. BLVNO LIBERTADOR	PQ. LA PASTORA	UNIDAD EDUCATIVA DISTRITAL UNITARIA NUMERO  44	441	1	7	396	267	389	0	1	0	4	117	396
DTTO. CAPITAL	CE. BLVNO LIBERTADOR	PQ. LA PASTORA	UNIDAD EDUCATIVA PRIVADA COLEGIO AGUSTINIANO LA DIVINA PASTORA	2889	5	45	2424	995	2379	0	9	2	2	1371	2424
DTTO. CAPITAL	CE. BLVNO LIBERTADOR	PQ. LA PASTORA	UNIDAD EDUCATIVA DISTRITAL ANTONIO VAAMONDE	649	2	8	552	280	544	0	4	0	3	257	552
DTTO. CAPITAL	CE. BLVNO LIBERTADOR	PQ. LA PASTORA	UNIDAD EDUCATIVA COLEGIO LUZ Y SABER	659	2	11	586	353	575	0	3	0	1	218	586
DTTO. CAPITAL	CE. BLVNO LIBERTADOR	PQ. LA PASTORA	UNIDAD EDUCATIVA PRIMAVERA	1031	2	24	859	385	835	0	5	0	1	444	859
DTTO. CAPITAL	CE. BLVNO LIBERTADOR	PQ. LA PASTORA	JARDÍN DE INFANCIA DOCTORA  CARMEN VERÓNICA COELLO	774	2	11	628	388	617	0	2	0	2	225	628
DTTO. CAPITAL	CE. BLVNO LIBERTADOR	PQ. LA PASTORA	UNIDAD EDUCATIVA NACIONAL BOLIVARIANA ESTEBAN GIL BORGES	2061	4	32	1557	788	1525	0	0	5	1	731	1557
DTTO. CAPITAL	CE. BLVNO LIBERTADOR	PQ. LA PASTORA	UNIDAD EDUCATIVA DISTRITAL URDANETA	1317	3	8	986	454	978	0	9	1	1	513	986
DTTO. CAPITAL	CE. BLVNO LIBERTADOR	PQ. LA PASTORA	UNIDAD EDUCATIVA PRIVADA INSTITUTO SAN JUDAS TADEO	607	2	7	490	240	483	2	3	0	0	238	490
DTTO. CAPITAL	CE. BLVNO LIBERTADOR	PQ. LA PASTORA	UNIDAD EDUCATIVA NACIONAL BOLIVARIANA CRUCITA DELGADO	3050	6	54	2472	1192	2418	2	15	2	1	1206	2472
DTTO. CAPITAL	CE. BLVNO LIBERTADOR	PQ. LA PASTORA	UNIDAD EDUCATIVA DISTRITAL  ALBERTINA ANDRESSEN	637	2	9	473	304	464	0	1	1	0	158	473
DTTO. CAPITAL	CE. BLVNO LIBERTADOR	PQ. LA PASTORA	UNIVERSIDAD CATÓLICA SANTA ROSA	1284	3	13	1039	449	1026	0	8	1	3	565	1039
DTTO. CAPITAL	CE. BLVNO LIBERTADOR	PQ. LA PASTORA	UNIDAD EDUCATIVA DISTRITAL JOSÉ LUÍS RAMOS	3679	7	43	2898	1631	2855	0	9	1	2	1212	2898
DTTO. CAPITAL	CE. BLVNO LIBERTADOR	PQ. CARICUAO	LICEO ROBERTO MARTINEZ CENTENO	3983	7	129	3386	2452	3257	3	23	2	5	772	3386
DTTO. CAPITAL	CE. BLVNO LIBERTADOR	PQ. CARICUAO	UNIDAD EDUCATIVA DISTRITAL MAURO PAEZ PUMAR	154	1	1	144	113	143	1	2	0	0	27	144
DTTO. CAPITAL	CE. BLVNO LIBERTADOR	PQ. CARICUAO	CENTRO DE SERVICIO SOCIAL DOCTOR JOAQUIN QUINTERO QUINTERO	1032	2	10	753	491	743	0	3	3	0	246	753
DTTO. CAPITAL	CE. BLVNO LIBERTADOR	PQ. CARICUAO	ESCUELA BASICA JOSE AGUSTIN MARQUIEGUI	2024	4	20	1730	712	1710	0	5	0	2	991	1730
DTTO. CAPITAL	CE. BLVNO LIBERTADOR	PQ. CARICUAO	CANTV CARICUAO	51	1	0	43	41	43	0	0	0	0	2	43
DTTO. CAPITAL	CE. BLVNO LIBERTADOR	PQ. CARICUAO	ESCUELA BASICA COLEGIO CARICUAO	2342	5	23	1955	837	1932	0	15	0	3	1077	1955
DTTO. CAPITAL	CE. BLVNO LIBERTADOR	PQ. CARICUAO	LICEO BOLIVARIANO BENITO JUAREZ	4205	8	56	3610	1717	3554	0	11	4	6	1816	3610
DTTO. CAPITAL	CE. BLVNO LIBERTADOR	PQ. CARICUAO	PREESCOLAR 19 DE MARZO	324	1	8	297	262	289	0	1	1	2	23	297
DTTO. CAPITAL	CE. BLVNO LIBERTADOR	PQ. CARICUAO	PRESCOLAR SAN CARLOS BORROMEO	1081	2	20	970	366	950	0	4	0	0	580	970
DTTO. CAPITAL	CE. BLVNO LIBERTADOR	PQ. CARICUAO	ANEXO UNIDAD EDUCATIVA NACIONAL DE CARICUAO	343	1	4	306	268	302	0	2	0	0	32	306
DTTO. CAPITAL	CE. BLVNO LIBERTADOR	PQ. CARICUAO	UNIDAD EDUCATIVA GUAYANA ESEQUIBA	3125	6	30	2583	1185	2553	0	10	0	4	1354	2583
DTTO. CAPITAL	CE. BLVNO LIBERTADOR	PQ. CARICUAO	MODULO DE BARRIO ADENTRO GUAICAIPURO	818	2	12	693	437	681	0	1	0	0	243	693
DTTO. CAPITAL	CE. BLVNO LIBERTADOR	PQ. CARICUAO	ASOSIACION CIVIL UNIDAD EDUCATIVA COLEGIO TIUNA	1424	3	25	1296	558	1271	0	6	0	1	706	1296
DTTO. CAPITAL	CE. BLVNO LIBERTADOR	PQ. CARICUAO	CENTRO PRESCOLAR LEONARDO RUIZ PINEDA	2111	4	27	1692	997	1665	1	6	4	2	655	1692
DTTO. CAPITAL	CE. BLVNO LIBERTADOR	PQ. CARICUAO	CASA DE LOS NIÑOS LOS VENADITOS	1046	2	21	892	384	871	0	3	1	2	481	892
DTTO. CAPITAL	CE. BLVNO LIBERTADOR	PQ. CARICUAO	LICEO BOLIVARIANO RAMON DIAZ SANCHEZ	2857	5	37	2360	963	2323	1	12	1	2	1344	2360
DTTO. CAPITAL	CE. BLVNO LIBERTADOR	PQ. CARICUAO	ESCUELA BASICA BOLIVARIANA MENCA DE LEONI	3399	6	77	2862	1582	2785	1	6	2	1	1193	2862
DTTO. CAPITAL	CE. BLVNO LIBERTADOR	PQ. CARICUAO	UNIDAD EDUCATIVA NACIONAL BOLIVARIANO LICEO CARICUAO	3460	6	39	2959	1076	2920	1	4	5	6	1828	2959
DTTO. CAPITAL	CE. BLVNO LIBERTADOR	PQ. CARICUAO	UNIDAD EDUCATIVA NACIOANL CIUDAD CUATRICENTERARIA	3564	7	51	2925	1463	2874	0	17	4	5	1385	2925
DTTO. CAPITAL	CE. BLVNO LIBERTADOR	PQ. CARICUAO	ESCUELA BOLIVARIANA MAESTRO JORGE RODRIGUEZ	378	1	8	337	224	329	1	3	0	0	101	337
DTTO. CAPITAL	CE. BLVNO LIBERTADOR	PQ. CARICUAO	CLINICA POPULAR CARICUAO	1409	3	23	1205	564	1182	1	5	0	0	612	1205
DTTO. CAPITAL	CE. BLVNO LIBERTADOR	PQ. CARICUAO	UNIDAD EDUCATIVA NACIONAL BOLIVARIANA TOMAS VICENTE GONZALEZ	4869	9	109	4064	1825	3955	1	14	2	5	2108	4064
DTTO. CAPITAL	CE. BLVNO LIBERTADOR	PQ. CARICUAO	PREESCOLAR ASISTENCIAL NEGRA HIPOLITA	428	1	7	363	318	356	0	2	0	0	36	363
DTTO. CAPITAL	CE. BLVNO LIBERTADOR	PQ. CARICUAO	CASA COMUNAL ANTONIO JOSE DE SUCRE	581	1	5	480	395	475	0	2	0	0	78	480
DTTO. CAPITAL	CE. BLVNO LIBERTADOR	PQ. CARICUAO	MODULO LA MILAGROSA	370	1	2	317	243	315	0	0	0	0	72	317
DTTO. CAPITAL	CE. BLVNO LIBERTADOR	PQ. CARICUAO	CENTRO MUNICIPAL DE ATENCION INTEGRAL (CMAI) CARICUAO	502	1	11	435	294	424	0	2	0	1	127	435
DTTO. CAPITAL	CE. BLVNO LIBERTADOR	PQ. CARICUAO	CENTRO DE EDUCACION INCIAL CARICUAO II	1279	3	28	1108	652	1080	0	2	2	2	422	1108
DTTO. CAPITAL	CE. BLVNO LIBERTADOR	PQ. CARICUAO	UNIDAD EDUCATIVA NACIONAL CARICUAO	3027	6	38	2483	1333	2445	1	10	4	3	1094	2483
DTTO. CAPITAL	CE. BLVNO LIBERTADOR	PQ. CARICUAO	CENTRO POLIDEPORTIVO LUIS APARICIO	904	2	9	785	333	776	2	5	0	2	434	785
DTTO. CAPITAL	CE. BLVNO LIBERTADOR	PQ. CARICUAO	ESCUELA TECNICA FRANCISCO FAJARDO	7178	13	111	6040	3787	5929	3	28	7	7	2097	6040
DTTO. CAPITAL	CE. BLVNO LIBERTADOR	PQ. CARICUAO	ESCUELA BASICA COLEGIO NUESTRA SEÑORA DEL ROSARIO	1851	4	20	1614	585	1594	1	13	0	2	993	1614
DTTO. CAPITAL	CE. BLVNO LIBERTADOR	PQ. CARICUAO	AMBULATORIO 13 DE ABRIL	317	1	5	284	252	279	0	1	0	0	26	284
DTTO. CAPITAL	CE. BLVNO LIBERTADOR	PQ. CARICUAO	COLEGIO SAN AGUSTIN	7083	13	119	6188	2333	6069	1	24	6	7	3698	6188
DTTO. CAPITAL	CE. BLVNO LIBERTADOR	PQ. CARICUAO	ESCUELA BASICA NACIONAL CREACION UD 4	1778	4	28	1578	695	1550	0	9	1	1	844	1578
DTTO. CAPITAL	CE. BLVNO LIBERTADOR	PQ. CARICUAO	UNIDAD EDUCATIVA BOLIVARIANA A. VALERO HOSTOS	4188	8	84	3530	1997	3446	4	20	2	6	1417	3530
DTTO. CAPITAL	CE. BLVNO LIBERTADOR	PQ. CARICUAO	LICEO MILITAR GRAN MARISCAL DE AYACUCHO	605	2	12	494	418	482	0	2	0	0	62	494
DTTO. CAPITAL	CE. BLVNO LIBERTADOR	PQ. CARICUAO	TALLER DE EDUCACION LABORAL BOLIVARIANO CARICUAO	728	2	10	649	319	639	0	2	0	2	316	649
DTTO. CAPITAL	CE. BLVNO LIBERTADOR	PQ. CARICUAO	BIBLIOTECA PUBLICA AQUILES NAZOA	1855	4	21	1641	774	1620	1	4	1	0	840	1641
DTTO. CAPITAL	CE. BLVNO LIBERTADOR	PQ. CARICUAO	UNIDAD EDUCATIVA NACIOANL JOSE MANUEL NUÑEZ PONTE	4485	8	85	3680	2325	3595	1	20	6	3	1240	3680
DTTO. CAPITAL	CE. BLVNO LIBERTADOR	PQ. CARICUAO	ESCUELA BASICA NACIONAL CONCENTRADA Nº 45	807	2	9	647	509	638	0	3	0	2	124	647
DTTO. CAPITAL	CE. BLVNO LIBERTADOR	PQ. CARICUAO	UNIDA EDUCATIVA JOSE ALBERTO HERNANDEZ PARRA	3961	7	53	3325	1491	3272	0	16	0	3	1762	3325
DTTO. CAPITAL	CE. BLVNO LIBERTADOR	PQ. CARICUAO	UNIDAD EDUCATIVA BOLIVARIANA RAFAEL GUINAND PERAZA	2334	4	42	1978	1141	1936	0	7	0	1	787	1978
DTTO. CAPITAL	CE. BLVNO LIBERTADOR	PQ. CARICUAO	ESCUELA DE ESTUDIO DE ORDEN INTERNO DE LA GUARDIA NACIONAL	149	1	1	128	107	127	0	3	0	1	16	128
DTTO. CAPITAL	CE. BLVNO LIBERTADOR	PQ. CARICUAO	ESCUELA BÁSICA NACIONAL MANUEL CABRE	3141	6	62	2613	1929	2551	0	11	1	1	609	2613
DTTO. CAPITAL	CE. BLVNO LIBERTADOR	PQ. CARICUAO	UNIDAD EDUCATIVA PRIVADA CRUZ SALMERON ACOSTA	558	1	6	500	301	494	0	2	0	0	191	500
DTTO. CAPITAL	CE. BLVNO LIBERTADOR	PQ. CARICUAO	UNIDAD EDUCATIVA NACIONAL MARIA TABEROA	1450	3	17	1228	525	1211	0	4	1	0	681	1228
DTTO. CAPITAL	CE. BLVNO LIBERTADOR	PQ. CARICUAO	LICEO SAN AGUSTIN**	4378	8	55	3806	1405	3751	1	11	1	5	2328	3806
DTTO. CAPITAL	CE. BLVNO LIBERTADOR	PQ. CARICUAO	CENTRO METROPOLITANO  INSTITUTO NACIONAL DE CAPACITACION EDUCATIVA SOCIALISTA CARICUAO	541	1	10	475	257	465	0	3	0	0	205	475
DTTO. CAPITAL	CE. BLVNO LIBERTADOR	PQ. CARICUAO	UNIDAD EDUCATIVA MIREYA VANEGAS	3535	7	38	3020	1276	2982	0	10	3	3	1690	3020
DTTO. CAPITAL	CE. BLVNO LIBERTADOR	PQ. CARICUAO	LICEO RAFAEL SEIJAS	3128	6	35	2621	1072	2586	1	10	0	0	1503	2621
DTTO. CAPITAL	CE. BLVNO LIBERTADOR	PQ. EL PARAISO	CENTRO DE EDUCACION INICIAL SIMONCITO SAN MARTIN II	270	1	4	236	128	232	0	1	0	0	103	236
DTTO. CAPITAL	CE. BLVNO LIBERTADOR	PQ. EL PARAISO	DESARROLLO URBANISTICO EL PARAISO	524	1	6	487	476	481	1	0	0	0	4	487
DTTO. CAPITAL	CE. BLVNO LIBERTADOR	PQ. EL PARAISO	PRE ESCOLAR BARRIO BICENTENARIO	908	2	26	798	558	772	0	2	1	0	211	798
DTTO. CAPITAL	CE. BLVNO LIBERTADOR	PQ. EL PARAISO	CENTRO DE ESTUDIOS DE TELECOMUNICACIONES ARTIGAS	2197	4	43	1723	927	1680	1	12	0	1	739	1723
DTTO. CAPITAL	CE. BLVNO LIBERTADOR	PQ. EL PARAISO	ESCUELA BASICA DOÑA ROSALIA CAMPINS DE HERRERA	649	2	10	555	474	545	2	1	0	0	68	555
DTTO. CAPITAL	CE. BLVNO LIBERTADOR	PQ. EL PARAISO	CENTRO DE EDUCACION INICIAL CARMEN SALLES	199	1	2	185	153	183	1	1	0	0	28	185
DTTO. CAPITAL	CE. BLVNO LIBERTADOR	PQ. EL PARAISO	UNIDAD EDUCATIVA COLEGIO SAN JOSÉ DE TARBES	5293	10	32	4439	867	4407	0	11	2	2	3525	4439
DTTO. CAPITAL	CE. BLVNO LIBERTADOR	PQ. EL PARAISO	INSTITUTO UNIVERSITARIO DE TECNOLOGIA INDUSTRIAL RODOLFO LOERO ARISMENDI	410	1	11	322	264	311	0	0	0	0	47	322
DTTO. CAPITAL	CE. BLVNO LIBERTADOR	PQ. EL PARAISO	UNIDAD EDUCATIVA NACIONAL EDUARDO CREMA	1552	3	12	1196	406	1184	2	12	0	3	761	1196
DTTO. CAPITAL	CE. BLVNO LIBERTADOR	PQ. EL PARAISO	LOMA ANDINA	369	1	6	316	260	310	0	1	0	0	49	316
DTTO. CAPITAL	CE. BLVNO LIBERTADOR	PQ. EL PARAISO	LICEO BOLIVARIANO PABLO ACOSTA ORTIZ	1715	3	34	1400	744	1366	1	8	2	4	607	1400
DTTO. CAPITAL	CE. BLVNO LIBERTADOR	PQ. EL PARAISO	CORPORACIÓN DE SERVICIOS GOBIERNO DEL DISTRITO CAPITAL	172	1	3	159	148	156	1	0	0	0	7	159
DTTO. CAPITAL	CE. BLVNO LIBERTADOR	PQ. EL PARAISO	CICLO BÁSICO PABLO VILA	1718	3	30	1421	1043	1391	0	6	0	1	341	1421
DTTO. CAPITAL	CE. BLVNO LIBERTADOR	PQ. EL PARAISO	ESCUELA BÁSICA NACIONAL JUAN RODRÍGUEZ SUÁREZ	2957	6	33	2333	546	2300	1	7	3	0	1743	2333
DTTO. CAPITAL	CE. BLVNO LIBERTADOR	PQ. EL PARAISO	UNIDAD EDUCATIVA TALENTO DEPORTIVO LICEO CARACAS	2613	5	30	1996	885	1966	1	18	0	4	1058	1996
DTTO. CAPITAL	CE. BLVNO LIBERTADOR	PQ. EL PARAISO	LICEO ANTONIO GUZMÁN BLANCO	2612	5	27	2013	917	1986	0	17	0	0	1052	2013
DTTO. CAPITAL	CE. BLVNO LIBERTADOR	PQ. EL PARAISO	UNIDAD EDUCATIVA DISTRITAL  MATÍAS NÚÑEZ	4779	9	45	3815	1015	3770	0	5	3	2	2745	3815
DTTO. CAPITAL	CE. BLVNO LIBERTADOR	PQ. EL PARAISO	CENTRO DE FORMACIÓN SOCIALISTA CAPACITACIÓN ESPECIAL	543	1	3	421	188	418	0	3	0	0	227	421
DTTO. CAPITAL	CE. BLVNO LIBERTADOR	PQ. EL PARAISO	COLEGIO CIUDAD MARIANA DE CARACAS	1509	3	10	1177	209	1167	0	2	0	0	956	1177
DTTO. CAPITAL	CE. BLVNO LIBERTADOR	PQ. EL PARAISO	UNIDAD EDUCATIVA COLEGIO TERESIANO NUESTRA SEÑORA DE COROMOTO	951	2	11	800	179	789	0	1	1	0	608	800
DTTO. CAPITAL	CE. BLVNO LIBERTADOR	PQ. EL PARAISO	UNIDAD EDUCATIVA DISTRITAL VIRGINIA DE RUIZ	472	1	10	434	350	424	0	1	0	0	73	434
DTTO. CAPITAL	CE. BLVNO LIBERTADOR	PQ. EL PARAISO	CENTRO DE EDUCACIÓN INICIAL PREESCOLAR  BOLIVARIANO EL SEMILLERO	479	1	6	430	159	424	0	1	0	0	264	430
DTTO. CAPITAL	CE. BLVNO LIBERTADOR	PQ. EL PARAISO	UNIDAD EDUCATIVA DISTRITAL  MARIO BRICEO IRAGORRY	3494	6	45	2865	1897	2820	1	15	2	1	904	2865
DTTO. CAPITAL	CE. BLVNO LIBERTADOR	PQ. EL PARAISO	ESCUELA TÉCNICA COMERCIAL LUÍS RAZETTI	3449	6	42	2889	1706	2847	2	17	3	4	1115	2889
DTTO. CAPITAL	CE. BLVNO LIBERTADOR	PQ. EL PARAISO	UNIDAD EDUCATIVA COLEGIO SANTA MARIA MICAELA	2288	4	13	1692	179	1679	1	7	0	3	1489	1692
DTTO. CAPITAL	CE. BLVNO LIBERTADOR	PQ. EL PARAISO	UNIDAD EDUCATIVA SANTA ELENA	1074	2	3	924	169	921	0	2	1	0	749	924
DTTO. CAPITAL	CE. BLVNO LIBERTADOR	PQ. EL PARAISO	ESTADIUM NACIONAL BRIGIDO IRIARTE	3103	6	32	2420	534	2388	1	6	0	3	1844	2420
DTTO. CAPITAL	CE. BLVNO LIBERTADOR	PQ. EL PARAISO	INSTITUTO UNIVERSITARIO PEDAGÓGICO DE CARACAS	3636	7	48	2687	971	2639	0	9	0	6	1653	2687
DTTO. CAPITAL	CE. BLVNO LIBERTADOR	PQ. EL PARAISO	UNIDAD EDUCATIVA DISTRITAL CONSUELO NAVAS TOVAR	2941	6	75	1990	1128	1915	0	6	0	3	778	1990
DTTO. CAPITAL	CE. BLVNO LIBERTADOR	PQ. EL PARAISO	CENTRO AMBULATORIO ANDRÉS ELOY BLANCO	786	2	18	686	402	668	0	7	0	2	257	686
DTTO. CAPITAL	CE. BLVNO LIBERTADOR	PQ. EL PARAISO	UNIDAD EDUCATIVA COLEGIO SAN AGUSTÍN	4513	8	24	3820	584	3796	1	6	0	2	3203	3820
DTTO. CAPITAL	CE. BLVNO LIBERTADOR	PQ. EL PARAISO	UNIDAD EDUCATIVA COLEGIO MIGUEL ÁNGEL	2557	5	28	2171	543	2143	0	8	2	2	1588	2171
DTTO. CAPITAL	CE. BLVNO LIBERTADOR	PQ. EL PARAISO	COLEGIO PESTALOZZI	2234	4	29	1852	305	1823	0	2	0	1	1515	1852
DTTO. CAPITAL	CE. BLVNO LIBERTADOR	PQ. EL PARAISO	HOSPITAL  MIGUEL PÉREZ CARREÑO	507	1	7	384	169	377	0	1	1	0	206	384
DTTO. CAPITAL	CE. BLVNO LIBERTADOR	PQ. EL PARAISO	UNIVERSIDAD SANTA MARIA EL PARAÍSO	5092	9	58	4172	1408	4114	1	15	3	4	2683	4172
DTTO. CAPITAL	CE. BLVNO LIBERTADOR	PQ. EL PARAISO	COLEGIO DEL AVE MARIA	2684	5	42	2151	574	2109	1	7	0	2	1525	2151
DTTO. CAPITAL	CE. BLVNO LIBERTADOR	PQ. EL PARAISO	LICEO BOLIVARIANO ANTONIO MUÑOZ TEBAR	3194	6	53	2717	1420	2664	0	11	0	3	1230	2717
DTTO. CAPITAL	CE. BLVNO LIBERTADOR	PQ. EL PARAISO	CENTRO MUNICIPAL DE APOYO AL PODER COMUNAL (CMAPC)	143	1	3	126	92	123	0	0	0	0	31	126
DTTO. CAPITAL	CE. BLVNO LIBERTADOR	PQ. EL PARAISO	UNIDAD EDUCATIVA  BOLIVARIANA JOSÉ ANTONIO GONZÁLEZ	1976	4	17	1561	370	1544	0	6	0	0	1168	1561
DTTO. CAPITAL	CE. BLVNO LIBERTADOR	PQ. EL PARAISO	ESCUELA BASICA NACIONAL BARRIO GUZMAN BLANCO	322	1	5	296	211	291	0	1	0	0	79	296
DTTO. CAPITAL	CE. BLVNO LIBERTADOR	PQ. EL PARAISO	UNIDAD EDUCATIVA DISTRITAL MANUEL ANTONIO CARREÑO	3990	7	36	3118	592	3082	1	9	0	2	2478	3118
DTTO. CAPITAL	CE. BLVNO LIBERTADOR	PQ. EL PARAISO	UNIDAD EDUCATIVA PRIVADA SIMÓN RODRÍGUEZ	3525	7	33	2915	597	2882	1	9	0	3	2272	2915
DTTO. CAPITAL	CE. BLVNO LIBERTADOR	PQ. EL PARAISO	CENTRO DE EDUCACIÓN INICIAL ABILIO REYES	833	2	22	687	387	665	0	3	1	1	273	687
DTTO. CAPITAL	CE. BLVNO LIBERTADOR	PQ. EL PARAISO	ESCUELA TÉCNICA INDUSTRIAL JOSÉ DE SAN MARTÍN	2137	4	25	1803	1026	1778	0	6	3	1	742	1803
DTTO. CAPITAL	CE. BLVNO LIBERTADOR	PQ. EL PARAISO	PRE ESCOLAR COTA 905	272	1	4	196	140	192	0	1	0	0	51	196
DTTO. CAPITAL	CE. BLVNO LIBERTADOR	PQ. EL PARAISO	UNIDAD EDUCATIVA PRIVADA NUESTRA SEÑORA DEL VALLE	2595	5	18	2052	291	2034	1	5	0	0	1737	2052
DTTO. CAPITAL	CE. BLVNO LIBERTADOR	PQ. ALTAGRACIA	BIBLIOTECA NACIONAL SALA UNO	2132	4	30	1654	730	1624	0	7	0	1	886	1654
DTTO. CAPITAL	CE. BLVNO LIBERTADOR	PQ. ALTAGRACIA	DESARROLLO URBANISTICO ALTAGRACIA IV	139	1	2	131	122	129	0	0	0	0	7	131
DTTO. CAPITAL	CE. BLVNO LIBERTADOR	PQ. ALTAGRACIA	UNIDAD EDUCATIVA SANTA TERESA DEL NIÑO JESÚS	2290	4	36	1726	473	1690	0	7	0	1	1209	1726
DTTO. CAPITAL	CE. BLVNO LIBERTADOR	PQ. ALTAGRACIA	UNIDAD EDUCATIVA SANTA BARBARA	2303	4	14	1964	892	1950	1	12	1	0	1044	1964
DTTO. CAPITAL	CE. BLVNO LIBERTADOR	PQ. ALTAGRACIA	CENTRO DE EDUCACIÓN INICIAL RAFAEL MARIA BARALT	1287	3	20	1082	646	1062	0	9	0	2	405	1082
DTTO. CAPITAL	CE. BLVNO LIBERTADOR	PQ. ALTAGRACIA	CASA DE NUESTRA AMERICA JOSE MARTI	1376	3	9	968	416	959	0	4	0	0	539	968
DTTO. CAPITAL	CE. BLVNO LIBERTADOR	PQ. ALTAGRACIA	CENTRO DE EDUCACIÓN INICIAL SAMUEL ROBINSÓN	817	2	9	734	515	725	0	5	1	0	204	734
DTTO. CAPITAL	CE. BLVNO LIBERTADOR	PQ. ALTAGRACIA	UNIDAD EDUCATIVA FUENTE DEL SABER	295	1	4	279	191	275	0	1	0	0	83	279
DTTO. CAPITAL	CE. BLVNO LIBERTADOR	PQ. ALTAGRACIA	ESCUELA NACIONAL DE ARTES ESCÉNICAS CESAR RENGIFO	2197	4	37	1692	770	1655	0	7	0	0	878	1692
DTTO. CAPITAL	CE. BLVNO LIBERTADOR	PQ. ALTAGRACIA	UNIDAD EDUCATIVA PRIVADA COLEGIO LA SALLE	6562	12	50	5240	1695	5190	2	16	0	5	3472	5240
DTTO. CAPITAL	CE. BLVNO LIBERTADOR	PQ. ALTAGRACIA	UNIDAD EDUCATIVA COP ANDRES ELOY BLANCO	316	1	7	298	193	291	0	1	0	0	97	298
DTTO. CAPITAL	CE. BLVNO LIBERTADOR	PQ. ALTAGRACIA	COLEGIO UNIVERSITARIO FRANCISCO DE MIRANDA	4821	9	79	3956	1952	3877	0	24	5	2	1894	3956
DTTO. CAPITAL	CE. BLVNO LIBERTADOR	PQ. ALTAGRACIA	CENTRO MUNICIPAL DE ATENCIÓN INTEGRAL ALTAGRACIA (CMAI)	893	2	17	786	586	769	1	2	1	0	179	786
DTTO. CAPITAL	CE. BLVNO LIBERTADOR	PQ. ALTAGRACIA	UNIDAD EDUCATIVA DISTRITAL ANTONIO ORNES	1421	3	24	1101	673	1077	1	7	0	6	390	1101
DTTO. CAPITAL	CE. BLVNO LIBERTADOR	PQ. ALTAGRACIA	UNIDAD EDUCATIVA NACIONL SIMÓN BOLÍVAR	4505	8	40	3604	1720	3564	0	21	3	2	1818	3604
DTTO. CAPITAL	CE. BLVNO LIBERTADOR	PQ. ALTAGRACIA	UNIDAD EDUCATIVA NACIONAL DOCTOR FRANCISCO MENDOZA	1684	3	28	1362	712	1334	0	5	0	2	615	1362
DTTO. CAPITAL	CE. BLVNO LIBERTADOR	PQ. ALTAGRACIA	UNIDAD EDUCATIVA DISTRITAL MADARIAGA	2173	4	34	1763	689	1729	0	5	0	1	1034	1763
DTTO. CAPITAL	CE. BLVNO LIBERTADOR	PQ. SAN PEDRO	COLEGIO JUAN XXIII	752	2	7	626	193	619	0	2	0	4	420	626
DTTO. CAPITAL	CE. BLVNO LIBERTADOR	PQ. SAN PEDRO	UNIDAD EDUCATIVA COLEGIO SANTA ELVIRA	1482	3	7	1186	257	1179	0	4	0	0	918	1186
DTTO. CAPITAL	CE. BLVNO LIBERTADOR	PQ. SAN PEDRO	COLEGIO NUESTRA SEÑORA DEL CARMEN	1779	3	13	1365	313	1352	0	5	0	1	1033	1365
DTTO. CAPITAL	CE. BLVNO LIBERTADOR	PQ. SAN PEDRO	ASOCIACION VENEZOLANA DE MUJERES	1492	3	9	1261	679	1252	0	5	1	3	564	1261
DTTO. CAPITAL	CE. BLVNO LIBERTADOR	PQ. SAN PEDRO	ESCUELA BASICA NACIONAL JOSE GONZALO MENDEZ	3666	7	16	2764	494	2748	0	3	3	2	2246	2764
DTTO. CAPITAL	CE. BLVNO LIBERTADOR	PQ. SAN PEDRO	COLEGIO SANTA CATERINA DE SIENA	1420	3	11	1114	166	1103	0	2	0	2	933	1114
DTTO. CAPITAL	CE. BLVNO LIBERTADOR	PQ. SAN PEDRO	UNIDA EDUCATIVA COLEGIO LAS ACACIAS	3230	6	31	2598	707	2567	2	3	1	3	1851	2598
DTTO. CAPITAL	CE. BLVNO LIBERTADOR	PQ. SAN PEDRO	ESCUELA BASICA FRANKLIN DELANO ROOSEVELT	3603	7	33	2661	674	2628	1	4	1	2	1946	2661
DTTO. CAPITAL	CE. BLVNO LIBERTADOR	PQ. SAN PEDRO	INSTITUTO LA CONSOLACION	1839	4	17	1583	308	1566	0	2	0	2	1254	1583
DTTO. CAPITAL	CE. BLVNO LIBERTADOR	PQ. SAN PEDRO	ESCUELA BASICA RAMON POMPILIO OROPEZA	1969	4	13	1468	398	1455	2	4	1	3	1047	1468
DTTO. CAPITAL	CE. BLVNO LIBERTADOR	PQ. SAN PEDRO	UNIDAD EDUCATIVA DISTRITAL PAEZ	245	1	9	204	121	195	0	1	1	0	72	204
DTTO. CAPITAL	CE. BLVNO LIBERTADOR	PQ. SAN PEDRO	IUTIRLA	1571	3	18	1270	271	1252	3	3	0	0	975	1270
DTTO. CAPITAL	CE. BLVNO LIBERTADOR	PQ. SAN PEDRO	UNIDAD EDUCATIVA COLEGIO NUESTRA MADRE	3762	7	30	2864	851	2834	1	10	1	7	1964	2864
DTTO. CAPITAL	CE. BLVNO LIBERTADOR	PQ. SAN PEDRO	LICEO URBANEJA ACHELPOHL	2860	5	36	2230	739	2194	0	5	0	1	1449	2230
DTTO. CAPITAL	CE. BLVNO LIBERTADOR	PQ. SAN PEDRO	UNIDAD EDUCATIVA BOLIVARIANA DOCTOR NICOLAS JOSE MENDIBLE	1456	3	18	1144	536	1126	0	5	4	1	580	1144
DTTO. CAPITAL	CE. BLVNO LIBERTADOR	PQ. SAN PEDRO	UNIDAD EDUCATIVA INSTITUTO DE EDUCACION INTEGRAL EL NIÑO DON SIMON	961	2	10	809	206	799	1	2	1	1	588	809
DTTO. CAPITAL	CE. BLVNO LIBERTADOR	PQ. SAN PEDRO	UNIDAD EDUCATIVA NACIONAL LEOPOLDO AGUERREVERE	2597	5	22	1909	499	1887	1	3	2	1	1381	1909
DTTO. CAPITAL	CE. BLVNO LIBERTADOR	PQ. SAN PEDRO	UNIVERSIDAD BOLIVARIANA DE VENEZUELA	908	2	11	788	460	777	1	1	0	1	314	788
DTTO. CAPITAL	CE. BLVNO LIBERTADOR	PQ. SAN PEDRO	COLEGIO SANTA MONICA	723	2	6	614	178	608	1	3	1	2	423	614
DTTO. CAPITAL	CE. BLVNO LIBERTADOR	PQ. SAN PEDRO	UNIDAD EDUCATIVA COLEGIO EL CARMELO	3423	6	24	2609	491	2585	1	4	0	1	2088	2609
DTTO. CAPITAL	CE. BLVNO LIBERTADOR	PQ. SAN PEDRO	COLEGIO SAN PEDRO	5676	10	50	4518	1116	4468	4	11	2	4	3331	4518
DTTO. CAPITAL	CE. BLVNO LIBERTADOR	PQ. SAN PEDRO	UNIDAD EDUCATIVA HUMBERTO PARODI	1692	3	21	1276	449	1255	1	7	0	1	797	1276
DTTO. CAPITAL	CE. BLVNO LIBERTADOR	PQ. SAN PEDRO	CENTRO DE EDUCACION INICIAL MARIA EDILIA VALERO	627	2	9	528	161	519	1	3	0	0	354	528
DTTO. CAPITAL	CE. BLVNO LIBERTADOR	PQ. SAN PEDRO	DESARROLLO URBANISTICO ROOSEVELT	30	1	1	30	29	29	0	0	0	0	0	30
DTTO. CAPITAL	CE. BLVNO LIBERTADOR	PQ. SAN PEDRO	DESARROLLO URBANISTICO SAN PEDRO I	404	1	10	373	357	363	0	0	0	0	6	373
DTTO. CAPITAL	CE. BLVNO LIBERTADOR	PQ. SAN PEDRO	UNIDAD EDUCATIVA COLEGIO LOS ROSALES	599	1	12	516	138	504	1	2	1	1	361	516
DTTO. CAPITAL	CE. BLVNO LIBERTADOR	PQ. SAN PEDRO	COLEGIO SAN LAZARO	1537	3	6	1203	199	1197	1	2	2	0	993	1203
DTTO. CAPITAL	CE. BLVNO LIBERTADOR	PQ. SAN PEDRO	ESCUELA BASICA OCTAVIO ANTONIO DIEZ.	1271	3	13	911	178	898	0	1	0	0	719	911
DTTO. CAPITAL	CE. BLVNO LIBERTADOR	PQ. SAN PEDRO	COLEGIO CRISTO REY	6536	12	46	5145	573	5099	1	5	1	3	4516	5145
DTTO. CAPITAL	CE. BLVNO LIBERTADOR	PQ. SAN PEDRO	JARDIN DE INFANCIA TEOTISTE DE GALLEGOS	351	1	3	318	110	315	0	1	0	0	204	318
DTTO. CAPITAL	CE. BLVNO LIBERTADOR	PQ. SAN PEDRO	DESARROLLO URBANISTICO LA VICTORIA	130	1	7	128	113	121	0	0	0	0	8	128
DTTO. CAPITAL	CE. BLVNO LIBERTADOR	PQ. SAN JOSE	DESARROLLO URBANISTICO SAN JOSÉ	37	1	6	36	30	30	0	0	0	0	0	36
DTTO. CAPITAL	CE. BLVNO LIBERTADOR	PQ. SAN JOSE	UNIDAD EDUCACIONAL PRIVADA INSTITUTO JUNKAL	787	2	14	706	331	692	0	2	0	2	357	706
DTTO. CAPITAL	CE. BLVNO LIBERTADOR	PQ. SAN JOSE	CENTRO DE EDUCACION INICIAL MIS PRIMERAS LUCES	1970	4	28	1611	429	1583	0	6	0	4	1144	1611
DTTO. CAPITAL	CE. BLVNO LIBERTADOR	PQ. SAN JOSE	UNIDAD EDUCATIVA NACIONAL BOLIVARIANA JESÚS MARIA PÁEZ	4046	7	72	3297	1855	3225	0	13	1	1	1355	3297
DTTO. CAPITAL	CE. BLVNO LIBERTADOR	PQ. SAN JOSE	ESCUELA NACIONAL PRIMARIA BERNARDO O HIGGINS	4495	8	56	3526	1482	3470	0	16	6	11	1955	3526
DTTO. CAPITAL	CE. BLVNO LIBERTADOR	PQ. SAN JOSE	UNIDAD EDUCATIVA ECOLÓGICA SANTÍSIMA TRINIDAD	2319	4	33	1779	785	1746	1	11	0	1	948	1779
DTTO. CAPITAL	CE. BLVNO LIBERTADOR	PQ. SAN JOSE	UNIDAD UDUCATIVA INTEGRAL ENRIQUE VASQUEZ FERMIN	228	1	7	202	128	195	0	0	0	0	67	202
DTTO. CAPITAL	CE. BLVNO LIBERTADOR	PQ. SAN JOSE	ESCUELA TÉCNICA COMERCIAL ROBINSONIANA SANTOS MICHELENA	5020	9	76	3876	1419	3800	0	16	1	3	2361	3876
DTTO. CAPITAL	CE. BLVNO LIBERTADOR	PQ. SAN JOSE	PREESCOLAR ASISTENCIAL JESUS DE LA DIVINA MISERICORDIA	363	1	5	324	200	319	0	2	0	0	117	324
DTTO. CAPITAL	CE. BLVNO LIBERTADOR	PQ. SAN JOSE	HOSPITAL DOCTOR FRANCISCO ANTONIO RISQUEZ	2480	5	48	2012	1215	1964	0	11	2	0	736	2012
DTTO. CAPITAL	CE. BLVNO LIBERTADOR	PQ. SAN JOSE	UNIDAD EDUCATIVA BOLIVARIANA RAFAEL URDANETA	4825	9	66	3691	1328	3625	0	13	1	4	2279	3691
DTTO. CAPITAL	CE. BLVNO LIBERTADOR	PQ. SAN JOSE	UNIDAD EDUCACIONAL NIÑO DIOS DE SAN JOSÉ	678	2	11	583	263	572	0	2	1	0	306	583
DTTO. CAPITAL	CE. BLVNO LIBERTADOR	PQ. SAN JOSE	UNIDAD EDUCATIVA NACIONAL BOLIVARIANA ARMANDO ZULOAGA BLANCO	4451	8	85	3586	1490	3501	0	17	3	3	1988	3586
DTTO. CAPITAL	CE. BLVNO LIBERTADOR	PQ. SAN JOSE	UNIDAD EDUCATIVA JOSÉ ANTONIO ANZOATEGUI	1505	3	25	1166	487	1141	0	5	1	2	646	1166
DTTO. CAPITAL	CE. BLVNO LIBERTADOR	PQ. EL JUNQUITO	ESCUELA JOSÉ ANTONIO PÁEZ	3502	6	50	2803	1871	2753	2	10	0	4	866	2803
DTTO. CAPITAL	CE. BLVNO LIBERTADOR	PQ. EL JUNQUITO	ESCUELA BÁSICA BOLIVARIANA SABANETA	4231	8	87	3401	1545	3314	3	15	2	2	1747	3401
DTTO. CAPITAL	CE. BLVNO LIBERTADOR	PQ. EL JUNQUITO	CASA COMUNAL MONTAÑA BAJA	147	1	3	140	91	137	0	0	0	1	45	140
DTTO. CAPITAL	CE. BLVNO LIBERTADOR	PQ. EL JUNQUITO	COLEGIO FE Y ALEGRÍA SAGRADA FAMILIA	4396	8	53	3459	2310	3406	5	19	3	3	1066	3459
DTTO. CAPITAL	CE. BLVNO LIBERTADOR	PQ. EL JUNQUITO	INSTITUTO NAUTICO LUZ BOLIVARIANA	964	2	11	794	542	783	0	4	0	0	237	794
DTTO. CAPITAL	CE. BLVNO LIBERTADOR	PQ. EL JUNQUITO	MODULO DE SALUD COLINA SUAVE	478	1	10	410	264	400	0	5	1	0	130	410
DTTO. CAPITAL	CE. BLVNO LIBERTADOR	PQ. EL JUNQUITO	ESCUELA BÁSICA DISTRITAL VICENTE EMILIO SOJO	3770	7	114	2955	1871	2841	2	17	0	1	950	2955
DTTO. CAPITAL	CE. BLVNO LIBERTADOR	PQ. EL JUNQUITO	UNIDAD EDUCATIVA NACIONAL TULA AMISTERSAROVE	1661	3	21	1127	403	1106	0	3	1	0	699	1127
DTTO. CAPITAL	CE. BLVNO LIBERTADOR	PQ. EL JUNQUITO	PREESCOLAR ASISTENCIAL MORAL Y LUCES	297	1	9	266	206	257	0	2	0	1	48	266
DTTO. CAPITAL	CE. BLVNO LIBERTADOR	PQ. EL JUNQUITO	COMUNIDAD TERAPUETICA SOCIALISTA EL JUNQUITO	281	1	14	256	183	242	0	0	1	0	58	256
DTTO. CAPITAL	CE. BLVNO LIBERTADOR	PQ. EL JUNQUITO	UNIDAD EDUCATIVA PRIVADA JUAN VICENTE BOLÍVAR	1957	4	26	1762	729	1736	1	9	2	1	994	1762
DTTO. CAPITAL	CE. BLVNO LIBERTADOR	PQ. EL JUNQUITO	PRE ESCOLAR CENAIM IV	939	2	13	790	584	777	0	6	0	0	187	790
DTTO. CAPITAL	CE. BLVNO LIBERTADOR	PQ. EL JUNQUITO	UNIDAD EDUCATIVA PRIVADA EL JUNQUITO	319	1	10	269	78	259	0	0	0	0	181	269
DTTO. CAPITAL	CE. BLVNO LIBERTADOR	PQ. EL JUNQUITO	UNIDAD EDUCATIVA NACIONAL HIPÓLITO CISNEROS	3066	6	43	2329	1335	2286	2	13	3	2	931	2329
DTTO. CAPITAL	CE. BLVNO LIBERTADOR	PQ. EL JUNQUITO	CENTRO COMUNAL EL TOPO	280	1	3	249	190	246	0	2	1	2	51	249
DTTO. CAPITAL	CE. BLVNO LIBERTADOR	PQ. EL JUNQUITO	UNIDAD EDUCATIVA MI MUNDO ESTUDIANTIL	256	1	5	232	81	227	0	0	0	0	146	232
DTTO. CAPITAL	CE. BLVNO LIBERTADOR	PQ. EL JUNQUITO	CASA COMUNAL ANDRES ELOY BLANCO	734	2	12	617	443	605	0	2	1	1	158	617
DTTO. CAPITAL	CE. BLVNO LIBERTADOR	PQ. EL JUNQUITO	CASA COMUNAL LOMA DE ORO	226	1	1	202	156	201	0	3	0	0	42	202
DTTO. CAPITAL	CE. BLVNO LIBERTADOR	PQ. EL JUNQUITO	ALBERGUE LA DIGNIDAD	167	1	3	150	116	147	0	1	0	0	30	150
DTTO. CAPITAL	CE. BLVNO LIBERTADOR	PQ. EL JUNQUITO	UNIDAD EDUCATIVA NACIONAL LUÍS HURTADO HIGUERA	7348	13	78	5724	2357	5646	1	30	2	7	3249	5724
DTTO. CAPITAL	CE. BLVNO LIBERTADOR	PQ. EL JUNQUITO	UNIDAD EDUCATIVA COLEGIO IBEROAMERICANO	542	1	10	491	244	481	0	2	0	0	235	491
DTTO. CAPITAL	CE. BLVNO LIBERTADOR	PQ. EL JUNQUITO	CENTRO DE SALUD LOMAS DE ORO	450	1	14	404	334	390	0	1	0	0	55	404
DTTO. CAPITAL	CE. BLVNO LIBERTADOR	PQ. EL JUNQUITO	CENTRO EL GUAMAL	404	1	9	354	224	345	0	1	0	0	120	354
DTTO. CAPITAL	CE. BLVNO LIBERTADOR	PQ. EL JUNQUITO	LICEO BOLIVARIANO AUGUSTO RISUÑER	2117	4	29	1641	604	1612	1	2	1	3	1001	1641
DTTO. CAPITAL	CE. BLVNO LIBERTADOR	PQ. EL JUNQUITO	COMPLEJO CULTURAL GUAICAIPURO	572	1	9	511	375	502	0	3	1	0	123	511
DTTO. CAPITAL	CE. BLVNO LIBERTADOR	PQ. EL JUNQUITO	PREESCOLAR ASISTENCIAL ANDRES BELLO	400	1	8	354	246	346	0	1	0	0	99	354
DTTO. CAPITAL	CE. BLVNO LIBERTADOR	PQ. EL JUNQUITO	PREESCOLAR EL CARDON	571	1	15	505	299	490	0	4	0	1	186	505
DTTO. CAPITAL	CE. BLVNO LIBERTADOR	PQ. SANTA TERESA	GRUPO ESCOLAR FRANCISCO PIMENTEL	6872	13	91	5277	2044	5186	2	26	2	4	3108	5277
DTTO. CAPITAL	CE. BLVNO LIBERTADOR	PQ. SANTA TERESA	CENTRO MUNICIPAL DE ATENCION INTEGRAL (CMAI)	204	1	1	177	119	176	0	1	0	1	55	177
DTTO. CAPITAL	CE. BLVNO LIBERTADOR	PQ. SANTA TERESA	COLEGIO LUZ Y VIDA	281	1	6	241	107	235	0	0	0	0	128	241
DTTO. CAPITAL	CE. BLVNO LIBERTADOR	PQ. SANTA TERESA	DESARROLLO URBANISTICO TEATROS II	305	1	3	292	280	289	0	1	0	0	8	292
DTTO. CAPITAL	CE. BLVNO LIBERTADOR	PQ. SANTA TERESA	COLEGIO MONSEÑOR CASTRO	2213	4	26	1666	584	1640	2	6	1	6	1041	1666
DTTO. CAPITAL	CE. BLVNO LIBERTADOR	PQ. SANTA TERESA	LICEO TERESA CARRENO	2686	5	32	1854	766	1822	0	11	1	2	1042	1854
DTTO. CAPITAL	CE. BLVNO LIBERTADOR	PQ. SANTA TERESA	UNIDAD EDUCACIONAL PRIVADA CEFERINO ALEGRIA	498	1	7	438	221	431	0	0	1	0	209	438
DTTO. CAPITAL	CE. BLVNO LIBERTADOR	PQ. SANTA TERESA	INSTITUTO ALCAZAR	289	1	7	253	138	246	0	1	0	0	107	253
DTTO. CAPITAL	CE. BLVNO LIBERTADOR	PQ. SANTA TERESA	COLEGIO PARROQUIAL SANTA TERESA	544	1	7	445	246	438	0	4	1	0	187	445
DTTO. CAPITAL	CE. BLVNO LIBERTADOR	PQ. SANTA TERESA	UNIDAD EDUCATIVA NACIONAL PROFESOR VICTOR MANUEL TURMERO MORALES	1597	3	27	1325	536	1298	1	7	0	1	753	1325
DTTO. CAPITAL	CE. BLVNO LIBERTADOR	PQ. SANTA TERESA	UNIVERSIDAD NUEVA ESPARTA	2225	4	38	1747	660	1709	0	4	0	1	1044	1747
DTTO. CAPITAL	CE. BLVNO LIBERTADOR	PQ. SANTA TERESA	COLEGIO NUESTRA SEÑORA DE LOURDES	2573	5	25	1983	575	1958	1	8	1	2	1371	1983
DTTO. CAPITAL	CE. BLVNO LIBERTADOR	PQ. SANTA TERESA	UNIDAD EDUCATIVA NACIONAL BOLIVARIANO ANTONIO ARRAIZ	492	1	6	441	222	435	1	2	1	0	209	441
DTTO. CAPITAL	CE. BLVNO LIBERTADOR	PQ. CANDELARIA	DESARROLLO URBANISTICO BELLAS ARTES	236	1	4	226	206	222	0	0	1	0	15	226
DTTO. CAPITAL	CE. BLVNO LIBERTADOR	PQ. CANDELARIA	COLEGIO LA VIRGEN NIÑA	1782	3	30	1443	678	1413	0	1	0	2	732	1443
DTTO. CAPITAL	CE. BLVNO LIBERTADOR	PQ. CANDELARIA	PATRONATO SAN JOSE DE TARBES	2774	5	31	2305	465	2274	1	5	2	6	1795	2305
DTTO. CAPITAL	CE. BLVNO LIBERTADOR	PQ. CANDELARIA	ESCUELA BASICA JOSEFINA DAVIOT	1674	3	20	1232	337	1212	1	2	0	3	869	1232
DTTO. CAPITAL	CE. BLVNO LIBERTADOR	PQ. CANDELARIA	UNIDAD EDUCATIVA LICEO ALCAZAR	3397	6	46	2414	701	2368	0	4	0	1	1662	2414
DTTO. CAPITAL	CE. BLVNO LIBERTADOR	PQ. CANDELARIA	CENTRO DE EDUCACION INICIAL BOLIVARIANO SIMONCITO	771	2	14	707	230	693	0	1	0	1	461	707
DTTO. CAPITAL	CE. BLVNO LIBERTADOR	PQ. CANDELARIA	COLEGIO DORA BURGUEÑO	615	2	11	560	160	549	0	3	0	0	386	560
DTTO. CAPITAL	CE. BLVNO LIBERTADOR	PQ. CANDELARIA	INSTI TUTO UNITARIO DEL CENTRO	3435	6	44	2502	601	2458	3	6	1	4	1843	2502
DTTO. CAPITAL	CE. BLVNO LIBERTADOR	PQ. CANDELARIA	COLEGIO SAN FRANCISCO DE SALES	4537	8	48	3599	1186	3551	3	12	0	2	2348	3599
DTTO. CAPITAL	CE. BLVNO LIBERTADOR	PQ. CANDELARIA	ESCUELA MUNICIPAL JOSE RAMON CAMEJO	1361	3	29	1018	514	989	0	7	0	1	467	1018
DTTO. CAPITAL	CE. BLVNO LIBERTADOR	PQ. CANDELARIA	IPOSTEL	2378	5	24	2071	750	2047	1	8	5	1	1282	2071
DTTO. CAPITAL	CE. BLVNO LIBERTADOR	PQ. CANDELARIA	ESCUELA BASICA NACIONAL JOSE ANGEL ALAMO	6375	12	88	4559	1269	4471	0	11	2	3	3186	4559
DTTO. CAPITAL	CE. BLVNO LIBERTADOR	PQ. CANDELARIA	LICEO ANDRES BELLO	12093	23	208	9312	3300	9104	2	37	7	13	5745	9312
DTTO. CAPITAL	CE. BLVNO LIBERTADOR	PQ. CANDELARIA	OFICINA DEL MINISTERIO DEL TRABAJO	1819	4	28	1477	466	1449	0	4	0	4	975	1477
DTTO. CAPITAL	CE. BLVNO LIBERTADOR	PQ. CANDELARIA	UNIDAD EDUCATIVA COLEGIO LUIS DE CAMOES	2233	4	33	1676	395	1643	0	6	1	2	1239	1676
DTTO. CAPITAL	CE. BLVNO LIBERTADOR	PQ. CANDELARIA	ESCUELA EXPERIMENTAL VENEZUELA	4760	9	73	3674	1269	3601	1	13	4	5	2309	3674
DTTO. CAPITAL	CE. BLVNO LIBERTADOR	PQ. ANTIMANO	UNIDAD EDUCATIVA ARCO DEL TRIUNFO	248	1	4	216	186	212	0	2	0	1	23	216
DTTO. CAPITAL	CE. BLVNO LIBERTADOR	PQ. ANTIMANO	CONSEJO COMUNAL LA INDEPENDENCIA	228	1	0	215	206	215	0	0	0	0	9	215
DTTO. CAPITAL	CE. BLVNO LIBERTADOR	PQ. ANTIMANO	UNIDAD EDUCATIVA HIJAS SAGRADOS CORAZONES	1861	4	24	1582	1253	1558	0	5	1	2	297	1582
DTTO. CAPITAL	CE. BLVNO LIBERTADOR	PQ. ANTIMANO	ESCUELA BÁSICA DISTRITAL BOLIVARIANA JUAN BAUTISTA ARISMENDI	1377	3	35	1089	909	1054	0	7	0	1	137	1089
DTTO. CAPITAL	CE. BLVNO LIBERTADOR	PQ. ANTIMANO	PREESCOLAR MADRE MARIA SAN JOSÉ II	1298	3	17	976	657	959	0	2	0	2	298	976
DTTO. CAPITAL	CE. BLVNO LIBERTADOR	PQ. ANTIMANO	UNIDAD EDUCATIVA GENERAL CRUZ CARRILLO	1330	3	29	1041	734	1012	0	4	2	1	271	1041
DTTO. CAPITAL	CE. BLVNO LIBERTADOR	PQ. ANTIMANO	ESCUELA NACIONAL CONCENTRADA Nº 13	1227	3	15	983	796	968	0	6	0	1	165	983
DTTO. CAPITAL	CE. BLVNO LIBERTADOR	PQ. ANTIMANO	ESCUELA MUNICIPAL INES PONTE	2579	5	54	2075	1570	2021	2	11	2	2	434	2075
DTTO. CAPITAL	CE. BLVNO LIBERTADOR	PQ. ANTIMANO	CASA COMUNAL ESPADA DE BOLIVAR	231	1	2	216	202	214	0	0	0	0	12	216
DTTO. CAPITAL	CE. BLVNO LIBERTADOR	PQ. ANTIMANO	ESCUELA BÁSICA DISTRITAL JOSÉ ANTONIO VILLAVICENCIO	2312	4	40	1813	1252	1773	0	9	1	1	510	1813
DTTO. CAPITAL	CE. BLVNO LIBERTADOR	PQ. ANTIMANO	ESCUELA BASICA ANTONIO LAURO	818	2	16	749	566	733	0	3	1	0	163	749
DTTO. CAPITAL	CE. BLVNO LIBERTADOR	PQ. ANTIMANO	CENTRO MOVIL TIERRA ROJA	252	1	1	214	190	213	0	0	0	0	23	214
DTTO. CAPITAL	CE. BLVNO LIBERTADOR	PQ. ANTIMANO	GRUPO ESCOLAR MERCEDES LIMARDO	4089	8	114	3337	2404	3223	2	13	2	3	799	3337
DTTO. CAPITAL	CE. BLVNO LIBERTADOR	PQ. ANTIMANO	ESCUELA BÁSICA BOLIVARIANA PEDRO FELIPE LEDEZMA	1063	2	19	870	661	851	0	1	0	1	188	870
DTTO. CAPITAL	CE. BLVNO LIBERTADOR	PQ. ANTIMANO	CONCENTRADA Nº 57 GERMAN RODRÍGUEZ	1472	3	12	1148	918	1136	0	3	0	2	213	1148
DTTO. CAPITAL	CE. BLVNO LIBERTADOR	PQ. ANTIMANO	PREESCOLAR MADRE MARIA SAN JOSÉ III	1837	4	29	1485	1243	1456	0	2	2	0	209	1485
DTTO. CAPITAL	CE. BLVNO LIBERTADOR	PQ. ANTIMANO	DESARROLLO URBANISTICO ANTÍMANO I	232	1	1	225	215	224	0	0	0	0	9	225
DTTO. CAPITAL	CE. BLVNO LIBERTADOR	PQ. ANTIMANO	CENTRO DE EDUCACIÓN INICIAL BLANCA ESTRELLA DE MESCOLI	1081	2	22	946	686	924	0	2	1	3	232	946
DTTO. CAPITAL	CE. BLVNO LIBERTADOR	PQ. ANTIMANO	UNIDAD EDUCATIVA SAN JOSE OBRERO FE Y ALEGRIA	584	1	11	495	375	484	0	0	0	1	108	495
DTTO. CAPITAL	CE. BLVNO LIBERTADOR	PQ. ANTIMANO	ESCUELA GRADUADA GUADALUPE ALFONSO FALERO	2809	5	37	2175	1748	2138	2	9	0	0	379	2175
DTTO. CAPITAL	CE. BLVNO LIBERTADOR	PQ. ANTIMANO	COMPLEJO HOSPITALARIO JOSÉ IGNACIA BALDO.	1076	2	15	838	522	823	0	3	0	0	298	838
DTTO. CAPITAL	CE. BLVNO LIBERTADOR	PQ. ANTIMANO	ESCUELA NACIONAL BOLIVARIANA JESÚS GONZÁLEZ CABRERA	2728	5	34	2152	1453	2118	2	18	0	2	643	2152
DTTO. CAPITAL	CE. BLVNO LIBERTADOR	PQ. ANTIMANO	CASA COMUNAL DEL CONSEJO COMUNAL MARIA AUXILIADORA	424	1	4	363	321	359	0	0	0	0	38	363
DTTO. CAPITAL	CE. BLVNO LIBERTADOR	PQ. ANTIMANO	LICEO BOLIVARIANO SIMON BOLIVAR	1032	2	14	794	582	780	0	5	0	1	192	794
DTTO. CAPITAL	CE. BLVNO LIBERTADOR	PQ. ANTIMANO	DISPENSARIO LEOPOLDO AGUERREVERRE	991	2	15	785	513	770	0	6	0	2	249	785
DTTO. CAPITAL	CE. BLVNO LIBERTADOR	PQ. ANTIMANO	ESCUELA BÁSICA NACIONAL LA CUMBRE	4281	8	71	3528	2912	3457	3	13	4	3	522	3528
DTTO. CAPITAL	CE. BLVNO LIBERTADOR	PQ. ANTIMANO	UNIDAD EDUCATIVA DOCTOR PRISCO VILLASMIL FE Y ALEGRÍA	958	2	18	809	653	791	0	2	3	1	132	809
DTTO. CAPITAL	CE. BLVNO LIBERTADOR	PQ. ANTIMANO	COLEGIO REFUGIO DE LA INFANCIA ANA SAN JOSÉ DE TARBES	2660	5	42	2107	1269	2065	1	9	2	0	784	2107
DTTO. CAPITAL	CE. BLVNO LIBERTADOR	PQ. ANTIMANO	ESCUELA NACIONAL BOLIVARIANA ANTIMANO	2842	5	37	2260	1529	2223	0	8	1	3	682	2260
DTTO. CAPITAL	CE. BLVNO LIBERTADOR	PQ. ANTIMANO	CENTRO DE EDUCACIÓN INICIAL SIMONCITO VICENTE SALIAS	266	1	4	241	195	237	0	0	1	0	41	241
DTTO. CAPITAL	CE. BLVNO LIBERTADOR	PQ. ANTIMANO	CASA DE CAMPO GUZMÁN BLANCO	3251	6	39	2628	2028	2589	2	13	3	2	541	2628
DTTO. CAPITAL	CE. BLVNO LIBERTADOR	PQ. ANTIMANO	CENTRO EDUCACIÓN INICIAL NACIONAL DON ROMULO GALLEGOS	226	1	1	205	156	204	1	1	0	1	45	205
DTTO. CAPITAL	CE. BLVNO LIBERTADOR	PQ. ANTIMANO	CENTRO MOVIL PLAN 5 LA PEDRERA	78	1	1	60	54	59	0	0	0	0	5	60
DTTO. CAPITAL	CE. BLVNO LIBERTADOR	PQ. ANTIMANO	UNIVERSIDAD CATÓLICA ANDRÉS BELLO	2575	5	37	2069	835	2032	3	7	1	0	1186	2069
DTTO. CAPITAL	CE. BLVNO LIBERTADOR	PQ. ANTIMANO	UNIDAD EDUCATIVA NACIONAL ANDRÉS BELLO	3439	6	98	2715	1811	2617	1	14	3	0	788	2715
DTTO. CAPITAL	CE. BLVNO LIBERTADOR	PQ. ANTIMANO	PARQUE INFANTIL JUNTA PARROQUIAL ANTIMANO	903	2	20	697	480	677	0	1	0	0	196	697
DTTO. CAPITAL	CE. BLVNO LIBERTADOR	PQ. ANTIMANO	CENTRO DE EDUCACION INICIAL NACIONAL SIMONCITO SIMON BOLIVAR ESCUELA AZUL	1545	3	17	1173	919	1156	1	3	0	1	232	1173
DTTO. CAPITAL	CE. BLVNO LIBERTADOR	PQ. ANTIMANO	ESCUELA BÁSICA NACIONAL CREACIÓN EL COLEGIO	1696	3	15	1445	1174	1430	1	5	2	1	247	1445
DTTO. CAPITAL	CE. BLVNO LIBERTADOR	PQ. ANTIMANO	MATERNAL PREESCOLAR ANA MARIA CAMPOS	1093	2	14	871	681	857	0	4	1	0	171	871
DTTO. CAPITAL	CE. BLVNO LIBERTADOR	PQ. ANTIMANO	CAPILLA RUTA DE BELÉN	2090	4	45	1747	1284	1702	0	12	0	0	406	1747
DTTO. CAPITAL	CE. BLVNO LIBERTADOR	PQ. ANTIMANO	ESCUELA NACIONAL CECILIO ACOSTA	1029	2	24	834	663	810	0	4	0	1	142	834
DTTO. CAPITAL	CE. BLVNO LIBERTADOR	PQ. ANTIMANO	INSTITUTO VENEZOLANO DE LOS SEGUROS SOCIALES  ARMANDO CASTILLO PLAZA	2627	5	74	2034	1443	1960	0	10	0	1	506	2034
DTTO. CAPITAL	CE. BLVNO LIBERTADOR	PQ. ANTIMANO	UNIDAD EDUCATIVA POLICIAL DON CRISTÓBAL MENDOZA	917	2	25	813	592	788	0	1	1	0	194	813
DTTO. CAPITAL	CE. BLVNO LIBERTADOR	PQ. ANTIMANO	UNIDAD EDUCATIVA POLICIAL DON LAUDELIANO MEJIAS	1073	2	16	864	628	848	0	2	1	0	217	864
DTTO. CAPITAL	CE. BLVNO LIBERTADOR	PQ. ANTIMANO	CENTRO DE ASESORIA DOCENTE	3865	7	60	3064	2258	3004	1	17	5	3	720	3064
DTTO. CAPITAL	CE. BLVNO LIBERTADOR	PQ. ANTIMANO	NUCLEO ESCOLAR MARGINAL NRO 2 ESCUELA EL CARMEN	199	1	5	184	166	179	0	0	0	0	13	184
DTTO. CAPITAL	CE. BLVNO LIBERTADOR	PQ. ANTIMANO	UNIDAD EDUCATIVA INTEGRAL PADRE MANUEL MARIA DE AGUILAR	585	1	9	495	384	486	0	2	0	0	100	495
DTTO. CAPITAL	CE. BLVNO LIBERTADOR	PQ. ANTIMANO	CENTRO PROTECCIÓN INTEGRAL LAS CLAVELLINAS	459	1	12	415	325	403	0	0	1	0	77	415
DTTO. CAPITAL	CE. BLVNO LIBERTADOR	PQ. ANTIMANO	CASA  COMUNAL CALLE  EL PADRE	170	1	3	164	146	161	0	0	0	0	15	164
DTTO. CAPITAL	CE. BLVNO LIBERTADOR	PQ. ANTIMANO	ESCUELA MUNICIPAL TULA AMISTERASAROVE	1964	4	23	1638	1206	1615	0	7	1	1	400	1638
DTTO. CAPITAL	CE. BLVNO LIBERTADOR	PQ. ANTIMANO	ESCUELA BASICA BOLIVARIANA BARRIO SAN JOSE	634	2	20	572	479	552	1	0	0	1	71	572
DTTO. CAPITAL	CE. BLVNO LIBERTADOR	PQ. ANTIMANO	ESCUELA MUNICIPAL DOCTOR ELOY GONZÁLEZ	1774	3	35	1457	1186	1422	1	2	0	1	232	1457
DTTO. CAPITAL	CE. BLVNO LIBERTADOR	PQ. ANTIMANO	PRESCOLAR JUAN FELIX SÁNCHEZ	936	2	11	697	537	686	0	3	1	0	145	697
DTTO. CAPITAL	CE. BLVNO LIBERTADOR	PQ. ANTIMANO	UNIDAD EDUCATIVA COLEGIO NUESTRA SEÑORA DEL ROSARIO	1116	2	21	904	529	883	0	4	0	1	349	904
DTTO. CAPITAL	CE. BLVNO LIBERTADOR	PQ. ANTIMANO	UNIDAD EDUCATIVA NACIONAL COLEGIO SANTA RORAIMA	744	2	15	628	463	613	0	2	1	1	146	628
DTTO. CAPITAL	CE. BLVNO LIBERTADOR	PQ. ANTIMANO	IUTOMS  MARISCAL SUCRE	33	1	0	27	22	27	0	0	0	0	5	27
DTTO. CAPITAL	CE. BLVNO LIBERTADOR	PQ. ANTIMANO	ESCUELA BÁSICA BOLIVARIANA ANTIMANO II	1312	3	12	1037	743	1025	1	5	1	0	275	1037
DTTO. CAPITAL	CE. BLVNO LIBERTADOR	PQ. ANTIMANO	CENTRO DE DIAGNOSTICO INTEGRAL LOS KIRIKIRITOS MODULO FUNDACOMUN	1941	4	22	1402	909	1380	0	5	1	3	462	1402
DTTO. CAPITAL	CE. BLVNO LIBERTADOR	PQ. ANTIMANO	LICEO BOLIVARIANO NACIONAL CREACIÓN ANTIMANO I	636	2	14	533	392	519	0	2	0	0	125	533
DTTO. CAPITAL	CE. BLVNO LIBERTADOR	PQ. ANTIMANO	LICEO BOLIVARIANO CICLO BÁSICO FELIPE FERMÍN PAÚL	3015	6	35	2360	1559	2325	0	13	3	5	745	2360
DTTO. CAPITAL	CE. BLVNO LIBERTADOR	PQ. ANTIMANO	ESCUELA BÁSICA DISTRITAL CARLOTA DE NOGUERA	1594	3	42	1341	1031	1299	1	7	1	0	259	1341
DTTO. CAPITAL	CE. BLVNO LIBERTADOR	PQ. ANTIMANO	ESCUELA BÁSICA MIGUEL OTERO SILVA	5744	10	99	4610	3584	4511	1	27	1	1	897	4610
DTTO. CAPITAL	CE. BLVNO LIBERTADOR	PQ. ANTIMANO	ESCUELA EDUCATIVA DISTRITAL ANDRÉS BELLO	1710	3	18	1277	985	1259	1	4	0	0	269	1277
DTTO. CAPITAL	CE. BLVNO LIBERTADOR	PQ. LA VEGA	UNIDAD EDUCATIVA FE Y ALEGRIA ANDY APARICIO	4160	8	61	3550	2556	3489	2	25	1	7	898	3550
DTTO. CAPITAL	CE. BLVNO LIBERTADOR	PQ. LA VEGA	COLEGIO PARROQUIAL MONSEÑOR ARTURO CELESTINO ALVAREZ	1807	4	32	1392	815	1360	0	7	1	2	535	1392
DTTO. CAPITAL	CE. BLVNO LIBERTADOR	PQ. LA VEGA	ESCUELA BOLIVARIANA NACIONAL SIMÓN RODRIGUEZ	1098	2	24	995	641	971	0	6	0	2	322	995
DTTO. CAPITAL	CE. BLVNO LIBERTADOR	PQ. LA VEGA	ESCUELA BASICA NACIONAL AMANDA DE SCHNELL	6387	12	140	5152	3328	5012	0	19	5	3	1657	5152
DTTO. CAPITAL	CE. BLVNO LIBERTADOR	PQ. LA VEGA	CENTRO DE SERVICIO COMUNAL EL MILAGRO	375	1	9	276	190	267	0	3	0	1	73	276
DTTO. CAPITAL	CE. BLVNO LIBERTADOR	PQ. LA VEGA	JARDIN DE INFANCIA BOLIVARIANO LA VEGA	930	2	12	735	531	723	0	3	0	0	189	735
DTTO. CAPITAL	CE. BLVNO LIBERTADOR	PQ. LA VEGA	NUCLEO DE APOYO FAMILIAR Y PARTICIPACION COMUNITARIA LUIS EZPELOSIN	1576	3	37	1338	889	1301	0	4	1	3	404	1338
DTTO. CAPITAL	CE. BLVNO LIBERTADOR	PQ. LA VEGA	ESCUELA BASICA NACIONAL JOSE VINICIO ADAMES PIÑERO	4060	7	55	3379	2627	3324	2	19	4	2	670	3379
DTTO. CAPITAL	CE. BLVNO LIBERTADOR	PQ. LA VEGA	UNIDAD EDUCATIVA PRIVADA  ALMIRANTE LUIS BRION	493	1	4	431	326	427	2	2	1	0	96	431
DTTO. CAPITAL	CE. BLVNO LIBERTADOR	PQ. LA VEGA	PREESCOLAR CARRUSEL	2593	5	12	2330	450	2318	0	6	2	0	1860	2330
DTTO. CAPITAL	CE. BLVNO LIBERTADOR	PQ. LA VEGA	UNIDAD EDUCATIVA COLEGIO LA CONCEPCION	7802	14	40	6201	676	6161	2	13	1	3	5466	6201
DTTO. CAPITAL	CE. BLVNO LIBERTADOR	PQ. LA VEGA	UNIDAD EDUCATIVA NACIONAL APLICACIÓN	4863	9	43	4109	680	4066	0	9	0	5	3372	4109
DTTO. CAPITAL	CE. BLVNO LIBERTADOR	PQ. LA VEGA	ESCUELA BÁSICA NACIONAL LA VEGA	686	2	30	573	396	543	0	2	0	0	145	573
DTTO. CAPITAL	CE. BLVNO LIBERTADOR	PQ. LA VEGA	ESCUELA BASICA NACIONAL BOLIVARIANA MISIÓN BARRIO ADENTRO	458	1	14	408	348	394	0	0	0	1	45	408
DTTO. CAPITAL	CE. BLVNO LIBERTADOR	PQ. LA VEGA	ESCUELA BASICA NACIONAL BOLIVARIANA CECILIO ACOSTA	3155	6	37	2586	1955	2549	0	16	1	2	575	2586
DTTO. CAPITAL	CE. BLVNO LIBERTADOR	PQ. LA VEGA	SALA DE REHABILITACION INTEGRAL ALFREDO BORJES	1055	2	25	799	514	774	0	7	0	1	252	799
DTTO. CAPITAL	CE. BLVNO LIBERTADOR	PQ. LA VEGA	CENTRO DE EDUCACION INICIAL BOLIVARIANO ALEJANDRO FUENMAYOR	1455	3	28	1252	841	1224	0	4	2	2	375	1252
DTTO. CAPITAL	CE. BLVNO LIBERTADOR	PQ. LA VEGA	DESARROLLO URBANISTICO LA VEGA III	346	1	1	326	315	325	0	1	0	0	9	326
DTTO. CAPITAL	CE. BLVNO LIBERTADOR	PQ. LA VEGA	UNIDAD EDUCATIVA NACIONAL VICENTE EMILIO SOJO	5263	10	74	4222	3162	4148	0	21	1	4	960	4222
DTTO. CAPITAL	CE. BLVNO LIBERTADOR	PQ. LA VEGA	ESCUELA BASICA BOLIVARIANA LOS NARANJOS	5237	10	80	4298	3136	4218	2	25	2	7	1046	4298
DTTO. CAPITAL	CE. BLVNO LIBERTADOR	PQ. LA VEGA	MULTIHOGAR GRAN PODER DE DIOS	183	1	3	155	123	152	0	3	0	0	26	155
DTTO. CAPITAL	CE. BLVNO LIBERTADOR	PQ. LA VEGA	CENTRO DEL NIÑO Y LA FAMILIA LA VEGA (C.N.F)	658	2	8	513	376	505	0	2	0	0	127	513
DTTO. CAPITAL	CE. BLVNO LIBERTADOR	PQ. LA VEGA	UNIDAD EDUCATIVA DISTRITAL FRANCISCO JAVIER YANEZ	2259	4	35	1834	1219	1799	1	10	0	0	569	1834
DTTO. CAPITAL	CE. BLVNO LIBERTADOR	PQ. LA VEGA	JUNTA PARROQUIAL LA VEGA	972	2	17	717	443	700	0	2	2	0	253	717
DTTO. CAPITAL	CE. BLVNO LIBERTADOR	PQ. LA VEGA	CASA DE LOS NIÑOS EL ARAGUANEY	1271	3	45	1056	667	1011	2	4	1	0	337	1056
DTTO. CAPITAL	CE. BLVNO LIBERTADOR	PQ. LA VEGA	CENTRO DE EDUCACION INICIAL BOLIVARIANO AMANDA DE SCHNELL	1259	3	21	1038	670	1017	1	1	2	0	343	1038
DTTO. CAPITAL	CE. BLVNO LIBERTADOR	PQ. LA VEGA	CENTRO DE EDUCACION INICIAL NACIONAL AUGUSTO MALAVE VILLALBA	1648	3	25	1365	933	1340	3	4	2	0	398	1365
DTTO. CAPITAL	CE. BLVNO LIBERTADOR	PQ. LA VEGA	UNIDAD EDUCATIVA DISTRITAL BERMUDEZ	5043	9	110	3975	2767	3865	2	25	3	2	1066	3975
DTTO. CAPITAL	CE. BLVNO LIBERTADOR	PQ. LA VEGA	LICEO BOLIVARIANO ELBA HERNANDEZ DE YANEZ	4487	8	82	3594	2621	3512	1	21	4	2	863	3594
DTTO. CAPITAL	CE. BLVNO LIBERTADOR	PQ. LA VEGA	ESCUELA BASICA NACIONAL BOLIVARIANA JUAN ANTONIO MANDARINO	1090	2	15	864	398	849	0	6	0	0	445	864
DTTO. CAPITAL	CE. BLVNO LIBERTADOR	PQ. LA VEGA	UNIDAD EDUCATIVA MARIA ANTONIA BOLIVAR	2042	4	36	1620	1002	1584	1	8	1	3	569	1620
DTTO. CAPITAL	CE. BLVNO LIBERTADOR	PQ. LA VEGA	PADRE JUAN VIVES SURIA	407	1	13	392	344	379	1	0	0	0	34	392
DTTO. CAPITAL	CE. BLVNO LIBERTADOR	PQ. LA VEGA	CASA COMUNITARIA EL PETROLEO	386	1	6	361	320	355	0	6	0	0	29	361
DTTO. CAPITAL	CE. BLVNO LIBERTADOR	PQ. LA VEGA	UNIDAD EDUCATIVA DISTRITAL LOS AGUACATICOS	313	1	7	269	199	262	0	0	0	0	63	269
DTTO. CAPITAL	CE. BLVNO LIBERTADOR	PQ. LA VEGA	VELODROMO TEO CAPRILES SALON CHICO CARRASQUEL	1203	3	11	944	514	933	0	5	0	2	412	944
DTTO. CAPITAL	CE. BLVNO LIBERTADOR	PQ. LA VEGA	COLEGIO FUNDACION CARLOS DELFINO	3339	6	69	2790	1516	2721	1	13	1	2	1188	2790
DTTO. CAPITAL	CE. BLVNO LIBERTADOR	PQ. LA VEGA	UNIDAD EDUCATIVA BOLIVARIANA NIÑO SIMÓN	285	1	4	261	154	257	0	0	1	0	102	261
DTTO. CAPITAL	CE. BLVNO LIBERTADOR	PQ. LA VEGA	FUNDACION COMUNIDAD MADRE EMILIA	931	2	6	721	162	715	0	2	1	2	548	721
DTTO. CAPITAL	CE. BLVNO LIBERTADOR	PQ. LA VEGA	UNIDAD EDUCATIVA BOLIVARIANA PEDRO FONTES	5610	10	68	4342	2425	4274	1	18	2	5	1823	4342
DTTO. CAPITAL	CE. BLVNO LIBERTADOR	PQ. LA VEGA	UNIDAD EDUCATIVA INSTITUTO HUMANITAS	3394	6	17	2768	373	2751	0	2	0	2	2374	2768
DTTO. CAPITAL	CE. BLVNO LIBERTADOR	PQ. LA VEGA	ESCUELA BOLIVARIANA PARROQUIA LA VEGA	622	2	15	531	405	516	0	2	0	0	109	531
DTTO. CAPITAL	CE. BLVNO LIBERTADOR	PQ. LA VEGA	UNIDAD EDUCATIVA FE Y ALEGRIA LUIS MARIA OLASO	1414	3	33	1197	943	1164	1	4	0	0	216	1197
DTTO. CAPITAL	CE. BLVNO LIBERTADOR	PQ. LA VEGA	MULTIHOGAR VIRGEN DEL VALLE,ASOCIACION CIVIL CORAZON DE JESUS	644	2	9	511	383	502	0	2	0	0	117	511
DTTO. CAPITAL	CE. BLVNO LIBERTADOR	PQ. LA VEGA	UNIDAD EDUCATIVA COLEGIO JOSEFA GOMEZ DE DELFINO	2938	6	45	2290	1502	2245	0	10	2	4	727	2290
DTTO. CAPITAL	CE. BLVNO LIBERTADOR	PQ. LA VEGA	UNIDAD EDUCATIVA INSTITUTO DE MEJORAMIENTO FISICO Y INTELECTUAL DEL NIÑO	498	1	3	445	108	442	0	0	0	1	333	445
DTTO. CAPITAL	CE. BLVNO LIBERTADOR	PQ. MACARAO	CASA COMUNAL LOS MUJICAS	304	1	9	275	234	266	0	0	0	1	31	275
DTTO. CAPITAL	CE. BLVNO LIBERTADOR	PQ. MACARAO	CENTRO DE EDUCACIÓN INICIAL LOLA DE FUENMAYOR	750	2	12	648	460	636	1	3	1	0	171	648
DTTO. CAPITAL	CE. BLVNO LIBERTADOR	PQ. MACARAO	CENTRO COMUNITARIO LUISA CACERES DE ARISMENDI	404	1	2	346	292	344	0	0	0	1	51	346
DTTO. CAPITAL	CE. BLVNO LIBERTADOR	PQ. MACARAO	NÚCLEO ESCOLAR MARGINAL Nº2 BARRIO COPEY	715	2	23	592	468	569	0	1	0	2	98	592
DTTO. CAPITAL	CE. BLVNO LIBERTADOR	PQ. MACARAO	UNIDAD EDUCATIVA NACIONAL LUIS EDUARDO EGUI AROCHA	500	1	10	442	366	432	0	1	0	0	65	442
DTTO. CAPITAL	CE. BLVNO LIBERTADOR	PQ. MACARAO	AMBULATORIO RURAL LUZ Y VIDA	116	1	4	96	78	92	0	1	0	0	13	96
DTTO. CAPITAL	CE. BLVNO LIBERTADOR	PQ. MACARAO	SUB ESTACIÓN DE BOMBEROS CABO SEGUNDO FALLECIDO CABRERA MARTIN	2005	4	33	1745	1274	1712	0	7	0	4	427	1745
DTTO. CAPITAL	CE. BLVNO LIBERTADOR	PQ. MACARAO	UNIDAD DE PRODUCION SOCIAL LA VEGUITA	144	1	3	130	120	127	0	0	0	0	7	130
DTTO. CAPITAL	CE. BLVNO LIBERTADOR	PQ. MACARAO	DESARROLLO URBANISTICO MACARAO	323	1	7	313	298	306	0	0	0	0	8	313
DTTO. CAPITAL	CE. BLVNO LIBERTADOR	PQ. MACARAO	UNIDAD EDUCATIVA NACIONAL ISAURA CORREA	4938	9	97	4086	2851	3989	3	17	6	2	1110	4086
DTTO. CAPITAL	CE. BLVNO LIBERTADOR	PQ. MACARAO	ESCUELA BÁSICA NACIONAL EL CIPRES	1312	3	32	1082	764	1050	0	4	0	2	280	1082
DTTO. CAPITAL	CE. BLVNO LIBERTADOR	PQ. MACARAO	UNIDAD EDUCATIVA COLEGIO SANTA CRUZ	1497	3	32	1285	923	1253	0	6	1	1	322	1285
DTTO. CAPITAL	CE. BLVNO LIBERTADOR	PQ. MACARAO	AMBULATORIO INTEGRAL DOCTOR HUMBERTO FERNANDEZ MORAN CENTRO MOVIL	881	2	34	766	545	732	1	2	1	1	182	766
DTTO. CAPITAL	CE. BLVNO LIBERTADOR	PQ. MACARAO	UNIDAD EDUCATIVA NACIONAL PARROQUIA MACARAO	4261	8	83	3518	2410	3435	3	17	1	2	1002	3518
DTTO. CAPITAL	CE. BLVNO LIBERTADOR	PQ. MACARAO	EL PRINCIPIO DE LA SABIDURIA	2087	4	31	1603	1210	1572	1	5	0	0	356	1603
DTTO. CAPITAL	CE. BLVNO LIBERTADOR	PQ. MACARAO	UNIDAD EDUCATIVA BÁSICA ANDRÉS ELOY BLANCO	1862	4	49	1611	928	1562	0	7	2	1	624	1611
DTTO. CAPITAL	CE. BLVNO LIBERTADOR	PQ. MACARAO	FUNDACIÓN SIEMBRA DE VENEZUELA	2379	5	37	1950	1302	1913	0	8	1	3	599	1950
DTTO. CAPITAL	CE. BLVNO LIBERTADOR	PQ. MACARAO	UNIDAD EDUCATIVA NACIONAL BOLIVARIANO CLAUDIO FELICIANO	7439	14	102	6138	4245	6036	3	30	8	7	1743	6138
DTTO. CAPITAL	CE. BLVNO LIBERTADOR	PQ. MACARAO	CENTRO DE EDUCION INICIAL SIMONCITO CENAIM I	190	1	4	183	177	179	0	0	0	0	2	183
DTTO. CAPITAL	CE. BLVNO LIBERTADOR	PQ. MACARAO	UNIDAD EDUCATIVA NACIONAL CENTRO AMÉRICA	3638	7	68	3047	1985	2979	2	15	3	2	972	3047
DTTO. CAPITAL	CE. BLVNO LIBERTADOR	PQ. MACARAO	CEMAI. CASA DE LA JUVENTUD DE MACARAO	630	2	7	468	300	461	0	2	1	1	157	468
DTTO. CAPITAL	CE. BLVNO LIBERTADOR	PQ. MACARAO	LICEO BOLIVARIANO JUAN LOVERA	4491	8	110	3701	2654	3591	4	13	3	4	913	3701
DTTO. CAPITAL	CE. BLVNO LIBERTADOR	PQ. MACARAO	CENTRO COMUNITARIO DE ATENCION PREESCOLAR SANTA BERNARDITA SOUBIRONS CECAP	270	1	9	240	198	231	0	1	1	0	31	240
DTTO. CAPITAL	CE. BLVNO LIBERTADOR	PQ. MACARAO	CASA COMUNAL GUANABANO II	746	2	5	660	544	655	0	4	1	0	106	660
DTTO. CAPITAL	CE. BLVNO LIBERTADOR	PQ. MACARAO	SERVICIO DE ELABORACIONES FARMACEUTICAS SEFAR	3048	6	85	2556	1778	2471	2	5	2	2	682	2556
DTTO. CAPITAL	CE. BLVNO LIBERTADOR	PQ. MACARAO	UNIDAD EDUCATIVA JOSÉ GREGORIO HERNÁNDEZ	373	1	11	331	213	320	0	1	0	0	106	331
DTTO. CAPITAL	CE. BLVNO LIBERTADOR	PQ. MACARAO	PREESCOLAR ASISTENCIAL CARLOS JOSE AGUSTIN LEIGHTON  ATICOM	95	1	3	85	74	82	0	1	0	0	7	85
DTTO. CAPITAL	CE. BLVNO LIBERTADOR	PQ. MACARAO	CONSEJO COMUNAL TOROMAIMA HACIENDA LOS BAEZ	494	1	3	445	279	442	1	4	1	1	156	445
DTTO. CAPITAL	CE. BLVNO LIBERTADOR	PQ. SAN BERNARDINO	UNIDAD EDUCATIVA NACIONAL BOLIVARIANA AMELIA COCKING	158	1	1	131	63	130	0	1	0	0	66	131
DTTO. CAPITAL	CE. BLVNO LIBERTADOR	PQ. SAN BERNARDINO	CENTRO DE EDUCACION INICIAL SIMONCITO  MARGOT MEYERT RANGEL	378	1	6	322	250	316	0	1	0	1	64	322
DTTO. CAPITAL	CE. BLVNO LIBERTADOR	PQ. SAN BERNARDINO	CENTRO MUNICIPAL DE ATENCION INTEGRAL (CMAI)	410	1	3	367	271	364	0	1	0	1	91	367
DTTO. CAPITAL	CE. BLVNO LIBERTADOR	PQ. SAN BERNARDINO	COLEGIO VIRGEN DE COROMOTO	918	2	11	740	300	729	0	2	1	1	425	740
DTTO. CAPITAL	CE. BLVNO LIBERTADOR	PQ. SAN BERNARDINO	UNIDAD EDUCATIVA PRIVADA COLEGIO SANTA TERESA	2362	4	22	1707	322	1685	0	8	0	4	1351	1707
DTTO. CAPITAL	CE. BLVNO LIBERTADOR	PQ. SAN BERNARDINO	UNIDAD EDUCATIVA COLEGIO ARAUCA	848	2	6	574	122	568	0	0	1	2	443	574
DTTO. CAPITAL	CE. BLVNO LIBERTADOR	PQ. SAN BERNARDINO	UNIVERSIDAD NACIONAL ABIERTA U.N.A.	5732	10	60	4253	1531	4193	1	11	1	2	2647	4253
DTTO. CAPITAL	CE. BLVNO LIBERTADOR	PQ. SAN BERNARDINO	CENTRO DE EDUCACION INTEGRAL AUTONOMO SIMONCITO ARGELIA LAYA	691	2	7	493	191	486	0	4	0	1	290	493
DTTO. CAPITAL	CE. BLVNO LIBERTADOR	PQ. SAN BERNARDINO	COLEGIO PARROQUIAL SAN BERNARDINO	235	1	3	207	68	204	0	0	0	0	136	207
DTTO. CAPITAL	CE. BLVNO LIBERTADOR	PQ. SAN BERNARDINO	UNIDAD EDUCATIVA PRIVADA COLEGIO CHURUN MERU	308	1	4	270	98	266	0	0	1	0	167	270
DTTO. CAPITAL	CE. BLVNO LIBERTADOR	PQ. SAN BERNARDINO	UNIDAD EDUCATIVA COLEGIO NAZARET	456	1	6	415	179	409	0	1	0	0	229	415
DTTO. CAPITAL	CE. BLVNO LIBERTADOR	PQ. SAN BERNARDINO	YMCA ASOCIACION CRISTIANA DE JOVENES	2381	5	33	1740	745	1707	1	13	1	1	946	1740
DTTO. CAPITAL	CE. BLVNO LIBERTADOR	PQ. SAN BERNARDINO	UNIDAD EDUCATIVA COLEGIO TIRSO DE MOLINA	4078	7	22	2981	592	2959	0	5	0	1	2361	2981
DTTO. CAPITAL	CE. BLVNO LIBERTADOR	PQ. SAN BERNARDINO	UNIDAD EDUCATIVA LICEO BOLIVARIANO CARLOS SOUBLETTE	5297	10	63	3754	1081	3691	1	15	0	1	2593	3754
DTTO. CAPITAL	CE. BLVNO LIBERTADOR	PQ. SAN BERNARDINO	UNIDAD EDUCATIVA NACIONAL VICENTE LANDAETA	2249	4	8	1678	460	1670	2	4	0	1	1203	1678
DTTO. CAPITAL	CE. BLVNO LIBERTADOR	PQ. 23 DE ENERO	ESCUELA TÉCNICA COMERCIAL ROBINSONIANA MANUEL PALACIOS FAJARDO	3391	6	48	2578	1628	2530	0	5	2	0	895	2578
DTTO. CAPITAL	CE. BLVNO LIBERTADOR	PQ. 23 DE ENERO	ESCUELA BÁSICA INSTITUTO TÉCNICO JESÚS OBRERO	2442	5	42	2007	1114	1965	0	7	3	1	840	2007
DTTO. CAPITAL	CE. BLVNO LIBERTADOR	PQ. 23 DE ENERO	ESCUELA BÁSICA NACIONAL GRADUADA Nº 70	1250	3	19	979	729	960	1	0	1	0	229	979
DTTO. CAPITAL	CE. BLVNO LIBERTADOR	PQ. 23 DE ENERO	UNIDAD EDUCATIVA BOLÍVARIANA LUZ MARÍA TOSTA	2240	4	36	1846	1346	1810	1	8	2	1	452	1846
DTTO. CAPITAL	CE. BLVNO LIBERTADOR	PQ. 23 DE ENERO	BIBLIOTECA PÚBLICA LA CAÑADA	1902	4	43	1592	987	1549	1	7	0	4	550	1592
DTTO. CAPITAL	CE. BLVNO LIBERTADOR	PQ. 23 DE ENERO	CENTRO DE EDUCACIÓN INICIAL NACIONAL BOLÍVAR Y TOVAR	862	2	17	703	395	686	0	3	5	0	283	703
DTTO. CAPITAL	CE. BLVNO LIBERTADOR	PQ. 23 DE ENERO	ESCUELA BÁSICA NACIONAL BOLIVARIANA DEPARTAMENTO VARGAS	573	1	9	518	347	509	0	6	0	2	154	518
DTTO. CAPITAL	CE. BLVNO LIBERTADOR	PQ. 23 DE ENERO	CASA COMUNITARIA KLEBER RAMIREZ	181	1	1	152	122	151	0	0	0	0	29	152
DTTO. CAPITAL	CE. BLVNO LIBERTADOR	PQ. 23 DE ENERO	UNIDAD EDUCATIVA BOLIVARIANA GABRIELA MISTRAL	2963	6	51	2420	1454	2369	2	11	2	3	897	2420
DTTO. CAPITAL	CE. BLVNO LIBERTADOR	PQ. 23 DE ENERO	CONSEJO COMUNAL LOS HORNOS	180	1	3	166	131	163	0	1	0	0	31	166
DTTO. CAPITAL	CE. BLVNO LIBERTADOR	PQ. 23 DE ENERO	ESCUELA BÁSICA NACIONAL CONCENTRADA Nº  71	1447	3	33	1191	797	1158	2	8	1	1	349	1191
DTTO. CAPITAL	CE. BLVNO LIBERTADOR	PQ. 23 DE ENERO	CENTRO MOVIL ESPACIO DE ENCUENTRO CONSEJO COMUNAL SANTA ROSA	257	1	3	226	202	223	0	0	0	0	21	226
DTTO. CAPITAL	CE. BLVNO LIBERTADOR	PQ. 23 DE ENERO	UNIDAD EDUCATIVA NACIONAL FRANCISCO GONZALEZ GUINAN	1518	3	24	1220	697	1196	1	6	0	2	490	1220
DTTO. CAPITAL	CE. BLVNO LIBERTADOR	PQ. 23 DE ENERO	UNIDAD EDUCATIVA COLEGIO FE Y ALEGRIA ABRAHAN REYES	335	1	6	293	155	287	0	1	0	0	131	293
DTTO. CAPITAL	CE. BLVNO LIBERTADOR	PQ. 23 DE ENERO	CEIN ARTURO MICHELENA	83	1	2	71	42	69	0	0	0	0	27	71
DTTO. CAPITAL	CE. BLVNO LIBERTADOR	PQ. 23 DE ENERO	UNIDAD EDUCATIVA NACIONAL 23 DE ENERO	6954	13	114	5650	3623	5536	2	30	9	9	1863	5650
DTTO. CAPITAL	CE. BLVNO LIBERTADOR	PQ. 23 DE ENERO	CENTRO PREESCOLAR DE ORGANIZACIÓN, EDUCACIÓN Y PARTICIPACIÓN COMUNITARIA (CEPREPAR)	375	1	7	313	194	306	0	2	0	0	110	313
DTTO. CAPITAL	CE. BLVNO LIBERTADOR	PQ. 23 DE ENERO	ESCUELA BÁSICA BOLÍVARIANA JOSÉ ENRIQUE RODO	2852	5	33	2314	1306	2281	0	9	2	7	957	2314
DTTO. CAPITAL	CE. BLVNO LIBERTADOR	PQ. 23 DE ENERO	PREESCOLAR ASISTENCIAL ANDRES ELOY BLANCO	292	1	3	243	197	240	0	2	1	0	40	243
DTTO. CAPITAL	CE. BLVNO LIBERTADOR	PQ. 23 DE ENERO	CENTRO MOVIL CONSEJO COMUNAL JUAN MANUEL CAJIGAL	140	1	1	134	101	133	0	0	0	0	32	134
DTTO. CAPITAL	CE. BLVNO LIBERTADOR	PQ. 23 DE ENERO	CENTRO DE EDUCACIÓN INICIAL NACIONAL BOLIVARIANO MARIO BRICEÑO IRAGORRY	332	1	13	301	224	288	0	0	0	1	63	301
DTTO. CAPITAL	CE. BLVNO LIBERTADOR	PQ. 23 DE ENERO	CENTRO MUNICIPAL DE ATENCION INTEGRAL CMAI	763	2	6	658	526	652	0	4	1	2	119	658
DTTO. CAPITAL	CE. BLVNO LIBERTADOR	PQ. 23 DE ENERO	PREESCOLAR SAN JOSE DE CALAZANS FE Y ALEGRIA	281	1	3	246	195	243	0	0	0	0	48	246
DTTO. CAPITAL	CE. BLVNO LIBERTADOR	PQ. 23 DE ENERO	UNIDAD EDUCATIVA DIEGO DE LOZADA	1918	4	48	1623	1061	1575	0	9	1	0	504	1623
DTTO. CAPITAL	CE. BLVNO LIBERTADOR	PQ. 23 DE ENERO	ESCUELA INTEGRAL BOLIVARIANA BLANCA PENSO DE REINA	316	1	7	272	215	265	0	1	0	0	49	272
DTTO. CAPITAL	CE. BLVNO LIBERTADOR	PQ. 23 DE ENERO	ESCUELA BÁSICA SANTIAGO KEY AYALA	1634	3	15	1415	1034	1400	2	6	0	1	357	1415
DTTO. CAPITAL	CE. BLVNO LIBERTADOR	PQ. 23 DE ENERO	UNIDAD EDUCATIVA DISTRITAL PREESCOLAR LA LIBERTAD	1812	4	42	1564	1008	1522	0	7	2	1	504	1564
DTTO. CAPITAL	CE. BLVNO LIBERTADOR	PQ. 23 DE ENERO	PREESCOLAR JOSE JOAQUIN VEROES	256	1	11	229	137	218	0	0	1	0	80	229
DTTO. CAPITAL	CE. BLVNO LIBERTADOR	PQ. 23 DE ENERO	UNIDAD EDUCATIVA DISTRITAL JOSÉ GREGORIO HERNÁNDEZ	2352	5	38	1897	1242	1859	1	11	3	3	599	1897
DTTO. CAPITAL	CE. BLVNO LIBERTADOR	PQ. 23 DE ENERO	CENTRO DE FORMACION SOCIALISTA METAL MINERO (INCES)	240	1	4	209	154	205	0	0	0	2	49	209
DTTO. CAPITAL	CE. BLVNO LIBERTADOR	PQ. 23 DE ENERO	CENTRO DE FORMACIÓN SOCIALISTA SIMÓN RODRÍGUEZ	545	1	11	454	268	443	0	2	1	3	169	454
DTTO. CAPITAL	CE. BLVNO LIBERTADOR	PQ. 23 DE ENERO	CONSEJO COMUNAL LA LADERA II	172	1	3	161	134	158	1	0	0	1	22	161
DTTO. CAPITAL	CE. BLVNO LIBERTADOR	PQ. 23 DE ENERO	ESCUELA BÁSICA NACIONAL DOCTOR ANDRÉS ELOY BLANCO	2341	4	72	1893	1417	1821	2	7	1	0	394	1893
DTTO. CAPITAL	CE. BLVNO LIBERTADOR	PQ. 23 DE ENERO	CONSEJO COMUNAL BARRIO SUCRE PARTE ALTA	107	1	1	100	83	99	0	1	0	0	15	100
DTTO. CAPITAL	CE. BLVNO LIBERTADOR	PQ. 23 DE ENERO	REGISTRO SUBALTERNO 23 DE ENERO	504	1	4	451	317	447	0	1	0	0	129	451
DTTO. CAPITAL	CE. BLVNO LIBERTADOR	PQ. 23 DE ENERO	ESCUELA BASICA NACIONAL NUCLEO ESCOLAR MARGINAL NUMERO 4	270	1	3	236	198	233	0	4	0	0	31	236
DTTO. CAPITAL	CE. BLVNO LIBERTADOR	PQ. 23 DE ENERO	CENTRO FAMILIAR DEPORTIVO Y CULTURAL LA CA#ADA	185	1	5	166	106	161	0	1	0	0	54	166
DTTO. CAPITAL	CE. BLVNO LIBERTADOR	PQ. 23 DE ENERO	UNIDAD EDUCATIVA NACIONAL LUIS RAFAEL PIMENTEL	3369	6	59	2602	1940	2543	1	16	3	2	581	2602
DTTO. CAPITAL	CE. BLVNO LIBERTADOR	PQ. 23 DE ENERO	UNIDAD EDUCATIVA NACIONAL BOLIVARIANA VIRGINIA MARTINEZ	1223	3	18	995	600	977	0	4	0	0	373	995
DTTO. CAPITAL	CE. BLVNO LIBERTADOR	PQ. 23 DE ENERO	PREESCOLAR NUEVO AMANECER	378	1	8	332	230	324	0	1	0	1	92	332
DTTO. CAPITAL	CE. BLVNO LIBERTADOR	PQ. 23 DE ENERO	CONSEJO COMUNAL BARRIO SUCRE PARTE BAJA	175	1	5	161	133	156	0	0	0	0	23	161
DTTO. CAPITAL	CE. BLVNO LIBERTADOR	PQ. 23 DE ENERO	UNIDAD EDUCATIVA COLEGIO SAN FRANCISCO SOLANO	2016	4	29	1726	1174	1697	0	1	2	4	516	1726
DTTO. CAPITAL	CE. BLVNO LIBERTADOR	PQ. 23 DE ENERO	CONSEJO COMUNAL SIERRA MAESTRA	297	1	7	281	238	274	0	0	0	0	36	281
DTTO. CAPITAL	CE. BLVNO LIBERTADOR	PQ. 23 DE ENERO	ASOCIACIÓN CIVIL UNIÓN OBSERVATORIO	328	1	7	264	202	257	1	0	0	0	54	264
DTTO. CAPITAL	CE. BLVNO LIBERTADOR	PQ. 23 DE ENERO	JARDÍN DE INFANCIA LEONCIO MARTÍNEZ	1061	2	18	838	505	820	0	5	0	3	307	838
DTTO. CAPITAL	CE. BLVNO LIBERTADOR	PQ. 23 DE ENERO	ESCUELA BÁSICA NACIONAL LUIS ENRIQUE MARMOL	3097	6	61	2553	1569	2492	0	8	1	3	911	2553
DTTO. CAPITAL	CE. BLVNO LIBERTADOR	PQ. 23 DE ENERO	UNIDAD EDUCATIVA DISTRITAL ARTESANAL JOSÉ GREGORIO HERNÁNDEZ	1684	3	17	1373	841	1356	1	4	0	0	510	1373
DTTO. CAPITAL	CE. BLVNO LIBERTADOR	PQ. 23 DE ENERO	PREESCOLAR BOLIVARIANO OLY CLEMENTE	1713	3	37	1401	890	1364	0	10	2	0	462	1401
DTTO. CAPITAL	CE. BLVNO LIBERTADOR	PQ. 23 DE ENERO	CENTRO EDUCACION INICIAL NACIONAL BOLIVARIANO SANTIAGO KEY AYALA	256	1	3	246	173	243	0	1	0	0	69	246
DTTO. CAPITAL	CE. BLVNO LIBERTADOR	PQ. 23 DE ENERO	UNIDAD EDUCATIVA NACIONAL FELIPE TEJERA	3077	6	67	2504	1391	2437	0	8	1	3	1034	2504
DTTO. CAPITAL	CE. BLVNO LIBERTADOR	PQ. 23 DE ENERO	FE Y ALEGRÍA ESCUELA BÁSICA LUIS CAÑIZALES VERDE	1632	3	40	1361	840	1321	0	5	0	0	476	1361
DTTO. CAPITAL	CE. BLVNO LIBERTADOR	PQ. 23 DE ENERO	MÓDULO DE SERVICIOS FUNDACOMÚN 23 DE ENERO	334	1	3	284	224	281	0	2	0	0	55	284
DTTO. CAPITAL	CE. BLVNO LIBERTADOR	PQ. 23 DE ENERO	PREESCOLAR SAMAN DE GUERE	156	1	2	129	99	127	0	0	0	0	28	129
DTTO. CAPITAL	CE. BLVNO LIBERTADOR	PQ. 23 DE ENERO	UNIDAD EDUCATIVA BOLIVARIANA NACIONAL LUIS TROCONIS GUERRERO	501	1	3	411	287	408	1	2	0	0	118	411
DTTO. CAPITAL	CE. BLVNO LIBERTADOR	PQ. 23 DE ENERO	CONSEJO COMUNAL PUERTA GRANDE	163	1	8	144	106	136	0	1	0	0	29	144
DTTO. CAPITAL	CE. BLVNO LIBERTADOR	PQ. 23 DE ENERO	UNIDAD EDUCATIVA BOLIVARIANA AMALIA PELLÍN	3131	6	55	2635	1757	2580	3	6	2	7	805	2635
DTTO. CAPITAL	CE. BLVNO LIBERTADOR	PQ. 23 DE ENERO	UNIDAD EDUCATIVA INTEGRAL NACIONAL BOLIVARIANA MARTÍN JOSÉ SANABRIA	3468	6	43	2808	1578	2765	0	7	2	3	1175	2808
DTTO. CAPITAL	CE. BLVNO LIBERTADOR	PQ. COCHE	EL ESTANQUE HIDROCAPITAL	324	1	3	271	229	268	0	0	0	0	39	271
DTTO. CAPITAL	CE. BLVNO LIBERTADOR	PQ. COCHE	NÚCLEO DE APOYO FAMILIAR Y PARTICIPACIÓN CIUDADANA DOCTORA  LYA IMBER DE CORONIL	823	2	6	665	336	659	0	3	0	0	320	665
DTTO. CAPITAL	CE. BLVNO LIBERTADOR	PQ. COCHE	UNIDAD EDUCATIVA BOLIVARIANA NACIONAL GLADYS VANEGAS	3155	6	28	2525	1654	2497	1	15	2	1	824	2525
DTTO. CAPITAL	CE. BLVNO LIBERTADOR	PQ. COCHE	ESCUELA BÁSICA LAS MAYAS FE Y ALEGRÍA	3805	7	69	3134	2443	3065	1	12	1	3	605	3134
DTTO. CAPITAL	CE. BLVNO LIBERTADOR	PQ. COCHE	ESCUELA TÉCNICA ROBINSONIANA GREGORIO MAC GREGOR	2085	4	47	1798	760	1751	0	6	3	2	980	1798
DTTO. CAPITAL	CE. BLVNO LIBERTADOR	PQ. COCHE	CONSEJO COMUNAL TURMERITO URBANISMO PROYECTO BARRIO NUEVO TRICOLOR	307	1	4	280	269	276	0	0	0	0	7	280
DTTO. CAPITAL	CE. BLVNO LIBERTADOR	PQ. COCHE	CENTRO ESCOLAR INTEGRAL NACIONAL JOSÉ ANTONIO CALCAÑO	1027	2	10	807	381	797	0	3	0	1	412	807
DTTO. CAPITAL	CE. BLVNO LIBERTADOR	PQ. COCHE	DESARROLLO URBANISTICO CIUDAD TIUNA	114	1	3	109	106	106	0	0	0	0	0	109
DTTO. CAPITAL	CE. BLVNO LIBERTADOR	PQ. COCHE	COMITE DE VIVIENDA ERNESTO CHE GUEVARA Y PEDRO EMILIO COLL	42	1	2	27	19	25	0	0	0	1	5	27
DTTO. CAPITAL	CE. BLVNO LIBERTADOR	PQ. COCHE	UNIDAD EDUCATIVA INSTITUTO RAFAEL RANGEL	1905	4	19	1573	628	1554	0	4	1	2	919	1573
DTTO. CAPITAL	CE. BLVNO LIBERTADOR	PQ. COCHE	JARDÍN DE INFANCIA LA RINCONADA	667	2	8	492	365	484	0	2	1	0	116	492
DTTO. CAPITAL	CE. BLVNO LIBERTADOR	PQ. COCHE	TRIBUNA C INSTITUTO NACIONAL DE HIPODROMO	352	1	6	325	311	319	0	0	0	0	8	325
DTTO. CAPITAL	CE. BLVNO LIBERTADOR	PQ. COCHE	ESCUELA BÁSICA NACIONAL REPUBLICA DE VENEZUELA	3633	7	30	2910	1174	2880	2	15	2	1	1686	2910
DTTO. CAPITAL	CE. BLVNO LIBERTADOR	PQ. COCHE	TURMERITO	26	1	1	22	21	21	0	0	0	0	0	22
DTTO. CAPITAL	CE. BLVNO LIBERTADOR	PQ. COCHE	ESCUELA BÁSICA BOLIVARIANA MADRE MARIA	3469	6	67	2699	1770	2632	2	11	2	5	842	2699
DTTO. CAPITAL	CE. BLVNO LIBERTADOR	PQ. COCHE	LICEO BOLIVARIANO PEDRO EMILIO COLL	7515	14	117	5678	2784	5561	1	20	2	7	2747	5678
DTTO. CAPITAL	CE. BLVNO LIBERTADOR	PQ. COCHE	CONSEJO COMUNAL LA ENSENADA	67	1	1	58	48	57	0	0	0	0	9	58
DTTO. CAPITAL	CE. BLVNO LIBERTADOR	PQ. COCHE	ESCUELA BASICA BOLIVARIANA CACIQUE TIUNA	1789	4	27	1646	1522	1619	0	8	0	2	87	1646
DTTO. CAPITAL	CE. BLVNO LIBERTADOR	PQ. COCHE	UNIDAD EDUCATIVA COLEGIO LUISA CÁCERES DE ARISMENDI	948	2	10	841	472	831	0	2	0	0	357	841
DTTO. CAPITAL	CE. BLVNO LIBERTADOR	PQ. COCHE	CONSEJO COMUNAL ESEQUIEL ZAMORA URBANIZACION FELIPE ANTONIO ACOSTA	616	2	8	581	562	573	0	0	0	0	11	581
DTTO. CAPITAL	CE. BLVNO LIBERTADOR	PQ. COCHE	CASA COMUNAL EL PROGRESO LA LAGUNA	182	1	8	163	138	155	0	0	0	0	17	163
DTTO. CAPITAL	CE. BLVNO LIBERTADOR	PQ. COCHE	PREESCOLAR BOLIVARIANO DOCTOR GUSTAVO H MACHADO	1007	2	22	763	582	741	0	1	1	1	156	763
DTTO. CAPITAL	CE. BLVNO LIBERTADOR	PQ. COCHE	CONSEJO COMUNAL METROPOLITANO I	130	1	4	107	84	103	0	0	1	0	18	107
DTTO. CAPITAL	CE. BLVNO LIBERTADOR	PQ. COCHE	CENTRO MOVIL PARCELA 52	294	1	5	236	188	231	0	1	1	0	41	236
DTTO. CAPITAL	CE. BLVNO LIBERTADOR	PQ. COCHE	FUNDACIÓN POLIEDRO DE CARACAS	561	1	7	432	297	425	0	3	0	0	125	432
DTTO. CAPITAL	CE. BLVNO LIBERTADOR	PQ. COCHE	CONSEJO COMUNAL EL BOSQUE I II III IV V	250	1	4	231	223	227	1	0	0	0	3	231
DTTO. CAPITAL	CE. BLVNO LIBERTADOR	PQ. COCHE	UNIDAD EDUCATIVA FE Y ALEGRÍA LA RINCONADA	3824	7	51	3182	1476	3131	1	5	3	3	1643	3182
DTTO. CAPITAL	CE. BLVNO LIBERTADOR	PQ. COCHE	UNIDAD EDUCATIVA BOLIVARIANA CORONEL CARLOS DELGADO CHALBAUD	4145	8	60	3391	1557	3331	1	9	1	2	1761	3391
DTTO. CAPITAL	CE. BLVNO LIBERTADOR	PQ. COCHE	REGISTRO CIVIL PARROQUIAL DE COCHE	436	1	5	347	194	342	0	0	1	0	147	347
DTTO. CAPITAL	CE. BLVNO LIBERTADOR	PQ. COCHE	CENTRO DE EDUCACIÓN INICIAL TOMAS DE JESÚS QUINTERO	469	1	4	422	211	418	0	3	0	0	204	422
DTTO. CAPITAL	CE. BLVNO LIBERTADOR	PQ. COCHE	UNIDAD NACIONAL EDUCATIVA BOLIVARIANA DOCTOR JESÚS MUÑOZ TEBAR	2998	6	32	2384	858	2352	1	6	0	5	1482	2384
DTTO. CAPITAL	CE. BLVNO LIBERTADOR	PQ. COCHE	CENTRO COMUNAL BOSQUE VALLE	409	1	10	379	251	369	1	4	0	1	112	379
DTTO. CAPITAL	CE. BLVNO LIBERTADOR	PQ. COCHE	UNIDAD EDUCATIVA BOLIVARIANA MARI ISABEL MARQUEZ	2445	5	46	1856	1308	1810	1	12	1	1	487	1856
DTTO. CAPITAL	CE. BLVNO LIBERTADOR	PQ. COCHE	CASA COMUNAL DE LAS CASITAS   PROYECTO ENDOGENO	614	2	3	537	516	534	0	2	0	0	16	537
DTTO. CAPITAL	CE. BLVNO LIBERTADOR	PQ. COCHE	UNIDAD EDUCATIVA DISTRITAL TERESA PAGES	2457	5	34	1966	1525	1932	3	15	2	1	386	1966
DTTO. CAPITAL	CE. BLVNO LIBERTADOR	PQ. EL RECREO	UNIDAD EDUCATIVA PRIVADA SAN MARTIN DE PORRES	1662	3	15	1318	585	1303	2	7	0	3	706	1318
DTTO. CAPITAL	CE. BLVNO LIBERTADOR	PQ. EL RECREO	UNIDAD EDUCATIVA PRIVADA COLEGIO NUESTRA SEÑORA DE LA CONSOLACION	6966	13	77	5246	1056	5169	1	12	0	2	4098	5246
DTTO. CAPITAL	CE. BLVNO LIBERTADOR	PQ. EL RECREO	UNIDAD EDUCATIVA COLEGIO NUESTRA SE ORA DE POMPEI	2396	5	30	1857	371	1827	0	5	0	1	1450	1857
DTTO. CAPITAL	CE. BLVNO LIBERTADOR	PQ. EL RECREO	UNIDAD EDUCATIVA PRIVADA NUESTRA SEÑORA DE LAS MERCEDES	1433	3	12	1135	329	1123	0	1	0	0	793	1135
DTTO. CAPITAL	CE. BLVNO LIBERTADOR	PQ. EL RECREO	CENTRO DE ECUCACIÓN INICIAL PREESCOLAR ASISTENCIAL MI RECREO	388	1	3	322	185	319	0	1	0	0	133	322
DTTO. CAPITAL	CE. BLVNO LIBERTADOR	PQ. EL RECREO	DESARROLLO URBANISTICO EL RECREO II	262	1	6	234	218	228	0	2	1	0	7	234
DTTO. CAPITAL	CE. BLVNO LIBERTADOR	PQ. EL RECREO	UNIDAD EDUCATIVA NACIONAL BOLIVARIANA DOMINGO FAUSTINO SARMIENTO	3572	7	36	2594	1135	2558	0	12	1	1	1409	2594
DTTO. CAPITAL	CE. BLVNO LIBERTADOR	PQ. EL RECREO	CENTRO MUNICIPAL DE ATENCION INTEGRAL (CEMAI) EL RECREO	1223	3	22	885	459	863	1	4	1	3	395	885
DTTO. CAPITAL	CE. BLVNO LIBERTADOR	PQ. EL RECREO	DESARROLLO URBANISTICO CHACAITO	137	1	1	129	124	128	0	0	0	0	4	129
DTTO. CAPITAL	CE. BLVNO LIBERTADOR	PQ. EL RECREO	UNIDAD EDUCATIVA COLEGIO CASTELAO	1624	3	17	1300	408	1283	0	6	0	0	869	1300
DTTO. CAPITAL	CE. BLVNO LIBERTADOR	PQ. EL RECREO	UNIDAD EDUCATIVA PRESCOLAR ASISTENCIAL VICENTE SALIAS	712	2	23	597	440	574	0	3	0	1	130	597
DTTO. CAPITAL	CE. BLVNO LIBERTADOR	PQ. EL RECREO	UNIDAD EDUCATIVA COLEGIO MARISCAL SUCRE	2957	5	45	2213	756	2168	1	2	2	2	1405	2213
DTTO. CAPITAL	CE. BLVNO LIBERTADOR	PQ. EL RECREO	UNIDAD EDUCATIVA INICIAL MI DULCE REFUGIO	1512	3	22	1232	810	1210	0	1	0	1	398	1232
DTTO. CAPITAL	CE. BLVNO LIBERTADOR	PQ. EL RECREO	UNIDAD EDUCATIVA COLEGIO HUMBOLDT	1023	2	7	746	71	739	0	3	0	0	665	746
DTTO. CAPITAL	CE. BLVNO LIBERTADOR	PQ. EL RECREO	UNIDAD EDUCATIVA NACIONAL PADRE SOJO	1570	3	18	1203	430	1185	0	2	0	0	753	1203
DTTO. CAPITAL	CE. BLVNO LIBERTADOR	PQ. EL RECREO	CENTRO DE EDUCACION INICIAL SIMONCITO DOCTOR FRANCISCO TORREALBA	422	1	13	372	204	359	0	3	0	0	152	372
DTTO. CAPITAL	CE. BLVNO LIBERTADOR	PQ. EL RECREO	INSTITUTO NACIONAL DE SERVICIOS SOCIALES INAGER	2889	5	14	1960	672	1946	0	5	1	1	1267	1960
DTTO. CAPITAL	CE. BLVNO LIBERTADOR	PQ. EL RECREO	DESARROLLO URBANISTICO ANDRES BELLO	167	1	2	161	156	159	0	0	0	0	3	161
DTTO. CAPITAL	CE. BLVNO LIBERTADOR	PQ. EL RECREO	UNIDAD EDUCATIVA COLEGIO RAMOS	1405	3	8	933	160	925	0	4	0	2	759	933
DTTO. CAPITAL	CE. BLVNO LIBERTADOR	PQ. EL RECREO	CENTRO EDUCATIVO INTEGARL BOLIVARIANO SANTIAGO MACHADO	1128	2	14	770	270	756	1	2	0	0	483	770
DTTO. CAPITAL	CE. BLVNO LIBERTADOR	PQ. EL RECREO	UNIDAD EDUCATIVA NACIONAL BOLIVARIANA JESUS ENRIQUE LOSSADA	2570	5	58	2023	1013	1965	2	14	1	4	931	2023
DTTO. CAPITAL	CE. BLVNO LIBERTADOR	PQ. EL RECREO	DESARROLLO URBANISTICO LOS JABILLOS II	134	1	5	130	123	125	1	0	0	0	1	130
DTTO. CAPITAL	CE. BLVNO LIBERTADOR	PQ. EL RECREO	UNIDAD EDUCATIVA COLEGIO LA INMACULADA CONCEPCION	1467	3	4	923	116	919	0	1	1	0	801	923
DTTO. CAPITAL	CE. BLVNO LIBERTADOR	PQ. EL RECREO	LICEO BOLIVARIANO JOSE MANUEL NUÑEZ PONTE	2871	5	29	2410	1233	2381	1	5	1	4	1137	2410
DTTO. CAPITAL	CE. BLVNO LIBERTADOR	PQ. EL RECREO	DESARROLLO URBANISTICO LIBERTADOR I	220	1	4	208	202	204	0	0	0	0	2	208
DTTO. CAPITAL	CE. BLVNO LIBERTADOR	PQ. EL RECREO	UNIDAD EDUCATIVA COLEGIO LA SALLE LA COLINA	2425	5	11	1724	234	1713	0	6	0	1	1472	1724
DTTO. CAPITAL	CE. BLVNO LIBERTADOR	PQ. EL RECREO	UNIDAD EDUCATIVA DISTRITAL SIMON RODRIGUEZ	3503	6	47	2822	1531	2775	1	11	1	7	1224	2822
DTTO. CAPITAL	CE. BLVNO LIBERTADOR	PQ. EL RECREO	UNIDAD EDUCACIONAL COLEGIO JARDIN FRANCISCANO	536	1	5	457	244	452	0	0	0	0	208	457
DTTO. CAPITAL	CE. BLVNO LIBERTADOR	PQ. EL RECREO	UNIDAD EDUCATIVA AGUSTIN CODAZZI	2647	5	13	1637	243	1624	0	3	1	1	1376	1637
DTTO. CAPITAL	CE. BLVNO LIBERTADOR	PQ. EL RECREO	AMBULATORIO DOCTOR PASTOR OROPEZA	1288	3	5	1013	415	1008	0	6	0	2	585	1013
DTTO. CAPITAL	CE. BLVNO LIBERTADOR	PQ. EL RECREO	UNIDAD EDUCATIVA STELLA MATUTINA	1430	3	8	959	138	951	0	0	0	0	813	959
DTTO. CAPITAL	CE. BLVNO LIBERTADOR	PQ. EL RECREO	JARDIN DE INFANCIA MORALUZ	1735	3	16	1459	570	1443	1	4	1	2	865	1459
DTTO. CAPITAL	CE. BLVNO LIBERTADOR	PQ. EL RECREO	COLEGIO UNIVERSITARIO DE CARACAS	453	1	12	405	173	393	0	0	1	0	219	405
DTTO. CAPITAL	CE. BLVNO LIBERTADOR	PQ. EL RECREO	UNIDAD EDUCATIVA COLEGIO SAN ANTONIO DE LA FLORIDA	6777	13	57	4975	948	4918	2	10	1	6	3951	4975
DTTO. CAPITAL	CE. BLVNO LIBERTADOR	PQ. EL RECREO	UNIDAD EDUCATIVA INTEGRAL BOLIVARIANA ANA EMILIA DELON	1592	3	17	1208	909	1191	0	2	0	1	279	1208
DTTO. CAPITAL	CE. BLVNO LIBERTADOR	PQ. EL RECREO	ESCUELA BASICA SIMON RODRIGUEZ	1331	3	29	1082	517	1053	0	3	1	0	532	1082
DTTO. CAPITAL	CE. BLVNO LIBERTADOR	PQ. EL RECREO	UNIDAD EDUCATIVA BOLIVARIANA JOSE MARTI	3801	7	61	3016	1762	2955	0	21	2	6	1164	3016
DTTO. CAPITAL	CE. BLVNO LIBERTADOR	PQ. EL RECREO	INSTITUTO PROGRESO	1407	3	10	1099	356	1089	0	3	0	2	728	1099
DTTO. CAPITAL	CE. BLVNO LIBERTADOR	PQ. EL RECREO	COLEGIO NUESTRA SEÑORA DE GUADALUPE	7115	13	79	5514	1698	5435	1	23	1	3	3709	5514
DTTO. CAPITAL	CE. BLVNO LIBERTADOR	PQ. EL RECREO	UNIDAD EDUCATIVA COLEGIO SIETE ESTRELLAS	1741	3	14	1336	324	1322	0	4	0	1	993	1336
DTTO. CAPITAL	CE. BLVNO LIBERTADOR	PQ. EL RECREO	UNIDAD EDUCATIVA COLEGIO SAN JOSE DE TARBES	2646	5	15	1982	234	1967	1	4	1	3	1724	1982
DTTO. CAPITAL	CE. BLVNO LIBERTADOR	PQ. EL RECREO	OFICINA DE TELEGRAFOS (IPOSTEL) CENTRO COMERCIAL CEDIAZ	1892	4	15	1040	386	1025	0	2	0	1	636	1040
DTTO. CAPITAL	CE. BLVNO LIBERTADOR	PQ. EL RECREO	UNIDAD EDUCATIVA NACIONAL JULIO BUSTAMANTE	3947	7	25	2743	705	2718	0	11	3	3	1996	2743
DTTO. CAPITAL	CE. BLVNO LIBERTADOR	PQ. EL RECREO	DESARROLLO URBANISTICO LOS JABILLOS I	290	1	10	270	250	260	0	0	0	0	10	270
DTTO. CAPITAL	CE. BLVNO LIBERTADOR	PQ. EL RECREO	CENTRO AMBULATORIO DOCTOR DILIO SEQUERA PERAZA IVSS	895	2	15	678	350	663	1	1	0	4	307	678
DTTO. CAPITAL	CE. BLVNO LIBERTADOR	PQ. EL RECREO	UNIDAD EDUCATIVA COLEGIO CERVANTES	4744	9	38	3616	888	3578	4	15	2	1	2668	3616
DTTO. CAPITAL	CE. BLVNO LIBERTADOR	PQ. EL RECREO	PREESCOLAR CENAIN III	1375	3	18	1165	564	1147	1	0	0	1	581	1165
DTTO. CAPITAL	CE. BLVNO LIBERTADOR	PQ. CATEDRAL	TORRE MPPRE (CANCILLERIA)	277	1	6	264	245	258	0	0	0	0	13	264
DTTO. CAPITAL	CE. BLVNO LIBERTADOR	PQ. CATEDRAL	INSTITUTO CICLO DIVERSIFICADO FERMÍN TORO	6465	12	137	4948	3640	4811	2	19	0	3	1147	4948
DTTO. CAPITAL	CE. BLVNO LIBERTADOR	PQ. CATEDRAL	OFICINA CONCEJO MUNICIPAL	1840	4	18	1213	692	1195	0	4	3	1	495	1213
DTTO. CAPITAL	CE. BLVNO LIBERTADOR	PQ. CATEDRAL	CASA COLONIAL SANTA INÉS CANO AMARILLO	1725	3	29	1149	722	1120	1	8	1	1	387	1149
DTTO. CAPITAL	CE. BLVNO LIBERTADOR	PQ. CATEDRAL	TORRE EL CHORRO	262	1	12	225	203	213	0	0	0	0	10	225
DTTO. CAPITAL	CE. BLVNO LIBERTADOR	PQ. CATEDRAL	UNIDAD EDUCATIVA COLEGIO ÁVILA	1905	4	33	1430	819	1397	2	8	1	0	567	1430
DTTO. CAPITAL	CE. BLVNO LIBERTADOR	PQ. CATEDRAL	ESCUELA BÁSICA BOLÍVAR	1739	3	29	1341	768	1312	0	6	2	0	536	1341
DTTO. CAPITAL	CE. BLVNO LIBERTADOR	PQ. CATEDRAL	UNIDAD EDUCATIVA SAN RAFAEL DE PAGUITA	2678	5	59	2032	1314	1973	1	10	0	1	647	2032
DTTO. CAPITAL	CE. BLVNO LIBERTADOR	PQ. SAN AGUSTIN	ESCUELA DE ARTES PLASTICAS CRISTOBAL ROJAS	2439	5	20	1893	796	1873	0	8	2	0	1067	1893
DTTO. CAPITAL	CE. BLVNO LIBERTADOR	PQ. SAN AGUSTIN	CENTRO DE EDUCACION INICIAL NACIONAL MATEA BOLIVAR	2322	4	54	1726	909	1672	0	8	1	3	751	1726
DTTO. CAPITAL	CE. BLVNO LIBERTADOR	PQ. SAN AGUSTIN	ESTACION METROCABLE LA CEIBA	705	2	10	624	563	614	0	2	1	0	48	624
DTTO. CAPITAL	CE. BLVNO LIBERTADOR	PQ. SAN AGUSTIN	DESARROLLO URBANISTICO SAN AGUSTIN II	339	1	9	324	306	315	0	2	0	0	7	324
DTTO. CAPITAL	CE. BLVNO LIBERTADOR	PQ. SAN AGUSTIN	ESCUELA BASICA NACIONAL MERIDA SISO DE VAZQUEZ	2724	5	35	2286	1361	2251	2	10	1	2	875	2286
DTTO. CAPITAL	CE. BLVNO LIBERTADOR	PQ. SAN AGUSTIN	COLEGIO CORAZON DE MARIA	2368	4	40	1835	865	1795	1	5	0	3	921	1835
DTTO. CAPITAL	CE. BLVNO LIBERTADOR	PQ. SAN AGUSTIN	ESTACION METROCABLE HORNOS DE CAL	372	1	4	313	242	309	1	3	0	0	63	313
DTTO. CAPITAL	CE. BLVNO LIBERTADOR	PQ. SAN AGUSTIN	UNIDAD EDUCATIVA NACIONAL DOCTOR ELIAS RODRIGUEZ	2911	6	55	2325	1649	2270	0	5	1	1	614	2325
DTTO. CAPITAL	CE. BLVNO LIBERTADOR	PQ. SAN AGUSTIN	CENTRO DE MISIONES MANUEL FOMBONA PACHANO	2683	5	59	2093	1557	2034	3	6	1	0	467	2093
DTTO. CAPITAL	CE. BLVNO LIBERTADOR	PQ. SAN AGUSTIN	BIBLIOTECA PUBLICA LEONARDO RUIZ PINEDA	1721	3	35	1423	950	1388	2	7	1	2	426	1423
DTTO. CAPITAL	CE. BLVNO LIBERTADOR	PQ. SAN AGUSTIN	UNIDAD EDUCATIVA NACIONAL BOLIVARIANA BICENTENERIA REPUBLICANO	6079	11	62	4700	2107	4638	0	15	1	2	2513	4700
DTTO. CAPITAL	CE. BLVNO LIBERTADOR	PQ. SAN AGUSTIN	UNIDAD EDUCATIVA DISTRITAL JUAN LANDAETA	3245	6	53	2477	1751	2424	0	2	3	4	664	2477
DTTO. CAPITAL	CE. BLVNO LIBERTADOR	PQ. SAN AGUSTIN	ESTACION DE METRO CABLE EL MANGUITO	672	2	8	604	553	596	0	4	0	0	39	604
DTTO. CAPITAL	CE. BLVNO LIBERTADOR	PQ. SAN AGUSTIN	PREESCOLAR CONCEPCION MARINO	1539	3	23	1333	973	1310	0	5	1	0	331	1333
DTTO. CAPITAL	CE. BLVNO LIBERTADOR	PQ. SAN AGUSTIN	CENTRO DE EDUCACION INICIAL SIMONCITO MARIA ANTONIA	379	1	3	350	284	347	1	1	0	0	61	350
DTTO. CAPITAL	CE. BLVNO LIBERTADOR	PQ. SAN AGUSTIN	CEMAI SAN AGUSTIN	1286	3	17	1020	757	1003	0	2	0	0	244	1020
DTTO. CAPITAL	CE. BLVNO LIBERTADOR	PQ. SAN AGUSTIN	MUSEO DE LA ESTAMPA Y EL DISEÑO CARLOS CRUZ DIEZ	1199	3	12	807	405	795	0	3	0	0	387	807
DTTO. CAPITAL	CE. BLVNO LIBERTADOR	PQ. SAN JUAN	MODULO EL CALVARIO	319	1	6	296	221	290	0	1	1	0	67	296
DTTO. CAPITAL	CE. BLVNO LIBERTADOR	PQ. SAN JUAN	UNIDAD EDUCATIVA NACIONAL LOS EUCALIPTOS	1238	3	14	998	697	984	0	5	0	3	279	998
DTTO. CAPITAL	CE. BLVNO LIBERTADOR	PQ. SAN JUAN	CENTRO DE EDUCACIÓN INICIAL CONVENCIONAL DOCTOR PASTOR OROPEZA	272	1	6	242	187	236	0	1	0	1	47	242
DTTO. CAPITAL	CE. BLVNO LIBERTADOR	PQ. SAN JUAN	INSTITUTO NACIONAL DE NUTRICIÓN	4330	8	49	3417	1275	3368	1	18	2	1	2071	3417
DTTO. CAPITAL	CE. BLVNO LIBERTADOR	PQ. SAN JUAN	IPOSTEL EL SILENCIO	1279	3	23	1034	469	1011	0	3	2	0	537	1034
DTTO. CAPITAL	CE. BLVNO LIBERTADOR	PQ. SAN JUAN	UNIDAD EDUCATIVA PARTICULAR SAN JUAN	2082	4	28	1725	656	1697	1	7	2	0	1031	1725
DTTO. CAPITAL	CE. BLVNO LIBERTADOR	PQ. SAN JUAN	UNIDAD EDUCATIVA NACIONAL BOLIVARIANA 25 DE JULIO.	5140	9	79	4211	1759	4132	2	16	4	5	2346	4211
DTTO. CAPITAL	CE. BLVNO LIBERTADOR	PQ. SAN JUAN	CENTRO DE EDUCACIÓN INICIAL JUAN TORO	1259	3	25	1050	677	1025	1	3	0	0	344	1050
DTTO. CAPITAL	CE. BLVNO LIBERTADOR	PQ. SAN JUAN	HOSPITAL MILITAR DOCTOR CARLOS ARVELO	1843	4	28	1490	994	1462	0	4	1	0	463	1490
DTTO. CAPITAL	CE. BLVNO LIBERTADOR	PQ. SAN JUAN	PRE ESCOLAR MARIA DEL ROSARIO	766	2	11	704	332	693	0	3	0	1	357	704
DTTO. CAPITAL	CE. BLVNO LIBERTADOR	PQ. SAN JUAN	UNIDAD EDUCATIVA DISTRITAL LEONCIO MARTINEZ	2666	5	62	2072	1320	2010	2	7	2	4	675	2072
DTTO. CAPITAL	CE. BLVNO LIBERTADOR	PQ. SAN JUAN	CENTRO DE EDUCACIÓN INTEGRAL PRE ESCOLAR GABRIELA MISTRAL	1018	2	11	826	391	815	1	3	0	1	419	826
DTTO. CAPITAL	CE. BLVNO LIBERTADOR	PQ. SAN JUAN	CENTRO DE EDUCACION INICIAL MEVAL LAS PIÑAS	327	1	9	290	220	281	0	2	0	0	59	290
DTTO. CAPITAL	CE. BLVNO LIBERTADOR	PQ. SAN JUAN	CENTRO CULTURAL LAS AMARILLAS	769	2	4	562	416	558	0	2	1	2	137	562
DTTO. CAPITAL	CE. BLVNO LIBERTADOR	PQ. SAN JUAN	PRE ESCOLAR LISANDRO ALVARADO	263	1	10	238	173	228	0	0	1	0	54	238
DTTO. CAPITAL	CE. BLVNO LIBERTADOR	PQ. SAN JUAN	CONSEJO COMUNAL LA ACEQUIA 3 SECTORES	322	1	5	307	289	302	0	0	0	1	12	307
DTTO. CAPITAL	CE. BLVNO LIBERTADOR	PQ. SAN JUAN	PREESCOLAR JOSE ANTONIO MAITIN	251	1	1	228	186	227	0	1	0	0	40	228
DTTO. CAPITAL	CE. BLVNO LIBERTADOR	PQ. SAN JUAN	ESCUELA BÁSICA NACIONAL GUZMÁN BLANCO	1827	4	23	1362	657	1339	2	4	0	0	676	1362
DTTO. CAPITAL	CE. BLVNO LIBERTADOR	PQ. SAN JUAN	UNIDAD EDUCATIVA NACIONAL BOLIVARIANA MIGUEL VILLAVICENCIO	5813	10	80	4752	2623	4672	2	32	0	6	2009	4752
DTTO. CAPITAL	CE. BLVNO LIBERTADOR	PQ. SAN JUAN	CASA COMUNAL LUISA CASERES DE ARISMENDI	462	1	5	407	346	402	0	1	0	1	54	407
DTTO. CAPITAL	CE. BLVNO LIBERTADOR	PQ. SAN JUAN	UNIDAD EDUCATIVA PRIVADA SAN FRANCISCO DE ASÍS	1723	3	26	1378	780	1352	0	10	0	1	561	1378
DTTO. CAPITAL	CE. BLVNO LIBERTADOR	PQ. SAN JUAN	ESCUELA BÁSICA COLEGIO PEDAGOGÍA ACTIVA	610	2	17	546	299	529	0	1	0	1	228	546
DTTO. CAPITAL	CE. BLVNO LIBERTADOR	PQ. SAN JUAN	CENTRO DE EDUCACIÓN INICIAL  ARTIGAS	1368	3	19	1163	634	1144	1	3	1	3	502	1163
DTTO. CAPITAL	CE. BLVNO LIBERTADOR	PQ. SAN JUAN	UNIDAD EDUCATIVA NACIONAL ZOE XIQUES SILVA	3462	6	53	2840	1795	2787	1	17	6	2	966	2840
DTTO. CAPITAL	CE. BLVNO LIBERTADOR	PQ. SAN JUAN	UNIDAD EDUCATIVA NACIONAL BOLIVARIANA TEOTISTE DE GALLEGOS	2080	4	48	1687	1173	1639	1	6	1	1	457	1687
DTTO. CAPITAL	CE. BLVNO LIBERTADOR	PQ. SAN JUAN	PRE ESCOLAR ASISTENCIAL JACINTO LARA	128	1	1	109	73	108	0	0	0	1	34	109
DTTO. CAPITAL	CE. BLVNO LIBERTADOR	PQ. SAN JUAN	UNIDAD EDUCATIVA COLEGIO SAN MARTÍN	3252	6	61	2581	982	2520	0	7	3	1	1527	2581
DTTO. CAPITAL	CE. BLVNO LIBERTADOR	PQ. SAN JUAN	UNIDAD EDUCATIVA NACIONAL AGUSTÍN ZAMORA QUINTANA	2283	4	35	1840	846	1805	0	11	1	4	943	1840
DTTO. CAPITAL	CE. BLVNO LIBERTADOR	PQ. SAN JUAN	CENTRO MUNICIPAL DE ATENCIÓN INTEGRAL  SAN JUAN (CEMAI)	894	2	12	690	411	678	0	2	0	1	264	690
DTTO. CAPITAL	CE. BLVNO LIBERTADOR	PQ. SAN JUAN	ESCUELA BÁSICA PARROQUIAL SAN JUAN BAUTISTA	3210	6	59	2485	1086	2426	0	9	4	3	1324	2485
DTTO. CAPITAL	CE. BLVNO LIBERTADOR	PQ. SAN JUAN	CENTRO DE FORMACIÓN COMERCIAL E INDUSTRIAL LUÍS BELTRÁN PRIETO FIGUEROA	3721	7	40	2839	1211	2799	0	16	1	3	1568	2839
DTTO. CAPITAL	CE. BLVNO LIBERTADOR	PQ. SAN JUAN	CENTRO DE EDUCACIÓN INICIAL  INCE	1330	3	23	1158	571	1135	0	6	1	0	557	1158
DTTO. CAPITAL	CE. BLVNO LIBERTADOR	PQ. SAN JUAN	UNIDAD EDUCATIVA NACIONAL BOLIVARIANA PEDRO PABLO BARNOLA	980	2	26	767	416	741	2	2	1	0	320	767
DTTO. CAPITAL	CE. BLVNO LIBERTADOR	PQ. SAN JUAN	DESARROLLO URBANISTICO SAN JUAN	164	1	3	155	145	152	0	0	0	0	7	155
DTTO. CAPITAL	CE. BLVNO LIBERTADOR	PQ. SAN JUAN	UNIDAD EDUCATIVA DISTRITAL CAJIGAL	1391	3	21	1089	760	1068	0	5	1	0	302	1089
DTTO. CAPITAL	CE. BLVNO LIBERTADOR	PQ. SAN JUAN	UNIDAD EDUCATIVA NACIONAL BOLIVARIANA DE ARTES Y OFICIOS INTENDENCIA	2593	5	31	1933	989	1902	0	11	2	5	895	1933
DTTO. CAPITAL	CE. BLVNO LIBERTADOR	PQ. SAN JUAN	ESCUELA NACIONAL BOLIVARIANA 19 DE ABRIL	6430	12	145	5009	2516	4864	3	26	3	6	2310	5009
DTTO. CAPITAL	CE. BLVNO LIBERTADOR	PQ. SAN JUAN	UNIDAD EDUCATIVA DISTRITAL  ÁNGEL RIVAS BALDWIN	1585	3	40	1195	809	1155	0	7	2	0	337	1195
DTTO. CAPITAL	CE. BLVNO LIBERTADOR	PQ. SAN JUAN	ESCUELA BÁSICA REPUBLICA DEL ECUADOR	4571	8	43	3662	1612	3619	1	16	2	7	1981	3662
DTTO. CAPITAL	CE. BLVNO LIBERTADOR	PQ. SAN JUAN	UNIDAD EDUCATIVA NACIONAL BOLIVARIANA DOCTOR LUÍS PADRINO	3892	7	29	3210	1393	3181	0	10	2	1	1775	3210
DTTO. CAPITAL	CE. BLVNO LIBERTADOR	PQ. EL VALLE	UNIDAD EDUCATIVA DISTRITAL PIAR	1564	3	31	1151	857	1120	0	5	1	0	257	1151
DTTO. CAPITAL	CE. BLVNO LIBERTADOR	PQ. EL VALLE	CENTRO DE EDUCACION INICIAL MANUELA ALVAREZ SOSA I	127	1	2	106	65	104	0	0	0	0	39	106
DTTO. CAPITAL	CE. BLVNO LIBERTADOR	PQ. EL VALLE	CENTRO DE EDUCACION INICIAL NACIONAL MANUEL ALVAREZ DE SOSA	213	1	1	195	118	194	0	1	0	0	75	195
DTTO. CAPITAL	CE. BLVNO LIBERTADOR	PQ. EL VALLE	CENTRO DE EDUCACION INICIAL ISABEL PELLIN	1122	2	15	887	513	872	0	2	0	3	354	887
DTTO. CAPITAL	CE. BLVNO LIBERTADOR	PQ. EL VALLE	UNIDAD EDUCATIVA NACIONAL ANTONIO PINTO SALINAS	4335	8	111	3439	2646	3328	1	15	3	1	662	3439
DTTO. CAPITAL	CE. BLVNO LIBERTADOR	PQ. EL VALLE	LICEO BOLIVARIANO DIEGO DE LOZADA	4657	8	82	3706	1802	3624	2	11	0	3	1806	3706
DTTO. CAPITAL	CE. BLVNO LIBERTADOR	PQ. EL VALLE	CENTRO MUNICIPAL ATENCION INTEGRAL	2639	5	77	2036	1280	1959	2	3	2	0	672	2036
DTTO. CAPITAL	CE. BLVNO LIBERTADOR	PQ. EL VALLE	UNIDAD EDUCATIVA JUAN ANTONIO ROMAN VALECILLOS	415	1	5	344	260	339	0	0	2	0	77	344
DTTO. CAPITAL	CE. BLVNO LIBERTADOR	PQ. EL VALLE	ESCUELA BASICA NACIONAL ANTONIO CALCAÑO	3575	7	48	2983	2242	2935	2	10	2	3	676	2983
DTTO. CAPITAL	CE. BLVNO LIBERTADOR	PQ. EL VALLE	UNIDAD EDUCATIVA PRIVADA SAN FRANCISCO PAZ Y BIEN	1386	3	31	1197	542	1166	0	6	1	1	616	1197
DTTO. CAPITAL	CE. BLVNO LIBERTADOR	PQ. EL VALLE	ESCUELA BÁSICA BOLIVARIANA CARMEN CONZOÑO	596	1	14	492	398	478	0	4	0	0	76	492
DTTO. CAPITAL	CE. BLVNO LIBERTADOR	PQ. EL VALLE	JARDIN DE INFANCIA AYACUCHO	1063	2	22	903	508	881	0	1	0	0	372	903
DTTO. CAPITAL	CE. BLVNO LIBERTADOR	PQ. EL VALLE	JARDIN DE INFANCIA FUNDACIÓN MEVAL NEGRO PRIMERO DISTRITO Nº1	519	1	5	400	363	395	0	2	0	1	29	400
DTTO. CAPITAL	CE. BLVNO LIBERTADOR	PQ. EL VALLE	LICEO BOLIVARIANO LUIS CARDENAS SAAVEDRA	4251	8	82	3364	1718	3282	0	10	1	1	1552	3364
DTTO. CAPITAL	CE. BLVNO LIBERTADOR	PQ. EL VALLE	JARDIN DE INFANCIA MARIA MAY	413	1	16	370	200	354	0	1	0	0	153	370
DTTO. CAPITAL	CE. BLVNO LIBERTADOR	PQ. EL VALLE	ESCUELA BASICA PADRE MENDOZA	4445	8	107	3600	2000	3493	0	17	1	0	1475	3600
DTTO. CAPITAL	CE. BLVNO LIBERTADOR	PQ. EL VALLE	CENTRO DE EDUCACION INICIAL CALIXTO SUAREZ GOMEZ	437	1	12	383	214	371	0	0	0	1	156	383
DTTO. CAPITAL	CE. BLVNO LIBERTADOR	PQ. EL VALLE	CENTRO DE EDUCACIÓN INICIAL MANUELA ALVAREZ DE SOSA	856	2	13	703	365	690	0	1	0	0	324	703
DTTO. CAPITAL	CE. BLVNO LIBERTADOR	PQ. EL VALLE	UNIDAD EDUCATIVA DOCTOR JULIÁN VISO	1776	3	15	1391	973	1376	2	4	2	3	392	1391
DTTO. CAPITAL	CE. BLVNO LIBERTADOR	PQ. EL VALLE	CENTRO DE EDUCACION INICIAL CECILIA PIMENTEL	1614	3	20	1354	865	1334	0	6	2	2	459	1354
DTTO. CAPITAL	CE. BLVNO LIBERTADOR	PQ. EL VALLE	CENTRO DE EDUCACIÓN INICIAL LUISA ELENA PALACIOS BETANCOURT	972	2	39	782	490	743	0	9	5	0	239	782
DTTO. CAPITAL	CE. BLVNO LIBERTADOR	PQ. EL VALLE	ESCUELA BASICA NACIONAL CARMEN MAIZO DE BELLO	6410	12	93	5403	3102	5310	1	23	4	4	2176	5403
DTTO. CAPITAL	CE. BLVNO LIBERTADOR	PQ. EL VALLE	ESCUELA BASICA NACIONAL ELIAS TORO	5171	10	81	4324	1829	4243	0	15	4	7	2388	4324
DTTO. CAPITAL	CE. BLVNO LIBERTADOR	PQ. EL VALLE	JEFATURA CIVIL DEL VALLE	2282	4	50	1810	1123	1760	1	9	2	0	625	1810
DTTO. CAPITAL	CE. BLVNO LIBERTADOR	PQ. EL VALLE	PREESCOLAR ANTONIO JOSÉ DE SUCRE	2055	4	39	1790	737	1751	2	4	0	5	1003	1790
DTTO. CAPITAL	CE. BLVNO LIBERTADOR	PQ. EL VALLE	CENTRO DE EDUCACION INICIAL EL PARAISO	899	2	32	755	296	723	0	1	3	0	423	755
DTTO. CAPITAL	CE. BLVNO LIBERTADOR	PQ. EL VALLE	JARDIN DE INFANCIA TEOTISTE AROCHA DE GALLEGOS	3080	6	40	2458	1358	2418	1	8	0	4	1047	2458
DTTO. CAPITAL	CE. BLVNO LIBERTADOR	PQ. EL VALLE	ESCUELA BASICA DE CRUZ CARRILLO	1990	4	32	1516	1013	1484	0	17	0	0	454	1516
DTTO. CAPITAL	CE. BLVNO LIBERTADOR	PQ. EL VALLE	LICEO BOLIVARIANO FRAY PEDRO DE AGREDA	4707	9	70	3801	2299	3731	2	11	0	4	1415	3801
DTTO. CAPITAL	CE. BLVNO LIBERTADOR	PQ. EL VALLE	LICEO ECOLOGICO NACIONAL BOLIVARIANO GENERAL EN JEFE ALBERTO MULLER ROJAS	361	1	7	317	280	310	0	1	0	0	29	317
DTTO. CAPITAL	CE. BLVNO LIBERTADOR	PQ. EL VALLE	CONSEJO COMUNAL 19 DE ABRIL	490	1	4	382	325	378	0	2	0	0	51	382
DTTO. CAPITAL	CE. BLVNO LIBERTADOR	PQ. EL VALLE	FNC ANTIGUA CEMEX	68	1	1	64	63	63	0	0	0	0	0	64
DTTO. CAPITAL	CE. BLVNO LIBERTADOR	PQ. EL VALLE	UNIDAD EDUCATIVA NACIONAL DOCTOR GUILLERMO PALACIOS	2512	5	38	1948	1338	1910	1	9	0	0	562	1948
DTTO. CAPITAL	CE. BLVNO LIBERTADOR	PQ. EL VALLE	UNIVERSIDAD EXPERIMENTAL SIMON RODRIGUEZ	3980	7	95	3231	1729	3136	0	13	2	2	1390	3231
DTTO. CAPITAL	CE. BLVNO LIBERTADOR	PQ. EL VALLE	CONSEJO COMUNAL MATEA BOLIVAR	356	1	6	304	237	298	0	0	0	0	61	304
DTTO. CAPITAL	CE. BLVNO LIBERTADOR	PQ. EL VALLE	JARDIN DE INFANCIA EL PARAISO SECCION ANDRES BELLO	697	2	12	573	311	561	0	2	0	1	247	573
DTTO. CAPITAL	CE. BLVNO LIBERTADOR	PQ. EL VALLE	CENTRO PRE ESCOLAR EL VALLE	876	2	21	652	490	631	0	1	0	0	140	652
DTTO. CAPITAL	CE. BLVNO LIBERTADOR	PQ. EL VALLE	ESCUELA BASICA PARROQUIAL EL VALLE	2496	5	29	1974	1706	1945	0	5	1	1	232	1974
DTTO. CAPITAL	CE. BLVNO LIBERTADOR	PQ. EL VALLE	UNIDAD EDUCATIVA DISTRITAL JUAN ESPAÑA	6566	12	154	5063	2915	4909	0	24	1	3	1966	5063
DTTO. CAPITAL	CE. BLVNO LIBERTADOR	PQ. EL VALLE	PRE ESCOLAR DELIA ROSAS	373	1	6	336	208	330	0	0	0	0	122	336
DTTO. CAPITAL	CE. BLVNO LIBERTADOR	PQ. EL VALLE	JARDIN DE INFANCIA VALLE ALTO	606	2	22	490	247	468	0	1	0	1	219	490
DTTO. CAPITAL	CE. BLVNO LIBERTADOR	PQ. EL VALLE	PRE ESCOLAR MARIA CONCEPCION PALACIOS	370	1	5	317	210	312	0	1	0	1	100	317
DTTO. CAPITAL	CE. BLVNO LIBERTADOR	PQ. EL VALLE	PREESCOLAR NACIONAL CALIXTO SUAREZ GOMEZ	762	2	17	610	327	593	0	0	3	2	261	610
DTTO. CAPITAL	CE. BLVNO LIBERTADOR	PQ. EL VALLE	UNIDAD EDUCATIVA VIRGEN BETANIA	1751	3	36	1394	840	1358	0	5	2	0	511	1394
DTTO. CAPITAL	CE. BLVNO LIBERTADOR	PQ. EL VALLE	UNIDAD EDUCATIVA MUNICIPAL ABIGAIL GONZALEZ	6231	12	160	5264	3696	5104	2	23	2	4	1377	5264
DTTO. CAPITAL	CE. BLVNO LIBERTADOR	PQ. EL VALLE	UNIDAD EDUCATIVA SAN JUDAS TADEO	1493	3	37	1173	933	1136	0	6	1	0	196	1173
DTTO. CAPITAL	CE. BLVNO LIBERTADOR	PQ. EL VALLE	CENTRO DE EDUCACION INICIAL MANUELA ALVAREZ DE SOSA II	738	2	7	592	304	585	0	4	0	1	276	592
DTTO. CAPITAL	CE. BLVNO LIBERTADOR	PQ. EL VALLE	LICEO BOLIVARIANO JOSÉ AVALOS	7956	14	147	6363	3907	6216	1	22	6	10	2270	6363
DTTO. CAPITAL	CE. BLVNO LIBERTADOR	PQ. EL VALLE	UNIDAD EDUCATIVA DISTRITAL BOLIVARIANA MIGUEL JOSE SANZ	202	1	8	177	106	169	0	0	0	0	63	177
DTTO. CAPITAL	CE. BLVNO LIBERTADOR	PQ. EL VALLE	JARDÍN DE INFANCIA LUÍS TOVAR	1107	2	22	917	538	895	0	2	0	0	355	917
DTTO. CAPITAL	CE. BLVNO LIBERTADOR	PQ. EL VALLE	UNIDAD EDUCATIVA PRIVADA VENEZUELA SOBERANA	1118	2	21	943	561	922	1	6	0	3	351	943
DTTO. CAPITAL	CE. BLVNO LIBERTADOR	PQ. EL VALLE	CENTRO DE EDUCACION INICIAL MENCA DE LEONI	1359	3	33	1131	535	1098	1	3	3	1	555	1131
DTTO. CAPITAL	CE. BLVNO LIBERTADOR	PQ. EL VALLE	ESCUELA BÁSICA BOLIVARIANA CARACCIOLO PARRA LEÓN	4948	9	129	4050	2170	3921	0	24	0	5	1722	4050
DTTO. CAPITAL	CE. BLVNO LIBERTADOR	PQ. EL VALLE	ESCUELA BASICA DOCTOR ENRIQUE DELGADO PALACIOS	3336	6	65	2768	1269	2703	0	9	4	2	1419	2768
DTTO. CAPITAL	CE. BLVNO LIBERTADOR	PQ. EL VALLE	ESCUELA ECOLÓGICA BOLIVARIANA SIMÓN RODRÍGUEZ	346	1	7	298	256	291	0	2	2	1	30	298
DTTO. CAPITAL	CE. BLVNO LIBERTADOR	PQ. SANTA ROSALIA	INSTITUTO VENEZOLANO DE EDUCACION	990	2	14	823	428	809	2	5	0	0	374	823
DTTO. CAPITAL	CE. BLVNO LIBERTADOR	PQ. SANTA ROSALIA	ESCUELA BASICA NACIONAL TOMAS AGUERREVERE	3213	6	54	2573	1289	2519	1	12	2	2	1213	2573
DTTO. CAPITAL	CE. BLVNO LIBERTADOR	PQ. SANTA ROSALIA	ESCUELA BASICA BOLIVARIANA 1 DE MAYO	2126	4	18	1695	1300	1677	0	6	3	1	367	1695
DTTO. CAPITAL	CE. BLVNO LIBERTADOR	PQ. SANTA ROSALIA	INSTITUTO NACIONAL DE NUTRICION MENCA DE LEONI	804	2	14	715	287	701	0	1	0	1	412	715
DTTO. CAPITAL	CE. BLVNO LIBERTADOR	PQ. SANTA ROSALIA	PRESCOLARISTENCIAL LYA IMBER DE CORONIL	877	2	20	712	486	692	0	3	0	0	203	712
DTTO. CAPITAL	CE. BLVNO LIBERTADOR	PQ. SANTA ROSALIA	ESCUELA BASICA NACIONAL BOGOTA	2330	4	54	1877	1289	1823	1	5	0	0	528	1877
DTTO. CAPITAL	CE. BLVNO LIBERTADOR	PQ. SANTA ROSALIA	CASA COMUNAL LA CRUZ	274	1	4	234	215	230	0	0	0	0	15	234
DTTO. CAPITAL	CE. BLVNO LIBERTADOR	PQ. SANTA ROSALIA	ESCUELA SANTA TERESITA DEL NIÑO JESUS	364	1	16	335	208	319	0	1	0	0	110	335
DTTO. CAPITAL	CE. BLVNO LIBERTADOR	PQ. SANTA ROSALIA	UNIDAD EDUCATIVA PRIVADA COLEGIO FRAY LUIS DE LEON	1630	3	19	1366	412	1347	0	3	0	0	932	1366
DTTO. CAPITAL	CE. BLVNO LIBERTADOR	PQ. SANTA ROSALIA	PRESCOLAR ASISTENCIAL DON BERNABE PLANA	537	1	6	492	328	486	0	0	0	1	157	492
DTTO. CAPITAL	CE. BLVNO LIBERTADOR	PQ. SANTA ROSALIA	PRESCOLAR MI DIVINO NIÑO	872	2	19	646	426	627	0	0	0	0	201	646
DTTO. CAPITAL	CE. BLVNO LIBERTADOR	PQ. SANTA ROSALIA	UNIDAD EDUCATIVA DISTRITAL SUCRE	3635	7	73	2875	1974	2802	1	14	0	1	812	2875
DTTO. CAPITAL	CE. BLVNO LIBERTADOR	PQ. SANTA ROSALIA	UNIDAD EDUCATIVA SANTISIMA VIRGEN DE COROMOTO	1656	3	31	1313	658	1282	0	3	0	1	620	1313
DTTO. CAPITAL	CE. BLVNO LIBERTADOR	PQ. SANTA ROSALIA	UNIDAD EDUCATIVA COLEGIO SANTA LUISA Nº 76	3301	6	48	2742	1078	2694	0	13	1	2	1600	2742
DTTO. CAPITAL	CE. BLVNO LIBERTADOR	PQ. SANTA ROSALIA	UNIDAD EDUCATIVA COLEGIO GRAN COLOMBIA	5686	10	103	4381	2648	4278	0	11	2	0	1617	4381
DTTO. CAPITAL	CE. BLVNO LIBERTADOR	PQ. SANTA ROSALIA	MPP PARA LAS COMUNAS Y PROTECCION SOCIAL INCES NUEVA GRANADA	90	1	3	85	77	82	0	0	0	0	5	85
DTTO. CAPITAL	CE. BLVNO LIBERTADOR	PQ. SANTA ROSALIA	JUNTA PARROQUIAL SANTA ROSALIA	265	1	3	222	169	219	0	1	1	0	48	222
DTTO. CAPITAL	CE. BLVNO LIBERTADOR	PQ. SANTA ROSALIA	EDIFICIO PANAMA COMPLEJO GRAN COLOMBIA	1467	3	14	1154	713	1140	0	7	1	1	418	1154
DTTO. CAPITAL	CE. BLVNO LIBERTADOR	PQ. SANTA ROSALIA	UNIDAD EDUCATIVA EUSEBIO GUZMAN	1362	3	19	1172	955	1153	0	5	0	0	193	1172
DTTO. CAPITAL	CE. BLVNO LIBERTADOR	PQ. SANTA ROSALIA	UNIDAD EDUCATIVA COLEGIO SANTA CECILIA	1020	2	19	882	340	863	0	1	1	3	518	882
DTTO. CAPITAL	CE. BLVNO LIBERTADOR	PQ. SANTA ROSALIA	UNIDAD EDUCATIVA COLEGIO   NUESTRA SEÑORA DEL  PILAR	2429	5	43	1757	558	1714	0	6	0	1	1149	1757
DTTO. CAPITAL	CE. BLVNO LIBERTADOR	PQ. SANTA ROSALIA	ESCUELA BASICA NACIONAL BOLIVAR	2954	6	57	2118	781	2061	0	7	2	6	1265	2118
DTTO. CAPITAL	CE. BLVNO LIBERTADOR	PQ. SANTA ROSALIA	CASA DE LA CULTURA DE SANTA EDUVIGIS	411	1	7	368	301	361	1	1	0	0	58	368
DTTO. CAPITAL	CE. BLVNO LIBERTADOR	PQ. SANTA ROSALIA	EDIFICIO ECUADOR COMPLEJO GRAN COLOMBIA	2376	5	37	1856	1081	1819	0	5	5	0	728	1856
DTTO. CAPITAL	CE. BLVNO LIBERTADOR	PQ. SANTA ROSALIA	CENTRO DE EDUCACION INICIAL ARMANDO REVERON	1245	3	11	1036	672	1025	0	3	3	1	346	1036
DTTO. CAPITAL	CE. BLVNO LIBERTADOR	PQ. SANTA ROSALIA	UNIDAD EDUCATIVA COLEGIO PAULO VI	2628	5	65	2198	1275	2133	0	16	1	2	839	2198
DTTO. CAPITAL	CE. BLVNO LIBERTADOR	PQ. SANTA ROSALIA	ESCUELA BASICA NACIONAL CONSUELO NAVAS TOVAR	1581	3	20	1223	692	1203	0	6	1	1	503	1223
DTTO. CAPITAL	CE. BLVNO LIBERTADOR	PQ. SANTA ROSALIA	UNIDAD EDUCATIVA PRIVADA SANTA ROSALIA	2392	5	40	1890	684	1850	1	10	3	3	1149	1890
DTTO. CAPITAL	CE. BLVNO LIBERTADOR	PQ. SANTA ROSALIA	CENTRO DE EDUCACION INICIAL SIMONCITO LEONARDO RUIZ PINEDA	400	1	4	372	165	368	0	1	1	0	201	372
DTTO. CAPITAL	CE. BLVNO LIBERTADOR	PQ. SANTA ROSALIA	LICEO INDEPENDENCIA	3540	7	37	2692	1056	2655	0	9	4	0	1586	2692
DTTO. CAPITAL	CE. BLVNO LIBERTADOR	PQ. SANTA ROSALIA	EDIFICIO COLOMBIA COMPLEJO GRAN COLOMBIA	2371	4	36	1727	817	1691	0	2	1	1	870	1727
DTTO. CAPITAL	CE. BLVNO LIBERTADOR	PQ. SANTA ROSALIA	UNIDAD EDUCATIVA COLEGIO GUAICAIPURO	2276	4	43	1883	1148	1840	2	7	2	2	679	1883
DTTO. CAPITAL	CE. BLVNO LIBERTADOR	PQ. SANTA ROSALIA	ASOCIACION CRISTIANA DE JOVENES DE CARACAS (YMCA)	3240	6	35	2610	1143	2575	0	13	1	2	1416	2610
DTTO. CAPITAL	CE. BLVNO LIBERTADOR	PQ. SANTA ROSALIA	ESCUELA NACIONAL BOLIVARIANA PRUDENCIO DIEZ	1440	3	22	1180	807	1158	0	3	0	4	344	1180
DTTO. CAPITAL	CE. BLVNO LIBERTADOR	PQ. SANTA ROSALIA	UNIDAD EDUCATIVA DISTRITAL PASTORA LANDAEZ	1759	3	20	1309	541	1289	1	5	1	3	738	1309
DTTO. CAPITAL	CE. BLVNO LIBERTADOR	PQ. SANTA ROSALIA	UNIDAD DE ATENCION DON ANTONIO RAIMA (INASS)	345	1	10	306	154	296	0	1	0	0	141	306
DTTO. CAPITAL	CE. BLVNO LIBERTADOR	PQ. SANTA ROSALIA	ESTACION DE MALARIOLOGIA Y SANIAMIENTO AMBIENTAL ZONA 10 (MSAS)	716	2	6	513	255	507	0	3	0	0	249	513
DTTO. CAPITAL	CE. BLVNO LIBERTADOR	PQ. SANTA ROSALIA	UNIDAD EDUCATIVA DISTRITAL PANCHITA ADRIANZA	1716	3	26	1382	599	1356	1	5	1	1	749	1382
DTTO. CAPITAL	CE. BLVNO LIBERTADOR	PQ. SANTA ROSALIA	UNIDAD EDUCATIVA DOCTOR MANUEL DIAZ RODRIGUEZ	4237	8	73	3422	2374	3349	2	18	0	3	952	3422
DTTO. CAPITAL	CE. BLVNO LIBERTADOR	PQ. SANTA ROSALIA	CONSEJO COMUNAL LA OCTAVA ESTRELLA DEL SIGLO 21	239	1	4	218	201	214	0	1	0	0	12	218
DTTO. CAPITAL	CE. BLVNO LIBERTADOR	PQ. SANTA ROSALIA	CUERPO DE BOMBEROS DE CARACAS	2030	4	50	1548	828	1498	3	5	1	0	661	1548
DTTO. CAPITAL	CE. BLVNO LIBERTADOR	PQ. SANTA ROSALIA	UNIDAD EDUCATIVA NACIONAL BOLIVARIANA LUIS RAZZETTI	1985	4	30	1477	604	1447	0	8	0	2	833	1477
DTTO. CAPITAL	CE. BLVNO LIBERTADOR	PQ. SANTA ROSALIA	UNIDAD EDUCATIVA PRIVADA COLEGIO SANTA ANA	2952	6	44	2541	1324	2497	0	6	3	1	1163	2541
DTTO. CAPITAL	CE. BLVNO LIBERTADOR	PQ. SANTA ROSALIA	AMBULATORIO ANGEL VICENTE OCHOA (SEGURO SOCIAL)	2880	5	72	2298	1362	2226	2	11	2	1	848	2298
DTTO. CAPITAL	CE. BLVNO LIBERTADOR	PQ. SANTA ROSALIA	LICEO BOLIVARIANO SANTIAGO KEY AYALA	3410	6	59	2715	1143	2656	0	13	1	5	1494	2715
DTTO. CAPITAL	CE. BLVNO LIBERTADOR	PQ. SANTA ROSALIA	PREESCOLAR COMUNITARIO MARCELA DIAZ	546	1	6	414	245	408	0	1	0	0	162	414
DTTO. CAPITAL	CE. BLVNO LIBERTADOR	PQ. SANTA ROSALIA	DESARROLLO URBANISTICO SANTA ROSALÍA I	187	1	2	186	171	184	0	1	0	0	12	186
DTTO. CAPITAL	CE. BLVNO LIBERTADOR	PQ. SANTA ROSALIA	DISTRIBUIDARA NACIONAL DE SERVICIOS FUNERARIOS (DINASERF,C.A.)	322	1	10	257	220	247	0	2	0	0	25	257
DTTO. CAPITAL	CE. BLVNO LIBERTADOR	PQ. SUCRE	INSTITUTO PRIVADO WALT DISNEY	923	2	20	796	366	776	0	5	1	2	402	796
DTTO. CAPITAL	CE. BLVNO LIBERTADOR	PQ. SUCRE	UNIDAD EDUCATIVA DISTRITAL CARACAS	1192	2	26	952	519	926	0	3	0	3	401	952
DTTO. CAPITAL	CE. BLVNO LIBERTADOR	PQ. SUCRE	COMEDOR DE LA DIVISIÓN DE TRANSPORTE POLICÍA METROPOLITANA	1002	2	10	751	496	741	1	4	1	2	237	751
DTTO. CAPITAL	CE. BLVNO LIBERTADOR	PQ. SUCRE	COLEGIO PADRE POLICARPIO KRAUTLE	1925	4	33	1637	1105	1604	1	10	1	2	485	1637
DTTO. CAPITAL	CE. BLVNO LIBERTADOR	PQ. SUCRE	ESCUELA BÁSICA PRIVADA GUAICAIPURO II	2148	4	31	1617	1197	1586	0	20	2	1	366	1617
DTTO. CAPITAL	CE. BLVNO LIBERTADOR	PQ. SUCRE	UNIDAD EDUCATIVA NACIONAL MIGUEL ANTONIO CARO	4673	9	113	3634	1995	3521	3	17	1	3	1502	3634
DTTO. CAPITAL	CE. BLVNO LIBERTADOR	PQ. SUCRE	ESCUELA BÁSICA NACIONAL 12 DE OCTUBRE	790	2	15	592	529	577	0	3	0	0	45	592
DTTO. CAPITAL	CE. BLVNO LIBERTADOR	PQ. SUCRE	YMCA EL CUARTEL	1424	3	38	1134	660	1096	0	8	0	3	425	1134
DTTO. CAPITAL	CE. BLVNO LIBERTADOR	PQ. SUCRE	PREESCOLAR ASISTENCIAL FEDERICO QUIROZ	776	2	23	600	412	577	1	4	0	2	158	600
DTTO. CAPITAL	CE. BLVNO LIBERTADOR	PQ. SUCRE	MODULO DE SALUD CASA BLANCA	231	1	6	189	145	183	0	0	0	0	38	189
DTTO. CAPITAL	CE. BLVNO LIBERTADOR	PQ. SUCRE	INSTITUTO TÉCNICO JESÚS OBRERO	5241	10	127	4222	2058	4095	0	12	2	6	2017	4222
DTTO. CAPITAL	CE. BLVNO LIBERTADOR	PQ. SUCRE	UNIDAD EDUCATIVA PRIVADA FEDERICO QUIROZ	2572	5	36	1978	1252	1942	3	11	4	2	670	1978
DTTO. CAPITAL	CE. BLVNO LIBERTADOR	PQ. SUCRE	CENTRO DE EDUCACION INICIAL SIMONCITO BICENTENARIO GUAL Y ESPANA	906	2	15	852	808	837	1	2	0	0	26	852
DTTO. CAPITAL	CE. BLVNO LIBERTADOR	PQ. SUCRE	UNIDAD EDUCATIVA DISTRITAL MIRANDA	1072	2	21	821	610	800	0	6	2	0	182	821
DTTO. CAPITAL	CE. BLVNO LIBERTADOR	PQ. SUCRE	CASA COMUNAL LA ESPERANZA DE ROMULO GALLEGOS	346	1	6	311	260	305	1	1	0	0	43	311
DTTO. CAPITAL	CE. BLVNO LIBERTADOR	PQ. SUCRE	UNIDAD EDUCATIVA ESCUELA PARROQUIAL EL VIVERO	3201	6	114	2572	1812	2458	1	16	2	2	625	2572
DTTO. CAPITAL	CE. BLVNO LIBERTADOR	PQ. SUCRE	PREESCOLAR CARLOS MANUEL CHAVEZ	1009	2	18	855	487	837	0	12	0	0	338	855
DTTO. CAPITAL	CE. BLVNO LIBERTADOR	PQ. SUCRE	UNIDAD EDUCATIVA TRICOLOR	724	2	10	681	341	671	0	1	0	0	329	681
DTTO. CAPITAL	CE. BLVNO LIBERTADOR	PQ. SUCRE	ESCUELA TÉCNICA INDUSTRIAL JULIO CALCAÑO	2140	4	41	1776	986	1735	1	14	2	2	730	1776
DTTO. CAPITAL	CE. BLVNO LIBERTADOR	PQ. SUCRE	CASA COMUNAL MINI PARQUE LA CRUZ	124	1	2	110	83	108	0	1	0	0	24	110
DTTO. CAPITAL	CE. BLVNO LIBERTADOR	PQ. SUCRE	JARDÍN DE INFANCIA TEOTISTE DE GALLEGOS	774	2	4	387	327	383	0	1	0	1	54	387
DTTO. CAPITAL	CE. BLVNO LIBERTADOR	PQ. SUCRE	ESCUELA BÁSICA DISTRITAL GUAICAIPURO	1927	4	53	1589	1044	1536	1	9	0	0	482	1589
DTTO. CAPITAL	CE. BLVNO LIBERTADOR	PQ. SUCRE	PREESCOLAR ANA TERESA PARRA	1381	3	18	1193	878	1175	0	8	0	1	288	1193
DTTO. CAPITAL	CE. BLVNO LIBERTADOR	PQ. SUCRE	UNIDAD EDUCATIVA PRIVADA SANTA BARBARA	353	1	4	303	198	299	0	2	0	0	99	303
DTTO. CAPITAL	CE. BLVNO LIBERTADOR	PQ. SUCRE	UNIDAD EDUCATIVA COLEGIO CRISTO REDENTOR	1513	3	38	1268	888	1230	0	7	0	1	334	1268
DTTO. CAPITAL	CE. BLVNO LIBERTADOR	PQ. SUCRE	UNIDAD EDUCATIVA  MADRE MARIA ROSA MOLAS FE Y ALEGRIA	2009	4	28	1656	803	1628	3	10	0	2	810	1656
DTTO. CAPITAL	CE. BLVNO LIBERTADOR	PQ. SUCRE	GALPON LA COCACOLA VALLE ABAJO	351	1	10	308	264	298	0	2	0	0	32	308
DTTO. CAPITAL	CE. BLVNO LIBERTADOR	PQ. SUCRE	ESCUELA NACIONAL FROILAN NORIEGA	3081	6	50	2570	1794	2520	2	14	3	2	705	2570
DTTO. CAPITAL	CE. BLVNO LIBERTADOR	PQ. SUCRE	UNIDAD EDUCATIVA RAMÓN ISIDRO MONTES	3564	7	49	2809	1338	2760	2	15	5	2	1398	2809
DTTO. CAPITAL	CE. BLVNO LIBERTADOR	PQ. SUCRE	UNIDAD EDUCATIVA NACIONAL MARIANO PICÓN SALAS	2067	4	58	1712	1095	1654	0	10	2	1	546	1712
DTTO. CAPITAL	CE. BLVNO LIBERTADOR	PQ. SUCRE	LICEO BOLIVARIANO MIGUEL ANTONIO CARO	4051	8	89	3215	1910	3126	0	18	2	2	1194	3215
DTTO. CAPITAL	CE. BLVNO LIBERTADOR	PQ. SUCRE	CENTRO DE EDUCACIÓN INICIAL NACIONAL CATALINA VALDERRAMA	1203	3	9	975	730	966	1	5	0	2	228	975
DTTO. CAPITAL	CE. BLVNO LIBERTADOR	PQ. SUCRE	PREESCOLAR ANTONIO JOSE DE SUCRE	367	1	10	329	243	319	0	4	0	1	71	329
DTTO. CAPITAL	CE. BLVNO LIBERTADOR	PQ. SUCRE	UNIDAD ESCOLAR NIÑO SIMÓN BOLÍVAR	399	1	4	338	272	334	0	1	0	0	61	338
DTTO. CAPITAL	CE. BLVNO LIBERTADOR	PQ. SUCRE	ESCUELA BÁSICA DISTRITAL ELISA DE IZQUIERDO	2007	4	28	1651	1288	1623	0	3	2	1	329	1651
DTTO. CAPITAL	CE. BLVNO LIBERTADOR	PQ. SUCRE	UNIDAD EDUCATIVA DISTRITAL CECILIA NUÑEZ SUCRE	3811	7	69	2950	2198	2881	2	14	2	2	663	2950
DTTO. CAPITAL	CE. BLVNO LIBERTADOR	PQ. SUCRE	MODULO DE SALUD EL MANATIAL	216	1	3	197	182	194	0	0	0	0	12	197
DTTO. CAPITAL	CE. BLVNO LIBERTADOR	PQ. SUCRE	INSTITUTO CECILIO ACOSTA	1722	3	21	1469	620	1448	1	8	2	2	815	1469
DTTO. CAPITAL	CE. BLVNO LIBERTADOR	PQ. SUCRE	ESCUELA BÁSICA NACIONAL EDUARDO CALCAÑO	3014	6	41	2352	1364	2311	0	10	0	1	936	2352
DTTO. CAPITAL	CE. BLVNO LIBERTADOR	PQ. SUCRE	ESCUELA BÁSICA NACIONAL MONSEÑOR RAMÓN INOCENTE LIZARDI	858	2	14	744	543	730	1	6	3	1	176	744
DTTO. CAPITAL	CE. BLVNO LIBERTADOR	PQ. SUCRE	MODULO DE SALUD SAN PEDRO	156	1	1	140	109	139	0	1	0	0	29	140
DTTO. CAPITAL	CE. BLVNO LIBERTADOR	PQ. SUCRE	UNIDAD EDUCATIVA DISTRITAL TAMANAQUITO	1662	3	28	1340	1137	1312	0	3	0	0	172	1340
DTTO. CAPITAL	CE. BLVNO LIBERTADOR	PQ. SUCRE	ESCUELA BÁSICA NACIONAL BOLIVARIANA JOSÉ FLORENCIO JIMÉNEZ	2356	5	48	1813	1193	1765	2	8	2	2	558	1813
DTTO. CAPITAL	CE. BLVNO LIBERTADOR	PQ. SUCRE	COLEGIO VIRGEN DEL PINO	472	1	3	400	293	397	1	0	0	0	103	400
DTTO. CAPITAL	CE. BLVNO LIBERTADOR	PQ. SUCRE	CENTRO DE ATENCIÓN COMUNITARIO DIEGO DE LOZADA	1820	4	36	1457	805	1421	0	12	0	2	602	1457
DTTO. CAPITAL	CE. BLVNO LIBERTADOR	PQ. SUCRE	PREESCOLAR SANTA RITA	1097	2	24	862	616	838	1	6	2	1	212	862
DTTO. CAPITAL	CE. BLVNO LIBERTADOR	PQ. SUCRE	EDUCACION INICIAL ANTOLÍN SEGUNDO ARANA	1013	2	13	858	507	845	0	2	0	2	334	858
DTTO. CAPITAL	CE. BLVNO LIBERTADOR	PQ. SUCRE	ANTIGUO MODULO DE LA POLICIA METROPOLITANA	384	1	4	310	246	306	0	3	0	0	57	310
DTTO. CAPITAL	CE. BLVNO LIBERTADOR	PQ. SUCRE	UNIDAD EDUCATIVA COLEGIO EL SALVADOR DEL MUNDO	1254	3	27	1012	397	985	0	6	0	2	580	1012
DTTO. CAPITAL	CE. BLVNO LIBERTADOR	PQ. SUCRE	ESCUELA BASICA NACIONAL BOLIVARIANA BICENTENARIA SAMUEL ROBINSON	656	2	20	623	592	603	0	0	0	0	11	623
DTTO. CAPITAL	CE. BLVNO LIBERTADOR	PQ. SUCRE	CENTRO DE ORIENTACIÓN PEDAGÓGICA ANDRÉS ELOY BLANCO I	465	1	8	379	259	371	0	2	0	0	110	379
DTTO. CAPITAL	CE. BLVNO LIBERTADOR	PQ. SUCRE	ESCUELA BÁSICA NACIONAL CIUDAD DE CARACAS	922	2	12	679	356	667	0	3	0	0	308	679
DTTO. CAPITAL	CE. BLVNO LIBERTADOR	PQ. SUCRE	LICEO BOLIVARIANO FIDEL JESÚS OROZCO	3266	6	44	2418	1763	2374	2	5	2	0	602	2418
DTTO. CAPITAL	CE. BLVNO LIBERTADOR	PQ. SUCRE	UNIDAD EDUCATIVA PÉREZ BONALDE	2554	5	20	1805	889	1785	1	10	1	1	883	1805
DTTO. CAPITAL	CE. BLVNO LIBERTADOR	PQ. SUCRE	CASA DE TALLERES DEL MUSEO JACOBO BORGES	1694	3	27	1314	762	1287	0	4	1	1	519	1314
DTTO. CAPITAL	CE. BLVNO LIBERTADOR	PQ. SUCRE	CASA DE LA SALUD RIO CARIBE	481	1	5	414	370	409	0	0	1	0	38	414
DTTO. CAPITAL	CE. BLVNO LIBERTADOR	PQ. SUCRE	ESCUELA BÁSICA NACIONAL VISTA HERMOSA	689	2	32	568	419	536	0	1	0	0	116	568
DTTO. CAPITAL	CE. BLVNO LIBERTADOR	PQ. SUCRE	LICEO BOLIVARIANO LUIS ESPELOZIN	3777	7	93	3047	1735	2954	2	13	1	1	1202	3047
DTTO. CAPITAL	CE. BLVNO LIBERTADOR	PQ. SUCRE	UNIDAD EDUCATIVA COLEGIO NIÑO JESÚS DE PRAGA	1270	3	23	982	556	959	0	2	1	2	398	982
DTTO. CAPITAL	CE. BLVNO LIBERTADOR	PQ. SUCRE	ESCUELA BOLIVARIANA NACIONAL SAN MARTÍN	2269	4	31	1738	1319	1707	0	10	0	0	378	1738
DTTO. CAPITAL	CE. BLVNO LIBERTADOR	PQ. SUCRE	JARDÍN DE INFANCIA MONSEÑOR JESÚS MARÍA PELLÍN	771	2	25	649	475	624	0	1	1	0	147	649
DTTO. CAPITAL	CE. BLVNO LIBERTADOR	PQ. SUCRE	ESCUELA BÁSICA NACIONAL DIEGO RENATO MEJIAS	3086	6	40	2479	1232	2439	1	8	1	6	1191	2479
DTTO. CAPITAL	CE. BLVNO LIBERTADOR	PQ. SUCRE	UNIDAD EDUCATIVA DISTRITAL LUIS ANTONIO PADRINO	655	2	23	566	456	543	0	4	2	1	80	566
DTTO. CAPITAL	CE. BLVNO LIBERTADOR	PQ. SUCRE	UNIDAD EDUCATIVA COLEGIO PARROQUIAL LA SAGRADA FAMILIA.	3296	6	67	2688	1449	2621	0	12	4	2	1154	2688
DTTO. CAPITAL	CE. BLVNO LIBERTADOR	PQ. SUCRE	UNIDAD EDUCATIVA SAN JOSÉ	1924	4	31	1578	1135	1547	0	8	2	3	399	1578
DTTO. CAPITAL	CE. BLVNO LIBERTADOR	PQ. SUCRE	COLEGIO DE EDUCACIÒN INTEGRAL DOCTOR RAUL LEONIS	1365	3	30	1201	752	1171	0	6	1	2	410	1201
DTTO. CAPITAL	CE. BLVNO LIBERTADOR	PQ. SUCRE	UNIDAD EDUCATIVA COLEGIO AGRAMONTE	2284	4	45	1956	936	1911	0	9	3	1	962	1956
DTTO. CAPITAL	CE. BLVNO LIBERTADOR	PQ. SUCRE	CENTRO DE EDUCACIÓN INICIAL CARLOS GUINAND SANDOZ	928	2	19	784	409	765	0	10	2	1	343	784
DTTO. CAPITAL	CE. BLVNO LIBERTADOR	PQ. SUCRE	UNIDAD EDUCATIVA NACIONAL PEDRO MANUEL RUIZ	3101	6	53	2510	1431	2457	2	8	2	3	1011	2510
DTTO. CAPITAL	CE. BLVNO LIBERTADOR	PQ. SUCRE	UNIDAD EDUCATIVA BOLIVARIANA CARDENAL QUINTERO	3077	6	89	2407	1679	2318	0	13	0	0	626	2407
DTTO. CAPITAL	CE. BLVNO LIBERTADOR	PQ. SUCRE	CENTRO NACIONAL DE FORMACION PERMANENTE DEL DOCENTE (CENAFOD)	544	1	11	463	298	452	0	2	0	0	152	463
DTTO. CAPITAL	CE. BLVNO LIBERTADOR	PQ. SUCRE	UNIDAD EDUCATIVA DISTRITAL ISAIAS MEDINA ANGARITA	3144	6	43	2567	1799	2524	0	14	2	2	707	2567
DTTO. CAPITAL	CE. BLVNO LIBERTADOR	PQ. SUCRE	ESCUELA INTEGRAL BOLIVARIANA MANUEL ANTONIO GÓMEZ	1101	2	12	934	752	922	0	0	0	2	168	934
DTTO. CAPITAL	CE. BLVNO LIBERTADOR	PQ. SUCRE	FUNDACIÓN DEL NIÑO CENTRO EDUCATIVO RECREACIONAL SIMON BOLIVAR I	1008	2	18	857	500	839	0	6	1	1	331	857
DTTO. CAPITAL	CE. BLVNO LIBERTADOR	PQ. SUCRE	UNIDAD EDUCATIVA VIRGINIA DE RUIZ FE Y ALEGRÍA	3038	6	42	2457	1658	2415	1	13	1	2	740	2457
DTTO. CAPITAL	CE. BLVNO LIBERTADOR	PQ. SUCRE	LICEO BOLIVARIANO ANDRÉS ELOY BLANCO	3577	7	79	2785	1773	2706	1	12	1	3	916	2785
DTTO. CAPITAL	CE. BLVNO LIBERTADOR	PQ. SUCRE	ESCUELA BÁSICA MIGUEL ÁNGEL LÓPEZ CÁRDENAS	4455	8	111	3675	2392	3564	1	14	1	6	1150	3675
DTTO. CAPITAL	CE. BLVNO LIBERTADOR	PQ. SUCRE	ESCUELA GRADUADA GRACIELA NAVAS TOVAR	3370	6	46	2750	2158	2704	0	12	4	1	529	2750
DTTO. CAPITAL	CE. BLVNO LIBERTADOR	PQ. SUCRE	ESCUELA BÁSICA NACIONAL ESPAÑA	5357	10	74	4402	2524	4328	3	24	2	4	1771	4402
DTTO. CAPITAL	CE. BLVNO LIBERTADOR	PQ. SUCRE	PREESCOLAR ANDRÉS MATA	284	1	1	253	189	252	0	0	0	0	63	253
DTTO. CAPITAL	CE. BLVNO LIBERTADOR	PQ. SUCRE	CENTRO DE EDUCACIÓN INICIAL PRIVADO LLUVIA DE GRACIA	345	1	5	299	189	294	0	4	0	1	100	299
DTTO. CAPITAL	CE. BLVNO LIBERTADOR	PQ. SUCRE	UNIDAD EDUCATIVA COLEGIO DE LA PRESENTACION	2370	5	19	1985	967	1966	1	8	0	6	984	1985
DTTO. CAPITAL	CE. BLVNO LIBERTADOR	PQ. SUCRE	UNIDAD EDUCATIVA NACIONAL MARIA LUISA ESTRADA MONTUFAR	3275	6	73	2573	1775	2500	0	5	2	5	713	2573
DTTO. CAPITAL	CE. BLVNO LIBERTADOR	PQ. SUCRE	UNIDAD EDUCATIVA COLEGIO PARROQUIAL SANTA TERESITA	3310	6	35	2731	1177	2696	1	22	1	4	1491	2731
DTTO. CAPITAL	CE. BLVNO LIBERTADOR	PQ. SUCRE	UNIDAD EDUCATIVA NACIONAL BOLIVARIANA SOCORRO MACHADO	2111	4	35	1685	985	1650	0	6	0	2	657	1685
DTTO. CAPITAL	CE. BLVNO LIBERTADOR	PQ. SUCRE	UNIDAD EDUCATIVA NUEVA ESPARTA	3567	7	49	2842	1978	2793	1	16	1	2	795	2842
DTTO. CAPITAL	CE. BLVNO LIBERTADOR	PQ. SUCRE	MODULO DE LA POLICIA NACIONAL CASALTA 3	225	1	4	182	140	178	0	0	0	0	38	182
DTTO. CAPITAL	CE. BLVNO LIBERTADOR	PQ. SUCRE	PREESCOLAR ASISTENCIAL SAN ONOFRE	400	1	4	349	263	345	0	2	0	1	79	349
DTTO. CAPITAL	CE. BLVNO LIBERTADOR	PQ. SUCRE	ESCUELA BÉSICA FE Y ALEGRIA VIRGEN NIÑA	1108	2	20	949	681	929	0	2	1	2	243	949
DTTO. CAPITAL	CE. BLVNO LIBERTADOR	PQ. SUCRE	UNIDAD EDUCATIVA PREESCOLAR VIANNEY	1628	3	51	1334	894	1283	1	8	1	3	376	1334
DTTO. CAPITAL	CE. BLVNO LIBERTADOR	PQ. SUCRE	UNIDAD EDUCATIVA NACIONAL NUEVA CARACAS	4948	9	152	4036	2537	3884	1	25	2	5	1314	4036
DTTO. CAPITAL	CE. BLVNO LIBERTADOR	PQ. SUCRE	UNIDAD EDUCATIVA NACIONAL BOLIVARIANA EDUARDO ROHLL	2872	5	36	2338	1367	2302	1	17	3	4	910	2338
DTTO. CAPITAL	CE. BLVNO LIBERTADOR	PQ. SUCRE	CENTRO PREESCOLAR FUNDAPOL	656	2	4	488	246	484	0	3	0	0	235	488
DTTO. CAPITAL	CE. BLVNO LIBERTADOR	PQ. SUCRE	MODULO DE SALUD MANUELITA SAENZ	220	1	3	176	136	173	0	1	1	0	35	176
DTTO. CAPITAL	CE. BLVNO LIBERTADOR	PQ. SUCRE	CENTRO COMUNAL CATIA	1449	3	18	1113	722	1095	0	11	1	0	361	1113
DTTO. CAPITAL	CE. BLVNO LIBERTADOR	PQ. SUCRE	UNIDAD EDUCATIVA BOLIVARIANA JOSÉ GERVASIO ARTIGAS	2396	5	50	1919	1169	1869	1	19	4	1	675	1919
DTTO. CAPITAL	CE. BLVNO LIBERTADOR	PQ. SUCRE	UNIDAD EDUCATIVA MANUEL LANDAETA ROSALES	1143	2	20	961	420	941	2	6	2	2	509	961
DTTO. CAPITAL	CE. BLVNO LIBERTADOR	PQ. SUCRE	LICEO BOLIVARIANO JOSÉ FELIX BLANCO	1443	3	22	1100	484	1078	0	2	0	0	592	1100
DTTO. CAPITAL	CE. BLVNO LIBERTADOR	PQ. SUCRE	LICEO BOLIVARIANO ALMIRANTE BRIÓN	1748	3	31	1530	1038	1499	2	5	0	4	450	1530
DTTO. CAPITAL	CE. BLVNO LIBERTADOR	PQ. SUCRE	UNIDAD EDUCATIVA DISTRITAL TULIO FEBRES CORDERO	2535	5	31	2057	1368	2026	0	4	1	3	650	2057
DTTO. CAPITAL	CE. BLVNO LIBERTADOR	PQ. SUCRE	UNIDAD EDUCATIVA NACIONAL ANTONIO JOSÉ DE SUCRE	4942	9	85	3853	2212	3768	1	19	4	6	1526	3853
DTTO. CAPITAL	CE. BLVNO LIBERTADOR	PQ. SUCRE	ESCUELA MANUEL MARÍA ECHANDÍA	3704	7	72	2891	2228	2819	5	10	2	4	570	2891
DTTO. CAPITAL	CE. BLVNO LIBERTADOR	PQ. SUCRE	UNIDAD EDUCATIVA NACIONAL INTEGRAL BOLIVARIANA AGUSTÍN AVELEDO	3480	6	45	2760	1647	2715	3	15	2	3	1045	2760
DTTO. CAPITAL	CE. BLVNO LIBERTADOR	PQ. SUCRE	ESCUELA BÁSICA NACIONAL CIUDAD DE BARCELONA	2970	6	61	2320	1163	2259	2	7	2	0	1085	2320
DTTO. CAPITAL	CE. BLVNO LIBERTADOR	PQ. SUCRE	UNIDAD EDUCATIVA ARNOLDO GABALDON	220	1	2	195	174	193	0	0	0	0	19	195
DTTO. CAPITAL	CE. BLVNO LIBERTADOR	PQ. SUCRE	CENTRO PREESCOLAR ANDRES ELOY BLANCO	309	1	7	243	168	236	0	2	0	0	66	243
DTTO. CAPITAL	CE. BLVNO LIBERTADOR	PQ. SUCRE	ESCUELA NACIONAL AMÉRICA	575	1	9	432	240	423	0	1	0	0	182	432
DTTO. CAPITAL	CE. BLVNO LIBERTADOR	PQ. SUCRE	CENTRO DE SALUD CHE GUEVARA	185	1	2	174	155	172	0	0	0	0	17	174
DTTO. CAPITAL	CE. BLVNO LIBERTADOR	PQ. SUCRE	ESCUELA MUNICIPAL LORENZO HERRERA MENDOZA	1677	3	23	1358	1023	1335	0	10	0	1	301	1358
DTTO. CAPITAL	CE. BLVNO LIBERTADOR	PQ. SUCRE	LICEO BOLIVARIANO GUSTAVO H. MACHADO	1647	3	18	1299	817	1281	1	4	1	1	457	1299
DTTO. CAPITAL	CE. BLVNO LIBERTADOR	PQ. SUCRE	ESCUELA PARROQUIAL MADRE CABRINI	1171	2	15	961	385	946	0	8	0	2	551	961
DTTO. CAPITAL	CE. BLVNO LIBERTADOR	PQ. SUCRE	CASA INTEGRAL 13 DE ABRIL	288	1	7	248	201	241	1	2	0	0	37	248
DTTO. CAPITAL	CE. BLVNO LIBERTADOR	PQ. SUCRE	PREESCOLAR LUIS PASTEUR	254	1	9	223	146	214	0	1	0	0	67	223
DTTO. CAPITAL	CE. BLVNO LIBERTADOR	PQ. SUCRE	UNIDAD EDUCATIVA NACIONAL 24 DE JULIO	3992	7	67	3288	1981	3221	0	17	3	4	1216	3288
DTTO. CAPITAL	CE. BLVNO LIBERTADOR	PQ. SUCRE	UNIDAD MATERNAL ASISTENCIAL MIS PRIMEROS PASOS	324	1	5	264	200	259	0	3	0	0	56	264
DTTO. CAPITAL	CE. BLVNO LIBERTADOR	PQ. SUCRE	UNIDAD EDUCATIVA DISTRITAL GUSTAVO LEDO	1464	3	13	1212	672	1199	1	6	2	2	516	1212
DTTO. CAPITAL	CE. BLVNO LIBERTADOR	PQ. SUCRE	UNIDAD EDUCATIVA DISTRITAL UNITARIA Nº 4	411	1	5	356	262	351	0	1	0	1	87	356
DTTO. CAPITAL	CE. BLVNO LIBERTADOR	PQ. SUCRE	PREESCOLAR SANTA TERESITA DEL NIÑO JESÚS	337	1	8	307	226	299	0	1	0	2	70	307
DTTO. CAPITAL	CE. BLVNO LIBERTADOR	PQ. SUCRE	CENTRO DE EDUCACIÓN INTEGRAL PASITO A PASITO	267	1	0	225	183	225	0	2	0	0	40	225
DTTO. CAPITAL	CE. BLVNO LIBERTADOR	PQ. SUCRE	SOCIEDAD EDUCATIVA ASISTENCIAL JOSÉ LEONARDO CHIRINOS	575	1	9	454	332	445	0	2	0	0	111	454
DTTO. CAPITAL	CE. BLVNO LIBERTADOR	PQ. SUCRE	UNIDAD EDUCATIVA DISTRITAL PABLO II	766	2	6	656	547	650	0	2	0	0	101	656
DTTO. CAPITAL	CE. BLVNO LIBERTADOR	PQ. SUCRE	CENTRO EDUCATIVO LA INMACULADA	411	1	8	365	262	357	0	2	0	1	92	365
DTTO. CAPITAL	CE. BLVNO LIBERTADOR	PQ. SUCRE	PREESCOLAR RAFAEL URDANETA	458	1	3	402	288	399	0	3	0	0	108	402
DTTO. CAPITAL	CE. BLVNO LIBERTADOR	PQ. SUCRE	ANTIGUA LECHERIA LA SILSA	565	1	9	451	332	442	0	2	0	0	108	451
DTTO. CAPITAL	CE. BLVNO LIBERTADOR	PQ. SUCRE	ESCUELA BÁSICA NACIONAL DON ROMULO GALLEGOS.	741	2	13	628	445	615	0	4	1	1	164	628
DTTO. CAPITAL	CE. BLVNO LIBERTADOR	PQ. SUCRE	CASA DE LA CIUDADANÍA EMILIO MOGOLLÓN	1215	3	17	925	670	908	0	4	0	0	234	925
DTTO. CAPITAL	CE. BLVNO LIBERTADOR	PQ. SUCRE	LOCAL DE LA CANCHA ANDRÉS QUINTERO	423	1	4	379	266	375	0	3	1	1	104	379
DTTO. CAPITAL	CE. BLVNO LIBERTADOR	PQ. SUCRE	UNIDAD EDUCATIVA NACIONAL BOLIVARIANA BALTAZAR PADRÓN	1296	3	13	1121	557	1108	0	4	1	0	546	1121
DTTO. CAPITAL	CE. BLVNO LIBERTADOR	PQ. SUCRE	UNIDAD EDUCATIVA COLEGIO PARROQUIAL SAN RAMÓN NONATO	3801	7	89	2954	1735	2865	0	19	0	4	1107	2954
DTTO. CAPITAL	CE. BLVNO LIBERTADOR	PQ. SUCRE	UNIDAD EDUCATIVA PRIVADA FUENTE DE JACOB	797	2	15	685	415	670	1	2	0	1	251	685
DTTO. CAPITAL	CE. BLVNO LIBERTADOR	PQ. SUCRE	UNIDAD EDUCATIVA PRIVADA EL CRISTO	1422	3	21	1196	606	1175	2	5	3	1	558	1196
DTTO. CAPITAL	CE. BLVNO LIBERTADOR	PQ. SUCRE	HOGAIN FRAILES II	165	1	3	134	112	131	0	0	0	0	19	134
DTTO. CAPITAL	CE. BLVNO LIBERTADOR	PQ. SUCRE	UNIDAD EDUCATIVA DISTRITAL TERESA CARREÑO	1553	3	28	1229	674	1201	1	6	0	1	519	1229
DTTO. CAPITAL	CE. BLVNO LIBERTADOR	PQ. SUCRE	SINDICATO SUNEPSAS	752	2	12	617	416	605	0	3	0	1	185	617
DTTO. CAPITAL	CE. BLVNO LIBERTADOR	PQ. SUCRE	DESARROLLO URBANISTICO AGUA SALUD	45	1	0	45	44	45	0	0	0	0	1	45
DTTO. CAPITAL	CE. BLVNO LIBERTADOR	PQ. SUCRE	ESCUELA BÁSICA NACIONAL 24 DE JUNIO	585	1	2	454	401	452	0	2	0	0	49	454
DTTO. CAPITAL	CE. BLVNO LIBERTADOR	PQ. SUCRE	PREESCOLAR MI ESPERANZA	512	1	8	443	336	435	0	3	0	1	95	443
DTTO. CAPITAL	CE. BLVNO LIBERTADOR	PQ. SUCRE	LICEO BOLIVARIANO JUAN LANDAETA	1604	3	25	1235	698	1210	2	6	1	3	500	1235
DTTO. CAPITAL	CE. BLVNO LIBERTADOR	PQ. SUCRE	UNIDAD EDUCATIVA BOLIVARIANA MONSEÑOR JESÚS MARÍA PELLÍN	3032	6	46	2430	1669	2384	1	17	1	2	694	2430
DTTO. CAPITAL	CE. BLVNO LIBERTADOR	PQ. SUCRE	UNIDAD EDUCATIVA DISTRITAL EL PAUJI	1349	3	16	1055	858	1039	1	8	3	2	167	1055
DTTO. CAPITAL	CE. BLVNO LIBERTADOR	PQ. SUCRE	CENTRO COMUNITARIO EL LIMÓN	430	1	3	337	278	334	1	2	0	0	53	337
DTTO. CAPITAL	CE. BLVNO LIBERTADOR	PQ. SUCRE	REGISTRO CIVIL	31	1	0	20	9	20	0	0	1	0	10	20
DTTO. CAPITAL	CE. BLVNO LIBERTADOR	PQ. SUCRE	UNIDAD EDUCATIVA BOLIVARIANA SERGIO MEDINA	3106	6	53	2367	1263	2314	0	13	1	5	1032	2367
DTTO. CAPITAL	CE. BLVNO LIBERTADOR	PQ. SUCRE	INSTITUTO EDUCACIONAL GLADYS DE FREITES	1393	3	20	1183	609	1163	1	4	0	6	543	1183
DTTO. CAPITAL	CE. BLVNO LIBERTADOR	PQ. SUCRE	ESCUELA BÁSICA DISTRITAL JOSÉ ANTONIO GONZÁLEZ	765	2	14	641	261	627	0	4	0	2	360	641
DTTO. CAPITAL	CE. BLVNO LIBERTADOR	PQ. SUCRE	UNIDAD EDUCATIVA DISTRITAL CECILIA PIMENTEL	3159	6	85	2579	1359	2494	2	10	1	2	1120	2579
DTTO. CAPITAL	CE. BLVNO LIBERTADOR	PQ. SUCRE	UNIDAD EDUCATIVA DISTRITAL JOSÉ ÁNGEL LAMAS	1861	4	29	1590	1109	1561	0	5	0	0	447	1590
DTTO. CAPITAL	CE. BLVNO LIBERTADOR	PQ. SUCRE	ASOCIACION CIVIL NUEVA COMUNIDAD SOCIALISTA	284	1	6	264	246	258	0	1	0	0	11	264
DTTO. CAPITAL	CE. BLVNO LIBERTADOR	PQ. SUCRE	CENTRO DE CAPACITACION ISAIAS MEDINA ANGARITA	2137	4	35	1717	1161	1682	0	6	0	0	515	1717
DTTO. CAPITAL	CE. BLVNO LIBERTADOR	PQ. SUCRE	ESCUELA BÁSICA NACIONAL 12 DE MARZO	1612	3	32	1358	883	1326	1	5	1	1	435	1358
DTTO. CAPITAL	CE. BLVNO LIBERTADOR	PQ. SUCRE	PLANTA CANTINAS PDVSA	322	1	2	260	220	258	0	1	0	1	36	260
DTTO. CAPITAL	CE. BLVNO LIBERTADOR	PQ. SUCRE	UNIDAD EDUCATIVA NACIONAL BÁSICA CATIA	1040	2	13	856	582	843	0	5	1	0	255	856
DTTO. CAPITAL	CE. BLVNO LIBERTADOR	PQ. SUCRE	CLUB SOCIAL DEPORTIVO ECUADOR	277	1	5	232	180	227	0	2	0	0	45	232
DTTO. CAPITAL	CE. BLVNO LIBERTADOR	PQ. SUCRE	ESCUELA FEDERICO QUIROZ	2031	4	46	1546	1075	1500	0	9	3	0	413	1546
DTTO. CAPITAL	CE. BLVNO LIBERTADOR	PQ. SUCRE	UNIDAD EDUCATIVA EUGENIO MENDOZA	3888	7	51	3108	2024	3057	1	18	0	4	1010	3108
DTTO. CAPITAL	CE. BLVNO LIBERTADOR	PQ. SUCRE	UNIDAD EDUCATIVA COLEGIO MADRE CECILIA CROSS FE Y ALEGRIA	2490	5	90	1831	1039	1741	2	5	1	1	693	1831
DTTO. CAPITAL	CE. BLVNO LIBERTADOR	PQ. SUCRE	UNIDAD EDUCATIVA PRIVADA CIUDAD DE ANGOSTURA	483	1	7	416	278	409	1	4	0	0	126	416
DTTO. CAPITAL	CE. BLVNO LIBERTADOR	PQ. SUCRE	PREESCOLAR ASISTENCIAL URDANETA	325	1	0	289	161	289	0	0	0	0	128	289
DTTO. CAPITAL	CE. BLVNO LIBERTADOR	PQ. SUCRE	CASA PARROQUIAL SANTO CRISTO	175	1	5	140	108	135	0	1	0	0	26	140
DTTO. CAPITAL	CE. BLVNO LIBERTADOR	PQ. SUCRE	UNIDAD EDUCATIVA COLEGIO LA SANTISIMA TRINIDAD	3313	6	51	2802	1445	2751	0	5	1	3	1297	2802
DTTO. CAPITAL	CE. BLVNO LIBERTADOR	PQ. SUCRE	PREESCOLAR ARTURO USLAR PIETRI	357	1	23	313	193	290	0	0	0	0	97	313
DTTO. CAPITAL	CE. BLVNO LIBERTADOR	PQ. SUCRE	NÚCLEO DE DESARROLLO ENDÓGENO FABRICIO OJEDA	1228	3	18	996	814	978	1	7	0	1	155	996
DTTO. CAPITAL	CE. BLVNO LIBERTADOR	PQ. SUCRE	UNIDAD EDUCATIVA DISTRITAL ALEJANDRO FUENMAYOR	697	2	15	603	317	588	0	5	0	2	264	603
DTTO. CAPITAL	CE. BLVNO LIBERTADOR	PQ. SUCRE	PREESCOLAR HERCILIA	301	1	9	271	180	262	0	0	0	0	82	271
DTTO. CAPITAL	CE. BLVNO LIBERTADOR	PQ. SUCRE	HOGARES DE ATENCIÓN INTEGRAL PARA NIÑOS Y NIÑAS (HOGAIN) DIVINO NIÑO JESÚS	169	1	1	136	115	135	0	1	0	0	19	136
DTTO. CAPITAL	CE. BLVNO LIBERTADOR	PQ. SUCRE	OFICINA POSTAL TELEGRÁFICA ZONA POSTAL 1030	1129	2	19	865	481	846	1	2	0	2	360	865
DTTO. CAPITAL	CE. BLVNO LIBERTADOR	PQ. SUCRE	UNIDAD EDUCATIVA PRIVADA NUESTRA SEÑORA DE AGUA SANTA	674	2	16	574	364	558	1	2	0	1	190	574
DTTO. CAPITAL	CE. BLVNO LIBERTADOR	PQ. SUCRE	ESCUELA TÉCNICA  INDUSTRIAL ROBINSONIANA RAFAEL VEGAS	2405	5	48	1908	1189	1860	0	9	2	2	658	1908
DTTO. CAPITAL	CE. BLVNO LIBERTADOR	PQ. SUCRE	ESCUELA PARROQUIAL LA CONSTANCIA	1268	3	19	987	601	968	0	3	0	0	364	987
DTTO. CAPITAL	CE. BLVNO LIBERTADOR	PQ. SUCRE	UNIDAD EDUCATIVA NACIONAL LICEO BOLIVARIANO NICANOR BOLET PERAZA	3365	6	61	2867	1573	2806	0	13	4	7	1209	2867
DTTO. CAPITAL	CE. BLVNO LIBERTADOR	PQ. SUCRE	LICEO BOLIVARIANO JUAN DE GURRUCEAGA	2787	5	83	2350	1691	2267	0	14	3	3	556	2350
DTTO. CAPITAL	CE. BLVNO LIBERTADOR	PQ. SUCRE	UNIDAD EDUCATIVA VIRGINIA DE RUIZ	3418	6	73	2735	1877	2662	0	11	2	2	770	2735
DTTO. CAPITAL	CE. BLVNO LIBERTADOR	PQ. SUCRE	ESCUELA BASICA NACIONAL SUCRE	3606	7	55	2910	1522	2855	0	18	4	4	1307	2910
DTTO. CAPITAL	CE. BLVNO LIBERTADOR	PQ. SUCRE	ESCUELA BÁSICA NACIONAL NUEVO HORIZONTE	4437	8	133	3330	2358	3197	0	16	2	3	818	3330
DTTO. CAPITAL	CE. BLVNO LIBERTADOR	PQ. SUCRE	ESCUELA BÁSICA NACIONAL EL AMPARO	993	2	20	802	511	782	0	3	0	0	268	802
DTTO. CAPITAL	CE. BLVNO LIBERTADOR	PQ. SUCRE	MUSEO JACOBO BORGES	1934	4	29	1478	867	1449	2	10	2	2	566	1478
DTTO. CAPITAL	CE. BLVNO LIBERTADOR	PQ. SUCRE	UNIDAD EDUCATIVA NACIONAL ANIBAL FLORENCIO MENDEZ	209	1	8	155	123	147	0	3	0	0	21	155
DTTO. CAPITAL	CE. BLVNO LIBERTADOR	PQ. SUCRE	UNIDAD EDUCATIVA PRIVADA JUAN PABLO II FE Y ALEGRIA	1297	3	15	1023	800	1008	0	6	0	0	202	1023
DTTO. CAPITAL	CE. BLVNO LIBERTADOR	PQ. SUCRE	CASA COMUNAL QUERER ES PODER	412	1	7	340	271	333	0	1	0	1	60	340
DTTO. CAPITAL	CE. BLVNO LIBERTADOR	PQ. SUCRE	SALA DE BATALLA SOCIAL CACICA ANA SOTO	123	1	0	104	77	104	0	0	0	0	27	104
DTTO. CAPITAL	CE. BLVNO LIBERTADOR	PQ. SUCRE	AMBULATORIO URBANO TIPO II NUEVA CARACAS	1720	3	22	1224	719	1202	1	2	1	0	479	1224
EDO. TRUJILLO	MP. PAMPANITO	PQ. LA CONCEPCION	UNIDAD EDUCATIVA SIMÓN RODRIGUEZ	269	1	2	229	166	227	0	1	0	1	59	229
EDO. TRUJILLO	MP. PAMPANITO	PQ. LA CONCEPCION	SEDE PRINCIPAL DE PROTECCIÓN CIVIL	395	1	7	366	207	359	0	0	0	0	152	366
EDO. TRUJILLO	MP. PAMPANITO	PQ. LA CONCEPCION	UNIDAD EDUCATIVA PROFESOR JOSÉ ALBERTO AZUAJE	1002	2	25	879	450	854	0	2	0	1	401	879
EDO. TRUJILLO	MP. PAMPANITO	PQ. LA CONCEPCION	MULTIHOGAR GOTITA DE AMOR	70	1	0	60	50	60	0	2	0	0	8	60
EDO. TRUJILLO	MP. PAMPANITO	PQ. LA CONCEPCION	ESCUELA CONCENTRADA LA CONCEPCIÓN	1514	3	17	1247	781	1230	0	5	1	0	443	1247
EDO. TRUJILLO	MP. PAMPANITO	PQ. PAMPANITO	BIBLIOTECA PÚBLICA	1234	3	22	1009	600	987	0	4	0	0	383	1009
EDO. TRUJILLO	MP. PAMPANITO	PQ. PAMPANITO	CENTRO MÓVIL ADYACENTE AL AMBULATORIO RURAL TIPO I LA MURALLA	742	2	15	692	473	677	0	3	0	0	201	692
EDO. TRUJILLO	MP. PAMPANITO	PQ. PAMPANITO	CASA COMUNAL LOMA DE LOS MOMONES	119	1	4	105	97	101	0	0	0	0	4	105
EDO. TRUJILLO	MP. PAMPANITO	PQ. PAMPANITO	ESCUELA TÉCNICA ROBINSONIANA AGROPECUARIA ADOLFO NAVAS CORONADO	677	2	15	558	288	543	0	2	0	0	253	558
EDO. TRUJILLO	MP. PAMPANITO	PQ. PAMPANITO	LICEO BOLIVARIANO PROFESOR ALFREDO RAMON DELGADO MEJIAS	121	1	3	105	61	102	0	0	0	1	40	105
EDO. TRUJILLO	MP. PAMPANITO	PQ. PAMPANITO	ESCUELA ESTADAL CONCENTRADA DOLORES DIONISIA SANTO MORENO	485	1	11	377	312	366	0	4	0	0	50	377
EDO. TRUJILLO	MP. PAMPANITO	PQ. PAMPANITO	UNIDAD EDUCATIVA PROFESOR SANTIAGO SANCHEZ	1947	4	24	1732	902	1708	1	3	1	0	801	1732
EDO. TRUJILLO	MP. PAMPANITO	PQ. PAMPANITO	ESCUELA BOLIVARIANA JUAN IGNACIO MONTILLA	2616	5	31	2148	1264	2117	1	9	0	1	842	2148
EDO. TRUJILLO	MP. PAMPANITO	PQ. PAMPANITO II	ESCUELA BOLIVARIANA VIVIENDA RURAL	2992	6	38	2494	1639	2456	0	8	0	0	809	2494
EDO. TRUJILLO	MP. PAMPANITO	PQ. PAMPANITO II	CANCHA DEPORTIVA RAFAEL ROSARIO	65	1	0	49	42	49	2	0	0	0	5	49
EDO. TRUJILLO	MP. PAMPANITO	PQ. PAMPANITO II	ESCUELA BOLIVARIANA JARDIN DE INFANCIA BUTAQUE	824	2	11	664	481	653	0	5	0	0	167	664
EDO. TRUJILLO	MP. PAMPANITO	PQ. PAMPANITO II	ESCUELA ESTADAL PALO NEGRO	452	1	3	383	319	380	0	1	0	0	60	383
EDO. TRUJILLO	MP. PAMPANITO	PQ. PAMPANITO II	UNIDAD EDUCATIVA SANTO DOMINGO	1098	2	22	903	574	881	0	6	1	0	300	903
EDO. TRUJILLO	MP. PAMPANITO	PQ. PAMPANITO II	ESCUELA BOLIVARIANA ALICIA PRIETI DE CALDERA	664	2	21	573	403	552	0	1	1	0	147	573
EDO. TRUJILLO	MP. MOTATAN	PQ. MOTATAN	CENTRO DE EDUCACION INICIAL BOLIVARIANO ANTONIO NICOLAS BRICEÑO	945	2	17	730	460	713	1	6	0	0	246	730
EDO. TRUJILLO	MP. MOTATAN	PQ. MOTATAN	ESCUELA BOLIVARIANA ANTONIO NICOLAS BRICEÑO	1913	4	34	1514	993	1480	0	8	0	1	478	1514
EDO. TRUJILLO	MP. MOTATAN	PQ. MOTATAN	ESCUELA BOLIVARIANA NER 175	291	1	4	277	233	273	0	1	0	0	39	277
EDO. TRUJILLO	MP. MOTATAN	PQ. MOTATAN	LICEO BOLIVARIANO HILARIO PIZANI ANSELMI	2476	5	81	2116	1342	2035	0	7	0	1	685	2116
EDO. TRUJILLO	MP. MOTATAN	PQ. MOTATAN	UNIDAD EDUCATIVA DOCTOR RAUL LEONI	1439	3	24	1251	852	1227	0	6	0	0	369	1251
EDO. TRUJILLO	MP. MOTATAN	PQ. MOTATAN	ESCUELA BOLIVARIANA GIRALUNA NER 175	1353	3	22	1146	809	1124	0	1	0	0	314	1146
EDO. TRUJILLO	MP. MOTATAN	PQ. EL BA#O	ESCUELA ESTADAL EL CACAO	369	1	8	342	268	334	0	0	0	0	66	342
EDO. TRUJILLO	MP. MOTATAN	PQ. EL BA#O	ESCUELA BOLIVARIANA EL BAÑO	1074	2	19	939	612	920	0	2	1	0	305	939
EDO. TRUJILLO	MP. MOTATAN	PQ. JALISCO	ESCUELA BOLIVARIANA AGUA BLANCA	492	1	6	430	373	424	0	0	1	0	50	430
EDO. TRUJILLO	MP. MOTATAN	PQ. JALISCO	ESCUELA CONCENTRADA SAN GONZALO	174	1	8	167	132	159	0	0	1	0	26	167
EDO. TRUJILLO	MP. MOTATAN	PQ. JALISCO	SIMINCITO BRISAS DE JALISCO	398	1	8	380	251	372	0	2	0	0	119	380
EDO. TRUJILLO	MP. MOTATAN	PQ. JALISCO	UNIDAD EDUCATIVA JALISCO	1942	4	50	1622	1198	1572	1	3	1	0	369	1622
EDO. TRUJILLO	MP. MOTATAN	PQ. JALISCO	ESCUELA CONCENTRADA  SAN MIGUEL NER 175	178	1	7	164	141	157	0	1	0	0	15	164
EDO. TRUJILLO	MP. ANDRES BELLO	PQ. EL JAGUITO	ESCUELA PREVOCACIONAL LOS NEGROS	1958	4	56	1465	885	1409	0	1	1	0	522	1465
EDO. TRUJILLO	MP. ANDRES BELLO	PQ. EL JAGUITO	UNIDAD BASICA CUATRO BOCAS DE CARRILLO NER 203	215	1	2	179	143	177	0	1	0	0	33	179
EDO. TRUJILLO	MP. ANDRES BELLO	PQ. EL JAGUITO	UNIDAD EDUCATIVA GENERAL EN JEFE JOSE DE LA CRUZ CARRILLO TERAN	534	1	9	397	346	388	0	0	0	0	42	397
EDO. TRUJILLO	MP. ANDRES BELLO	PQ. SANTA ISABEL	ESCUELA BOLIVARIANA SANTA ROSA	807	2	16	651	457	635	0	0	0	0	178	651
EDO. TRUJILLO	MP. ANDRES BELLO	PQ. SANTA ISABEL	ESCUELA CONCENTRADA NUMERO 346 LA ATASCOSA	441	1	0	351	294	351	0	2	0	0	55	351
EDO. TRUJILLO	MP. ANDRES BELLO	PQ. SANTA ISABEL	UNIDAD EDUCATIVA CORONEL MIGUEL VICENTE CEGARRA	614	2	10	452	287	442	0	0	0	0	155	452
EDO. TRUJILLO	MP. ANDRES BELLO	PQ. SANTA ISABEL	UNIDAD BÁSICA PASCUAL IGNACIO VILLASMIL	2950	5	73	2203	1381	2130	0	8	3	1	737	2203
EDO. TRUJILLO	MP. ANDRES BELLO	PQ. ARAGUANEY	ESCUELA BOLIVARIANA LA CURVA	284	1	4	254	195	250	0	0	0	0	55	254
EDO. TRUJILLO	MP. ANDRES BELLO	PQ. ARAGUANEY	UNIDAD EDUCATIVA EL ARAGUANEY	1274	3	18	908	543	890	0	2	0	0	345	908
EDO. TRUJILLO	MP. ANDRES BELLO	PQ. LA ESPERANZA	ESCUELA RURAL DE EDUCACIÓN BÁSICA LAS PALMAS	1088	2	36	824	605	788	0	2	0	0	181	824
EDO. TRUJILLO	MP. ANDRES BELLO	PQ. LA ESPERANZA	ESCUELA ESTADAL GRADUADA ANTONIO PINTO SALINAS	994	2	15	755	509	740	0	0	0	0	231	755
EDO. TRUJILLO	MP. ANDRES BELLO	PQ. LA ESPERANZA	ESCUELA BOLIVARIANA LA SABANA	563	1	11	416	338	405	0	1	0	0	66	416
EDO. TRUJILLO	MP. BOCONO	PQ. MOSQUEY	ESCUELA BOLIVARIANA LAS PALMITAS	94	1	3	89	58	86	0	1	0	0	27	89
EDO. TRUJILLO	MP. BOCONO	PQ. MOSQUEY	ESCUELA BOLIVARIANA RURAL DOCTOR CARLOS BARAZARTE	2947	5	31	2331	1750	2300	0	19	1	1	529	2331
EDO. TRUJILLO	MP. BOCONO	PQ. MOSQUEY	UNIDAD EDUCATIVA DOCTOR ALBERTO CARNEVALLI	665	2	7	528	454	521	0	3	0	0	64	528
EDO. TRUJILLO	MP. BOCONO	PQ. EL CARMEN	ESCUELA ESTADAL CONCENTRADA NÚMERO 60, LOMA ISLETA I	926	2	19	721	583	702	0	1	0	0	118	721
EDO. TRUJILLO	MP. BOCONO	PQ. EL CARMEN	ESCUELA BOLIVARIANA LA CAVITA	125	1	5	116	86	111	0	1	0	0	24	116
EDO. TRUJILLO	MP. BOCONO	PQ. EL CARMEN	ESCUELA BOLIVARIANA  LOMA DE MITIMBIS	810	2	10	660	517	650	0	7	1	0	125	660
EDO. TRUJILLO	MP. BOCONO	PQ. EL CARMEN	LICEO BOLIVARIANO ANDRES LOMELLI ROSARIO	610	2	7	492	265	485	0	8	1	0	211	492
EDO. TRUJILLO	MP. BOCONO	PQ. EL CARMEN	UNIDAD EDUCATIVA  AMÉRICA FERNÁNDEZ DE LEONI	2572	5	42	2093	1149	2051	1	13	1	1	886	2093
EDO. TRUJILLO	MP. BOCONO	PQ. EL CARMEN	LICEO BOLIVARIANO MONSEÑOR MEJIAS	714	2	11	544	327	533	1	3	0	1	201	544
EDO. TRUJILLO	MP. BOCONO	PQ. EL CARMEN	ESCUELA CASA DE LOS NIÑOS EL ROSAL	1355	3	33	1137	610	1104	0	3	1	1	489	1137
EDO. TRUJILLO	MP. BOCONO	PQ. EL CARMEN	ESCUELA BOLIVARIANA LOMA EL PABELLÓN	1660	3	21	1286	1036	1265	0	9	0	0	220	1286
EDO. TRUJILLO	MP. BOCONO	PQ. EL CARMEN	ESCUELA ESTADAL BISNACA NER SFR	441	1	10	360	314	350	0	0	0	0	36	360
EDO. TRUJILLO	MP. BOCONO	PQ. EL CARMEN	GRUPO ESCOLAR BOLIVARIANO MÁXIMO SAAVEDRA	3477	6	40	2812	1340	2772	0	18	2	2	1410	2812
EDO. TRUJILLO	MP. BOCONO	PQ. EL CARMEN	ESCUELA BOLIVARIANA MONSEÑOR MEJIAS	3117	6	74	2500	1379	2426	2	22	1	1	1021	2500
EDO. TRUJILLO	MP. BOCONO	PQ. EL CARMEN	ESCUELA ESTADAL UNITARIA SIN NÚMERO	171	1	2	115	96	113	0	0	0	0	17	115
EDO. TRUJILLO	MP. BOCONO	PQ. EL CARMEN	ESCUELA BOLIVARIANA PRESBÍTERO JOSÉ DE JESÚS ESPINOZA	2975	6	47	2416	1547	2369	0	16	3	1	802	2416
EDO. TRUJILLO	MP. BOCONO	PQ. EL CARMEN	ESCUELA TECNICA ROBINSONIANA DR.EUSEBIO BAPTISTA	110	1	4	90	80	86	0	0	0	0	6	90
EDO. TRUJILLO	MP. BOCONO	PQ. GENERAL RIVAS	ESCUELA ESTADAL CONCENTRADA NÚMERO 30 LA PEDREGOZA	281	1	6	201	148	195	0	1	0	0	46	201
EDO. TRUJILLO	MP. BOCONO	PQ. GENERAL RIVAS	ESCUELA ESTADAL CONCENTRADA SIN NÚMERO EL VOLCAN	333	1	4	216	138	212	0	2	0	0	72	216
EDO. TRUJILLO	MP. BOCONO	PQ. GENERAL RIVAS	ESCUELA ESTADAL CONCENTRADA NÚMERO 384 EL PAJARITO	375	1	8	238	192	230	0	0	0	0	38	238
EDO. TRUJILLO	MP. BOCONO	PQ. GENERAL RIVAS	ESCUELA ESTADAL CONCENTRADA S N BARRO NEGRO NER PIEDRA GORDA	63	1	1	39	34	38	0	2	0	0	2	39
EDO. TRUJILLO	MP. BOCONO	PQ. GENERAL RIVAS	ESCUELA BOLIVARIANA ISABEL DE GONZÁLEZ	881	2	12	662	346	650	1	2	2	1	298	662
EDO. TRUJILLO	MP. BOCONO	PQ. GENERAL RIVAS	MODULO DE CAPACITACIÓN ADJUNTO AL AMBULATORIO	53	1	0	40	17	40	0	0	0	0	23	40
EDO. TRUJILLO	MP. BOCONO	PQ. GENERAL RIVAS	ESCUELA ESTADAL CONCENTRADA SIN NÚMERO MIRAFLORES	253	1	5	164	122	159	0	0	1	0	36	164
EDO. TRUJILLO	MP. BOCONO	PQ. GENERAL RIVAS	ESCUELA BOLIVARIANA EL POTRERO	361	1	11	252	141	241	1	0	0	0	99	252
EDO. TRUJILLO	MP. BOCONO	PQ. GENERAL RIVAS	LICEO BOLIVARIANO ISABEL DE GONZALEZ	46	1	1	27	13	26	0	0	0	0	13	27
EDO. TRUJILLO	MP. BOCONO	PQ. GENERAL RIVAS	ESCUELA CONCENTRADA S N PIEDRAS DE SAL NER PIEDRA GORDA	70	1	1	61	11	60	0	0	0	0	49	61
EDO. TRUJILLO	MP. BOCONO	PQ. GENERAL RIVAS	ESCUELA ESTADAL CONCENTRADA NÚMERO 31 VISUN	559	1	11	345	273	334	1	2	1	0	57	345
EDO. TRUJILLO	MP. BOCONO	PQ. GENERAL RIVAS	ESCUELA ESTADAL CONCENTRADA SIN NÚMERO  EL RESBALÓN	232	1	5	131	110	126	0	1	2	0	13	131
EDO. TRUJILLO	MP. BOCONO	PQ. BURBUSAY	ESCUELA BOLIVARIANA LOS PANTANOS NER 587	123	1	2	110	97	108	0	0	0	0	11	110
EDO. TRUJILLO	MP. BOCONO	PQ. BURBUSAY	ESCUELA BOLIVARIANA PADRE DURAN	1602	3	22	1182	851	1160	0	4	0	0	305	1182
EDO. TRUJILLO	MP. BOCONO	PQ. BURBUSAY	ESCUELA ESTADAL UNITARIA BISNAJA	342	1	3	244	209	241	0	5	0	0	27	244
EDO. TRUJILLO	MP. BOCONO	PQ. BURBUSAY	ESCUELA BOLIVARIANA ÁRBOL REDONDO	157	1	8	123	63	115	0	0	0	0	52	123
EDO. TRUJILLO	MP. BOCONO	PQ. BURBUSAY	ESCUELA ESTADAL NÚMERO 451	384	1	2	283	236	281	0	1	0	0	44	283
EDO. TRUJILLO	MP. BOCONO	PQ. BURBUSAY	ESCUELA CONCENTRADA LAS TRAVESIAS	535	1	5	405	369	400	0	1	0	0	30	405
EDO. TRUJILLO	MP. BOCONO	PQ. BURBUSAY	ESCUELA BOLIVARIANA LAS LEONAS	183	1	2	133	120	131	0	0	0	0	11	133
EDO. TRUJILLO	MP. BOCONO	PQ. SAN JOSE	ESCUELA BOLIVARIANA LA PUERTA	462	1	7	307	277	300	0	0	1	0	22	307
EDO. TRUJILLO	MP. BOCONO	PQ. SAN JOSE	ESCUELA ESTADAL CONCENTRADA S N LA MESA NER 590	57	1	2	54	40	52	0	0	0	0	12	54
EDO. TRUJILLO	MP. BOCONO	PQ. SAN JOSE	ESCUELA ESTADAL CONCENTRADA TATUY NER 364	77	1	0	69	62	69	0	2	1	0	4	69
EDO. TRUJILLO	MP. BOCONO	PQ. SAN JOSE	CARPINTERÍA RÚSTICOS ANDAR TORRES	339	1	4	217	180	213	0	1	1	0	31	217
EDO. TRUJILLO	MP. BOCONO	PQ. SAN JOSE	ESCUELA BOLIVARIANA ALTAMIRA	286	1	4	197	170	193	0	1	0	1	21	197
EDO. TRUJILLO	MP. BOCONO	PQ. SAN JOSE	UNIDAD EDUCATIVA AUGUSTO MALAVE VILLALBA	548	1	2	392	350	390	0	2	1	0	37	392
EDO. TRUJILLO	MP. BOCONO	PQ. SAN JOSE	ESCUELA ESTADAL CONCENTRADA PIEDRAS DE SAL	244	1	5	166	158	161	0	0	0	0	3	166
EDO. TRUJILLO	MP. BOCONO	PQ. SAN JOSE	LICEO BOLIVARIANO TOSTOS	166	1	1	128	87	127	0	0	0	0	40	128
EDO. TRUJILLO	MP. BOCONO	PQ. SAN JOSE	ESCUELA BOLIVARIANA EL CHAMIZAL	116	1	1	97	89	96	0	0	0	0	7	97
EDO. TRUJILLO	MP. BOCONO	PQ. SAN JOSE	ESCUELA BOLIVARIANA DOCTOR EUSEBIO BAPTISTA	838	2	9	626	359	617	0	3	0	0	255	626
EDO. TRUJILLO	MP. BOCONO	PQ. SAN JOSE	ESCUELA ESTADAL CONCENTRADA AGUA CLARA	109	1	0	79	77	79	0	0	0	0	2	79
EDO. TRUJILLO	MP. BOCONO	PQ. SAN JOSE	ESCUELA ESTADAL LOMA ABAJO SAN JOSÉ DE TOSTOS NER 590	220	1	2	189	182	187	0	0	0	0	5	189
EDO. TRUJILLO	MP. BOCONO	PQ. SAN JOSE	ESCUELA ESTADAL NUMERO 61	344	1	13	258	218	245	0	2	1	0	24	258
EDO. TRUJILLO	MP. BOCONO	PQ. SAN JOSE	ESCUELA ESTADAL NÚMERO 35   SIN NÚMERO	202	1	3	149	132	146	0	0	0	0	14	149
EDO. TRUJILLO	MP. BOCONO	PQ. GUARAMACAL	ESCUELA ESTADAL CONCENTRADA SIN NÚMERO AGUA LINDA
EDO. TRUJILLO	MP. BOCONO	PQ. GUARAMACAL	ESCUELA BOLIVARIANA CERRO DE GUARAMACAL	150	1	1	123	109	122	0	0	0	0	13	123
EDO. TRUJILLO	MP. BOCONO	PQ. GUARAMACAL	ESCUELA BOLIVARIANA CUCHILLA DE GUARAMACAL	423	1	2	281	256	279	0	0	0	0	23	281
EDO. TRUJILLO	MP. BOCONO	PQ. GUARAMACAL	ESCUELA ESTADAL CONCENTRADO MESA DE CUNAVICHE	324	1	3	278	271	275	1	0	0	0	3	278
EDO. TRUJILLO	MP. BOCONO	PQ. LA VEGA DE GUARAMACAL	ESCUELA CONCENTRADA ESTADAL AGUA FRIA	267	1	20	189	159	169	0	0	1	0	9	189
EDO. TRUJILLO	MP. BOCONO	PQ. LA VEGA DE GUARAMACAL	UNIDAD EDUCATIVA LUIS ALBERTO SANCHEZ	273	1	6	188	165	182	0	1	0	0	16	188
EDO. TRUJILLO	MP. BOCONO	PQ. LA VEGA DE GUARAMACAL	ESCUELA BOLIVARIANA VEGA DE GUARAMACAL	638	2	5	513	469	508	0	1	0	0	38	513
EDO. TRUJILLO	MP. BOCONO	PQ. RAFAEL RANGEL	ESCUELA ESTADAL NUMERO 235	166	1	2	102	53	100	0	2	0	0	45	102
EDO. TRUJILLO	MP. BOCONO	PQ. RAFAEL RANGEL	ESCUELA NACIONAL NUMERO 1333	328	1	5	220	178	215	0	2	0	0	35	220
EDO. TRUJILLO	MP. BOCONO	PQ. RAFAEL RANGEL	ESCUELA ESTADAL CONCENTRADA EL JARILLO	292	1	6	225	168	219	0	0	0	0	51	225
EDO. TRUJILLO	MP. BOCONO	PQ. RAFAEL RANGEL	ESCUELA BOLIVARIANA LOMA PANCHA	330	1	4	259	244	255	0	0	0	1	10	259
EDO. TRUJILLO	MP. BOCONO	PQ. RAFAEL RANGEL	ESCUELA BOLIVARIANA ALTAMIRA NER 586	67	1	1	64	56	63	0	0	0	0	7	64
EDO. TRUJILLO	MP. BOCONO	PQ. RAFAEL RANGEL	UNIDAD EDUCATIVA MÁXIMO SAAVEDRA	881	2	10	619	377	609	0	5	2	0	225	619
EDO. TRUJILLO	MP. BOCONO	PQ. RAFAEL RANGEL	ESCUELA BOLIVARIANA CECILIO ACOSTA	633	2	8	461	359	453	1	2	1	0	90	461
EDO. TRUJILLO	MP. BOCONO	PQ. RAFAEL RANGEL	ESCUELA ESTADAL EL SAY	73	1	1	57	54	56	0	0	0	0	2	57
EDO. TRUJILLO	MP. BOCONO	PQ. RAFAEL RANGEL	ESCUELA BOLIVARIANA EL PALCHAL	281	1	2	217	192	215	0	1	0	0	22	217
EDO. TRUJILLO	MP. BOCONO	PQ. RAFAEL RANGEL	ESCUELA ESTADAL CONCENTRADA NÚMERO 22 VILLA NUEVA	228	1	6	182	159	176	0	0	0	0	17	182
EDO. TRUJILLO	MP. BOCONO	PQ. RAFAEL RANGEL	ESCUELA BOLIVARIANA LA ENCOMIENDA	106	1	1	102	89	101	0	2	0	0	10	102
EDO. TRUJILLO	MP. BOCONO	PQ. SAN MIGUEL	ESCUELA ESTADAL CONCENTRADA SIN NÚMERO RIO NEGRO III	121	1	1	92	88	91	0	0	0	0	3	92
EDO. TRUJILLO	MP. BOCONO	PQ. SAN MIGUEL	ESCUELA ESTADAL CONCENTRADA POTRERO GRANDE	282	1	5	166	121	161	0	2	1	0	37	166
EDO. TRUJILLO	MP. BOCONO	PQ. SAN MIGUEL	ESCUELA BOLIVARIANA CABIMBU II	507	1	1	393	376	392	0	0	0	0	16	393
EDO. TRUJILLO	MP. BOCONO	PQ. SAN MIGUEL	ESCUELA BOLIVARIANA LOMA II	43	1	1	40	37	39	0	0	0	0	2	40
EDO. TRUJILLO	MP. BOCONO	PQ. SAN MIGUEL	ESCUELA BOLIVARIANA LA CAVA III	265	1	1	194	178	193	0	2	1	0	12	194
EDO. TRUJILLO	MP. BOCONO	PQ. SAN MIGUEL	ESCUELA BOLIVARIANA PIEDRA GORDA	363	1	1	304	297	303	0	1	0	0	5	304
EDO. TRUJILLO	MP. BOCONO	PQ. SAN MIGUEL	ESCUELA BOLIVARIANA LOMAS DE SAN MIGUEL	255	1	1	209	169	208	0	0	0	0	39	209
EDO. TRUJILLO	MP. BOCONO	PQ. SAN MIGUEL	LICEO BOLIVARIANO ARMANDO MADRID	149	1	4	120	93	116	0	0	0	1	22	120
EDO. TRUJILLO	MP. BOCONO	PQ. SAN MIGUEL	GRUPO ESCOLAR ARMANDO MADRID	1160	2	9	810	693	801	1	0	0	0	107	810
EDO. TRUJILLO	MP. BOCONO	PQ. MONSE#OR JAUREGUI	ESCUELA BOLIVARIANA CHEJENDE 1955 NER 229	182	1	1	150	136	149	0	1	0	0	12	150
EDO. TRUJILLO	MP. BOCONO	PQ. MONSE#OR JAUREGUI	ESCUELA ESTADAL SIN NUMERO  LA AGUADA	87	1	1	69	58	68	0	0	0	0	10	69
EDO. TRUJILLO	MP. BOCONO	PQ. MONSE#OR JAUREGUI	ESCUELA BOLIVARIANA ESTICHO	72	1	0	65	56	65	0	0	0	0	9	65
EDO. TRUJILLO	MP. BOCONO	PQ. MONSE#OR JAUREGUI	ESCUELA ESTADAL CONCENTRADA LOMA DEL SANTO	100	1	1	34	32	33	0	0	0	0	1	34
EDO. TRUJILLO	MP. BOCONO	PQ. MONSE#OR JAUREGUI	ESCUELA BOLIVARIANA PBRO JOSE RICARDO GAMBOA	177	1	6	138	98	132	0	1	0	0	33	138
EDO. TRUJILLO	MP. BOCONO	PQ. MONSE#OR JAUREGUI	ESCUELA ESTADAL CONCENTRADA NÚMERO 43 SIN NÚMERO LA PEÑA	162	1	0	112	112	112	0	0	0	0	0	112
EDO. TRUJILLO	MP. BOCONO	PQ. MONSE#OR JAUREGUI	ESCUELA BOLIVARIANA EL CANJILON	378	1	2	306	250	304	0	3	0	0	51	306
EDO. TRUJILLO	MP. BOCONO	PQ. MONSE#OR JAUREGUI	LICEO BOLIVARIANO MANUEL ANTONIO ARRAIZ	1139	2	27	810	517	783	0	3	0	1	262	810
EDO. TRUJILLO	MP. BOCONO	PQ. MONSE#OR JAUREGUI	ESCUELA ESTADAL SIN NÚMERO  EL RAIZÓN	139	1	1	60	59	59	0	0	0	0	0	60
EDO. TRUJILLO	MP. BOCONO	PQ. MONSE#OR JAUREGUI	ESCUELA BOLIVARIANA VITISAY	233	1	4	164	100	160	0	2	0	0	58	164
EDO. TRUJILLO	MP. BOCONO	PQ. MONSE#OR JAUREGUI	ESCUELA ESTADAL UNITARIA NÚMERO 276 LOMA DE LOS CABALLOS	65	1	0	27	24	27	0	0	1	0	2	27
EDO. TRUJILLO	MP. BOCONO	PQ. MONSE#OR JAUREGUI	UNIDAD EDUCATIVA MIGUEL JOSÉ SANZ	712	2	16	489	377	473	2	3	0	1	90	489
EDO. TRUJILLO	MP. BOCONO	PQ. BOCONO	CEI LAS ESPERANZAS	157	1	6	113	65	107	0	1	0	0	41	113
EDO. TRUJILLO	MP. BOCONO	PQ. BOCONO	NER 133 ESCUELA BOLIVARIANA VIVIENDAS RURALES	342	1	4	300	244	296	0	0	1	1	50	300
EDO. TRUJILLO	MP. BOCONO	PQ. BOCONO	INSTITUTO UNIVERSITARIO DE TECNOLOGIA DEL ESTADO TRUJILLO BOCONO	105	1	2	96	57	94	0	0	0	0	37	96
EDO. TRUJILLO	MP. BOCONO	PQ. BOCONO	ESCUELA ESTADAL CONCENTRADA EL MACIEGAL NER 236	793	2	30	555	447	525	0	1	0	0	77	555
EDO. TRUJILLO	MP. BOCONO	PQ. BOCONO	ESCUELA ESTADAL CONCENTRADA LA MILLA	784	2	9	581	363	572	1	3	3	0	202	581
EDO. TRUJILLO	MP. BOCONO	PQ. BOCONO	UNIDAD  EDUCATIVA SALVANO VELAZCO	1369	3	29	1022	669	993	0	5	0	0	319	1022
EDO. TRUJILLO	MP. BOCONO	PQ. BOCONO	UNIDAD EDUCATIVA  DOCTOR LEONARDO RUIZ PINEDA	3410	6	65	2759	1431	2694	0	10	1	1	1251	2759
EDO. TRUJILLO	MP. BOCONO	PQ. BOCONO	INSTITUTO NACIONAL DE CAPACITACION Y EDUCACION SOCIALISTA (INCES)	31	1	1	21	19	20	0	0	0	0	1	21
EDO. TRUJILLO	MP. BOCONO	PQ. BOCONO	ESCUELA BOLIVARIANA EL POCITO	599	1	7	397	339	390	1	8	2	0	40	397
EDO. TRUJILLO	MP. BOCONO	PQ. BOCONO	ESCUELA BOLIVARIANA MESA DE LA ARENOSA	216	1	5	179	131	174	0	1	1	0	41	179
EDO. TRUJILLO	MP. BOCONO	PQ. BOCONO	ESCUELA BOLIVARIANA EL HATO	694	2	8	532	373	524	0	2	0	0	149	532
EDO. TRUJILLO	MP. BOCONO	PQ. BOCONO	UNIDAD EDUCATIVA HILARIO PISANI ANSELMI	376	1	7	312	164	305	0	1	0	0	140	312
EDO. TRUJILLO	MP. BOCONO	PQ. BOCONO	ESCUELA BOLIVARIANA LA VIRA VIRA	232	1	5	135	114	130	0	0	2	1	13	135
EDO. TRUJILLO	MP. BOCONO	PQ. BOCONO	ESCUELA BOLIVARIANA VEGA ABAJO	70	1	2	50	36	48	0	0	0	0	12	50
EDO. TRUJILLO	MP. BOCONO	PQ. BOCONO	UNIDAD EDUCATIVA JUAN BAUTISTA DALLA COSTA	2597	5	34	2058	905	2024	0	10	2	2	1105	2058
EDO. TRUJILLO	MP. BOCONO	PQ. BOCONO	ESCUELA BOLIVARIANA SANTA RITA	425	1	5	295	277	290	0	1	0	0	12	295
EDO. TRUJILLO	MP. BOCONO	PQ. BOCONO	ESCUELA BOLIVARIANA CERRO DEL SANTO	260	1	6	161	132	155	3	2	1	0	17	161
EDO. TRUJILLO	MP. BOCONO	PQ. BOCONO	ESCUELA BOLIVARIANA EL QUEVEDITO	177	1	1	127	119	126	1	1	0	0	5	127
EDO. TRUJILLO	MP. BOCONO	PQ. BOCONO	ESCUELA BOLIVARIANA EL ARBOLITO	342	1	2	219	188	217	0	1	0	0	28	219
EDO. TRUJILLO	MP. BOCONO	PQ. BOCONO	ESCUELA BOLIVARIANA DOCTOR DOMINGO MILIANI	142	1	1	120	106	119	0	1	0	0	12	120
EDO. TRUJILLO	MP. BOCONO	PQ. BOCONO	ESCUELA BOLIVARIANA MITICUN	1568	3	27	1250	911	1223	1	10	1	1	299	1250
EDO. TRUJILLO	MP. BOCONO	PQ. BOCONO	ATENEO DE BOCONO	1914	4	23	1515	618	1492	0	4	0	2	868	1515
EDO. TRUJILLO	MP. BOCONO	PQ. BOCONO	INSTITUTO UNIVERSITARIO DE TECNOLOGIA AGROPECUARIO DE BOCONO	888	2	25	735	361	710	0	4	1	1	343	735
EDO. TRUJILLO	MP. BOCONO	PQ. AYACUCHO	ESCUELA BOLIVARIANA ALTO DE SAN ANTONIO	263	1	1	176	144	175	0	1	1	1	28	176
EDO. TRUJILLO	MP. BOCONO	PQ. AYACUCHO	ESCUELA ESTADAL CONCENTRADA RIO NEGRO II 18	361	1	2	246	228	244	0	1	0	0	15	246
EDO. TRUJILLO	MP. BOCONO	PQ. AYACUCHO	ESCUELA ESTADAL CONCENTRADA RIO BLANCO	255	1	2	188	129	186	0	0	0	0	57	188
EDO. TRUJILLO	MP. BOCONO	PQ. AYACUCHO	ESCUELA NACIONAL CONCENTRADA JIMENEZ	143	1	4	114	101	110	0	0	0	0	9	114
EDO. TRUJILLO	MP. BOCONO	PQ. AYACUCHO	ESCUELA BOLIVARIANA DOCTOR CARACCIOLO PARRA OLMEDO	1050	2	8	747	568	739	0	2	1	0	168	747
EDO. TRUJILLO	MP. BOCONO	PQ. AYACUCHO	UNIDAD EDUCATIVA CREACION BATATAL	91	1	2	60	27	58	0	0	1	0	30	60
EDO. TRUJILLO	MP. BOCONO	PQ. AYACUCHO	ESCUELA ESTADAL CONCENTRADA LA DEFENSA	185	1	6	149	115	143	0	0	0	0	28	149
EDO. TRUJILLO	MP. RAFAEL RANGEL	PQ. JOSE G HERNANDEZ	ESCUELA ESTADAL CONCENTRADA SAN PEDRO	967	2	13	743	495	730	1	6	0	0	228	743
EDO. TRUJILLO	MP. RAFAEL RANGEL	PQ. JOSE G HERNANDEZ	UNIDAD EDUCATIVA SARA LINDA	380	1	1	325	231	324	0	3	0	1	89	325
EDO. TRUJILLO	MP. RAFAEL RANGEL	PQ. JOSE G HERNANDEZ	ESCUELA BOLIVARIANA SAMUEL DARIO MALDONADO	2072	4	30	1743	930	1713	0	6	1	2	774	1743
EDO. TRUJILLO	MP. RAFAEL RANGEL	PQ. JOSE G HERNANDEZ	UNIDAD EDUCATIVA ESTADAL EMIRO FUENMAYOR	819	2	10	668	399	658	0	5	0	1	253	668
EDO. TRUJILLO	MP. RAFAEL RANGEL	PQ. EL CEDRO	ESCUELA ESTADAL NO 284	658	2	6	546	353	540	0	4	0	1	182	546
EDO. TRUJILLO	MP. RAFAEL RANGEL	PQ. EL CEDRO	ESCUELA BOLIVARIANA LA GIRA	350	1	9	273	200	264	0	1	0	0	63	273
EDO. TRUJILLO	MP. RAFAEL RANGEL	PQ. EL CEDRO	UNIDAD EDUCATIVA FRANCISCA ARÉVALO	2357	4	53	1864	1010	1811	0	6	0	1	794	1864
EDO. TRUJILLO	MP. RAFAEL RANGEL	PQ. BETIJOQUE	ESCUELA ESPECIAL JOSE GREGORIO HERNANDEZ	196	1	4	152	87	148	0	0	0	0	61	152
EDO. TRUJILLO	MP. RAFAEL RANGEL	PQ. BETIJOQUE	GRUPO ESCOLAR DIEGO BUSTILLOS	2210	4	39	1812	861	1773	0	7	0	0	905	1812
EDO. TRUJILLO	MP. RAFAEL RANGEL	PQ. BETIJOQUE	ESCUELA BOLIVARIANA LA CANTARRANA	1537	3	29	1245	645	1216	1	2	0	0	568	1245
EDO. TRUJILLO	MP. RAFAEL RANGEL	PQ. LA PUEBLITA	ESCUELA BASICA LAS RURALES	283	1	12	240	161	228	0	1	0	0	66	240
EDO. TRUJILLO	MP. RAFAEL RANGEL	PQ. LA PUEBLITA	UNIDAD EDUCATIVA FRANCISCO DE MIRANDA	690	2	9	599	332	590	0	2	1	0	255	599
EDO. TRUJILLO	MP. RAFAEL RANGEL	PQ. LA PUEBLITA	LICEO EMIRO FUENMAYOR	2903	5	54	2512	1337	2458	0	12	2	0	1107	2512
EDO. TRUJILLO	MP. BOLIVAR	PQ. GRANADOS	ESCUELA BOLIVARIANA GRANADOS	1860	4	29	1449	1011	1420	0	3	0	0	406	1449
EDO. TRUJILLO	MP. BOLIVAR	PQ. GRANADOS	ESCUELA BOLIVARIANA LA QUINTA	264	1	5	243	215	238	0	3	2	0	18	243
EDO. TRUJILLO	MP. BOLIVAR	PQ. CHEREGUE	UNIDAD EDUCATIVA RAFAEL ANTONIO RIVERO	518	1	12	399	284	387	0	1	0	0	102	399
EDO. TRUJILLO	MP. BOLIVAR	PQ. CHEREGUE	UNIDAD BÁSICA EDUCATIVA MONSEÑOR CARRILLO	954	2	10	753	634	743	0	4	0	1	104	753
EDO. TRUJILLO	MP. BOLIVAR	PQ. CHEREGUE	ESCUELA CONCENTRADA EL GUAMO	53	1	1	39	38	38	0	0	0	0	0	39
EDO. TRUJILLO	MP. BOLIVAR	PQ. CHEREGUE	UNIDAD EDUCATIVA JUAN RAMÓN MÉNDEZ ALTUVE	1077	2	9	798	676	789	0	5	0	0	108	798
EDO. TRUJILLO	MP. BOLIVAR	PQ. CHEREGUE	ESCUELA CONCENTRADA CHEREGUÉ NÚCLEO ESCOLAR RURAL 132	353	1	4	297	183	293	0	2	0	0	108	297
EDO. TRUJILLO	MP. BOLIVAR	PQ. CHEREGUE	ESCUELA BOLIVARIANA METE MIEDO	292	1	1	218	159	217	0	1	0	0	57	218
EDO. TRUJILLO	MP. BOLIVAR	PQ. SABANA GRANDE	UNIDAD EDUCATIVA ANDRÉS BELLO	920	2	12	727	489	715	0	2	0	0	224	727
EDO. TRUJILLO	MP. BOLIVAR	PQ. SABANA GRANDE	ESCUELA BOLIVARIANA SAN MIGUEL	234	1	4	197	139	193	0	1	0	0	53	197
EDO. TRUJILLO	MP. BOLIVAR	PQ. SABANA GRANDE	ESCUELA EL CAMPAMENTO	1049	2	16	823	635	807	0	1	0	0	171	823
EDO. TRUJILLO	MP. BOLIVAR	PQ. SABANA GRANDE	UNIDAD BÁSICA NACIONAL MARCELINO ZAMBRANO	2269	4	42	1808	1183	1766	0	4	0	0	579	1808
EDO. TRUJILLO	MP. BOLIVAR	PQ. SABANA GRANDE	ESCUELA BOLIVARIANA EL CASTILLO	471	1	6	397	318	391	0	0	0	0	73	397
EDO. TRUJILLO	MP. BOLIVAR	PQ. SABANA GRANDE	ESCUELA BOLIVARIANA SAN JUAN DE LOS ESBARRANCADOS	299	1	3	229	179	226	0	0	0	1	46	229
EDO. TRUJILLO	CE. TRUJILLO	PQ. TRES ESQUINAS	UNIDAD EDUCATIVA DOCTOR ANDRÉS LOMELLI ROSARIO	3263	6	59	2749	1659	2690	0	9	4	0	1018	2749
EDO. TRUJILLO	CE. TRUJILLO	PQ. TRES ESQUINAS	LICEO ANDRÉS LOMELLI ROSARIO	327	1	2	267	181	265	0	2	0	0	82	267
EDO. TRUJILLO	CE. TRUJILLO	PQ. TRES ESQUINAS	GIMNASIO CUBIERTO ULISES ZULETA	49	1	0	40	29	40	0	0	0	0	11	40
EDO. TRUJILLO	CE. TRUJILLO	PQ. ANDRES LINARES	ESCUELA BOLIVARIANA EL CHORRO	173	1	7	135	116	128	0	0	1	0	11	135
EDO. TRUJILLO	CE. TRUJILLO	PQ. ANDRES LINARES	ESCUELA ESTADAL CONCENTRADA LA MITIMBUEN	171	1	2	125	107	123	0	0	1	0	15	125
EDO. TRUJILLO	CE. TRUJILLO	PQ. ANDRES LINARES	ESCUELA BOLIVARIANA LOS LLANITOS	356	1	3	259	207	256	0	1	1	0	47	259
EDO. TRUJILLO	CE. TRUJILLO	PQ. ANDRES LINARES	ESCUELA BOLIVARIANA RAFAEL MARIA ALTUVE	1088	2	19	807	359	788	0	0	0	0	429	807
EDO. TRUJILLO	CE. TRUJILLO	PQ. ANDRES LINARES	ESCUELA ESTADAL CONCENTRADA NÚMERO 229 ESDORA	267	1	3	163	134	160	0	0	0	0	26	163
EDO. TRUJILLO	CE. TRUJILLO	PQ. ANDRES LINARES	ATENEO DE SAN LAZARO	152	1	2	131	55	129	0	0	0	0	74	131
EDO. TRUJILLO	CE. TRUJILLO	PQ. ANDRES LINARES	ESCUELA ESTADAL CONCENTRADA LA MANGA	235	1	6	166	98	160	0	2	2	0	58	166
EDO. TRUJILLO	CE. TRUJILLO	PQ. ANDRES LINARES	ESCUELA BOLIVARIANA EL HATILLO	257	1	5	193	142	188	0	0	0	0	46	193
EDO. TRUJILLO	CE. TRUJILLO	PQ. ANDRES LINARES	ESCUELA BOLIVARIANA LAS AGUADITAS	218	1	1	145	136	144	0	0	0	0	8	145
EDO. TRUJILLO	CE. TRUJILLO	PQ. MATRIZ	LICEO BOLIVARIANO RAMON IGNACIO MENDEZ	3286	6	47	2825	1352	2778	0	12	4	4	1406	2825
EDO. TRUJILLO	CE. TRUJILLO	PQ. MATRIZ	ESCUELA BOLIVARIANA ROSARIO ALMARZA	1100	2	15	1008	522	993	0	0	0	1	470	1008
EDO. TRUJILLO	CE. TRUJILLO	PQ. MATRIZ	ESCUELA BOLIVARIANA LA CAÑADA	71	1	1	56	49	55	0	0	0	0	6	56
EDO. TRUJILLO	CE. TRUJILLO	PQ. MATRIZ	ESCUELA BOLIVARIANA BORÓN BAJO	239	1	3	194	173	191	0	1	1	0	16	194
EDO. TRUJILLO	CE. TRUJILLO	PQ. MATRIZ	ESCUELA BOLIVARIANA EL RECREO	1766	3	35	1527	691	1492	0	5	1	0	795	1527
EDO. TRUJILLO	CE. TRUJILLO	PQ. MATRIZ	ESCUELA BOLIVARIANA LA URBINA	201	1	5	153	121	148	1	2	0	0	24	153
EDO. TRUJILLO	CE. TRUJILLO	PQ. MONSE#OR CARRILLO	ESCUELA BOLIVARIANA MARIO BRICEÑO IRAGORRY	1955	4	24	1577	811	1553	0	9	0	0	733	1577
EDO. TRUJILLO	CE. TRUJILLO	PQ. MONSE#OR CARRILLO	ESCUELA ESTADAL CONCENTRADA S N EL COROZO	149	1	0	131	122	131	0	1	0	0	8	131
EDO. TRUJILLO	CE. TRUJILLO	PQ. MONSE#OR CARRILLO	ESCUELA ESTADAL CONCENTRADA EL RIECITO	272	1	4	206	191	202	0	1	0	0	10	206
EDO. TRUJILLO	CE. TRUJILLO	PQ. MONSE#OR CARRILLO	ESCUELA CONCENTRADA LOMA DE PIEDRAS NEGRAS	149	1	2	144	132	142	0	0	1	0	9	144
EDO. TRUJILLO	CE. TRUJILLO	PQ. MONSE#OR CARRILLO	UNIDAD EDUCATIVA MONSEÑOR ESTANISLAO CARRILLO	2743	5	56	2233	1355	2177	0	15	3	0	804	2233
EDO. TRUJILLO	CE. TRUJILLO	PQ. MONSE#OR CARRILLO	ESCUELA CONCENTRADA ESTADAL PÁRAMO DE ORTÍZ	282	1	4	213	153	209	0	0	0	0	56	213
EDO. TRUJILLO	CE. TRUJILLO	PQ. MONSE#OR CARRILLO	UNIDAD EDUCATIVA MONSEÑOR VICENTE VALERO MARQUEZ	277	1	1	185	172	184	0	0	0	0	12	185
EDO. TRUJILLO	CE. TRUJILLO	PQ. MONSE#OR CARRILLO	ESCUELA BOLIVARIANA TIMIRISIS	372	1	3	289	244	286	0	4	0	0	38	289
EDO. TRUJILLO	CE. TRUJILLO	PQ. MONSE#OR CARRILLO	UNIDAD EDUCATIVA MARÍA BARTOLA BECERRA	1235	3	17	964	718	947	0	4	1	1	223	964
EDO. TRUJILLO	CE. TRUJILLO	PQ. CHIQUINQUIRA	ESCUELA BOLIVARIANA ESTADO CARABOBO	2905	5	37	2327	1251	2290	0	5	1	0	1033	2327
EDO. TRUJILLO	CE. TRUJILLO	PQ. CHIQUINQUIRA	ESCUELA BOLIVARIANA MANUELA SAENZ	184	1	3	156	128	153	0	2	0	0	23	156
EDO. TRUJILLO	CE. TRUJILLO	PQ. CHIQUINQUIRA	COLEGIO NUESTRA SEÑORA DE COROMOTO	465	1	3	417	96	414	0	0	0	1	317	417
EDO. TRUJILLO	CE. TRUJILLO	PQ. CHIQUINQUIRA	ESCUELA ESTADAL CONCENTRADA OCANTO	378	1	6	291	216	285	0	4	0	0	65	291
EDO. TRUJILLO	CE. TRUJILLO	PQ. CHIQUINQUIRA	UNIDAD EDUCATIVA ROSARIO CARRILLO HEREDIA	1641	3	20	1324	815	1304	0	8	1	0	480	1324
EDO. TRUJILLO	CE. TRUJILLO	PQ. CHIQUINQUIRA	ESCUELA BÁSICA PREBISTERO RAFAEL MARÍA VILLASMIL	1737	3	25	1472	826	1447	0	10	0	1	610	1472
EDO. TRUJILLO	CE. TRUJILLO	PQ. CHIQUINQUIRA	ESCUELA CONCENTRADA EL ALGARROBO	127	1	0	107	91	107	0	0	1	0	15	107
EDO. TRUJILLO	CE. TRUJILLO	PQ. CRISTOBAL MENDOZA	CARCEL NACIONAL	589	1	4	185	144	181	0	1	0	1	35	185
EDO. TRUJILLO	CE. TRUJILLO	PQ. CRISTOBAL MENDOZA	ESCUELA ESTADAL LOMA DE CORONADO NER 547	209	1	4	158	102	154	0	1	0	0	51	158
EDO. TRUJILLO	CE. TRUJILLO	PQ. CRISTOBAL MENDOZA	ESCUELA CONCENTRADA BARBARITA DE LA TORRE	116	1	7	113	81	106	0	2	0	0	23	113
EDO. TRUJILLO	CE. TRUJILLO	PQ. CRISTOBAL MENDOZA	CENTRO DE EDUCACIÓN TRUJILLO	2494	5	22	2047	1185	2025	0	12	0	3	825	2047
EDO. TRUJILLO	CE. TRUJILLO	PQ. CRISTOBAL MENDOZA	ESCUELA ESTADAL CONCENTRADA DOÑA ESTEFANÍA MORÓN DE RUMBOS	198	1	3	136	91	133	0	0	0	0	42	136
EDO. TRUJILLO	CE. TRUJILLO	PQ. CRISTOBAL MENDOZA	ESCUELA BOLIVARIANA AMÉRICO BRICEÑO VALERO	2395	5	39	1924	1078	1885	0	6	0	1	800	1924
EDO. TRUJILLO	CE. TRUJILLO	PQ. CRISTOBAL MENDOZA	ESCUELA CONCENTRADA EL LIMON	109	1	1	101	77	100	0	0	0	0	23	101
EDO. TRUJILLO	CE. TRUJILLO	PQ. CRISTOBAL MENDOZA	ESCUELA BOLIVARIANA LA TUNITA	1549	3	23	1311	848	1288	0	10	0	1	429	1311
EDO. TRUJILLO	CE. TRUJILLO	PQ. CRISTOBAL MENDOZA	ESCUELA BOLIVARIANA EL HATÍCO	462	1	6	413	288	407	0	0	0	1	118	413
EDO. TRUJILLO	CE. TRUJILLO	PQ. CRISTOBAL MENDOZA	ESCUELA BOLIVARIANA CARRILLO GUERRA	3141	6	31	2607	1501	2576	0	7	1	2	1065	2607
EDO. TRUJILLO	CE. TRUJILLO	PQ. CRUZ CARRILLO	ESCUELA BOLIVARIANA CAPELLANIAS	309	1	3	232	179	229	0	2	0	2	46	232
EDO. TRUJILLO	CE. TRUJILLO	PQ. CRUZ CARRILLO	ESCUELA ESTADAL CONCENTRADA LLANO GRANDE	211	1	3	137	127	134	0	0	1	0	6	137
EDO. TRUJILLO	CE. TRUJILLO	PQ. CRUZ CARRILLO	ESCUELA ESTADAL 160 PÁRAMO DE MISISI
EDO. TRUJILLO	CE. TRUJILLO	PQ. CRUZ CARRILLO	ESCUELA BOLIVARIANA TOBÍAS VALERA MARTÍNEZ	1097	2	19	938	491	919	0	2	0	0	426	938
EDO. TRUJILLO	CE. TRUJILLO	PQ. CRUZ CARRILLO	ESCUELA ESTADAL CONCENTRADA MOCOY ABAJO	349	1	4	251	195	247	0	2	0	0	50	251
EDO. TRUJILLO	CE. TRUJILLO	PQ. CRUZ CARRILLO	ESCUELA ESTADAL CONCENTRADA LA CUCHILLA DE SIQUISAY	94	1	1	71	55	70	0	1	0	0	14	71
EDO. TRUJILLO	CE. TRUJILLO	PQ. CRUZ CARRILLO	ESCUELA BOLIVARIANA PADRE RASQUIN	1296	3	11	1108	503	1097	0	3	0	1	590	1108
EDO. TRUJILLO	MP. CARACHE	PQ. CUICAS	UNIDAD EDUCATIVA ESTADAL JAPAZ	365	1	0	274	175	274	0	0	1	0	98	274
EDO. TRUJILLO	MP. CARACHE	PQ. CUICAS	ESCUELA BOLIVARIANA PALMAS REALES	186	1	1	145	124	144	0	0	1	0	19	145
EDO. TRUJILLO	MP. CARACHE	PQ. CUICAS	ESCUELA BOLIVARIANA PALMIRA	91	1	1	80	71	79	0	0	0	0	8	80
EDO. TRUJILLO	MP. CARACHE	PQ. CUICAS	SALON DE LECTURA ROSARIO MONTERO DE MORON	94	1	2	64	39	62	0	1	0	0	22	64
EDO. TRUJILLO	MP. CARACHE	PQ. CUICAS	ESCUELA BOLIVARIANA EL HELECHAL	221	1	0	158	144	158	0	0	0	0	14	158
EDO. TRUJILLO	MP. CARACHE	PQ. CUICAS	ESCUELA BOLIVARIANA EL CUMBE	365	1	2	277	246	275	0	1	0	0	28	277
EDO. TRUJILLO	MP. CARACHE	PQ. CUICAS	ESCUELA ESTADAL CONCENTRADA VENTILACIÓN	114	1	0	85	80	85	0	1	0	0	4	85
EDO. TRUJILLO	MP. CARACHE	PQ. CUICAS	ESCUELA NACIONAL CONCENTRADA BOLIVARIANA JOSE EULOGIO FERNÁNDEZ	238	1	0	158	148	158	0	1	1	0	8	158
EDO. TRUJILLO	MP. CARACHE	PQ. CUICAS	LICEO BOLIVARIANO ANTONIO JOSÉ SALDIVIA	1066	2	13	738	416	725	0	4	0	1	304	738
EDO. TRUJILLO	MP. CARACHE	PQ. CUICAS	UNIDAD EDUCATIVA ESTADAL CONCENTRADA NUMERO 99 S N CASA DE ZINC	62	1	0	55	48	55	0	0	0	0	7	55
EDO. TRUJILLO	MP. CARACHE	PQ. CUICAS	UNIDAD EDUCATIVA RAFAEL ANTONIO CAÑIZALES	443	1	3	317	268	314	0	0	0	0	46	317
EDO. TRUJILLO	MP. CARACHE	PQ. CUICAS	ESCUELA BOLIVARIANA DOCTOR SEIJAS	239	1	3	152	124	149	0	0	0	0	25	152
EDO. TRUJILLO	MP. CARACHE	PQ. CUICAS	ESCUELA BOLIVARIANA SAN JUAN DE CUICAS	226	1	1	144	126	143	0	0	0	0	17	144
EDO. TRUJILLO	MP. CARACHE	PQ. CUICAS	ESCUELA ESTADAL CONCENTRADA EL VIGIA	225	1	2	178	156	176	0	0	0	0	20	178
EDO. TRUJILLO	MP. CARACHE	PQ. CUICAS	ESCUELA BOLIVARIANA MONSEÑOR LUÍS PARDO MANCILLA	356	1	4	272	234	268	0	1	0	0	33	272
EDO. TRUJILLO	MP. CARACHE	PQ. CUICAS	ESCUELA BOLIVRIANA ARENALES	88	1	0	74	60	74	0	0	0	0	14	74
EDO. TRUJILLO	MP. CARACHE	PQ. CUICAS	ESCUELA ASOCIACIÓN DE PROMOCIÓN DE LA EDUCACIÓN POPULAR SIMÓN BOLÍVAR	313	1	3	264	157	261	0	4	1	0	99	264
EDO. TRUJILLO	MP. CARACHE	PQ. CUICAS	UNIDAD EDUCATIVA BÁSICA CONCENTRADA NÚMERO 207 238	235	1	5	171	143	166	0	1	0	0	22	171
EDO. TRUJILLO	MP. CARACHE	PQ. CUICAS	ESCUELA BOLIVARIANA EL JUMANGAL	135	1	1	96	70	95	0	0	0	0	25	96
EDO. TRUJILLO	MP. CARACHE	PQ. SANTA CRUZ	ESCUELA ESTADAL EZEQUIEL ZAMORA NER 110	229	1	7	212	192	205	0	2	0	0	11	212
EDO. TRUJILLO	MP. CARACHE	PQ. SANTA CRUZ	ESCUELA CONCENTRADA SIN NÚMERO  MONGON	236	1	2	178	142	176	0	1	0	0	33	178
EDO. TRUJILLO	MP. CARACHE	PQ. SANTA CRUZ	ESCUELA CONCENTRADA  SIN NÚMERO EL FUNDO	362	1	11	277	190	266	0	0	0	1	75	277
EDO. TRUJILLO	MP. CARACHE	PQ. SANTA CRUZ	UNIDAD EDUCATIVA ESTADAL AÑO INTERNACIONAL DEL NIÑO	840	2	21	636	440	615	0	5	0	0	170	636
EDO. TRUJILLO	MP. CARACHE	PQ. SANTA CRUZ	ESCUELA ESTADAL CONCENTRADA SIN NÚMERO SANTO DOMINGO	107	1	0	85	62	85	0	0	0	0	23	85
EDO. TRUJILLO	MP. CARACHE	PQ. PANAMERICANA	ESCUELA TECNICA AGROPECUARIA ROBINZONIANA DR ZUI BREWER GROSS	86	1	0	73	57	73	0	1	0	0	15	73
EDO. TRUJILLO	MP. CARACHE	PQ. PANAMERICANA	UNIDA EDUCATIVA SAN MIGUEL	96	1	1	94	92	93	0	0	0	0	1	94
EDO. TRUJILLO	MP. CARACHE	PQ. PANAMERICANA	UNIDAD EDUCATIVA ESTADAL MIGUEL ENRIQUE GUDIÑO	804	2	12	645	529	633	0	2	0	0	102	645
EDO. TRUJILLO	MP. CARACHE	PQ. PANAMERICANA	ESCUELA BOLIVARIANA SAN FELIPE	220	1	3	183	159	180	0	3	0	0	18	183
EDO. TRUJILLO	MP. CARACHE	PQ. PANAMERICANA	ESCUELA BOLIVARIANA PARAMITO CALIENTE	521	1	2	418	372	416	0	1	1	0	42	418
EDO. TRUJILLO	MP. CARACHE	PQ. PANAMERICANA	UNIDAD EDUCATIVA CAMILO CAÑIZALES	190	1	2	171	155	169	0	1	0	0	13	171
EDO. TRUJILLO	MP. CARACHE	PQ. LA CONCEPCION	ESCUELA UNITARIA ESTADAL EL POTRERO	88	1	0	70	69	70	0	0	0	0	1	70
EDO. TRUJILLO	MP. CARACHE	PQ. LA CONCEPCION	ESCUELA BOLIVARIANA MIQUIMU	223	1	3	182	119	179	0	1	0	0	59	182
EDO. TRUJILLO	MP. CARACHE	PQ. LA CONCEPCION	ESCUELA BOLIVARIANA MESA POSTRERA	187	1	1	144	84	143	0	0	0	0	59	144
EDO. TRUJILLO	MP. CARACHE	PQ. LA CONCEPCION	ESCUELA BOLIVARIANA QUEBRADA DE AGUA	421	1	7	296	254	289	0	1	1	0	33	296
EDO. TRUJILLO	MP. CARACHE	PQ. LA CONCEPCION	ESCUELA BOLIVARIANA MIQUIA ABAJO	236	1	1	189	184	188	0	1	0	0	3	189
EDO. TRUJILLO	MP. CARACHE	PQ. LA CONCEPCION	ESCUELA BOLIVARIANA BITICUY LAS COCUIZAS	179	1	1	163	157	162	1	0	0	0	4	163
EDO. TRUJILLO	MP. CARACHE	PQ. LA CONCEPCION	SALÓN DE LECTURA PADRE VASQUÉZ	222	1	3	189	137	186	0	0	0	0	49	189
EDO. TRUJILLO	MP. CARACHE	PQ. LA CONCEPCION	ESCUELA BOLIVARIANA MIQUIA ARRIBA	551	1	5	403	334	398	0	1	0	1	62	403
EDO. TRUJILLO	MP. CARACHE	PQ. LA CONCEPCION	ESCUELA CONCENTRADA EL POTRERITO	141	1	2	96	84	94	0	1	0	0	9	96
EDO. TRUJILLO	MP. CARACHE	PQ. LA CONCEPCION	ESCUELA ESTADAL EL RINCON	98	1	1	85	79	84	0	0	0	0	5	85
EDO. TRUJILLO	MP. CARACHE	PQ. LA CONCEPCION	ESCUELA BOLIVARIANA EL POLIPODIO	96	1	3	92	81	89	0	1	1	0	6	92
EDO. TRUJILLO	MP. CARACHE	PQ. LA CONCEPCION	ESCUELA BOLIVARIANA RIO ARRIBA	214	1	2	186	154	184	0	0	0	0	30	186
EDO. TRUJILLO	MP. CARACHE	PQ. LA CONCEPCION	UNIDAD EDUCATIVA NACIONAL GUADALUPE ROMÁN COLMENARES	870	2	6	706	527	700	0	0	0	0	173	706
EDO. TRUJILLO	MP. CARACHE	PQ. LA CONCEPCION	ESCUELA ESTADAL CONCENTRADA QUEBRADA ARRIBA	188	1	1	155	138	154	0	0	0	0	16	155
EDO. TRUJILLO	MP. CARACHE	PQ. LA CONCEPCION	ESCUELA BOLIVARIANA SISI	189	1	0	130	122	130	0	1	0	0	7	130
EDO. TRUJILLO	MP. CARACHE	PQ. CARACHE	COMPLEJO CULTURAL CARACHY	924	2	21	732	456	711	0	1	0	0	254	732
EDO. TRUJILLO	MP. CARACHE	PQ. CARACHE	CENTRO DE EDUCACION INICIAL EL SAMAN	208	1	7	166	93	159	0	0	0	0	66	166
EDO. TRUJILLO	MP. CARACHE	PQ. CARACHE	ESCUELA BOLIVARIANA MESA ARRIBA	499	1	11	360	249	349	0	4	0	0	96	360
EDO. TRUJILLO	MP. CARACHE	PQ. CARACHE	ESCUELA BOLIVARIANA AGUA DE OBISPO	65	1	0	40	31	40	1	0	0	0	8	40
EDO. TRUJILLO	MP. CARACHE	PQ. CARACHE	ESCUELA BOLIVARIANA LAS PALMAS	98	1	1	78	72	77	0	0	0	0	5	78
EDO. TRUJILLO	MP. CARACHE	PQ. CARACHE	ESCUELA ESTADAL UNITARIA LAS PEÑITAS	110	1	0	83	68	83	0	1	0	0	14	83
EDO. TRUJILLO	MP. CARACHE	PQ. CARACHE	ESCUELA NACIONAL GRADUADA LA PLAYA	722	2	10	561	341	551	0	4	0	0	206	561
EDO. TRUJILLO	MP. CARACHE	PQ. CARACHE	ESCUELA BOLIVARIANA CARACHE	616	2	15	468	301	453	0	3	0	0	149	468
EDO. TRUJILLO	MP. CARACHE	PQ. CARACHE	ESCUELA BOLIVARIANA LA UNIÓN	248	1	0	195	142	195	0	0	0	0	53	195
EDO. TRUJILLO	MP. CARACHE	PQ. CARACHE	ESCUELA BOLIVARIANA CAHINGO	111	1	1	102	96	101	0	0	0	0	5	102
EDO. TRUJILLO	MP. CARACHE	PQ. CARACHE	ESCUELA ESTADAL CONCENTRADA EL CORTIJO NÚMERO 308	155	1	0	101	94	101	0	0	1	0	6	101
EDO. TRUJILLO	MP. CARACHE	PQ. CARACHE	ESCUELA BOLIVARIANA EL POTRERO	80	1	0	69	64	69	0	0	0	0	5	69
EDO. TRUJILLO	MP. CARACHE	PQ. CARACHE	ESCUELA BOLIVARIANA DOCTOR ERNERT	1121	2	25	872	463	847	0	7	1	0	376	872
EDO. TRUJILLO	MP. CARACHE	PQ. CARACHE	CENTRO DE EDUCACIÓN INICIAL SIMONCITO DOCTOR ERNST	1055	2	16	806	424	790	0	2	0	0	364	806
EDO. TRUJILLO	MP. CARACHE	PQ. CARACHE	ESCUELA ESTADAL UNITARIA LA LAGUNETA	109	1	0	81	44	81	0	1	0	0	36	81
EDO. TRUJILLO	MP. CARACHE	PQ. CARACHE	ESCUELA BOLIVARIANA RIO ABAJO	130	1	1	99	56	98	0	2	0	0	40	99
EDO. TRUJILLO	MP. CARACHE	PQ. CARACHE	ESCUELA BOLIVARIANA LAS ADJUNTAS	277	1	2	202	124	200	0	0	0	0	76	202
EDO. TRUJILLO	MP. CARACHE	PQ. CARACHE	ESCUELA BOLIVARIANA LA PEÑA	238	1	1	186	173	185	0	1	0	0	11	186
EDO. TRUJILLO	MP. CARACHE	PQ. CARACHE	ESCUELA ESTADAL LOMA DEL MEDIO	117	1	3	104	96	101	0	0	0	0	5	104
EDO. TRUJILLO	MP. CARACHE	PQ. CARACHE	ESCUELA BOLIVARIANA MIQUIMBAY	146	1	3	105	86	102	1	0	1	0	14	105
EDO. TRUJILLO	MP. CARACHE	PQ. CARACHE	LICEO BOLIVARIANO JUAN ANTONIO ROMÁN VALECILLOS	1747	3	27	1373	745	1346	0	5	1	0	595	1373
EDO. TRUJILLO	MP. CARACHE	PQ. CARACHE	ESCUELA BOLIVARIANA LA MORITA	386	1	6	293	189	287	0	1	0	0	97	293
EDO. TRUJILLO	MP. CANDELARIA	PQ. MANUEL SALVADOR ULLOA	UNIDAD EDUCATIVA DR AMILCAR FONSECA	1613	3	33	1187	956	1154	0	4	0	0	194	1187
EDO. TRUJILLO	MP. CANDELARIA	PQ. CARRILLO	ESCUELA BOLIVARIANA MOGOTON	88	1	1	67	63	66	0	0	0	0	3	67
EDO. TRUJILLO	MP. CANDELARIA	PQ. CARRILLO	ESCUELA BOLIVARIANA SAN PEDRO	353	1	3	271	214	268	0	0	0	0	54	271
EDO. TRUJILLO	MP. CANDELARIA	PQ. CARRILLO	ESCUELA ESTADAL CONCENTRADA CRUZ VERDE	275	1	0	185	123	185	0	0	0	0	62	185
EDO. TRUJILLO	MP. CANDELARIA	PQ. CARRILLO	ESCUELA BOLIVARIANA ANTONIO JOSÉ PACHECO	950	2	9	694	524	685	0	1	0	0	160	694
EDO. TRUJILLO	MP. CANDELARIA	PQ. CARRILLO	UNIDAD EDUCATIVA NUMERO 111 438 EL GUARAMACAL	113	1	0	85	79	85	0	0	0	0	6	85
EDO. TRUJILLO	MP. CANDELARIA	PQ. ARNOLDO GABALDON	UNIDAD EDUCATIVA ANTONIO JOSE MENDOZA	630	2	4	493	428	489	0	3	0	0	58	493
EDO. TRUJILLO	MP. CANDELARIA	PQ. ARNOLDO GABALDON	ESCUELA GRADUADA ERNESTO JOSE RENGIFO
EDO. TRUJILLO	MP. CANDELARIA	PQ. ARNOLDO GABALDON	ESCUELA ESTADAL CONCENTRADA LAS INVACIONES	34	1	0	29	25	29	0	0	0	0	4	29
EDO. TRUJILLO	MP. CANDELARIA	PQ. ARNOLDO GABALDON	ESCUELA BOLIVARIANA MINAS DE MONAY	1359	3	14	1084	880	1070	1	2	0	0	187	1084
EDO. TRUJILLO	MP. CANDELARIA	PQ. CEGARRA	ESCUELA BOLIVARIANA ROBERTO GABALDON IRRAGORRY	767	2	6	574	429	568	0	2	0	0	137	574
EDO. TRUJILLO	MP. CANDELARIA	PQ. CEGARRA	ESCUELA ESTADAL NO 325	104	1	2	68	54	66	0	0	0	0	12	68
EDO. TRUJILLO	MP. CANDELARIA	PQ. SAN JOSE	ESCUELA BOLIVARIANA FRANCISCA FERRINI VELAZCO	2503	5	22	1958	1650	1936	0	9	2	0	275	1958
EDO. TRUJILLO	MP. CANDELARIA	PQ. BOLIVIA	ESCUELA BOLIVARIANA LOS PANTANOS	209	1	5	153	127	148	0	0	0	0	21	153
EDO. TRUJILLO	MP. CANDELARIA	PQ. BOLIVIA	ESCUELA BOLIVARIANA PIEDRA AZUL	67	1	0	54	41	54	0	0	0	0	13	54
EDO. TRUJILLO	MP. CANDELARIA	PQ. BOLIVIA	ESCUELA BOLIVARIANA MOROMOY	208	1	5	163	119	158	0	5	0	0	34	163
EDO. TRUJILLO	MP. CANDELARIA	PQ. BOLIVIA	COMEDOR ESCOLAR UNIDAD BASICA BOLIVIA	88	1	2	72	51	70	0	0	0	0	19	72
EDO. TRUJILLO	MP. CANDELARIA	PQ. BOLIVIA	ESCUELA UNITARIA ESTADAL EL CARDONAL	67	1	0	41	26	41	0	0	0	0	15	41
EDO. TRUJILLO	MP. CANDELARIA	PQ. BOLIVIA	ESCUELA ESTADAL UNITARIA NUMERO 332 CERRO DE PIEDRA	195	1	2	154	143	152	0	0	0	0	9	154
EDO. TRUJILLO	MP. CANDELARIA	PQ. BOLIVIA	UNIDAD EDUCATIVA LA LAGUNETA	311	1	0	240	187	240	0	0	0	0	53	240
EDO. TRUJILLO	MP. CANDELARIA	PQ. BOLIVIA	ESCUELA BOLIVARIANA BOLIVIA	509	1	1	407	321	406	0	2	2	0	81	407
EDO. TRUJILLO	MP. CANDELARIA	PQ. BOLIVIA	ESCUELA BOLIVARIANA LOMA DE BOLIVIA	240	1	3	170	145	167	0	1	0	0	21	170
EDO. TRUJILLO	MP. CANDELARIA	PQ. BOLIVIA	ESCUELA ESTADAL NUMERO 41	208	1	2	140	122	138	0	0	0	0	16	140
EDO. TRUJILLO	MP. CANDELARIA	PQ. BOLIVIA	ESCUELA ESTADAL SUPERNUMERARIA	327	1	1	245	216	244	0	1	0	0	27	245
EDO. TRUJILLO	MP. CANDELARIA	PQ. CHEJENDE	ESCUELA BOLIVARIANA RIÓ SECO NUCLEO ESCOLAR RURAL 172	401	1	2	317	278	315	0	1	0	0	36	317
EDO. TRUJILLO	MP. CANDELARIA	PQ. CHEJENDE	ESCUELA CONCENTRADA LOS CUMBITOS	140	1	1	128	94	127	0	3	0	0	30	128
EDO. TRUJILLO	MP. CANDELARIA	PQ. CHEJENDE	COMPLEJO EDUCATIVO CRISTOBAL MENDOZA	521	1	6	389	243	383	0	0	0	0	140	389
EDO. TRUJILLO	MP. CANDELARIA	PQ. CHEJENDE	ESCUELA CONCENTRADA EL MONTANON	71	1	2	60	50	58	0	1	0	0	7	60
EDO. TRUJILLO	MP. CANDELARIA	PQ. CHEJENDE	ESCUELA BOLIVARIANA GUAMAS DE MONAY	1313	3	19	1016	852	997	1	4	1	0	139	1016
EDO. TRUJILLO	MP. CANDELARIA	PQ. CHEJENDE	UNIDAD EDUCATIVA NARIGUETE NUMERO 50 NER 176	213	1	2	168	87	166	0	0	0	0	79	168
EDO. TRUJILLO	MP. CANDELARIA	PQ. CHEJENDE	ESCUELA BOLIVARIANA SABANA LARGA	209	1	1	186	132	185	0	4	0	0	49	186
EDO. TRUJILLO	MP. CANDELARIA	PQ. CHEJENDE	ESCUELA ESTADAL SN	96	1	2	67	39	65	0	0	0	0	26	67
EDO. TRUJILLO	MP. CANDELARIA	PQ. CHEJENDE	ESCUELA ESTADAL CONCENTRADA SIN NUMERO  LA VICIOSA	398	1	5	317	223	312	0	2	1	0	86	317
EDO. TRUJILLO	MP. CANDELARIA	PQ. CHEJENDE	UNIDAD EDUCATIVA CHEJENDE	319	1	8	250	136	242	0	1	0	0	105	250
EDO. TRUJILLO	MP. CANDELARIA	PQ. CHEJENDE	ESCUELA BOLIVARIANA LA PREGONERA	220	1	1	130	118	129	0	1	0	0	10	130
EDO. TRUJILLO	MP. CANDELARIA	PQ. CHEJENDE	UNIDAD EDUCATIVA MARIA ELECTA TORRES	301	1	1	268	243	267	0	1	0	0	23	268
EDO. TRUJILLO	MP. CANDELARIA	PQ. CHEJENDE	UNIDAD EDUCATIVA EL BATATILLO	861	2	15	635	476	620	0	2	0	0	142	635
EDO. TRUJILLO	MP. CANDELARIA	PQ. CHEJENDE	UNIDAD EDUCATIVA SAN FELIPE	425	1	4	312	253	308	0	1	0	0	54	312
EDO. TRUJILLO	MP. CANDELARIA	PQ. CHEJENDE	UNIDAD EDUCATIVA FRANCISCO TORRES TORO	1014	2	24	769	602	745	0	2	0	1	140	769
EDO. TRUJILLO	MP. CANDELARIA	PQ. CHEJENDE	UNIDAD BASICA NUMERO 260 BITUBU	165	1	4	110	63	106	0	0	0	0	43	110
EDO. TRUJILLO	MP. CANDELARIA	PQ. CHEJENDE	ESCUELA BOLIVARIANA JOSE FELIPE MARQUEZ	1372	3	23	961	601	938	0	2	0	0	335	961
EDO. TRUJILLO	MP. CANDELARIA	PQ. CHEJENDE	ESCUELA BOLIVARIANA LAS MESETAS	103	1	3	88	69	85	0	2	0	0	14	88
EDO. TRUJILLO	MP. SUCRE	PQ. EL PARAISO	ESCUELA ESTADAL SIN NÚMERO EL PARAISO	244	1	4	184	126	180	0	0	0	0	54	184
EDO. TRUJILLO	MP. SUCRE	PQ. EL PARAISO	UNIDAD EDUCATIVA EL PARAISO	1087	2	16	757	506	741	0	0	0	0	235	757
EDO. TRUJILLO	MP. SUCRE	PQ. SABANA DE MENDOZA	ESCUELA CONCENTRADA NACIONAL SIMÓN BOLÍVAR NER 071	347	1	7	289	238	282	1	0	0	0	43	289
EDO. TRUJILLO	MP. SUCRE	PQ. SABANA DE MENDOZA	ESCUELA BOLIVARIANA GRAN MARISCAL ANTONIO JOSE DE SUCRE	360	1	4	289	225	285	0	1	0	0	59	289
EDO. TRUJILLO	MP. SUCRE	PQ. SABANA DE MENDOZA	UNIDAD BÁSICA MERCEDEZ DIAZ	2946	5	43	2389	1299	2346	0	10	0	1	1036	2389
EDO. TRUJILLO	MP. SUCRE	PQ. SABANA DE MENDOZA	CASA DE LA CULTURA DE SABANA DE MENDOZA	1372	3	19	1143	670	1124	0	3	0	1	450	1143
EDO. TRUJILLO	MP. SUCRE	PQ. SABANA DE MENDOZA	LICEO BOLIVARIANO CRUZ CARRILLLO	1640	3	16	1314	778	1298	2	8	0	0	510	1314
EDO. TRUJILLO	MP. SUCRE	PQ. SABANA DE MENDOZA	CENTRO DE EDUCACIÓN INICIAL SABANA DE MENDOZA	852	2	17	704	331	687	0	3	0	0	353	704
EDO. TRUJILLO	MP. SUCRE	PQ. JUNIN	UNIDAD BÁSICA 27 DE JUNIO DE 1870	2148	4	19	1705	1167	1686	0	2	0	0	517	1705
EDO. TRUJILLO	MP. SUCRE	PQ. JUNIN	ESCUELA GRADUADA RÓMULO BETANCOURT	554	1	3	429	285	426	0	1	0	0	140	429
EDO. TRUJILLO	MP. SUCRE	PQ. VALMORE RODRIGUEZ	COLEGIO MARISCAL ANTONIO JOSÉ DE SUCRE	3122	6	41	2563	1633	2522	3	6	1	0	879	2563
EDO. TRUJILLO	MP. SUCRE	PQ. VALMORE RODRIGUEZ	GIMNASIO CUBIERTO SABANA DE MENDOZA	1057	2	17	819	606	802	0	5	2	0	189	819
EDO. TRUJILLO	MP. SUCRE	PQ. VALMORE RODRIGUEZ	ESCUELA TÉCNICA ROBINSONIANA SABANA DE MENDOZA	236	1	7	214	197	207	0	0	0	0	10	214
EDO. TRUJILLO	MP. SUCRE	PQ. VALMORE RODRIGUEZ	UNIDAD EDUCATIVA VALMORE RODRIGUEZ	2730	5	32	2146	1423	2114	1	8	2	0	680	2146
EDO. TRUJILLO	MP. SUCRE	PQ. VALMORE RODRIGUEZ	ALDEA BOLIVARIANA MUNICIPIO SUCRE	655	2	10	526	450	516	0	2	0	0	64	526
EDO. TRUJILLO	MP. SUCRE	PQ. VALMORE RODRIGUEZ	UNIVERSIDAD PEDAGOGICA EXPERIMENTAL LIBERTADOR (UPEL)	41	1	1	38	22	37	0	1	0	0	14	38
EDO. TRUJILLO	MP. PAMPAN	PQ. SANTA ANA	ESCUELA NACIONAL 540 EL ZAMURITO	273	1	3	204	184	201	0	0	0	0	17	204
EDO. TRUJILLO	MP. PAMPAN	PQ. SANTA ANA	ESCUELA BASICA SIN NUMERO COROZO DE SIQUISAY	135	1	0	112	110	112	0	0	0	0	2	112
EDO. TRUJILLO	MP. PAMPAN	PQ. SANTA ANA	ESCUELA CONCENTRADA LAS LAJAS	337	1	2	260	247	258	0	0	0	0	11	260
EDO. TRUJILLO	MP. PAMPAN	PQ. SANTA ANA	ESCUELA BOLIVARIANA LOS CORRALES	246	1	3	216	187	213	0	0	0	0	26	216
EDO. TRUJILLO	MP. PAMPAN	PQ. SANTA ANA	ESCUELA BOLIVARIANA SIQUISAY	388	1	3	294	241	291	0	2	0	0	48	294
EDO. TRUJILLO	MP. PAMPAN	PQ. SANTA ANA	ESCUELA ESTADAL CONCENTRADA	147	1	1	111	100	110	0	1	0	0	9	111
EDO. TRUJILLO	MP. PAMPAN	PQ. SANTA ANA	ESCUELA BOLIVARIANA 27 DE NOVIEMBRE DE 1820	2658	5	28	2050	1426	2022	1	6	0	1	588	2050
EDO. TRUJILLO	MP. PAMPAN	PQ. SANTA ANA	ESCUELA BOLIVARIANA LA BECERRERA	142	1	2	103	96	101	0	0	0	0	5	103
EDO. TRUJILLO	MP. PAMPAN	PQ. SANTA ANA	ESCUELA CONCENTRADA SIN NUMERO	270	1	4	201	186	197	0	1	1	0	9	201
EDO. TRUJILLO	MP. PAMPAN	PQ. SANTA ANA	UNIDAD EDUCATIVA BOLIVARIANA VITU	675	2	7	531	403	524	0	1	0	0	120	531
EDO. TRUJILLO	MP. PAMPAN	PQ. SANTA ANA	ESCUELA BOLIVARIANA EL LLANITO	238	1	6	221	165	215	0	0	0	0	50	221
EDO. TRUJILLO	MP. PAMPAN	PQ. SANTA ANA	ESCUELA ESTADAL CONCENTRADA NUMERO 305 EL COROZO	325	1	3	216	190	213	0	0	1	0	22	216
EDO. TRUJILLO	MP. PAMPAN	PQ. FLOR DE PATRIA	ESCUELA CONCENTRADA SIN NUMERO EL COROZAL	273	1	11	254	213	243	0	0	0	0	30	254
EDO. TRUJILLO	MP. PAMPAN	PQ. FLOR DE PATRIA	ESCUELA BOLIVARIANA EL VALLE	242	1	4	207	160	203	0	1	0	0	42	207
EDO. TRUJILLO	MP. PAMPAN	PQ. FLOR DE PATRIA	ESCUELA BOLIVARIANA LA VERA	214	1	3	177	146	174	0	0	0	0	28	177
EDO. TRUJILLO	MP. PAMPAN	PQ. FLOR DE PATRIA	ESCUELA BOLIVARIANA FERNÁNDO SEGNINI LUPI	1434	3	25	1149	818	1124	1	5	0	0	300	1149
EDO. TRUJILLO	MP. PAMPAN	PQ. FLOR DE PATRIA	ESCUELA BOLIVARIANA MONTAÑAS DE PERAZA
EDO. TRUJILLO	MP. PAMPAN	PQ. FLOR DE PATRIA	ESCUELA BOLIVARIANA FRANCISCO JAVIER URBINA	3339	6	42	2721	1534	2679	0	10	0	1	1134	2721
EDO. TRUJILLO	MP. PAMPAN	PQ. FLOR DE PATRIA	ESCUELA BÁSICA LA CONCENTRADA LA BETICÓ	320	1	7	239	201	232	0	0	0	0	31	239
EDO. TRUJILLO	MP. PAMPAN	PQ. FLOR DE PATRIA	NUCLEO ESCOLAR RURAL EL CAPUCAL	129	1	1	117	113	116	0	0	0	0	3	117
EDO. TRUJILLO	MP. PAMPAN	PQ. FLOR DE PATRIA	UNIDAD EDUCATIVA  ELVIA MONTILLA DE SANTOS	1066	2	24	913	550	889	0	2	0	0	337	913
EDO. TRUJILLO	MP. PAMPAN	PQ. FLOR DE PATRIA	ESCUELA UNITARIA CARACOLES	41	1	0	38	37	38	0	0	0	0	1	38
EDO. TRUJILLO	MP. PAMPAN	PQ. FLOR DE PATRIA	ESCUELA BOLIVARIANA DE EDUCACION ESPECIAL	2110	4	46	1758	1043	1712	1	6	1	0	661	1758
EDO. TRUJILLO	MP. PAMPAN	PQ. LA PAZ	ESCUELA BOLIVARIANA PUENTE BLANCO	126	1	6	111	85	105	0	0	0	0	20	111
EDO. TRUJILLO	MP. PAMPAN	PQ. LA PAZ	ESCUELA COCENTRADA LA GARITA NER 540	125	1	4	116	106	112	0	0	0	0	6	116
EDO. TRUJILLO	MP. PAMPAN	PQ. LA PAZ	ESCUELA ESTADAL LUCILA CORONADO	193	1	3	163	139	160	0	1	0	0	20	163
EDO. TRUJILLO	MP. PAMPAN	PQ. LA PAZ	ESCUELA BOLIVARIANA CAMPO ESTRELLA	445	1	7	354	312	347	0	4	1	0	30	354
EDO. TRUJILLO	MP. PAMPAN	PQ. LA PAZ	ALDEA BOLIVARIANA   LA PAZ	532	1	5	434	376	429	0	1	0	0	52	434
EDO. TRUJILLO	MP. PAMPAN	PQ. LA PAZ	SEDE DE PROTECCIÓN CIVIL	1120	2	31	856	606	825	1	4	0	0	214	856
EDO. TRUJILLO	MP. PAMPAN	PQ. LA PAZ	ESCUELA BOLIVARIANA SANTA LUCIA DE MONAY	638	2	6	505	401	499	0	3	0	0	95	505
EDO. TRUJILLO	MP. PAMPAN	PQ. LA PAZ	UNIDAD EDUCATIVA JOSÉ ANTONIO GALUE	1509	3	21	1139	924	1118	0	10	0	0	184	1139
EDO. TRUJILLO	MP. PAMPAN	PQ. LA PAZ	UNIDAD EDUCATIVA JOSEFINA PIMENTEL	3128	6	70	2473	1647	2403	1	7	2	0	746	2473
EDO. TRUJILLO	MP. PAMPAN	PQ. LA PAZ	ESCUELA  BOLIVARIANO EL MACOYAL	1266	3	19	987	824	968	0	5	1	0	138	987
EDO. TRUJILLO	MP. PAMPAN	PQ. LA PAZ	LICEO BOLIVARIANO MONAY	2404	5	30	1931	1297	1901	0	6	2	1	595	1931
EDO. TRUJILLO	MP. PAMPAN	PQ. PAMPAN	ESCUELA BOLIVARIANA LA CATALINA	248	1	4	169	151	165	0	0	0	0	14	169
EDO. TRUJILLO	MP. PAMPAN	PQ. PAMPAN	CENTRO RECREACIONAL Y DEPOTIVO PAMPÁN (PARQUE)	108	1	5	93	41	88	0	1	0	0	46	93
EDO. TRUJILLO	MP. PAMPAN	PQ. PAMPAN	LICEO BOLIVARIANO RAFAEL MARIA URRECHEAGA	2424	5	46	2054	992	2008	1	11	0	2	1002	2054
EDO. TRUJILLO	MP. PAMPAN	PQ. PAMPAN	ESCUELA BOLIVARIANA LOS PAJONES	115	1	0	93	88	93	0	0	0	0	5	93
EDO. TRUJILLO	MP. PAMPAN	PQ. PAMPAN	ESCUELA BOLIVARIANA FRANCISCO DE SALES PÉREZ	3521	7	57	2862	1560	2805	0	16	0	0	1229	2862
EDO. TRUJILLO	MP. JUAN V CAMPO ELI	PQ. ARNOLDO GABALDON	ESCUELA ESTADAL CONCENTRADA N#55 LA CIMA	163	1	3	145	110	142	0	1	0	0	31	145
EDO. TRUJILLO	MP. JUAN V CAMPO ELI	PQ. ARNOLDO GABALDON	ESCUELA BOLIVARIANA NUMERO 06 EL MORRITO	271	1	3	211	166	208	0	1	0	0	41	211
EDO. TRUJILLO	MP. JUAN V CAMPO ELI	PQ. ARNOLDO GABALDON	ESCUELA ESTADAL UNITARIA N*431 LA CUCHILLA DE SAGUAS	87	1	1	65	54	64	0	0	0	0	10	65
EDO. TRUJILLO	MP. JUAN V CAMPO ELI	PQ. ARNOLDO GABALDON	ESCUELA BOLIVARIANA FÉLIX BEREBESI PÉREZ	378	1	6	282	258	276	1	0	0	0	17	282
EDO. TRUJILLO	MP. JUAN V CAMPO ELI	PQ. ARNOLDO GABALDON	UNIDAD EDUCATIVA ESTADAL CONCENTRADA NUMERO 26 TIERRA BLANCA	426	1	3	320	251	317	0	1	1	0	64	320
EDO. TRUJILLO	MP. JUAN V CAMPO ELI	PQ. ARNOLDO GABALDON	ESCUELA BOLIVARIANA LAS QUEBRADAS	485	1	6	359	286	353	0	0	0	0	67	359
EDO. TRUJILLO	MP. JUAN V CAMPO ELI	PQ. CAMPO ELIAS	ESCUELA BOLIVARIANA LA CUCHILLA DE CAMPO ELIAS	450	1	7	353	308	346	0	1	0	0	37	353
EDO. TRUJILLO	MP. JUAN V CAMPO ELI	PQ. CAMPO ELIAS	ESCUELA ESTADAL UNITARIA NUMERO 177 LA MORITA	363	1	7	318	263	311	1	1	2	0	44	318
EDO. TRUJILLO	MP. JUAN V CAMPO ELI	PQ. CAMPO ELIAS	ESCUELA BOLIVARIANA CUNAVICHE	364	1	5	300	267	295	0	1	0	0	27	300
EDO. TRUJILLO	MP. JUAN V CAMPO ELI	PQ. CAMPO ELIAS	ESCUELA BOLIVARIANA LOS APOSENTOS	131	1	1	125	115	124	0	0	0	0	9	125
EDO. TRUJILLO	MP. JUAN V CAMPO ELI	PQ. CAMPO ELIAS	ESCUELA BOLIVARIANA PORTILLO Y VALERA	2324	4	28	1888	1208	1860	0	5	0	2	645	1888
EDO. TRUJILLO	MP. ESCUQUE	PQ. ESCUQUE	UNIDAD EDUCATIVA JUAN DIAZ	28	1	0	25	16	25	0	0	0	0	9	25
EDO. TRUJILLO	MP. ESCUQUE	PQ. ESCUQUE	ESCUELA ESTADAL UNITARIA NUMERO 195 EL PALMICHERO	0	94	5	2
EDO. TRUJILLO	MP. ESCUQUE	PQ. ESCUQUE	GRUPO ESCOLAR EDUARDO BLANCO	2037	4	26	1681	915	1655	0	8	0	1	731	1681
EDO. TRUJILLO	MP. ESCUQUE	PQ. ESCUQUE	ESCUELA NACIONAL NÚMERO 968	128	1	0	105	99	105	0	2	0	0	4	105
EDO. TRUJILLO	MP. ESCUQUE	PQ. ESCUQUE	CENTRO DE EDUCACIÓN INICIAL ROSA BRICEÑO DE GONZALEZ	351	1	7	312	217	305	0	2	0	0	86	312
EDO. TRUJILLO	MP. ESCUQUE	PQ. ESCUQUE	CENTRO DE EDUCACION INICIAL EDUARDO BLANCO	1069	2	15	879	456	864	0	5	0	1	402	879
EDO. TRUJILLO	MP. ESCUQUE	PQ. ESCUQUE	COMPLEJO CULTURAL POLINIA SANCHEZ DE OLMOS	1264	3	21	1057	525	1036	0	4	0	0	507	1057
EDO. TRUJILLO	MP. ESCUQUE	PQ. ESCUQUE	ESCUELA ESTADAL CONCENTRADA SABANETA	348	1	1	278	226	277	0	2	0	0	49	278
EDO. TRUJILLO	MP. ESCUQUE	PQ. ESCUQUE	UNIDAD EDUCATIVA SANTA ROSA	86	1	2	84	79	82	0	0	0	0	3	84
EDO. TRUJILLO	MP. ESCUQUE	PQ. ESCUQUE	ESCUELA NACIONAL EL TENDAL	186	1	1	175	129	174	0	0	0	0	45	175
EDO. TRUJILLO	MP. ESCUQUE	PQ. ESCUQUE	CENTRO PREESCOLAR SOPOTOCIENTOS	451	1	2	413	276	411	0	2	0	0	133	413
EDO. TRUJILLO	MP. ESCUQUE	PQ. ESCUQUE	UNIDAD EDUCATIVA VICENTE DE LA TORRE	537	1	5	472	343	467	0	1	1	0	122	472
EDO. TRUJILLO	MP. ESCUQUE	PQ. ESCUQUE	ESCUELA ESTADAL UNITARIA SIN NÚMERO EL CHARAL	130	1	3	102	83	99	0	1	0	0	15	102
EDO. TRUJILLO	MP. ESCUQUE	PQ. ESCUQUE	ESCUELA BOLIVARIANA LA HONDA	426	1	9	354	243	345	0	1	0	0	101	354
EDO. TRUJILLO	MP. ESCUQUE	PQ. ESCUQUE	UNIDAD ESCOLAR MEDIA LUNA	1372	3	32	1103	667	1071	0	1	0	1	402	1103
EDO. TRUJILLO	MP. ESCUQUE	PQ. ESCUQUE	LICEO BOLIVARIANO IGNACIO CARRASQUERO	1527	3	22	1311	808	1289	0	9	0	0	472	1311
EDO. TRUJILLO	MP. ESCUQUE	PQ. SANTA RITA	ESCUELA NACIONAL COLINAS DE CARMANIA	406	1	8	376	258	368	0	5	1	0	104	376
EDO. TRUJILLO	MP. ESCUQUE	PQ. SANTA RITA	ESCUELA ESTADAL SIN NUMERO  QUEVEDO	254	1	5	217	156	212	0	0	0	0	56	217
EDO. TRUJILLO	MP. ESCUQUE	PQ. SANTA RITA	UNIDAD EDUCATIVA ANTONIO GUZMAN BLANCO	301	1	7	272	234	265	0	0	0	1	30	272
EDO. TRUJILLO	MP. ESCUQUE	PQ. SANTA RITA	UNIDAD EDUCATIVA RURAL LA MATA	1241	3	19	1028	624	1009	0	6	0	0	379	1028
EDO. TRUJILLO	MP. ESCUQUE	PQ. SABANA LIBRE	ESCUELA CONCENTRADA EL COROZO	311	1	3	257	177	254	0	1	0	0	76	257
EDO. TRUJILLO	MP. ESCUQUE	PQ. SABANA LIBRE	ESCUELA CONCENTRADA RETOÑITOS EL PENCIL	762	2	7	663	549	656	0	2	1	0	104	663
EDO. TRUJILLO	MP. ESCUQUE	PQ. SABANA LIBRE	ESCUELA BOLIVARIANA NEPTALÍ VALERA HURTADO	2746	5	54	2256	997	2202	0	7	1	0	1197	2256
EDO. TRUJILLO	MP. ESCUQUE	PQ. SABANA LIBRE	ESCUELA ESTADAL CONCENTRADA NUMERO 123	325	1	4	270	185	266	0	2	0	0	79	270
EDO. TRUJILLO	MP. ESCUQUE	PQ. SABANA LIBRE	LICEO BOLIVARIANO SABANA LIBRE	625	2	9	537	302	528	0	2	0	0	224	537
EDO. TRUJILLO	MP. ESCUQUE	PQ. LA UNION	ESCUELA BOLIVARIANA ESTEBAN RASQUIN	1116	2	18	938	506	920	0	5	0	0	409	938
EDO. TRUJILLO	MP. ESCUQUE	PQ. LA UNION	ESCUELA NUMERO 1275 LAS CRUCES	447	1	4	386	238	382	1	1	0	0	142	386
EDO. TRUJILLO	MP. ESCUQUE	PQ. LA UNION	ESCUELA ESTADAL CONCENTRADA LA QUINTA	321	1	6	265	151	259	0	3	0	0	105	265
EDO. TRUJILLO	MP. ESCUQUE	PQ. LA UNION	ESCUELA ESTADAL CONCENTRADA EL BOQUERÓN	362	1	4	303	184	299	0	1	0	0	114	303
EDO. TRUJILLO	MP. VALERA	PQ. LA PUERTA	ESCUELA ESTADAL CONCENTRADA LA FLECHA NER 05	371	1	8	300	196	292	0	0	0	0	96	300
EDO. TRUJILLO	MP. VALERA	PQ. LA PUERTA	ESCUELA CONCENTRADA ESTADAL PARAMO DE LOS TORRES	196	1	1	169	163	168	0	0	0	0	5	169
EDO. TRUJILLO	MP. VALERA	PQ. LA PUERTA	ESCUELA BÁSICA CONCENTRADA CARORITA	302	1	2	263	233	261	0	2	1	0	25	263
EDO. TRUJILLO	MP. VALERA	PQ. LA PUERTA	ESCUELA BASICA CONCENTRADA LAS DELICIAS	415	1	3	321	189	318	0	1	0	0	128	321
EDO. TRUJILLO	MP. VALERA	PQ. LA PUERTA	UNIDAD EDUCATIVA JOSÉ LUIS FAURET SABAUT	3336	6	47	2631	1264	2584	0	8	0	2	1310	2631
EDO. TRUJILLO	MP. VALERA	PQ. LA PUERTA	CENTRO EDUCACION INICIAL  SIMONCITO JOSE LUIS FAURE SABAUT	540	1	10	430	227	420	0	0	0	0	193	430
EDO. TRUJILLO	MP. VALERA	PQ. LA PUERTA	ESCUELA ESTADAL CONCENTRADA CARMEN DELIA ARTIGAS DE VILORIA	883	2	11	723	530	712	0	4	1	0	177	723
EDO. TRUJILLO	MP. VALERA	PQ. LA PUERTA	UNIDAD EDUCATIVA ADOLFO NAVAS CORONADO	859	2	16	713	405	697	0	3	0	1	288	713
EDO. TRUJILLO	MP. VALERA	PQ. SAN LUIS	ESCUELA CONCENTRADA SAN LUIS NER 365	87	1	2	76	49	74	0	0	1	0	24	76
EDO. TRUJILLO	MP. VALERA	PQ. SAN LUIS	CENTRO INTEGRAL BOLIVARIANO REINA BARRETO DE MOLINA	1270	3	19	1100	661	1081	0	9	0	0	411	1100
EDO. TRUJILLO	MP. VALERA	PQ. SAN LUIS	UNIDAD EDUCATIVA FE Y ALEGRÍA  GONZALO SENIOR	1013	2	9	891	639	882	1	2	0	0	240	891
EDO. TRUJILLO	MP. VALERA	PQ. SAN LUIS	VILLA DEPORTIVA	45	1	0	39	29	39	0	0	0	0	10	39
EDO. TRUJILLO	MP. VALERA	PQ. SAN LUIS	CENTRO DE EDUCACION INTEGRAL RÓMULO GALLEGOS	1111	2	33	921	556	888	0	4	1	0	327	921
EDO. TRUJILLO	MP. VALERA	PQ. SAN LUIS	UNIDAD EDUCATIVA ESTADAL ROMULO GALLEGOS	3330	6	59	2764	1741	2705	0	14	2	1	947	2764
EDO. TRUJILLO	MP. VALERA	PQ. SAN LUIS	MODULO DE SERVICIO FONDO COMUNAL SAN LUI	54	1	1	49	38	48	0	0	0	0	10	49
EDO. TRUJILLO	MP. VALERA	PQ. SAN LUIS	INSTITUTO NACIONAL DE TIERRAS (INTI)	1167	3	14	1001	634	987	0	5	1	1	346	1001
EDO. TRUJILLO	MP. VALERA	PQ. SAN LUIS	UNIDAD EDUCATIVA JOSE GREGORIO HERNANDEZ	2131	4	69	1842	1144	1773	0	12	1	2	614	1842
EDO. TRUJILLO	MP. VALERA	PQ. MERCEDES DIAZ	UNIDAD EDUCATIVA BOLIVARIANA PRE VOCACIONAL AGUA CLARA	1136	2	16	952	519	936	0	2	1	2	412	952
EDO. TRUJILLO	MP. VALERA	PQ. MERCEDES DIAZ	ESCUELA BOLIVARIANA SAN RAFAEL	1557	3	34	1375	624	1341	3	8	0	0	706	1375
EDO. TRUJILLO	MP. VALERA	PQ. MERCEDES DIAZ	UNIDAD EDUCATIVA SAN VICENTE DE PAÚL	1151	2	20	984	609	964	0	3	0	1	351	984
EDO. TRUJILLO	MP. VALERA	PQ. MERCEDES DIAZ	CENTRO DE EDUCACIÓN INICIAL REINA BARRETO DE MOLINA	211	1	1	177	106	176	0	0	0	0	70	177
EDO. TRUJILLO	MP. VALERA	PQ. MERCEDES DIAZ	JARDIN DE INFANCIA BOLIVARIANA NUESTRA SEÑORA DE LA PAZ	2978	6	49	2433	1748	2384	0	9	2	1	624	2433
EDO. TRUJILLO	MP. VALERA	PQ. MERCEDES DIAZ	ESCUELA BOLIVARIANA CAJA DE AGUA	2267	4	37	1805	1183	1768	2	10	1	0	572	1805
EDO. TRUJILLO	MP. VALERA	PQ. MERCEDES DIAZ	UNIDAD EDUCATIVA ANTONIO NICOLÁS BRICEÑO	1110	2	17	894	410	877	0	1	0	0	466	894
EDO. TRUJILLO	MP. VALERA	PQ. MERCEDES DIAZ	UNIDAD EDUCATIVA LAS MERCEDES	3015	6	48	2411	1720	2363	2	10	3	0	628	2411
EDO. TRUJILLO	MP. VALERA	PQ. MERCEDES DIAZ	LICEO CULTURAL BOLIVARIANO  MONSEÑOR JOSÉ HUMBERTO CONTRERAS	1619	3	22	1348	695	1326	0	4	0	0	627	1348
EDO. TRUJILLO	MP. VALERA	PQ. MERCEDES DIAZ	UNIDAD EDUCATIVA DR. JOSE MANUEL SISO MARTINEZ	468	1	4	433	328	429	0	4	0	0	97	433
EDO. TRUJILLO	MP. VALERA	PQ. MERCEDES DIAZ	UNIDAD EDUCATIVA COLEGIO MADRE RAFOLS	1926	4	41	1570	794	1529	0	4	0	1	730	1570
EDO. TRUJILLO	MP. VALERA	PQ. MERCEDES DIAZ	ESCUELA BOLIVARIANA MONSEÑOR LUCAS GUILLERMO CASTILLO	2696	5	53	2265	1082	2212	1	7	1	0	1121	2265
EDO. TRUJILLO	MP. VALERA	PQ. MERCEDES DIAZ	MODULO DE SERVICIO LA FLORESTA	235	1	4	194	140	190	0	0	1	0	49	194
EDO. TRUJILLO	MP. VALERA	PQ. MERCEDES DIAZ	COMEDOR POPULAR MONSEÑOR MEJIAS	587	1	4	508	258	504	0	4	0	2	240	508
EDO. TRUJILLO	MP. VALERA	PQ. MERCEDES DIAZ	CENTRO DE EDUCACION INICIAL BOLIVARIANO REINA BARRETO	1201	3	14	1019	465	1005	0	5	2	1	532	1019
EDO. TRUJILLO	MP. VALERA	PQ. MERCEDES DIAZ	UNIDAD EDUCATIVA SAN JOSÉ	1149	2	11	1003	509	992	0	2	0	0	481	1003
EDO. TRUJILLO	MP. VALERA	PQ. MERCEDES DIAZ	LICEO BOLIVARIANO ANTONIO NICOLÁS BRICEÑO	3350	6	39	2826	1535	2787	0	7	1	4	1240	2826
EDO. TRUJILLO	MP. VALERA	PQ. MERCEDES DIAZ	UNIDAD EDUCATIVA COLEGIO PRIVADO DR. ARISTIDES CALVANI	1419	3	20	1191	527	1171	0	4	1	0	639	1191
EDO. TRUJILLO	MP. VALERA	PQ. MERCEDES DIAZ	CENTRO DE EDUCACIÓN INICIAL ALBORADA	1269	3	18	1173	477	1155	0	4	0	0	674	1173
EDO. TRUJILLO	MP. VALERA	PQ. MERCEDES DIAZ	UNIDAD EDUCATIVA NACIONAL PADRE BLANCO	3214	6	43	2568	1161	2525	2	15	3	4	1340	2568
EDO. TRUJILLO	MP. VALERA	PQ. MERCEDES DIAZ	UNIDAD EDUCATIVA ANDRÉS ELOY BLANCO	980	2	7	798	412	791	0	6	0	1	372	798
EDO. TRUJILLO	MP. VALERA	PQ. MERCEDES DIAZ	ESCUELA BOLIVARIANA LAS TRAVESIAS	357	1	8	314	255	306	1	1	0	0	49	314
EDO. TRUJILLO	MP. VALERA	PQ. MERCEDES DIAZ	ESCUELA BOLIVARIANA LA CABAÑA	863	2	20	690	395	670	0	1	0	0	274	690
EDO. TRUJILLO	MP. VALERA	PQ. MERCEDES DIAZ	UNIDAD EDUCATIVA SIMON BOLIVAR	455	1	6	400	324	394	0	1	0	0	69	400
EDO. TRUJILLO	MP. VALERA	PQ. MERCEDES DIAZ	UNIDAD EDUCATIVA GENERALA DOLORES DIONISIA SANTOS MORENO	52	1	0	45	34	45	0	0	0	0	11	45
EDO. TRUJILLO	MP. VALERA	PQ. MERCEDES DIAZ	LICEO BOLIVARIANO ANTONIO JOSÉ PACHECO	369	1	2	333	133	331	0	0	0	0	198	333
EDO. TRUJILLO	MP. VALERA	PQ. MERCEDES DIAZ	ESCUELA BÁSICA BARRIO NUEVO	2733	5	37	2234	1658	2197	3	10	1	0	525	2234
EDO. TRUJILLO	MP. VALERA	PQ. MERCEDES DIAZ	UNIDAD EDUCATIVA ESTADAL RICARDO LABASTIDAS	1590	3	20	1350	702	1330	0	5	0	0	623	1350
EDO. TRUJILLO	MP. VALERA	PQ. MENDOZA	ESCUELA BÁSICA CONCENTRADA LA CAÑADA	368	1	5	314	174	309	0	1	0	1	133	314
EDO. TRUJILLO	MP. VALERA	PQ. MENDOZA	UNIDAD EDUCATIVA RURAL JOSE FELIX RIBAS	1273	3	16	1092	608	1076	0	4	0	0	464	1092
EDO. TRUJILLO	MP. VALERA	PQ. MENDOZA	LICEO BOLIVARIANO DOCTOR REGULO BURELLI RIVAS	3169	6	36	2555	1346	2519	0	8	0	1	1164	2555
EDO. TRUJILLO	MP. VALERA	PQ. MENDOZA	ESCUELA CONCENTRADA ESTADAL LA CULEBRINA NÚCLEO ESCOLAR RURAL 365	263	1	1	198	164	197	1	0	1	0	31	198
EDO. TRUJILLO	MP. VALERA	PQ. MENDOZA	ESCUELA ESTADAL S N CORDILLERA DE MENDOZA	184	1	0	106	99	106	1	0	0	0	6	106
EDO. TRUJILLO	MP. VALERA	PQ. MENDOZA	ESCUELA CONCENTRADA SAN PABLO	1102	2	23	892	471	869	1	7	1	0	389	892
EDO. TRUJILLO	MP. VALERA	PQ. MENDOZA	ESCUELA UNITARIA EL QUEBRADON	142	1	1	104	77	103	0	0	0	1	25	104
EDO. TRUJILLO	MP. VALERA	PQ. LA BEATRIZ	JARDÍN DE INFANCIA NUESTRA SEÑORA DE LA CANDELARIA	1541	3	11	1391	652	1380	0	4	1	0	723	1391
EDO. TRUJILLO	MP. VALERA	PQ. LA BEATRIZ	INSTITUTO DE EDUCACIÓN ESPECIAL BOLIVARIANO FRAY IGNACIO ALVAREZ	2494	5	27	2249	1018	2222	0	9	0	2	1193	2249
EDO. TRUJILLO	MP. VALERA	PQ. LA BEATRIZ	UNIDAD EDUCATIVA NUESTRA SEÑORA DE LA CANDELARIA	3255	6	34	2883	1279	2849	1	10	2	1	1556	2883
EDO. TRUJILLO	MP. VALERA	PQ. LA BEATRIZ	UNIVERSIDAD NACIONAL  EXPERIMENTAL  SIMÓN RODRIGUEZ	934	2	20	841	329	821	0	1	0	0	491	841
EDO. TRUJILLO	MP. VALERA	PQ. JUAN IGNACIO MONTILLA	CENTRO EDUCACION INICIAL BOLIVARIANA EL NIÑO SIMÓN	1969	4	17	1729	561	1712	1	5	2	2	1141	1729
EDO. TRUJILLO	MP. VALERA	PQ. JUAN IGNACIO MONTILLA	ESCUELA BOLIVARIANA LA PLATA III	2485	5	28	2197	812	2169	0	8	0	0	1349	2197
EDO. TRUJILLO	MP. VALERA	PQ. JUAN IGNACIO MONTILLA	CASA DEL NIÑO Y ADOLESCENTE  TRABAJADOR EL MILAGRO	1270	3	24	1036	675	1012	0	4	0	0	333	1036
EDO. TRUJILLO	MP. VALERA	PQ. JUAN IGNACIO MONTILLA	ESCUELA BOLIVARIANA ELOISA FONSECA	2920	5	26	2379	879	2353	0	10	1	2	1461	2379
EDO. TRUJILLO	MP. VALERA	PQ. JUAN IGNACIO MONTILLA	LICEO BOLVARIANO RAFAEL RANGEL	421	1	12	365	181	353	0	2	1	0	169	365
EDO. TRUJILLO	MP. VALERA	PQ. JUAN IGNACIO MONTILLA	UNIDAD EDUCATIVA EL CUMBE	1348	3	23	1109	833	1086	0	8	0	0	245	1109
EDO. TRUJILLO	MP. VALERA	PQ. JUAN IGNACIO MONTILLA	ESCUELA TÉCNICA COMERCIAL SANTO TOMAS DE AQUINO (SALESIANOS)	2993	6	24	2519	535	2495	0	7	0	1	1952	2519
EDO. TRUJILLO	MP. VALERA	PQ. JUAN IGNACIO MONTILLA	ESCUELA BOLIVARIANA CIUDAD DE VALERA	3282	6	41	2560	1709	2519	0	11	0	0	799	2560
EDO. TRUJILLO	MP. VALERA	PQ. JUAN IGNACIO MONTILLA	ESCUELA BOLIVARIANA PASCUAL IGNACIO VILLASMIL	3160	6	47	2670	1467	2623	1	10	3	2	1140	2670
EDO. TRUJILLO	MP. VALERA	PQ. JUAN IGNACIO MONTILLA	JARDIN DE INFANCIA PASCUAL IGNACIO VILLASMIL	322	1	5	278	187	273	0	0	0	0	86	278
EDO. TRUJILLO	MP. VALERA	PQ. JUAN IGNACIO MONTILLA	ESCUELA TÉCNICA ROBINSONIANA PEDRO GARCÍA LEAL	690	2	3	613	179	610	0	0	1	0	430	613
EDO. TRUJILLO	MP. VALERA	PQ. JUAN IGNACIO MONTILLA	LICEO BOLIVARIANO CIUDAD DE VALERA	2970	6	26	2647	417	2621	0	2	0	0	2202	2647
EDO. TRUJILLO	MP. VALERA	PQ. JUAN IGNACIO MONTILLA	UNIDAD EDUCATIVA JOSEFA ESPINOZA DEL GALLEGO	1910	4	22	1617	518	1595	0	0	1	0	1076	1617
EDO. TRUJILLO	MP. MONTE CARMELO	PQ. STA MARIA DEL HORCON	ESCUELA BÁSICA CONCENTRADA LA VALERANA	241	1	3	199	165	196	0	0	0	0	31	199
EDO. TRUJILLO	MP. MONTE CARMELO	PQ. STA MARIA DEL HORCON	UNIDAD EDUCATIVA BOLIVARIANA EL MILAGRO	76	1	0	70	67	70	0	0	0	0	3	70
EDO. TRUJILLO	MP. MONTE CARMELO	PQ. STA MARIA DEL HORCON	UNIDAD EDUCATIVA EL HORCÓN	778	2	18	598	434	580	0	1	0	1	144	598
EDO. TRUJILLO	MP. MONTE CARMELO	PQ. MONTE CARMELO	ESCUELA ESTADAL CONCENTRADA SAN PEDRO	202	1	1	144	104	143	0	1	0	0	38	144
EDO. TRUJILLO	MP. MONTE CARMELO	PQ. MONTE CARMELO	ESCUELA BÁSICA CONCENTRADA SIN NÚMERO LOS HOYOS	255	1	3	173	95	170	0	1	1	0	73	173
EDO. TRUJILLO	MP. MONTE CARMELO	PQ. MONTE CARMELO	ESCUELA BOLIVARIANA SAN PABLO	236	1	2	169	153	167	0	1	1	0	12	169
EDO. TRUJILLO	MP. MONTE CARMELO	PQ. MONTE CARMELO	ESCUELA BÁSICA CONCENTRADA SIN NÚMERO  CRISTÓBAL	221	1	4	179	107	175	0	0	0	0	68	179
EDO. TRUJILLO	MP. MONTE CARMELO	PQ. MONTE CARMELO	ESCUELA ESTADAL CONCENTRADA NÚMERO 520 LA AMARILLA	328	1	6	254	212	248	0	3	0	0	33	254
EDO. TRUJILLO	MP. MONTE CARMELO	PQ. MONTE CARMELO	UNIDAD EDUCATIVA MESA DEL PALMAR	544	1	7	406	282	399	0	2	0	0	115	406
EDO. TRUJILLO	MP. MONTE CARMELO	PQ. MONTE CARMELO	ESCUELA BÁSICA CONCENTRADA SIN NÚMERO BELEN	351	1	3	284	202	281	0	0	0	0	79	284
EDO. TRUJILLO	MP. MONTE CARMELO	PQ. MONTE CARMELO	LICEO ANTONIO ANSELMI BERTI	1546	3	28	1193	719	1165	0	8	0	0	438	1193
EDO. TRUJILLO	MP. MONTE CARMELO	PQ. MONTE CARMELO	ESCUELA BÁSICA CONCENTRADA SIN NÚMERO EL JABILLAL	199	1	0	166	142	166	0	1	0	0	23	166
EDO. TRUJILLO	MP. MONTE CARMELO	PQ. MONTE CARMELO	ESCUELA BÁSICA CONCENTRADA NÚMERO 388 LA DELGADITA	197	1	3	143	117	140	0	0	0	0	23	143
EDO. TRUJILLO	MP. MONTE CARMELO	PQ. MONTE CARMELO	ESCUELA BOLIVARIANA SAN ANTONIO	530	1	2	375	272	373	0	1	0	0	100	375
EDO. TRUJILLO	MP. MONTE CARMELO	PQ. MONTE CARMELO	UNIDAD EDUCATIVA ESTADAL EL PRADO	721	2	10	549	343	539	0	2	0	0	194	549
EDO. TRUJILLO	MP. MONTE CARMELO	PQ. BUENA VISTA	UNIDAD EDUCATIVA ANA FUENMAYOR	2288	4	50	1738	1194	1688	0	3	0	0	491	1738
EDO. TRUJILLO	MP. MONTE CARMELO	PQ. BUENA VISTA	ESCUELA BÁSICA CONCENTRADA LA RECRIA	198	1	5	170	106	165	0	0	0	0	59	170
EDO. TRUJILLO	MP. MONTE CARMELO	PQ. BUENA VISTA	ESCUELA BOLIVARIANA EL ALBARICO NUCLEO ESCOLAR RURAL 413	579	1	3	462	351	459	0	2	0	0	106	462
EDO. TRUJILLO	MP. MONTE CARMELO	PQ. BUENA VISTA	ESCUELA BÁSICA CONCENTRADA SAN MARCOS	331	1	5	250	184	245	0	1	0	0	60	250
EDO. TRUJILLO	MP. MONTE CARMELO	PQ. BUENA VISTA	ESCUELA ESTADAL CONCENTRADA DOÑA CONCHITA GRATEROL 195	500	1	2	409	346	407	0	0	0	0	61	409
EDO. TRUJILLO	MP. MONTE CARMELO	PQ. BUENA VISTA	ESCUELA BASICA CONCENTRADA EL ANTEOJO	115	1	1	101	81	100	0	0	0	0	19	101
EDO. TRUJILLO	MP. MONTE CARMELO	PQ. BUENA VISTA	ESCUELA BOLIVARINA LA VEGA DEL CARMEN	74	1	0	67	63	67	1	0	0	0	3	67
EDO. TRUJILLO	MP. MONTE CARMELO	PQ. BUENA VISTA	ESCUELA BASICA CONCENTRADA BUENA VISTA VIEJA	74	1	3	65	40	62	0	1	0	0	21	65
EDO. TRUJILLO	MP. MONTE CARMELO	PQ. BUENA VISTA	ESCUELA BÁSICA ESTADAL CAÑO NEGRO	336	1	2	267	222	265	0	0	0	0	43	267
EDO. TRUJILLO	MP. URDANETA	PQ. CABIMBU	ESCUELA ESTADAL CONCENTRADA VEGA DE CABIMBÚ	813	2	3	647	346	644	0	0	1	0	297	647
EDO. TRUJILLO	MP. URDANETA	PQ. CABIMBU	ESCUELA NACIONAL FERMIN ROJAS	43	1	0	41	17	41	0	0	0	0	24	41
EDO. TRUJILLO	MP. URDANETA	PQ. CABIMBU	ESCUELA ESTADAL CONCENTRADA SIN NÚMERO VEGA ARRIBA	1085	2	4	849	467	845	1	1	2	0	374	849
EDO. TRUJILLO	MP. URDANETA	PQ. TU#AME	ESCUELA ESTADAL CONCENTRADA SIN NÚMERO LAS PORQUERAS	530	1	8	399	285	391	0	2	0	0	104	399
EDO. TRUJILLO	MP. URDANETA	PQ. TU#AME	ESCUELA ESTADAL CONCENTRADA EL PAJARITO	262	1	1	201	175	200	0	1	0	0	24	201
EDO. TRUJILLO	MP. URDANETA	PQ. TU#AME	UNIDAD EDUCATIVA ESTADAL MARIA ANTONIA ARAUJO DE ARAUJO	203	1	5	172	151	167	0	1	0	0	15	172
EDO. TRUJILLO	MP. URDANETA	PQ. TU#AME	UNIDAD EDUCATIVA TUÑAME	2312	4	35	1542	1059	1507	2	11	10	0	425	1542
EDO. TRUJILLO	MP. URDANETA	PQ. JAJO	ESCUELA ESTADAL CONCENTRADA SIN NÚMERO ALTO DE SAN JUAN	368	1	12	279	204	267	0	1	0	0	62	279
EDO. TRUJILLO	MP. URDANETA	PQ. JAJO	ESCUELA ESTADAL CONCENTRADA S N LA LOMA	128	1	4	109	75	105	0	1	0	0	29	109
EDO. TRUJILLO	MP. URDANETA	PQ. JAJO	ESCUELA BOLIVARIANA PREBÍSTERO NICOLAS MATHEUS	2096	4	20	1659	897	1639	0	4	0	0	738	1659
EDO. TRUJILLO	MP. URDANETA	PQ. JAJO	ESCUELA BOLIVARIANA MESA DE LOS MORENO	245	1	3	208	102	205	0	0	0	0	103	208
EDO. TRUJILLO	MP. URDANETA	PQ. JAJO	ESCUELA ESTADAL CONCENTRADA SIN NÚMERO LOS ÁRBOLES	208	1	4	161	103	157	0	0	0	0	54	161
EDO. TRUJILLO	MP. URDANETA	PQ. JAJO	ESCUELA ESTADAL CONCENTRADA SIN NÚMERO MONTERO	802	2	8	606	436	598	1	1	1	0	159	606
EDO. TRUJILLO	MP. URDANETA	PQ. JAJO	ESCUELA DURI	208	1	3	159	72	156	0	0	0	0	84	159
EDO. TRUJILLO	MP. URDANETA	PQ. JAJO	ESCUELA ESTADAL CONCENTRADA SIN NÚMERO QUEBRADA CHICA	160	1	3	137	101	134	0	1	0	0	32	137
EDO. TRUJILLO	MP. URDANETA	PQ. JAJO	ESCUELA ESTADAL CONCENTRADA LLANO DE JARILLO	543	1	8	422	206	414	0	0	0	0	208	422
EDO. TRUJILLO	MP. URDANETA	PQ. JAJO	ESCUELA ESTADAL CONCENTRADA S N MIRA FLORES	108	1	3	100	81	97	0	0	0	0	16	100
EDO. TRUJILLO	MP. URDANETA	PQ. LA QUEBRADA	ESCUELA ESTADAL CONCENTRADA LOMA DE MARIA	148	1	3	91	70	88	0	0	0	0	18	91
EDO. TRUJILLO	MP. URDANETA	PQ. LA QUEBRADA	ESCUELA ESTADAL CONCENTRADA MIQUINOCO	670	2	5	496	271	491	0	0	0	0	220	496
EDO. TRUJILLO	MP. URDANETA	PQ. LA QUEBRADA	ESCUELA BOLIVARIANA ESTAPAPE	370	1	5	284	246	279	0	0	0	0	33	284
EDO. TRUJILLO	MP. URDANETA	PQ. LA QUEBRADA	CENTRO DE EDUCACIÓN INICIAL ADHEMAR DÁVILA	674	2	21	608	326	587	0	2	0	0	259	608
EDO. TRUJILLO	MP. URDANETA	PQ. LA QUEBRADA	ESCUELA ESTADAL CONCENTRADA SIN NÚMERO LOMA DEL MEDIO	583	1	17	382	266	365	1	4	1	0	93	382
EDO. TRUJILLO	MP. URDANETA	PQ. LA QUEBRADA	ESCUELA ESTADAL CONCENTRADA SIN NUMERO  EL POTRERITO	213	1	4	139	106	135	0	0	0	0	29	139
EDO. TRUJILLO	MP. URDANETA	PQ. LA QUEBRADA	ESCUELA ESTADAL CONCENTRADA EL HUMO	78	1	1	47	36	46	0	0	0	0	10	47
EDO. TRUJILLO	MP. URDANETA	PQ. LA QUEBRADA	ESCUELA BOLIVARIANA TOSTA GARCIA	1753	3	26	1363	547	1337	0	3	0	0	787	1363
EDO. TRUJILLO	MP. URDANETA	PQ. LA QUEBRADA	ESCUELA ESTADAL CONCENTRADA EL COROZO	320	1	5	264	171	259	0	0	0	0	88	264
EDO. TRUJILLO	MP. URDANETA	PQ. LA QUEBRADA	ESCUELA ESTADAL UNITARIA ESDOVAS	126	1	2	69	50	67	0	1	0	0	16	69
EDO. TRUJILLO	MP. URDANETA	PQ. LA QUEBRADA	ESCUELA BOLIVARIANA QUEBRADA DE CUEVAS	564	1	14	431	277	417	0	0	1	1	138	431
EDO. TRUJILLO	MP. URDANETA	PQ. LA MESA	ESCUELA ESTADAL CONCENTRADA SIN NÚMERO EL HORNO	502	1	6	380	282	374	0	4	0	0	88	380
EDO. TRUJILLO	MP. URDANETA	PQ. LA MESA	ESCUELA ESTADAL CONCENTRADA SIN NÚMERO JUAN MARTIN	657	2	19	490	341	471	0	2	0	0	128	490
EDO. TRUJILLO	MP. URDANETA	PQ. LA MESA	ESCUELA BOLIVARIANA VILLA MERCEDES	870	2	15	656	454	641	0	4	1	0	182	656
EDO. TRUJILLO	MP. URDANETA	PQ. LA MESA	UNIDAD EDUCATIVA ANDRES BELLO	206	1	1	190	171	189	0	0	0	0	18	190
EDO. TRUJILLO	MP. URDANETA	PQ. LA MESA	ESCUELA BOLIVARIANA FRANCISCO BRICEÑO ARAUJO	3241	6	54	2459	1459	2405	0	12	1	1	932	2459
EDO. TRUJILLO	MP. URDANETA	PQ. SANTIAGO	ESCUELA ESTADAL CONCENTRADA NÚMERO 188 ESTIGUATEZ	193	1	4	144	84	140	0	4	0	0	52	144
EDO. TRUJILLO	MP. URDANETA	PQ. SANTIAGO	ESCUELA ESTADAL CONCENTRADA LOS HOYOS	284	1	2	210	186	208	0	1	0	0	21	210
EDO. TRUJILLO	MP. URDANETA	PQ. SANTIAGO	ESCUELA BOLIVARIANA CORDILLERA DE LOS RUÍZ	180	1	0	120	116	120	0	1	0	0	3	120
EDO. TRUJILLO	MP. URDANETA	PQ. SANTIAGO	ESCUELA ESTADAL CONCENTRADA NÚMERO 131 LAS GUARDIAS	267	1	4	183	166	179	0	0	1	0	12	183
EDO. TRUJILLO	MP. URDANETA	PQ. SANTIAGO	ESCUELA ESTADAL NÚMERO 295	360	1	2	298	287	296	0	0	0	0	9	298
EDO. TRUJILLO	MP. URDANETA	PQ. SANTIAGO	ESCUELA ESTADAL CONCENTRADA NUMERO 118 CUENCAS	251	1	3	208	158	205	0	1	0	1	45	208
EDO. TRUJILLO	MP. URDANETA	PQ. SANTIAGO	ESCUELA BOLIVARIANA PADRE CANO	1470	3	14	1132	763	1118	0	1	0	0	354	1132
EDO. TRUJILLO	MP. URDANETA	PQ. SANTIAGO	ESCUELA BOLIVARIANA MESA DE LOS CONTRERAS	314	1	0	228	173	228	0	0	0	0	55	228
EDO. TRUJILLO	MP. LA CEIBA	PQ. SANTA APOLONIA	ESCUELA ESTADAL LOS CIENEGOS	236	1	8	144	112	136	0	0	0	0	24	144
EDO. TRUJILLO	MP. LA CEIBA	PQ. SANTA APOLONIA	ESCUELA BÁSICA SANTA APOLONIA	2031	4	19	1581	1245	1562	0	3	0	0	314	1581
EDO. TRUJILLO	MP. LA CEIBA	PQ. SANTA APOLONIA	CICLO BÁSICO VII DE SANTA APOLONIA	1300	3	8	984	758	976	0	1	0	0	217	984
EDO. TRUJILLO	MP. LA CEIBA	PQ. TRES DE FEBRERO	UNIDAD EDUCATIVA DOÑA JULIETA DE FUENMAYOR	945	2	15	740	579	725	1	3	0	0	142	740
EDO. TRUJILLO	MP. LA CEIBA	PQ. TRES DE FEBRERO	LICEO BOLIVARIANO ANTONIO JOSÉ DE SUCRE	1105	2	11	795	616	784	0	3	0	0	165	795
EDO. TRUJILLO	MP. LA CEIBA	PQ. TRES DE FEBRERO	ESCUELA ESTADAL LAS FRANQUERAS	553	1	7	429	389	422	0	0	1	0	32	429
EDO. TRUJILLO	MP. LA CEIBA	PQ. TRES DE FEBRERO	ESCUELA BOLIVARIANA LAS ADJUNTAS NER 388	52	1	0	42	36	42	0	0	0	0	6	42
EDO. TRUJILLO	MP. LA CEIBA	PQ. TRES DE FEBRERO	UNIDAD EDUCATIVA TRES DE FEBRERO	1636	3	15	1163	916	1148	0	2	0	0	230	1163
EDO. TRUJILLO	MP. LA CEIBA	PQ. TRES DE FEBRERO	ESCUELA CONCENTRADA ESTADAL PUNTA DE MAYA	495	1	4	393	335	389	0	3	0	0	51	393
EDO. TRUJILLO	MP. LA CEIBA	PQ. EL PROGRESO	ESCUELA ESTADAL CONCENTRADA SIN NÚMERO LOS VERALES	292	1	4	234	176	230	1	0	0	0	53	234
EDO. TRUJILLO	MP. LA CEIBA	PQ. EL PROGRESO	UNIDAD BÁSICA ANTONIO ARAUJO SAEZ	1533	3	15	1185	965	1170	0	3	0	0	202	1185
EDO. TRUJILLO	MP. LA CEIBA	PQ. EL PROGRESO	UNIDAD ESCOLAR ZONA RICA	1763	3	18	1318	898	1300	0	2	0	0	400	1318
EDO. TRUJILLO	MP. LA CEIBA	PQ. LA CEIBA	ESCUELA NACIONAL BOLIVARIANA LA CEIBA NER 388	550	1	12	443	356	431	1	0	0	0	74	443
EDO. TRUJILLO	MP. LA CEIBA	PQ. LA CEIBA	ESCUELA CONCENTRADA  SIN NÚMERO LA CEIBITA	285	1	3	214	188	211	0	0	0	0	23	214
EDO. TRUJILLO	MP. JOSE F M CA#IZAL	PQ. ANTONIO JOSE DE SUCRE	ESCUELA ESTADAL CONCENTRADA NÚMERO 642	578	1	7	398	188	391	0	1	0	0	202	398
EDO. TRUJILLO	MP. JOSE F M CA#IZAL	PQ. ANTONIO JOSE DE SUCRE	ESCUELA ESTADAL LA PLACITA	372	1	2	264	169	262	0	0	0	0	93	264
EDO. TRUJILLO	MP. JOSE F M CA#IZAL	PQ. EL SOCORRO	ESCUELA PRIMARIA BOLIVARIANA VIRGILIO GERMAN DÍAZ	1588	3	24	1213	759	1189	1	5	2	0	422	1213
EDO. TRUJILLO	MP. JOSE F M CA#IZAL	PQ. EL SOCORRO	UNIDAD EDUCATIVA CREACIÓN 10	1444	3	19	1131	731	1112	0	1	0	0	380	1131
EDO. TRUJILLO	MP. JOSE F M CA#IZAL	PQ. LOS CAPRICHOS	ESCUELA ESTADAL LOS CAPRICHOS	413	1	2	279	183	277	0	4	0	0	90	279
EDO. TRUJILLO	MP. MIRANDA	PQ. EL CENIZO	UNIDAD EDUCATIVA BICENTENARIO	1897	4	27	1428	1157	1401	0	8	2	0	234	1428
EDO. TRUJILLO	MP. MIRANDA	PQ. VALERITA	ESCUELA ESTADAL CONCENTRADA NUMERO  9 SIN NUMERO	596	1	7	436	363	429	0	7	0	0	59	436
EDO. TRUJILLO	MP. MIRANDA	PQ. AGUA CALIENTE	UNIDAD EDUCATIVA ESTADAL MONSEÑOR ROJAS CHAPARRO	832	2	12	614	479	602	0	3	0	0	120	614
EDO. TRUJILLO	MP. MIRANDA	PQ. AGUA CALIENTE	ESCUELA ESTADAL CONCENTRADA NUMERO 249 SIN NUMERO	314	1	2	227	178	225	0	1	0	0	46	227
EDO. TRUJILLO	MP. MIRANDA	PQ. AGUA SANTA	UNIDAD EDUCATIVA DOCTOR LUIS BELTRAN PRIETO FIGUEROA	342	1	4	263	203	259	0	1	0	0	55	263
EDO. TRUJILLO	MP. MIRANDA	PQ. AGUA SANTA	REGISTRO CIVIL AGUA SANTA	269	1	5	189	146	184	0	1	0	0	37	189
EDO. TRUJILLO	MP. MIRANDA	PQ. AGUA SANTA	ESCUELA BASICA ELISA PULGAR DE RAMIREZ	2224	4	41	1755	1259	1714	0	5	1	1	448	1755
EDO. TRUJILLO	MP. MIRANDA	PQ. AGUA SANTA	ESCUELA BOLIVARIANA EL SALTO	729	2	15	585	449	570	1	3	0	0	117	585
EDO. TRUJILLO	MP. MIRANDA	PQ. EL DIVIDIVE	CENTRO PREESCOLAR BOLIVARIANO ANDRES BELLO	1967	4	48	1675	937	1627	0	6	0	0	684	1675
EDO. TRUJILLO	MP. MIRANDA	PQ. EL DIVIDIVE	ESCUELA BOLIVARIANA EL TENDAL	1185	3	28	938	538	910	0	3	0	0	369	938
EDO. TRUJILLO	MP. MIRANDA	PQ. EL DIVIDIVE	LICEO BOLIVARIANO FULGENCIA GIMENEZ DE OLMOS	102	1	1	73	57	72	0	0	0	0	15	73
EDO. TRUJILLO	MP. MIRANDA	PQ. EL DIVIDIVE	UNIDAD EDUCATIVA GUZMAN BLANCO	1428	3	16	1129	913	1113	0	3	0	0	197	1129
EDO. TRUJILLO	MP. MIRANDA	PQ. EL DIVIDIVE	ESCUELA BOLIVARIANA ENRIQUE FLORES	2886	5	60	2355	1346	2295	0	6	0	0	943	2355
EDO. TRUJILLO	MP. MIRANDA	PQ. EL DIVIDIVE	SALON DE USOS MULTIPLES	54	1	1	44	28	43	0	0	0	0	15	44
EDO. TRUJILLO	MP.S RAFAEL CARVAJAL	PQ. CARVAJAL	UNIDAD EDUCATIVA JOSÉ ANTONIO VELASCO	2315	4	38	1874	1197	1836	1	2	1	1	634	1874
EDO. TRUJILLO	MP.S RAFAEL CARVAJAL	PQ. CARVAJAL	ESCUELA NACIONAL CONCENTRADA ALTO DE LA CRUZ	180	1	3	138	130	135	0	0	0	0	5	138
EDO. TRUJILLO	MP.S RAFAEL CARVAJAL	PQ. CARVAJAL	ESCUELA CONCENTRADA EL COROZAL NUCLEO ESCOLAR RURAL SIN NUMERO CREACION CARVAJAL	568	1	17	494	332	477	0	0	0	0	145	494
EDO. TRUJILLO	MP.S RAFAEL CARVAJAL	PQ. CARVAJAL	ESCUELA INTEGRAL BOLIVARIANA MARIA DOLORES ARAUJO	3135	6	36	2668	1067	2632	0	7	0	1	1557	2668
EDO. TRUJILLO	MP.S RAFAEL CARVAJAL	PQ. CARVAJAL	ESCUELA CONCENTRADA  EL FILO	263	1	5	233	136	228	0	1	0	0	91	233
EDO. TRUJILLO	MP.S RAFAEL CARVAJAL	PQ. CARVAJAL	ESCUELA BOLIVARIANA LA LLANADA	2389	5	45	2068	901	2023	0	6	1	1	1114	2068
EDO. TRUJILLO	MP.S RAFAEL CARVAJAL	PQ. ANTONIO N BRICE#O	UNIDAD EDUCATIVA HUGO CHAVEZ FRIAS	479	1	8	444	383	436	0	0	0	0	53	444
EDO. TRUJILLO	MP.S RAFAEL CARVAJAL	PQ. ANTONIO N BRICE#O	LICEO BOLIVARIANO JULIO SANCHEZ VIVAS	2703	5	43	2256	1284	2213	1	7	2	0	919	2256
EDO. TRUJILLO	MP.S RAFAEL CARVAJAL	PQ. ANTONIO N BRICE#O	ESCUELA CONCENTRADA NACIONAL LA HOYADA	648	2	10	572	359	562	0	1	1	0	201	572
EDO. TRUJILLO	MP.S RAFAEL CARVAJAL	PQ. ANTONIO N BRICE#O	ESCUELA INTEGRAL BOLIVARIANA JULIO SÁNCHEZ VIVAS	3252	6	46	2673	1405	2627	0	6	1	2	1213	2673
EDO. TRUJILLO	MP.S RAFAEL CARVAJAL	PQ. ANTONIO N BRICE#O	BRIGADA DE RESCATE Y SALVAMENTO LA CEJITA 20	225	1	2	199	123	197	0	1	0	0	73	199
EDO. TRUJILLO	MP.S RAFAEL CARVAJAL	PQ. JOSE LEONARDO SUAREZ	UNIDAD EDUCATIVA RAFAEL RANGEL	1982	4	31	1638	1057	1607	0	11	1	0	538	1638
EDO. TRUJILLO	MP.S RAFAEL CARVAJAL	PQ. JOSE LEONARDO SUAREZ	ESCUELA CONCENTRADA MESA DE CHIPUEN	147	1	0	129	96	129	0	0	0	0	33	129
EDO. TRUJILLO	MP.S RAFAEL CARVAJAL	PQ. JOSE LEONARDO SUAREZ	UNIDAD EDUCATIVA NACIONAL SALOMÓN BRICEÑO GABALDON	2544	5	57	2010	1292	1953	0	5	0	0	656	2010
EDO. TRUJILLO	MP.S RAFAEL CARVAJAL	PQ. JOSE LEONARDO SUAREZ	ESCUELA CONCENTRADA EL TURAGUAL	1453	3	24	1270	851	1246	0	4	0	1	390	1270
EDO. TRUJILLO	MP.S RAFAEL CARVAJAL	PQ. CAMPO ALEGRE	LICEO BOLIVARIANO RAFAEL QUEVEDO URBINA	1028	2	11	884	510	873	0	2	0	1	360	884
EDO. TRUJILLO	MP.S RAFAEL CARVAJAL	PQ. CAMPO ALEGRE	UNIDAD EDUCATIVA  MANUEL MARIA CARRASQUERO	2905	6	42	2375	1236	2333	0	6	0	0	1091	2375
EDO. TRUJILLO	MP.S RAFAEL CARVAJAL	PQ. CAMPO ALEGRE	ESCUELA CONCENTRADA SABANA DE CUBA	251	1	2	234	165	232	0	0	0	0	67	234
EDO. TRUJILLO	MP.S RAFAEL CARVAJAL	PQ. CAMPO ALEGRE	UNIDAD EDUCATIVA MONSEÑOR ARIAS BLANCO	1633	3	27	1393	625	1366	0	5	0	0	736	1393
EDO. TRUJILLO	MP.S RAFAEL CARVAJAL	PQ. CAMPO ALEGRE	ESCUELA GRADUADA CUBITA	2362	4	45	1957	1250	1912	1	8	0	0	653	1957
EDO. TRUJILLO	MP.S RAFAEL CARVAJAL	PQ. CAMPO ALEGRE	LICEO BOLIVARIANO RAFAEL BENITO PERDOMO	569	1	6	510	423	504	0	0	0	0	81	510
EDO. TRUJILLO	MP.S RAFAEL CARVAJAL	PQ. CAMPO ALEGRE	UNIDAD EDUCATIVA RAFAEL QUEVEDO URBINA	3528	7	62	2840	1634	2778	0	10	3	0	1131	2840
EDO. TRUJILLO	MP.S RAFAEL CARVAJAL	PQ. CAMPO ALEGRE	CENTRO DE EDUCACION INTEGRAL RAFAEL QUEVEDO URBINA	1450	3	13	1177	654	1164	0	2	0	0	508	1177
EDO. APURE	MP. PEDRO CAMEJO	PQ. CUNAVICHE	ESCUELA BASICA FRANCISCO DE MIRANDA	811	2	8	583	407	575	0	1	1	0	166	583
EDO. APURE	MP. PEDRO CAMEJO	PQ. CUNAVICHE	ESCUELA BASICA BOLIVARIANA LA MACANILLA	941	2	5	648	440	643	0	1	0	0	202	648
EDO. APURE	MP. PEDRO CAMEJO	PQ. CUNAVICHE	ESCUELA BÁSICA BOLIVARIANA LAGUNA CLARA	91	1	0	76	38	76	0	0	0	0	38	76
EDO. APURE	MP. PEDRO CAMEJO	PQ. CUNAVICHE	ESCUELA BASICA LA ESTACION	516	1	5	399	256	394	0	2	0	0	136	399
EDO. APURE	MP. PEDRO CAMEJO	PQ. CUNAVICHE	ESCUELA BASICA BOLIVARIANA MATA DE LOS INDIOS	396	1	10	331	215	321	0	0	1	0	105	331
EDO. APURE	MP. PEDRO CAMEJO	PQ. CUNAVICHE	ESCUELA BÁSICA BOLIVARIANA SANTA BÁRBARA	233	1	2	173	114	171	0	0	0	0	57	173
EDO. APURE	MP. PEDRO CAMEJO	PQ. CUNAVICHE	ESCUELA BASICA BOLIVARIANA PIEDRA AZUL	157	1	0	136	104	136	0	1	0	0	31	136
EDO. APURE	MP. PEDRO CAMEJO	PQ. CUNAVICHE	CENTRO DE EDUCACION INICIAL PEDRO CAMEJO	666	2	8	583	367	575	0	4	0	0	204	583
EDO. APURE	MP. PEDRO CAMEJO	PQ. CUNAVICHE	ESCUELA BASICA BOLIVARIANA AGUA LINDA	181	1	2	156	74	154	0	0	0	0	80	156
EDO. APURE	MP. PEDRO CAMEJO	PQ. CUNAVICHE	ESCUELA PRIMARIA MONTIEL	451	1	3	346	235	343	0	0	0	0	108	346
EDO. APURE	MP. PEDRO CAMEJO	PQ. CUNAVICHE	ESCUELA BASICA BOLIVARIANA JUAN FRANCISCO VILLEGA	509	1	6	427	236	421	0	3	0	0	182	427
EDO. APURE	MP. PEDRO CAMEJO	PQ. CUNAVICHE	ESCUELA GRANJA URAÑON	306	1	0	159	137	159	0	0	0	0	22	159
EDO. APURE	MP. PEDRO CAMEJO	PQ. CUNAVICHE	ESCUELA BASICA BOLIVARIANA VILLAGUERO	179	1	3	145	106	142	0	0	0	0	36	145
EDO. APURE	MP. PEDRO CAMEJO	PQ. CUNAVICHE	LICEO BOLIVARIANO DON ROMULO GALLEGOS	1791	4	13	1390	802	1377	0	5	0	1	569	1390
EDO. APURE	MP. PEDRO CAMEJO	PQ. CUNAVICHE	ESCUELA BASICA MEDANO ALTO	447	1	1	137	97	136	0	0	0	0	39	137
EDO. APURE	MP. PEDRO CAMEJO	PQ. CUNAVICHE	ESCUELA BASICA PEDRO CAMEJO	2268	4	18	1780	1165	1762	0	8	2	0	587	1780
EDO. APURE	MP. PEDRO CAMEJO	PQ. SAN JUAN DE PAYARA	ESCUELA BASICA BOLIVARIANA CUNAVICHITO 5	509	1	3	426	345	423	0	0	1	0	77	426
EDO. APURE	MP. PEDRO CAMEJO	PQ. SAN JUAN DE PAYARA	LICEO BOLIVARIANO COMBINADO PEDRO CAMEJO	2564	5	39	1992	1325	1953	1	3	0	1	623	1992
EDO. APURE	MP. PEDRO CAMEJO	PQ. SAN JUAN DE PAYARA	ESCUELA BASICA BOLIVARIANA CONCENTRADA NUMERO 85	1076	2	3	851	511	848	0	3	0	0	334	851
EDO. APURE	MP. PEDRO CAMEJO	PQ. SAN JUAN DE PAYARA	ESCUELA BASICA PASO PAYARA	547	1	4	419	241	415	0	1	0	0	173	419
EDO. APURE	MP. PEDRO CAMEJO	PQ. SAN JUAN DE PAYARA	ESCUELA BASICA  BOLIVARIANA JUAN BAUTISTA ESTE	2721	5	39	2092	1302	2053	1	9	0	0	741	2092
EDO. APURE	MP. PEDRO CAMEJO	PQ. CODAZZI	ESCUELA BÁSICA BOLIVARIANA CAÑO LA GUARDIA	159	1	9	132	122	123	0	1	0	0	0	132
EDO. APURE	MP. PEDRO CAMEJO	PQ. CODAZZI	ESCUELA BASICA BOLIVARIANA JOSE MANUEL SANCHEZ OSTOS	448	1	28	278	186	250	0	1	0	0	63	278
EDO. APURE	MP. PEDRO CAMEJO	PQ. CODAZZI	ESCUELA GRANJA JOSE MANUEL SANCHEZ OSTOS	1566	3	58	987	684	929	0	3	1	0	241	987
EDO. APURE	MP. PEDRO CAMEJO	PQ. CODAZZI	ESCUELA BASICA BOLIVARIANA DON SIMON RODRIGUEZ	66	1	2	45	36	43	0	0	0	0	7	45
EDO. APURE	MP. PEDRO CAMEJO	PQ. CODAZZI	ESC BASICA BOLIVARIANA BUENAVISTA DEL META	325	1	1	226	217	225	0	0	0	0	8	226
EDO. APURE	MP. PEDRO CAMEJO	PQ. CODAZZI	ESCUELA BÁSICA EL PROGRESO	228	1	7	181	158	174	0	0	0	0	16	181
EDO. APURE	MP. PEDRO CAMEJO	PQ. CODAZZI	ESCUELA PRIMARIA BOLIVARIANA BOCA DE CINARUCO	126	1	5	108	40	103	0	0	0	0	63	108
EDO. APURE	MP. MU#OZ	PQ. MANTECAL	ESCUELA PRIMARIA LUÍS HUMBERTO DÍAZ	730	2	11	631	513	620	0	2	0	0	105	631
EDO. APURE	MP. MU#OZ	PQ. MANTECAL	ESCUELA PRIMARIA GUARITICO	278	1	6	221	172	215	0	0	0	0	43	221
EDO. APURE	MP. MU#OZ	PQ. MANTECAL	ESCUELA PRIMARIA PULIDO I	117	1	2	106	89	104	0	1	0	0	14	106
EDO. APURE	MP. MU#OZ	PQ. MANTECAL	CENTRO EDUCACION INICIAL BOLIVARIANO ANTONIO JOSE DE SUCRE	2427	5	40	1918	1362	1878	1	11	1	0	503	1918
EDO. APURE	MP. MU#OZ	PQ. MANTECAL	ESCUELA PRIMARIA BOLIVARIANA  JOSE ANTONIO PAEZ	3589	7	39	2573	1836	2534	0	17	1	0	680	2573
EDO. APURE	MP. MU#OZ	PQ. MANTECAL	ESCUELA PRIMARIA BOLIVARIANA SAN MIGUEL DE MANTECAL	1151	2	16	934	735	918	0	8	0	0	175	934
EDO. APURE	MP. MU#OZ	PQ. MANTECAL	ESCUELA PRIMARIA BOLIVARIANA EL MAMON	457	1	7	407	315	400	0	1	0	0	84	407
EDO. APURE	MP. MU#OZ	PQ. MANTECAL	ESCUELA PRIMARIA BOLIVARIANA OLGA RIVERO	237	1	3	214	168	211	0	2	0	0	41	214
EDO. APURE	MP. MU#OZ	PQ. MANTECAL	ESCUELA PRIMARIA BOLIVARIANA ANDRES BELLO	290	1	2	238	195	236	0	2	1	0	38	238
EDO. APURE	MP. MU#OZ	PQ. SAN VICENTE	ESCUELA PRIMARIA EL PALMAR	287	1	0	217	126	217	0	1	0	0	90	217
EDO. APURE	MP. MU#OZ	PQ. SAN VICENTE	ESCUELA PRIMARIA PUNTA LARGA	70	1	0	49	43	49	0	0	0	0	6	49
EDO. APURE	MP. MU#OZ	PQ. SAN VICENTE	ESCUELA PRIMARIA BOLIVARIANA FEDERICO SCHWARZEMBERG	1365	3	9	1028	793	1019	0	6	0	0	220	1028
EDO. APURE	MP. MU#OZ	PQ. SAN VICENTE	ESCUELA PRIMARIA LOS MATIAS	176	1	2	126	92	124	0	0	0	0	32	126
EDO. APURE	MP. MU#OZ	PQ. BRUZUAL	ESCUELA PRIMARIA EL SETENTA	399	1	1	247	205	246	0	0	0	0	41	247
EDO. APURE	MP. MU#OZ	PQ. BRUZUAL	ESCUELA PRIMARIA BOLIVARIANA  MANUELITA SÁENZ	693	2	8	579	458	571	0	3	0	0	110	579
EDO. APURE	MP. MU#OZ	PQ. BRUZUAL	ESCUELA PRIMARIA BOLIVARIANA BRUZUAL	2542	5	34	1957	1351	1923	0	15	2	0	555	1957
EDO. APURE	MP. MU#OZ	PQ. BRUZUAL	ESCUELA BOLIVARIANA PRODUCTIVA  VUELVAN CARAS	583	1	8	510	469	502	0	1	0	0	32	510
EDO. APURE	MP. MU#OZ	PQ. BRUZUAL	ESCUELA PRIMARIA NEGRA HIPOLITA	232	1	3	209	162	206	1	1	1	0	41	209
EDO. APURE	MP. MU#OZ	PQ. RINCON HONDO	ESCUELA PRIMARIA LA ORTEGUERA	198	1	2	184	151	182	0	1	0	0	30	184
EDO. APURE	MP. MU#OZ	PQ. RINCON HONDO	ESCUELA PRIMARIA LUIS RAMON FARFAN	137	1	0	110	110	110	0	0	0	0	0	110
EDO. APURE	MP. MU#OZ	PQ. RINCON HONDO	ESCUELA PRIMARIA ARAGUAYUNA	243	1	0	179	167	179	0	0	0	0	12	179
EDO. APURE	MP. MU#OZ	PQ. RINCON HONDO	ESCUELA PRIMARIA EDUARDO IZQUIERDO	422	1	8	300	232	292	1	3	0	0	56	300
EDO. APURE	MP. MU#OZ	PQ. RINCON HONDO	ESCUELA PRIMARIA JUAN VICENTE TORRES DEL VALLE	1716	3	24	1277	877	1253	0	5	0	0	371	1277
EDO. APURE	MP. MU#OZ	PQ. RINCON HONDO	ESCUELA PRIMARIA BANCO DEL MEDIO	175	1	6	153	102	147	0	1	0	0	44	153
EDO. APURE	MP. MU#OZ	PQ. RINCON HONDO	ESCUELA PRIMARIA SAN FRANCISCO	224	1	3	158	133	155	0	1	0	0	21	158
EDO. APURE	MP. MU#OZ	PQ. RINCON HONDO	ESCUELA PRIMARIA BOLIVARIANA JUAN INES GRATEROL	666	2	14	491	347	477	0	2	0	1	127	491
EDO. APURE	MP. MU#OZ	PQ. QUINTERO	ESCUELA PRIMARIA JESUS MARIA HERRERA	847	2	5	599	390	594	0	2	0	0	202	599
EDO. APURE	MP. ROMULO GALLEGOS	PQ. ELORZA	ESCUELA PRIMARIA JESUS RAFAEL ASTUDILLO	281	1	4	231	169	227	0	1	0	0	57	231
EDO. APURE	MP. ROMULO GALLEGOS	PQ. ELORZA	ESCUELA BASICA BOLIVARIANA MANGUITO I	276	1	0	203	170	203	0	0	0	0	33	203
EDO. APURE	MP. ROMULO GALLEGOS	PQ. ELORZA	ESCUELA PRIMARIA CHIMBORAZO	229	1	0	204	177	204	0	0	0	0	27	204
EDO. APURE	MP. ROMULO GALLEGOS	PQ. ELORZA	ESCUELA  BASICA LORENZO	732	2	13	547	406	534	0	7	1	0	120	547
EDO. APURE	MP. ROMULO GALLEGOS	PQ. ELORZA	ESCUELA BASICA PUERTO INFANTE	481	1	6	313	207	307	0	1	0	0	99	313
EDO. APURE	MP. ROMULO GALLEGOS	PQ. ELORZA	ESCUELA BASICA RIECITO	738	2	0	332	302	332	0	0	0	0	30	332
EDO. APURE	MP. ROMULO GALLEGOS	PQ. ELORZA	ESCUELA DE EDUCACIÓN INICIAL NUMERO 9 DE ELORZA	2258	4	38	1702	1009	1664	0	14	1	0	640	1702
EDO. APURE	MP. ROMULO GALLEGOS	PQ. ELORZA	ESCUELA BÁSICA AIDEE PATIÑO DE SILVA	904	2	13	712	485	699	0	4	0	0	210	712
EDO. APURE	MP. ROMULO GALLEGOS	PQ. ELORZA	ESCUELA BASICA BOLIVARIANA BOCA TRONADOR	359	1	2	245	226	243	0	0	0	0	17	245
EDO. APURE	MP. ROMULO GALLEGOS	PQ. ELORZA	ESCUELA BASICA BARRANCO YOPAL	176	1	1	147	146	146	0	0	0	0	0	147
EDO. APURE	MP. ROMULO GALLEGOS	PQ. ELORZA	ESCUELA BASICA MAGIN PEREZ	582	1	12	461	353	449	0	1	0	0	95	461
EDO. APURE	MP. ROMULO GALLEGOS	PQ. ELORZA	ESCUELA BASICA SIMON GARCIA ROSALES	3061	6	42	2189	1370	2147	1	12	5	0	759	2189
EDO. APURE	MP. ROMULO GALLEGOS	PQ. ELORZA	LICEO BOLIVARIANO MANUEL ANTONIO NIEVES	4016	7	80	3153	2120	3073	1	19	2	0	931	3153
EDO. APURE	MP. ROMULO GALLEGOS	PQ. ELORZA	ESCUELA BASICA BOLIVARIANA EL ALCORNOCAL	366	1	0	178	170	178	0	0	0	0	8	178
EDO. APURE	MP. ROMULO GALLEGOS	PQ. LA TRINIDAD	ESCUELA  BASICA LA TRINIDAD DE ORICHUNA	2006	4	42	1446	897	1404	1	6	2	0	498	1446
EDO. APURE	MP. ROMULO GALLEGOS	PQ. LA TRINIDAD	ESCUELA PRIMARIA ESTADAL LOS LIMONES	291	1	4	234	188	230	0	0	0	1	41	234
EDO. APURE	MP. ROMULO GALLEGOS	PQ. LA TRINIDAD	ESCUELA BOLIVARIANA EL PARAISO	422	1	8	336	264	328	0	0	0	0	64	336
EDO. APURE	MP. ROMULO GALLEGOS	PQ. LA TRINIDAD	ESCUELA BASICA ESTADAL EL CHARAL	761	2	10	569	443	559	0	2	0	0	114	569
EDO. APURE	CE. SAN FERNANDO	PQ. SAN FERNANDO	CENTRO DE FORMACION FAMILAR CRISTO REY	1472	3	21	1151	794	1130	0	7	2	0	327	1151
EDO. APURE	CE. SAN FERNANDO	PQ. SAN FERNANDO	ESCUELA BASICA LA HIDALGUIA	967	2	7	776	574	769	0	4	0	0	191	776
EDO. APURE	CE. SAN FERNANDO	PQ. SAN FERNANDO	ESCUELA NACIONAL AVELINA DUARTE	1589	3	43	1287	730	1244	0	7	0	0	507	1287
EDO. APURE	CE. SAN FERNANDO	PQ. SAN FERNANDO	ESCUELA BASICA DANIEL OLEARY	3757	7	57	3177	1580	3120	0	16	5	1	1518	3177
EDO. APURE	CE. SAN FERNANDO	PQ. SAN FERNANDO	ESCUELA PRIMARIA EL CALVARIO	198	1	6	171	122	165	0	0	0	0	43	171
EDO. APURE	CE. SAN FERNANDO	PQ. SAN FERNANDO	ESCUELA BASICA SIMON BOLIVAR	1794	3	34	1490	1170	1456	0	4	0	0	282	1490
EDO. APURE	CE. SAN FERNANDO	PQ. SAN FERNANDO	ESCUELA BASICA NACIONAL AGUSTIN CODAZZI	1035	2	27	915	491	888	0	1	0	0	396	915
EDO. APURE	CE. SAN FERNANDO	PQ. SAN FERNANDO	ESCUELA BASICA MANUEL ANTONIO NIEVE	1845	4	45	1509	995	1464	0	5	0	1	463	1509
EDO. APURE	CE. SAN FERNANDO	PQ. SAN FERNANDO	ESCUELA BASICA EL MUERTICO	301	1	4	230	181	226	0	2	0	0	43	230
EDO. APURE	CE. SAN FERNANDO	PQ. SAN FERNANDO	ESCUELA DE EDUCACION INICIAL BOLIVARIANA LOS CENTAUROS	1162	2	32	965	711	933	0	4	1	0	217	965
EDO. APURE	CE. SAN FERNANDO	PQ. SAN FERNANDO	PREESCOLAR. BOLIVARIANO AÑO INTERNACIONAL DEL NIÑO	2578	5	40	2234	1303	2194	0	18	2	0	871	2234
EDO. APURE	CE. SAN FERNANDO	PQ. SAN FERNANDO	ESCUELA BASICA VICTOR LINO GOMEZ	3246	6	51	2682	1837	2631	1	23	5	0	765	2682
EDO. APURE	CE. SAN FERNANDO	PQ. SAN FERNANDO	ESCUELA BASICA LUIS FELIPE MARCANO HERNANDEZ	3259	6	44	2577	1487	2533	0	14	1	1	1030	2577
EDO. APURE	CE. SAN FERNANDO	PQ. SAN FERNANDO	CENTRO EDUCACION INICIAL CAPERUCITA	119	1	4	105	57	101	0	1	0	0	43	105
EDO. APURE	CE. SAN FERNANDO	PQ. SAN FERNANDO	ESCUELA DE EDUCACION INICIAL SENDERO DE LUZ	351	1	6	300	241	294	0	4	0	0	49	300
EDO. APURE	CE. SAN FERNANDO	PQ. SAN FERNANDO	ESCUELA PRIMARIA BOLIVARIANA ARNALDO REINA	2609	5	45	2090	1136	2045	0	10	0	1	898	2090
EDO. APURE	CE. SAN FERNANDO	PQ. SAN FERNANDO	ESCUELA BASICA MARIA DE SOLORZANO	613	2	11	517	363	506	1	1	0	0	141	517
EDO. APURE	CE. SAN FERNANDO	PQ. SAN FERNANDO	ESCUELA BASICA PRIMARIA CAPOTE	428	1	3	373	257	370	0	1	0	0	112	373
EDO. APURE	CE. SAN FERNANDO	PQ. SAN FERNANDO	UNIDAD EDUCATIVA VUELVAN CARAS	3140	6	50	2662	1029	2612	2	18	3	0	1560	2662
EDO. APURE	CE. SAN FERNANDO	PQ. SAN FERNANDO	ESCUELA BASICA BOLIVARIANA CAMPO ALEGRE	1499	3	33	1292	1015	1259	0	5	0	0	239	1292
EDO. APURE	CE. SAN FERNANDO	PQ. SAN FERNANDO	COMPLEJO EDUCATIVO ALIRIO GOITIA ARAUJO	3319	6	79	2690	1308	2611	0	13	2	4	1284	2690
EDO. APURE	CE. SAN FERNANDO	PQ. SAN FERNANDO	ESCUELA ESTADAL BASICA BOLIVARIANA CRISTO REY	487	1	14	446	236	432	0	0	0	1	195	446
EDO. APURE	CE. SAN FERNANDO	PQ. SAN FERNANDO	ESCUELA BASICA MARIO BRICEÑO IRAGORY	3631	7	74	3170	1910	3096	2	24	3	0	1157	3170
EDO. APURE	CE. SAN FERNANDO	PQ. SAN FERNANDO	ESCUELA PRIMARIA ANDRÉS BELLO	256	1	6	236	94	230	0	4	0	0	132	236
EDO. APURE	CE. SAN FERNANDO	PQ. SAN FERNANDO	LICEO BOLIVARIANO FRANCISCO LAZO MARTI	3734	7	43	2998	1539	2955	0	19	2	1	1394	2998
EDO. APURE	CE. SAN FERNANDO	PQ. SAN FERNANDO	LICEO BOLIVARIANO CLARISA ESTE DE TREJO	3276	6	64	2818	1539	2754	0	15	3	1	1196	2818
EDO. APURE	CE. SAN FERNANDO	PQ. SAN FERNANDO	ESCUELA BASICA BOLIVARIANA OSWALDO DEL NOGAL	885	2	16	799	470	783	0	2	0	1	310	799
EDO. APURE	CE. SAN FERNANDO	PQ. SAN FERNANDO	CENTRO DE EDUCACIÓN INICIAL BOLIVARIANO VUELVAN CARAS	840	2	22	745	530	723	0	5	0	0	188	745
EDO. APURE	CE. SAN FERNANDO	PQ. SAN FERNANDO	ESCUELA BASICA NEGRO AFUERA	598	1	8	360	281	352	0	0	0	0	71	360
EDO. APURE	CE. SAN FERNANDO	PQ. SAN FERNANDO	ESCUELA PRIMARIA BOLIVARIANA ANA LEONOR MAYOL	190	1	4	168	145	164	0	0	0	0	19	168
EDO. APURE	CE. SAN FERNANDO	PQ. SAN FERNANDO	ESCUELA CAPACITACION FEMENINA TERESA HEREDIA	1698	3	27	1439	739	1412	0	7	0	3	663	1439
EDO. APURE	CE. SAN FERNANDO	PQ. SAN FERNANDO	UNIVERSIDAD EZEQUIEL ZAMORA	2566	5	26	2090	1002	2064	1	9	1	0	1051	2090
EDO. APURE	CE. SAN FERNANDO	PQ. SAN FERNANDO	ESCUELA BASICA MAC GREGOR	3146	6	54	2623	1341	2569	0	17	1	0	1210	2623
EDO. APURE	CE. SAN FERNANDO	PQ. SAN FERNANDO	INTERNADO JUDICIAL SAN FERNANDO	1836	4	21	1472	718	1451	2	10	1	0	720	1472
EDO. APURE	CE. SAN FERNANDO	PQ. SAN FERNANDO	ESC BASICA SAN JOSE	3492	6	54	2906	2097	2852	1	19	0	1	734	2906
EDO. APURE	CE. SAN FERNANDO	PQ. SAN FERNANDO	LICEO BOLIVARIANO SAN FERNANDO	2197	4	38	1661	731	1623	0	5	3	1	883	1661
EDO. APURE	CE. SAN FERNANDO	PQ. SAN FERNANDO	ESCUELA BASICA ANDRES ELOY BLANCO	1974	4	56	1712	1182	1656	1	8	3	1	461	1712
EDO. APURE	CE. SAN FERNANDO	PQ. SAN FERNANDO	SIMONCITO YAMILET BORJAS	776	2	23	649	494	626	0	3	1	0	128	649
EDO. APURE	CE. SAN FERNANDO	PQ. SAN FERNANDO	ESCUELA BÁSICA SERAFÍN CEDEÑO	505	1	9	461	210	452	0	4	0	0	238	461
EDO. APURE	CE. SAN FERNANDO	PQ. SAN FERNANDO	UNIDAD EDUCATIVA ANTONIO JOSE DE SUCRE	294	1	10	252	151	242	0	1	0	0	90	252
EDO. APURE	CE. SAN FERNANDO	PQ. SAN FERNANDO	ESCUELA PRIMARIA BOLIVARIANA EL BUCARE	869	2	16	742	542	726	0	6	1	1	176	742
EDO. APURE	CE. SAN FERNANDO	PQ. SAN FERNANDO	PREESCOLAR BOLIVARIANO AGROKINDER LOS COQUITOS	1386	3	16	1168	614	1152	0	8	2	0	528	1168
EDO. APURE	CE. SAN FERNANDO	PQ. SAN FERNANDO	LICEO BOLIVARIANO DON ROMULO GALLEGOS	874	2	16	750	400	734	0	2	1	0	331	750
EDO. APURE	CE. SAN FERNANDO	PQ. SAN FERNANDO	ESCUELA BASICA YUCA GUAMA I	346	1	3	268	192	265	0	2	0	0	71	268
EDO. APURE	CE. SAN FERNANDO	PQ. SAN FERNANDO	UNIDAD EDUCATIVA DE DEFICIENCIAS AUDITIVAS CARLOS RAFAEL PEREZ	652	2	10	593	347	583	0	3	0	1	232	593
EDO. APURE	CE. SAN FERNANDO	PQ. SAN FERNANDO	ESCUELA DE EDUCACIÓN INICIAL ROSALIA DE HERRERA MI GARCITA	520	1	11	452	331	441	0	2	0	0	108	452
EDO. APURE	CE. SAN FERNANDO	PQ. SAN FERNANDO	CENTRO DE EDUCACION INICIAL MONTE CALVARIO	235	1	6	205	157	199	0	1	0	0	41	205
EDO. APURE	CE. SAN FERNANDO	PQ. SAN FERNANDO	LICEO BOLIVARIANO EZEQUIEL ZAMORA	503	1	11	452	278	441	0	2	0	0	161	452
EDO. APURE	CE. SAN FERNANDO	PQ. SAN FERNANDO	ESCUELA BASICA SANTA TERESA	3772	7	61	3048	2338	2987	0	16	2	1	630	3048
EDO. APURE	CE. SAN FERNANDO	PQ. SAN FERNANDO	LICEO BOLIVARIANO MIGUEL ANGEL ESCALANTE	1589	3	23	1273	763	1250	0	12	0	0	475	1273
EDO. APURE	CE. SAN FERNANDO	PQ. EL RECREO	CENTRO DE EDUCACIÓN INICIAL SIMÓN BOLIVAR	603	2	10	550	371	540	0	5	1	1	162	550
EDO. APURE	CE. SAN FERNANDO	PQ. EL RECREO	ESCUELA EDUCACION INICIAL ROMULO GALLEGOS	312	1	6	285	193	279	0	1	1	0	84	285
EDO. APURE	CE. SAN FERNANDO	PQ. EL RECREO	ESCUELA BASICA ISLA APURITO 44	892	2	7	659	567	652	0	3	0	0	82	659
EDO. APURE	CE. SAN FERNANDO	PQ. EL RECREO	ESCUELA DE EDUCACION INICIAL ALTAMIRA	568	1	10	500	328	490	0	2	1	0	159	500
EDO. APURE	CE. SAN FERNANDO	PQ. EL RECREO	ESCUELA PRIMARIA ISLA APURITO 422	180	1	0	171	165	171	0	1	0	0	5	171
EDO. APURE	CE. SAN FERNANDO	PQ. EL RECREO	ESCUELA BASICA NEGRO ABAJO	819	2	22	584	476	562	0	2	1	1	82	584
EDO. APURE	CE. SAN FERNANDO	PQ. EL RECREO	ESCUELA BASICA ARTURO USLAR PIETRI	774	2	3	591	444	588	0	0	0	0	144	591
EDO. APURE	CE. SAN FERNANDO	PQ. EL RECREO	ESCUELA PRIMARIA BOLIVARIANA CARMELO JOSE MUJICA	932	2	17	836	669	819	0	10	0	1	139	836
EDO. APURE	CE. SAN FERNANDO	PQ. EL RECREO	ESCUELA TECNICA INDUSTRIAL	1525	3	20	1286	814	1266	0	8	0	0	444	1286
EDO. APURE	CE. SAN FERNANDO	PQ. EL RECREO	ESCUELA BASICA BOCA DE TURUMBA	444	1	6	352	245	346	0	1	0	0	100	352
EDO. APURE	CE. SAN FERNANDO	PQ. EL RECREO	ESCUELA BASICA BOLIVARIANA EL RECREO II	779	2	11	678	467	667	0	4	0	1	195	678
EDO. APURE	CE. SAN FERNANDO	PQ. EL RECREO	ESCUELA PRIMARIA BOLIVARIANA MARIA PEREZ DE PRIETO	645	2	9	581	434	572	0	2	0	0	136	581
EDO. APURE	CE. SAN FERNANDO	PQ. EL RECREO	ESCUELA PRIMARIA LUISA CLOTILDE FARFAN	309	1	10	286	254	276	0	1	0	0	21	286
EDO. APURE	CE. SAN FERNANDO	PQ. EL RECREO	ESCUELA BASICA LA BARTOLERA	300	1	0	255	174	255	0	1	1	0	79	255
EDO. APURE	CE. SAN FERNANDO	PQ. EL RECREO	ESCUELA PRIMARIA 23 DE ENERO	278	1	4	244	210	240	0	0	0	0	30	244
EDO. APURE	CE. SAN FERNANDO	PQ. EL RECREO	ESCUELA BASICA JESUS RAFAEL MAYORA	710	2	11	564	388	553	0	4	0	0	161	564
EDO. APURE	CE. SAN FERNANDO	PQ. EL RECREO	ESCUELA BASICA EL RECREO	3452	6	60	2775	1750	2715	0	25	0	1	939	2775
EDO. APURE	CE. SAN FERNANDO	PQ. EL RECREO	ESCUELA PRIMARIA BOLIVARIANA ANTONIO JOSÉ TORREALBA	3356	6	48	2800	2075	2752	1	18	1	1	656	2800
EDO. APURE	CE. SAN FERNANDO	PQ. EL RECREO	ESCUELA BÁSICA RAFAEL MITILO GONZÁLEZ	441	1	8	391	319	383	0	1	0	0	63	391
EDO. APURE	CE. SAN FERNANDO	PQ. SN RAFAEL DE ATAMAICA	ESCUELA BASICA BOLIVARIANA MADARIAGA	2606	5	17	2027	1289	2010	1	10	1	0	709	2027
EDO. APURE	CE. SAN FERNANDO	PQ. SN RAFAEL DE ATAMAICA	HATO CABUYARE ESCUELA NACIONAL	430	1	0	241	200	241	0	0	0	0	41	241
EDO. APURE	CE. SAN FERNANDO	PQ. SN RAFAEL DE ATAMAICA	ESCUELA PRIMARIA BOLIVARIANA CARUTICO	232	1	4	209	142	205	0	4	1	0	58	209
EDO. APURE	CE. SAN FERNANDO	PQ. SN RAFAEL DE ATAMAICA	ESCUELA PRIMARIA BOLIVARIANA UVERAL	277	1	1	213	131	212	0	1	0	0	80	213
EDO. APURE	CE. SAN FERNANDO	PQ. SN RAFAEL DE ATAMAICA	ESCUELA BASICA JOSE LUIS ROJAS	540	1	6	385	219	379	0	1	0	0	159	385
EDO. APURE	CE. SAN FERNANDO	PQ. SN RAFAEL DE ATAMAICA	ESCUELA ESTADAL EL TERRON	410	1	5	260	175	255	0	3	0	0	77	260
EDO. APURE	CE. SAN FERNANDO	PQ. SN RAFAEL DE ATAMAICA	ESCUELA BÁSICA LA CEIBA DEL ORINOCO	274	1	1	209	195	208	1	0	0	0	12	209
EDO. APURE	CE. SAN FERNANDO	PQ. SN RAFAEL DE ATAMAICA	ESCUELA BÁSICA BOCA ARAUQUITA	498	1	0	346	287	346	0	1	0	0	58	346
EDO. APURE	CE. SAN FERNANDO	PQ. PE#ALVER	ESC ESTADAL EL PERRO NO 116	311	1	0	178	145	178	0	0	0	0	33	178
EDO. APURE	CE. SAN FERNANDO	PQ. PE#ALVER	ESCUELA BASICA EL COCHINO	329	1	2	239	199	237	0	0	0	0	38	239
EDO. APURE	CE. SAN FERNANDO	PQ. PE#ALVER	ESCUELA BASICA EL DRAGAL
EDO. APURE	CE. SAN FERNANDO	PQ. PE#ALVER	ESCUELA BASICA LOS ALGODONALES	346	1	1	294	282	293	0	0	0	0	11	294
EDO. APURE	CE. SAN FERNANDO	PQ. PE#ALVER	ESCUELA BASICA BOCA APURE 212	274	1	0	188	175	188	0	0	0	0	13	188
EDO. APURE	CE. SAN FERNANDO	PQ. PE#ALVER	LICEO BOLIVARIANO GABRIEL MUÑOZ	340	1	8	282	201	274	0	0	0	0	73	282
EDO. APURE	CE. SAN FERNANDO	PQ. PE#ALVER	ESCUELA BASICA EL GUAMAL	298	1	2	147	119	145	0	0	0	0	26	147
EDO. APURE	CE. SAN FERNANDO	PQ. PE#ALVER	ESCUELA PRIMARIA LA CEIBA	200	1	6	188	169	182	0	0	0	0	13	188
EDO. APURE	CE. SAN FERNANDO	PQ. PE#ALVER	ESCUELA BASICA ESTADAL BARRANCA AMARILLA	634	2	0	449	368	449	0	0	0	0	81	449
EDO. APURE	CE. SAN FERNANDO	PQ. PE#ALVER	ESCUELA BASICA TAMANACO	2617	5	21	2016	1315	1995	0	5	1	0	674	2016
EDO. APURE	CE. SAN FERNANDO	PQ. PE#ALVER	ESCUELA BASICA PALMARITO	440	1	1	368	301	367	0	0	0	2	64	368
EDO. APURE	MP. PAEZ	PQ. SAN CAMILO	ESCUELA PRIMARIA ESTADAL EDITA DE CORREDOR	590	1	19	503	360	484	1	2	0	0	121	503
EDO. APURE	MP. PAEZ	PQ. SAN CAMILO	LICEO BOLIVARIANO EL NULA	2166	4	33	1598	999	1565	1	9	0	0	556	1598
EDO. APURE	MP. PAEZ	PQ. SAN CAMILO	ESCUELA PRIMARIA ESTADAL SIMON RODRIGUEZ	3103	6	46	2235	1227	2189	0	10	4	0	948	2235
EDO. APURE	MP. PAEZ	PQ. SAN CAMILO	ESCUELA PRIMARIA ESTADAL TERESA DE LA PARRA	507	1	5	422	239	417	0	3	0	0	175	422
EDO. APURE	MP. PAEZ	PQ. SAN CAMILO	ESCUELA PRIMARIA BOLIVARIANA EL TOPON	1302	3	18	941	554	923	0	11	1	0	357	941
EDO. APURE	MP. PAEZ	PQ. SAN CAMILO	ESCUELA PRIMARIA BOLIVARIANA BARRIO PÁEZ	869	2	19	675	456	656	0	3	1	0	196	675
EDO. APURE	MP. PAEZ	PQ. SAN CAMILO	LICEO BOLIVARIANO FERMIN TORO	284	1	10	247	172	237	0	2	1	0	62	247
EDO. APURE	MP. PAEZ	PQ. SAN CAMILO	ESCUELA PRIMARIA BOLIVARIANA SAN CAMILO	2242	4	18	1646	1057	1628	1	12	1	0	557	1646
EDO. APURE	MP. PAEZ	PQ. URDANETA	ESCUELA PRIMARIA BOLIVARIANA CAÑO REGRESO	886	2	11	730	575	719	0	2	1	0	141	730
EDO. APURE	MP. PAEZ	PQ. URDANETA	ESCUELA PRIMARIA BOLIVARIANA SANTA ROSA	611	2	6	386	304	380	1	4	0	0	71	386
EDO. APURE	MP. PAEZ	PQ. URDANETA	ESCUELA PRIMARIA GRADUADA LA SOLEDAD	664	2	7	473	413	466	1	2	0	0	50	473
EDO. APURE	MP. PAEZ	PQ. URDANETA	ESCUELA PRIMARIA ESTADAL LAS CANOAS	226	1	3	200	127	197	0	4	1	0	65	200
EDO. APURE	MP. PAEZ	PQ. URDANETA	ESCUELA PRIMARIA BOLIVARIANA MATA DE BRECHARIA	403	1	9	335	275	326	0	5	0	0	46	335
EDO. APURE	MP. PAEZ	PQ. URDANETA	ESCUELA PRIMARIA BOLIVARIANA TRES ESQUINAS	381	1	7	299	256	292	1	3	1	0	31	299
EDO. APURE	MP. PAEZ	PQ. URDANETA	CENTRO DE EDUCACION INICIAL BOLIVARIANA LA VICTORIA	606	2	7	448	354	441	0	3	0	0	84	448
EDO. APURE	MP. PAEZ	PQ. URDANETA	UNIDAD EDUCATIVA SIMON RODRIGUEZ FE Y ALEGRIA	708	2	16	505	334	489	0	2	0	0	153	505
EDO. APURE	MP. PAEZ	PQ. URDANETA	ESCUELA PRIMARIA BOLIVARIANA LA VICTORIA	2969	6	33	2001	1516	1968	1	26	3	0	422	2001
EDO. APURE	MP. PAEZ	PQ. URDANETA	ESCUELA PRIMARIA BOLIVARIANA BRISAS DEL CUTUFI	703	2	5	486	336	481	0	3	0	1	141	486
EDO. APURE	MP. PAEZ	PQ. URDANETA	ESCUELA PRIMARIA BOLIVARIANA LA OSA	203	1	3	172	134	169	0	2	1	1	31	172
EDO. APURE	MP. PAEZ	PQ. EL AMPARO	ESCUELA TECNICA AGROPECUARIA FRANCISCO ARAMENDI	3939	7	63	2292	1224	2229	0	21	0	1	983	2292
EDO. APURE	MP. PAEZ	PQ. EL AMPARO	LICEO BOLIVARIANO EL AMPARO	761	2	24	545	306	521	0	12	0	0	203	545
EDO. APURE	MP. PAEZ	PQ. EL AMPARO	ESCUELA PRIMARIA NUEVA GENERACION 2000	663	2	27	476	249	449	0	9	0	1	190	476
EDO. APURE	MP. PAEZ	PQ. EL AMPARO	ESCUELA PRIMARIA BOLIVARIANA LAS MONAS
EDO. APURE	MP. PAEZ	PQ. EL AMPARO	ESCUELA PRIMARIA BOLIVARIANA INDIGENA GUAMALITO	167	1	1	140	119	139	0	1	0	0	19	140
EDO. APURE	MP. PAEZ	PQ. EL AMPARO	ESCUELA PRIMARIA BOLIVARIANA PUENTE PAEZ	299	1	14	223	166	209	0	1	0	0	42	223
EDO. APURE	MP. PAEZ	PQ. EL AMPARO	ESCUELA PRIMARIA BOLIVARIANA CAÑAFISTOLA	718	2	17	528	440	511	1	3	1	0	66	528
EDO. APURE	MP. PAEZ	PQ. EL AMPARO	ESCUELA PRIMARIA BOLIVARIANA DIEGO EUGENIO CHACON	1615	3	38	886	510	848	2	12	1	0	323	886
EDO. APURE	MP. PAEZ	PQ. EL AMPARO	ESCUELA PRIMARIA BOLIVARIANA ANA ROSA CARO DE SOSA	1170	2	21	840	560	819	0	5	0	1	253	840
EDO. APURE	MP. PAEZ	PQ. ARAMENDI	ESCUELA PRIMARIA BOLIVARIANA SAMANAL	194	1	0	146	75	146	0	0	0	0	71	146
EDO. APURE	MP. PAEZ	PQ. ARAMENDI	CICLO BASICO COMUN PALMARITO	468	1	5	360	266	355	1	2	0	0	86	360
EDO. APURE	MP. PAEZ	PQ. ARAMENDI	ESCUELA PRIMARIA BOLIVARIANA EL GUAMITO	132	1	4	74	58	70	0	1	0	0	11	74
EDO. APURE	MP. PAEZ	PQ. ARAMENDI	ESCUELA PRIMARIA BOLIVARIANA EL ESPINOCERO	167	1	2	136	104	134	0	0	0	0	30	136
EDO. APURE	MP. PAEZ	PQ. ARAMENDI	ESCUELA PRIMARIA BOLIVARIANA EL CHARO	101	1	2	64	27	62	0	0	0	0	35	64
EDO. APURE	MP. PAEZ	PQ. ARAMENDI	GRUPO ESCOLAR NEPOMUCENA FIGUEREDO	1618	3	10	1050	654	1040	0	6	0	0	380	1050
EDO. APURE	MP. PAEZ	PQ. GUASDUALITO	LICEO BOLIVARIANO LA AURORA	457	1	6	390	293	384	0	3	0	0	88	390
EDO. APURE	MP. PAEZ	PQ. GUASDUALITO	ESCUELA PRIMARIA BOLIVARIANA LUIS RINCONES CASTILLO	704	2	24	539	355	515	0	4	0	0	156	539
EDO. APURE	MP. PAEZ	PQ. GUASDUALITO	INSTITUTO DE EDUCACION ESPECIAL BOLIVARIANO GUASDUALITO	2124	4	46	1790	1002	1744	0	17	2	2	721	1790
EDO. APURE	MP. PAEZ	PQ. GUASDUALITO	ESCUELA PRIMARIA BOLIVARIANA ESTADAL GRADUADA ANGELICA ZAPATA	341	1	4	302	220	298	0	3	0	0	75	302
EDO. APURE	MP. PAEZ	PQ. GUASDUALITO	ESCUELA PRIMARIA BOLIVARIANA GUACHIVA	104	1	3	86	57	83	0	0	0	0	26	86
EDO. APURE	MP. PAEZ	PQ. GUASDUALITO	ESCUELA PRIMARIA BOLIVARIANA ESTADAL GRADUADA HERMINIA PEREZ	523	1	24	440	212	416	0	3	0	0	201	440
EDO. APURE	MP. PAEZ	PQ. GUASDUALITO	ESCUELA PRIMARIA ESTADAL GRADUADA  ROSA MARIA SOTO	524	1	10	391	214	381	0	5	0	0	162	391
EDO. APURE	MP. PAEZ	PQ. GUASDUALITO	ESCUELA TÉCNICA INDUSTRIAL ROBINSONIANA Y ZAMORANA JUAN PABLO PÉREZ ALFONZO	541	1	17	428	224	411	0	4	0	0	183	428
EDO. APURE	MP. PAEZ	PQ. GUASDUALITO	ESCUELA PRIMARIA BOLIVARIANA  FRANCISCO DE MIRANDA	594	1	15	454	248	439	0	2	1	0	188	454
EDO. APURE	MP. PAEZ	PQ. GUASDUALITO	ESCUELA PRIMARIA BOLIVARIANA LAS MALVINAS	433	1	5	335	257	330	2	3	1	0	67	335
EDO. APURE	MP. PAEZ	PQ. GUASDUALITO	ESCUELA PRIMARIA BOLIVARIANA BOCA DE URIBANTE	197	1	2	138	58	136	0	0	0	0	78	138
EDO. APURE	MP. PAEZ	PQ. GUASDUALITO	ESCUELA BASICA EVA QUINTERO	851	2	14	695	439	681	0	5	1	0	236	695
EDO. APURE	MP. PAEZ	PQ. GUASDUALITO	ESCUELA DE EDUCACION INICIAL BOLIVARIANA ARAMENDI	685	2	9	544	270	535	0	5	0	0	260	544
EDO. APURE	MP. PAEZ	PQ. GUASDUALITO	ESCUELA BASICA BOLIVARIANA MATA PALAR	186	1	7	165	94	158	0	2	0	0	62	165
EDO. APURE	MP. PAEZ	PQ. GUASDUALITO	ESCUELA BASICA ESTADAL GRADUADA HERMINIA MACIAS	880	2	18	752	501	734	0	7	0	0	226	752
EDO. APURE	MP. PAEZ	PQ. GUASDUALITO	CENTRO DE EDUCACION INICIAL BLANCA NIEVES	1330	3	9	1089	557	1080	0	6	0	2	515	1089
EDO. APURE	MP. PAEZ	PQ. GUASDUALITO	ESCUELA BASICA ESTADAL GRADUADA MARCOS DANIEL HERNANDEZ BRITO	2131	4	45	1468	898	1423	0	15	0	1	509	1468
EDO. APURE	MP. PAEZ	PQ. GUASDUALITO	ESCUELA BASICA ESTADAL GRADUADA JOSEFA ORELLANA	393	1	9	344	246	335	0	2	1	0	86	344
EDO. APURE	MP. PAEZ	PQ. GUASDUALITO	ESCUELA NACIONAL MATA DE CABO	359	1	3	266	146	263	0	1	0	0	116	266
EDO. APURE	MP. PAEZ	PQ. GUASDUALITO	ESCUELA PRIMARIA BOLIVARIANA ARAMENDI	3911	7	81	2946	1364	2865	3	14	4	3	1477	2946
EDO. APURE	MP. PAEZ	PQ. GUASDUALITO	ESCUELA PRIMARIA BOLIVARIANA  DOCTOR JULIO DE ARMAS	3645	7	70	2871	1491	2801	1	19	0	1	1289	2871
EDO. APURE	MP. PAEZ	PQ. GUASDUALITO	ESCUELA PRIMARIA BOLIVARIANA TOTUMITO	626	2	14	447	219	433	1	1	0	0	212	447
EDO. APURE	MP. PAEZ	PQ. GUASDUALITO	ESCUELA BASICA GRADUADA ANA MERY DE GUERRERO	722	2	16	604	371	588	0	2	0	0	215	604
EDO. APURE	MP. PAEZ	PQ. GUASDUALITO	ESCUELA PRIMARIA BOLIVARIANA ESTADAL GRADUADA COROCITO	454	1	16	370	239	354	0	3	1	0	111	370
EDO. APURE	MP. PAEZ	PQ. GUASDUALITO	ESCUELA PRIMARIA MARIA APOLONIA ROJAS DE GUTIERREZ	303	1	8	215	89	207	0	3	1	0	114	215
EDO. APURE	MP. PAEZ	PQ. GUASDUALITO	ESCUELA BÁSICA SAÚL DARÍO ROA ROMERO	562	1	11	481	268	470	0	4	2	0	196	481
EDO. APURE	MP. PAEZ	PQ. GUASDUALITO	ESCUELA PRIMARIA BOLIVARIANA GUASDUALITO	2752	5	41	2173	1036	2132	2	23	0	1	1070	2173
EDO. APURE	MP. PAEZ	PQ. GUASDUALITO	ESCUELA PRIMARIA BOLIVARIANA LA PALMA	468	1	7	384	191	377	0	2	0	0	184	384
EDO. APURE	MP. PAEZ	PQ. GUASDUALITO	ESCUELA PRIMARIA  ESTADAL GRADUADA GUACAS DE RIVERA	1685	3	20	1235	671	1215	1	12	0	0	531	1235
EDO. APURE	MP. PAEZ	PQ. GUASDUALITO	LICEO BOLIVARIANO FERNANDO CALZADILLA VALDES	2207	4	33	1679	855	1646	0	18	1	0	772	1679
EDO. APURE	MP. PAEZ	PQ. GUASDUALITO	ESCUELA BÁSICA MEREICITO	1196	3	28	962	495	934	0	2	0	1	436	962
EDO. APURE	MP. PAEZ	PQ. GUASDUALITO	ESCUELA PRIMARIA GLADIS GONZALEZ	1173	2	32	861	436	829	0	6	1	0	386	861
EDO. APURE	MP. ACHAGUAS	PQ. QUESERAS DEL MEDIO	ESCUELA BASICA PEDRO TEODORO RODRIGUEZ	1226	3	8	911	756	903	1	2	1	0	143	911
EDO. APURE	MP. ACHAGUAS	PQ. QUESERAS DEL MEDIO	ESCUELA PRIMARIA JABILLAR	185	1	5	167	151	162	0	0	0	0	11	167
EDO. APURE	MP. ACHAGUAS	PQ. QUESERAS DEL MEDIO	ESCUELA PRIMARIA MANGA ROMANERA	318	1	5	299	272	294	0	0	0	0	22	299
EDO. APURE	MP. ACHAGUAS	PQ. QUESERAS DEL MEDIO	ESCUELA PRIMARIA LA ROSITA	99	1	0	74	43	74	0	0	0	0	31	74
EDO. APURE	MP. ACHAGUAS	PQ. QUESERAS DEL MEDIO	GRUPO ESCOLAR QUESERAS DEL MEDIO	1758	3	17	1317	905	1300	0	7	1	0	387	1317
EDO. APURE	MP. ACHAGUAS	PQ. EL YAGUAL	ESCUELA PRIMARIA VICENTA CROQUER	520	1	1	265	182	264	0	1	0	0	81	265
EDO. APURE	MP. ACHAGUAS	PQ. EL YAGUAL	ESCUELA PRIMARIA EL PUEBLITO	386	1	6	340	291	334	0	0	0	0	43	340
EDO. APURE	MP. ACHAGUAS	PQ. EL YAGUAL	ESCUELA PRIMARIA PALMIRA
EDO. APURE	MP. ACHAGUAS	PQ. EL YAGUAL	ESCUELA PRIMARIA CHAPARRALITO	192	1	4	161	107	157	0	1	1	0	48	161
EDO. APURE	MP. ACHAGUAS	PQ. EL YAGUAL	ESCUELA PRIMARIA BOLIVARIANA PALMARITO	507	1	3	347	263	344	0	1	0	0	80	347
EDO. APURE	MP. ACHAGUAS	PQ. EL YAGUAL	ESCUELA PRIMARIA BOLIVARIANA RAIMUNDO FONSECA	1562	3	23	1187	822	1164	0	3	1	0	338	1187
EDO. APURE	MP. ACHAGUAS	PQ. GUACHARA	ESCUELA BASICA BOLIVARIANA INDIGENA CHAPARRALITO	172	1	0	147	147	147	0	0	0	0	0	147
EDO. APURE	MP. ACHAGUAS	PQ. GUACHARA	ESCUELA PRIMARIA LAS CAMPANAS	419	1	0	221	210	221	0	0	0	0	11	221
EDO. APURE	MP. ACHAGUAS	PQ. GUACHARA	ESCUELA PRIMARIA BOLIVARIANA INDÍGENA SANTA JOSEFINA	182	1	0	120	119	120	0	0	0	0	1	120
EDO. APURE	MP. ACHAGUAS	PQ. GUACHARA	ESCUELA PRIMARIA BOLIVARIANA FRUTA DE BURRO	290	1	1	264	228	263	0	0	0	0	35	264
EDO. APURE	MP. ACHAGUAS	PQ. GUACHARA	ESCUELA PRIMARIA GUACHARA	1938	4	13	1396	896	1383	0	6	0	0	481	1396
EDO. APURE	MP. ACHAGUAS	PQ. GUACHARA	ESCUELA PRIMARIA ANSELMO RAMON SOLORZANO	228	1	1	194	144	193	0	0	0	0	49	194
EDO. APURE	MP. ACHAGUAS	PQ. GUACHARA	ESCUELA PRIMARIA SAN JOSE DE CAPANAPARO	303	1	3	184	138	181	0	0	0	0	43	184
EDO. APURE	MP. ACHAGUAS	PQ. ACHAGUAS	JARDIN DE INFANCIA ACHAGUAS	478	1	7	399	280	392	0	3	1	0	108	399
EDO. APURE	MP. ACHAGUAS	PQ. ACHAGUAS	ESCUELA PRIMARIA BOLIVARIANA EL NAZARENO	2988	6	35	2447	1641	2412	0	22	1	0	748	2447
EDO. APURE	MP. ACHAGUAS	PQ. ACHAGUAS	ESCUELA PRIMARIA PEDRO CAMEJO	881	2	10	679	503	669	0	3	1	0	162	679
EDO. APURE	MP. ACHAGUAS	PQ. ACHAGUAS	CENTRO DE EDUCACIÓN INICIAL BOLIVARIANO SIMOMCITO TERESA HURTADO	683	2	7	594	414	587	0	5	0	0	168	594
EDO. APURE	MP. ACHAGUAS	PQ. ACHAGUAS	ESCUELA BASICA BOLIVARIANA TERESA HURTADO	3950	7	62	3068	2009	3006	0	32	6	0	959	3068
EDO. APURE	MP. ACHAGUAS	PQ. ACHAGUAS	ESCUELA PRIMARIA BOLIVARIANA FLORA DE CELIS	1454	3	40	1191	948	1151	1	9	0	0	193	1191
EDO. APURE	MP. ACHAGUAS	PQ. ACHAGUAS	ESCUELA PRIMARIA JOSE ANGEL MONTENEGRO	685	2	5	589	469	584	0	6	0	0	109	589
EDO. APURE	MP. ACHAGUAS	PQ. ACHAGUAS	CASA DE LA CULTURA CARLOS GUEVARA	937	2	7	764	514	757	0	9	0	0	234	764
EDO. APURE	MP. ACHAGUAS	PQ. ACHAGUAS	ESCUELA PRIMARIA BOLIVARIANA BUENA VISTA	859	2	35	674	498	639	0	1	0	2	138	674
EDO. APURE	MP. ACHAGUAS	PQ. ACHAGUAS	ESCUELA TECNICA AGROPECUARIA ACHAGUAS	310	1	3	260	184	257	0	0	1	0	72	260
EDO. APURE	MP. ACHAGUAS	PQ. ACHAGUAS	ESCUELA PRIMARIA LAMEDERO NER 080	207	1	2	174	163	172	0	1	0	0	8	174
EDO. APURE	MP. ACHAGUAS	PQ. ACHAGUAS	ESCUELA PRIMARIA TOTUMITO	192	1	1	115	105	114	0	0	0	0	9	115
EDO. APURE	MP. ACHAGUAS	PQ. ACHAGUAS	LICEO DIEGO EUGENIO CHACON	3436	6	40	2664	1765	2624	3	24	3	0	829	2664
EDO. APURE	MP. ACHAGUAS	PQ. ACHAGUAS	ESCUELA PRIMARIA BOLIVARIANA LOS VIEJITOS	291	1	5	248	182	243	0	2	0	0	59	248
EDO. APURE	MP. ACHAGUAS	PQ. ACHAGUAS	ESCUELA PRIMARIA JOSE  HERNANDEZ	824	2	10	667	499	657	1	2	0	0	155	667
EDO. APURE	MP. ACHAGUAS	PQ. ACHAGUAS	ESCUELA PRIMARIA BOLIVARIANA MENCA DE LEONI	1428	3	51	1236	877	1185	0	12	1	0	295	1236
EDO. APURE	MP. ACHAGUAS	PQ. ACHAGUAS	ESCUELA PRIMARIA  EL ROSARIO	115	1	1	71	52	70	0	0	0	0	18	71
EDO. APURE	MP. ACHAGUAS	PQ. ACHAGUAS	CENTRO DE EDUCACIÓN INICIAL BOLIVARIANO LA PAZ	550	1	7	476	359	469	0	0	1	0	109	476
EDO. APURE	MP. ACHAGUAS	PQ. ACHAGUAS	ESCUELA PRIMARIA ISABEL DE NAKATA	661	2	4	518	439	514	0	1	0	0	74	518
EDO. APURE	MP. ACHAGUAS	PQ. ACHAGUAS	ESCUELA PRIMARIA GRACIELA DE CÁMEL	348	1	6	313	219	307	0	2	1	0	85	313
EDO. APURE	MP. ACHAGUAS	PQ. ACHAGUAS	ESCUELA PRIMARIA BOLIVARIANA EL JOBO	155	1	1	84	60	83	0	0	0	0	23	84
EDO. APURE	MP. ACHAGUAS	PQ. ACHAGUAS	ESCUELA PRIMARIA BOQUERONES	196	1	3	128	88	125	0	0	0	0	37	128
EDO. APURE	MP. ACHAGUAS	PQ. MUCURITAS	ESCUELA PRIMARIA  JOSE ANTONIO PAEZ	660	2	7	527	337	520	0	3	0	0	180	527
EDO. APURE	MP. ACHAGUAS	PQ. MUCURITAS	ESCUELA PRIMARIA EL GUAYABO	262	1	4	213	147	209	0	0	0	0	62	213
EDO. APURE	MP. ACHAGUAS	PQ. MUCURITAS	ESCUELA PRIMARIA BOLIVARIANA IGNACIA DE MAYOL	1866	4	27	1354	935	1327	0	5	1	1	385	1354
EDO. APURE	MP. ACHAGUAS	PQ. MUCURITAS	CENTRO DE EDUCACION INICIAL BOLIVARIANO IGNACIA DE MAYOL	588	1	11	467	375	456	0	1	0	0	80	467
EDO. APURE	MP. ACHAGUAS	PQ. MUCURITAS	ESCUELA PRIMARIA LA TIGRA	216	1	1	131	102	130	0	2	0	0	26	131
EDO. APURE	MP. ACHAGUAS	PQ. MUCURITAS	ESCUELA PRIMARIA SAN JOSE	295	1	8	240	178	232	0	2	0	0	52	240
EDO. APURE	MP. ACHAGUAS	PQ. APURITO	ESCUELA PRIMARIA BOLIVARIANA MADRE VIEJA	229	1	5	189	163	184	0	4	0	0	17	189
EDO. APURE	MP. ACHAGUAS	PQ. APURITO	ESCUELA PRIMARIA EL CARRAO	730	2	12	565	412	553	0	4	1	0	136	565
EDO. APURE	MP. ACHAGUAS	PQ. APURITO	ESCUELA PRIMARIA EL CHORRO	386	1	4	274	196	270	0	2	0	0	72	274
EDO. APURE	MP. ACHAGUAS	PQ. APURITO	LICEO BOLIVARIANO SABERIO BARBARITO	361	1	7	270	205	263	1	0	1	1	55	270
EDO. APURE	MP. ACHAGUAS	PQ. APURITO	ESCUELA PRIMARIA BOLIVARIANA  COSME LOPEZ HURTADO	1692	3	24	1216	826	1192	0	9	1	1	355	1216
EDO. APURE	MP. BIRUACA	PQ. BIRUACA	ESCUELA PRIMARIA MANUEL JOSE HIDALGO	139	1	4	129	98	125	0	0	0	0	27	129
EDO. APURE	MP. BIRUACA	PQ. BIRUACA	ESCUELA PRIMARIA BOLIVARIANA PALO QUEMAO.	300	1	7	277	171	270	0	1	0	0	98	277
EDO. APURE	MP. BIRUACA	PQ. BIRUACA	ESCUELA BASICA JOSE GREGORIO HERNANDEZ	1978	4	39	1678	957	1639	0	11	1	0	670	1678
EDO. APURE	MP. BIRUACA	PQ. BIRUACA	ESCUELA PRIMARIA BOLIVARIANA OLINDA FRANCO DE CASTRO	1913	4	39	1476	1050	1437	0	6	0	1	380	1476
EDO. APURE	MP. BIRUACA	PQ. BIRUACA	ESCUELA PRIMARIA SANTA RUFINA	2808	5	60	2417	1286	2357	0	15	1	3	1052	2417
EDO. APURE	MP. BIRUACA	PQ. BIRUACA	ESCUELA PRIMARIA BOLIVARIANA LOS ALGARROBOS	1481	3	16	1115	747	1099	0	6	1	0	345	1115
EDO. APURE	MP. BIRUACA	PQ. BIRUACA	CENTRO DE EDUCACIÓN INICIAL MI LINDA BIRUACA	446	1	6	399	259	393	0	1	0	0	133	399
EDO. APURE	MP. BIRUACA	PQ. BIRUACA	ESCUELA PRIMARIA BOLIVARIANA ANA DE MEDINA	598	1	7	493	272	486	0	1	0	0	213	493
EDO. APURE	MP. BIRUACA	PQ. BIRUACA	ESCUELA PRIMARIA BOLAVARIANA RABANAL	1183	2	12	984	727	972	0	4	0	0	241	984
EDO. APURE	MP. BIRUACA	PQ. BIRUACA	ESCUELA BASICA RAMONA FIGUEREDO	410	1	11	366	226	355	0	6	0	0	123	366
EDO. APURE	MP. BIRUACA	PQ. BIRUACA	CENTRO DE EDUCACION INICIAL MI FLORECITA	696	2	24	621	455	597	0	4	0	0	138	621
EDO. APURE	MP. BIRUACA	PQ. BIRUACA	ESCUELA BASICA CARMELO JOSE MUJICA	902	2	13	750	623	737	0	2	1	0	111	750
EDO. APURE	MP. BIRUACA	PQ. BIRUACA	CASA CUNA MUCURITA	126	1	4	113	76	109	0	0	0	0	33	113
EDO. APURE	MP. BIRUACA	PQ. BIRUACA	ESCUELA PRIMARIA BETHEL TURUMBA	598	1	4	411	267	407	0	0	0	0	140	411
EDO. APURE	MP. BIRUACA	PQ. BIRUACA	ESCUELA PRIMARIA BOLIVARIANA BELEN SAN JUAN	176	1	2	168	129	166	0	2	0	0	35	168
EDO. APURE	MP. BIRUACA	PQ. BIRUACA	CENTRO DE EDUCACION INICIAL MERECURE II	999	2	18	903	579	885	0	2	0	1	303	903
EDO. APURE	MP. BIRUACA	PQ. BIRUACA	COLEGIO FRAY BUENA VENTURA BENAUCAZ	2545	5	36	1984	1049	1948	1	19	1	0	878	1984
EDO. APURE	MP. BIRUACA	PQ. BIRUACA	ESCUELA BASICA  JUANAPARO	538	1	0	401	299	401	0	0	0	0	102	401
EDO. APURE	MP. BIRUACA	PQ. BIRUACA	ESCUELA BASICA SANTA ELISA	1130	2	36	835	540	799	0	2	0	0	257	835
EDO. APURE	MP. BIRUACA	PQ. BIRUACA	ESCUELA PRIMARIA BASICA SIMON RODRIGUEZ	253	1	6	221	202	215	0	1	0	0	12	221
EDO. APURE	MP. BIRUACA	PQ. BIRUACA	ESCUELA PRIMARIA PABLO ANICETO CAMEJO	216	1	5	201	146	196	0	2	0	0	48	201
EDO. APURE	MP. BIRUACA	PQ. BIRUACA	ESCUELA DE EDUCACION INICIAL BOLIVARIANA SANTA RUFINA	224	1	8	196	107	188	0	2	0	0	79	196
EDO. APURE	MP. BIRUACA	PQ. BIRUACA	ESCUELA BASICA BOLIVARIANA MARIA CASTRO	350	1	8	313	264	305	0	0	0	0	41	313
EDO. APURE	MP. BIRUACA	PQ. BIRUACA	UNIDA EDUCATIVA AMANTINA DE SUCRE	2482	5	50	2029	1307	1979	0	5	1	0	666	2029
EDO. APURE	MP. BIRUACA	PQ. BIRUACA	ESCUELA BASICA ROSA DIAZ DE ARTAHONA	856	2	10	673	530	663	1	0	1	0	131	673
EDO. APURE	MP. BIRUACA	PQ. BIRUACA	ESCUELA PRIMARIA LA MORITA II VECINDARIO	1165	2	17	902	470	885	0	6	0	0	409	902
EDO. APURE	MP. BIRUACA	PQ. BIRUACA	ESCUELA PRIMARIA BOLIVARIANA VIENTO A.	1007	2	8	781	558	773	0	1	0	0	214	781
EDO. APURE	MP. BIRUACA	PQ. BIRUACA	ESCUELA BASICA BOLIVARIANA HECTOR VIDAL BENAUCO	1763	4	34	1472	841	1438	1	10	0	0	586	1472
EDO. APURE	MP. BIRUACA	PQ. BIRUACA	ESCUELA BASICA JOSE ANDRES ORTIZ	2340	5	35	1919	1401	1884	1	12	0	1	469	1919
EDO. APURE	MP. BIRUACA	PQ. BIRUACA	ESCUELA PRIMARIA PAYARITA	844	2	7	647	403	640	0	2	0	0	235	647
EDO. APURE	MP. BIRUACA	PQ. BIRUACA	ESCUELA PRIMARIA BOLIVARIANA LEONARDO AGRINZONES	730	2	10	629	358	619	0	1	0	0	260	629
EDO. APURE	MP. BIRUACA	PQ. BIRUACA	ESCUELA BASICA JULIETA CARABALLO	1225	3	24	1072	684	1048	0	9	2	0	353	1072
EDO. APURE	MP. BIRUACA	PQ. BIRUACA	ESCUELA PRIMARIA MORITA II ASENTAMIENTO	187	1	1	160	122	159	0	2	0	0	35	160
EDO. APURE	MP. BIRUACA	PQ. BIRUACA	ESCUELA EDUCACION INICIAL LIBERTADOR SIMON BOLIVAR	187	1	6	174	112	168	0	3	0	0	53	174
EDO. APURE	MP. BIRUACA	PQ. BIRUACA	ESCUELA PRIMARIA CLEOTILDE PEREZ DE FERNANDEZ	837	2	11	682	538	671	0	2	0	1	130	682
EDO. APURE	MP. BIRUACA	PQ. BIRUACA	ESCUELA PRIMARIA BOLIVARIANA PETRA FRANCISCA ALVARADO	113	1	0	106	80	106	0	1	0	0	25	106
EDO. APURE	MP. BIRUACA	PQ. BIRUACA	ESCUELA PRIMARIA BOLIVARIANA  MARIA NICASIA GAMARRA	644	2	11	541	373	530	0	2	0	0	155	541
EDO. APURE	MP. BIRUACA	PQ. BIRUACA	ESCUELA PRIMARIA GRADUADA MIGUELINA MORILLO	625	2	22	467	341	445	0	1	1	0	102	467
EDO. APURE	MP. BIRUACA	PQ. BIRUACA	ESCUELA BASICA LAS MANGAS	870	2	19	647	499	628	0	3	0	0	126	647
EDO. CARABOBO	MP. SAN DIEGO	PQ. URB SAN DIEGO	ESCUELA BASICA BOLIVARIANA LA LUZ (NUCLEO ESCOLAR RURAL 49)	472	1	6	415	190	409	0	1	0	0	218	415
EDO. CARABOBO	MP. SAN DIEGO	PQ. URB SAN DIEGO	COLEGIO UNIVERSITARIO MONSEÑOR DE TALAVERA	11722	22	109	10484	1960	10375	1	29	11	9	8365	10484
EDO. CARABOBO	MP. SAN DIEGO	PQ. URB SAN DIEGO	UNIDAD EDUCATIVA SAN DIEGO DE ALCALA	2456	5	26	2197	774	2171	1	8	0	0	1388	2197
EDO. CARABOBO	MP. SAN DIEGO	PQ. URB SAN DIEGO	GRUPO ESCOLAR QUEIPA	6738	12	77	5606	1631	5529	1	22	3	4	3868	5606
EDO. CARABOBO	MP. SAN DIEGO	PQ. URB SAN DIEGO	UNIDAD EDUCATIVA LA JOSEFINA	1175	2	25	1034	637	1009	0	3	0	0	369	1034
EDO. CARABOBO	MP. SAN DIEGO	PQ. URB SAN DIEGO	LICEO HIPOLITO CISNEROS	6384	12	47	5544	1369	5497	1	17	6	4	4100	5544
EDO. CARABOBO	MP. SAN DIEGO	PQ. URB SAN DIEGO	UNIDAD EDUCATIVA CREACION SAN DIEGO NORTE	3248	6	25	3052	807	3027	0	8	2	1	2209	3052
EDO. CARABOBO	MP. SAN DIEGO	PQ. URB SAN DIEGO	UNIDAD EDUCATIVA NACIONAL CAMPO SOLO	4296	8	57	3539	1989	3482	0	20	2	3	1468	3539
EDO. CARABOBO	MP. SAN DIEGO	PQ. URB SAN DIEGO	UNIDAD EDUCATIVA ESTADAL SANTIAGO MARIÑO	7330	13	47	6470	1240	6423	1	18	3	1	5160	6470
EDO. CARABOBO	MP. SAN DIEGO	PQ. URB SAN DIEGO	ESCUELA BASICA NACIONALCLORINDA AZCUÑES	3846	7	32	3546	706	3514	2	9	0	1	2796	3546
EDO. CARABOBO	MP. SAN DIEGO	PQ. URB SAN DIEGO	UNIDAD EDUCATIVA LOS MAGALLANES	2483	5	25	2009	1099	1984	1	16	1	1	866	2009
EDO. CARABOBO	MP. SAN DIEGO	PQ. URB SAN DIEGO	INSTITUTO UNIVERSITARIO DE TECNOLOGIA DE SEGURIDAD INDUSTRIAL	4872	9	50	4217	1247	4167	1	21	3	3	2892	4217
EDO. CARABOBO	MP. SAN DIEGO	PQ. URB SAN DIEGO	UNIDAD EDUCATIVA PRIVADO VIRGEN DE COROMOTO	4264	8	29	3724	640	3695	0	12	0	3	3040	3724
EDO. CARABOBO	MP. LOS GUAYOS	PQ. U LOS GUAYOS	CENTRO EDUCACION INICIAL GUAPARO	885	2	12	728	528	716	0	5	0	0	183	728
EDO. CARABOBO	MP. LOS GUAYOS	PQ. U LOS GUAYOS	ESCUELA BASICA NACIONAL BOLIVARIANA LOS CERRITOS	5692	10	73	4895	1857	4822	0	21	1	3	2940	4895
EDO. CARABOBO	MP. LOS GUAYOS	PQ. U LOS GUAYOS	UNIDAD EDUCATIVA SIMON JOSE GUEDEZ ORTIZ	837	2	9	693	521	684	0	4	0	0	159	693
EDO. CARABOBO	MP. LOS GUAYOS	PQ. U LOS GUAYOS	UNIDAD BASICA RAMONA DE ROMERO	2190	4	24	1809	848	1785	0	2	0	0	935	1809
EDO. CARABOBO	MP. LOS GUAYOS	PQ. U LOS GUAYOS	INSTITUTO DE EDUCACION ESPECIAL LAS AGUITAS	3095	6	37	2513	1476	2476	2	13	2	3	980	2513
EDO. CARABOBO	MP. LOS GUAYOS	PQ. U LOS GUAYOS	UNIDAD EDUCATIVA DIVINO NIÑO	1685	3	18	1277	767	1259	0	8	0	0	484	1277
EDO. CARABOBO	MP. LOS GUAYOS	PQ. U LOS GUAYOS	UNIDAD EDUCATIVA LUISA TERESA DE MONTEMAYOR	2433	5	29	1922	1575	1893	1	9	1	2	305	1922
EDO. CARABOBO	MP. LOS GUAYOS	PQ. U LOS GUAYOS	ESCUELA NACIONAL PIRITAL	1064	2	21	834	650	813	1	2	2	0	158	834
EDO. CARABOBO	MP. LOS GUAYOS	PQ. U LOS GUAYOS	GRUPO ESCOLAR LOS HIJOS DE BOLIVAR	2698	5	35	2166	1756	2131	2	20	3	0	350	2166
EDO. CARABOBO	MP. LOS GUAYOS	PQ. U LOS GUAYOS	JARDIN DE INFANCIA EL ROBLE	2287	4	24	1598	1184	1574	0	11	1	2	376	1598
EDO. CARABOBO	MP. LOS GUAYOS	PQ. U LOS GUAYOS	GRUPO ESCOLAR BATALLA DE AYACUCHO	4908	9	88	4123	2518	4035	3	31	1	3	1479	4123
EDO. CARABOBO	MP. LOS GUAYOS	PQ. U LOS GUAYOS	NAPIS DE GARCILLERA III	432	1	5	359	240	354	0	4	0	0	110	359
EDO. CARABOBO	MP. LOS GUAYOS	PQ. U LOS GUAYOS	ESCUELA BOLIVARIANA LOS CERRITOS	5248	9	72	4523	1970	4451	1	34	2	3	2441	4523
EDO. CARABOBO	MP. LOS GUAYOS	PQ. U LOS GUAYOS	ESCUELA TECNOLOGICA RURAL FRANCISCO DE MIRANDA	947	2	21	752	529	731	0	2	0	0	200	752
EDO. CARABOBO	MP. LOS GUAYOS	PQ. U LOS GUAYOS	ESCUELA BASICA LICENCIADA ELISA GUEVARA DE CACERES	3137	6	68	2476	1428	2408	0	14	0	2	964	2476
EDO. CARABOBO	MP. LOS GUAYOS	PQ. U LOS GUAYOS	UNIDAD EDUCATIVA JUAN PABLO PEREZ	714	2	17	595	415	578	1	2	0	0	160	595
EDO. CARABOBO	MP. LOS GUAYOS	PQ. U LOS GUAYOS	ESCUELA BASICA NACIONAL LAS AGUITAS I Y II JULIO GARMENDIA	2708	5	53	2242	1379	2189	0	9	1	0	800	2242
EDO. CARABOBO	MP. LOS GUAYOS	PQ. U LOS GUAYOS	ANEXO RURAL 6	3508	7	40	2508	1519	2468	0	21	2	2	924	2508
EDO. CARABOBO	MP. LOS GUAYOS	PQ. U LOS GUAYOS	MATERNAL PANCHITO MANDEFUA	892	2	14	776	590	762	0	3	0	1	168	776
EDO. CARABOBO	MP. LOS GUAYOS	PQ. U LOS GUAYOS	UNIDAD EDUCATIVA JACINTO LARA III	1715	3	35	1263	832	1228	0	6	0	2	388	1263
EDO. CARABOBO	MP. LOS GUAYOS	PQ. U LOS GUAYOS	ESCUELA BASICA JUAN VICENTE GONZALEZ DELGADO	491	1	7	428	382	421	0	1	0	0	38	428
EDO. CARABOBO	MP. LOS GUAYOS	PQ. U LOS GUAYOS	JARDIN DE INFANCIA CABRIALES	3126	6	59	2420	1690	2361	1	9	4	1	656	2420
EDO. CARABOBO	MP. LOS GUAYOS	PQ. U LOS GUAYOS	CENTRO EDUCACION INICIAL LIBERTADOR	638	2	14	467	348	453	0	2	0	0	103	467
EDO. CARABOBO	MP. LOS GUAYOS	PQ. U LOS GUAYOS	LICEO BOLIVARIANO COMUN ANDRES BELLO	1078	2	12	884	535	872	0	3	0	0	334	884
EDO. CARABOBO	MP. LOS GUAYOS	PQ. U LOS GUAYOS	UNIDAD EDUCATIVA ESTADAL SANTISIMA TRINIDAD	4214	8	76	3567	2050	3491	1	20	1	3	1416	3567
EDO. CARABOBO	MP. LOS GUAYOS	PQ. U LOS GUAYOS	ESCUELA BASICA ARTURO USLAR PIETRI	1684	3	20	1374	941	1354	0	4	0	2	407	1374
EDO. CARABOBO	MP. LOS GUAYOS	PQ. U LOS GUAYOS	ESCUELA. BASICA ESTADAL MIGUEL OTERO SILVA	560	1	10	455	350	445	0	2	1	0	92	455
EDO. CARABOBO	MP. LOS GUAYOS	PQ. U LOS GUAYOS	GRUPO ESCOLAR YORACO	6795	12	127	5415	3684	5288	2	35	2	2	1563	5415
EDO. CARABOBO	MP. LOS GUAYOS	PQ. U LOS GUAYOS	JARDIN DE INFANCIA LAS AGUITAS	3806	7	54	3058	2027	3004	1	13	2	2	959	3058
EDO. CARABOBO	MP. LOS GUAYOS	PQ. U LOS GUAYOS	LICEO NACIONAL BOLIVARIANO ANDRES BELLO	3845	7	55	3155	1876	3100	0	18	1	0	1205	3155
EDO. CARABOBO	MP. LOS GUAYOS	PQ. U LOS GUAYOS	LICEO NACIONAL PABLO NERUDA	534	1	8	442	310	434	0	1	0	0	123	442
EDO. CARABOBO	MP. LOS GUAYOS	PQ. U LOS GUAYOS	PRE ESCOLAR BATALLA DE JUNIN	6120	11	106	5082	3275	4976	2	30	4	6	1659	5082
EDO. CARABOBO	MP. LOS GUAYOS	PQ. U LOS GUAYOS	UNIDAD EDUCATIVA VICENTE EMPARAN	1025	2	23	835	575	812	0	5	0	0	232	835
EDO. CARABOBO	MP. LOS GUAYOS	PQ. U LOS GUAYOS	UNIDAD EDUCATIVA ESTADAL MARIA ESCAMILLO	857	2	16	717	525	701	0	2	0	0	174	717
EDO. CARABOBO	MP. LOS GUAYOS	PQ. U LOS GUAYOS	UNIDAD EDUCATIVA ANTONIO JOSE DE SUCRE	3398	6	37	2817	1717	2780	0	17	0	3	1043	2817
EDO. CARABOBO	MP. LOS GUAYOS	PQ. U LOS GUAYOS	UNIDAD EDUCATIVA LICEO BOLIVARIANO LA GLORIETA	775	2	16	607	406	591	0	3	1	0	181	607
EDO. CARABOBO	MP. LOS GUAYOS	PQ. U LOS GUAYOS	ESCUELA DE ESPECIALIDADES FEMENINAS	1060	2	17	851	541	834	0	3	0	1	289	851
EDO. CARABOBO	MP. LOS GUAYOS	PQ. U LOS GUAYOS	UNIDAD EDUCATIVA BOLIVARIANA RURAL LA DIOSA DE LOS TACARIGUAS	732	2	17	556	395	539	0	2	1	0	141	556
EDO. CARABOBO	MP. LOS GUAYOS	PQ. U LOS GUAYOS	MARIA FIDELA CHIRINOS	2139	4	34	1656	937	1622	0	6	1	2	676	1656
EDO. CARABOBO	MP. LOS GUAYOS	PQ. U LOS GUAYOS	ESCUELA BASICA NACIONAL BOLIVARIANA LAS AGUITAS III	3514	7	71	2822	1787	2751	1	14	1	2	946	2822
EDO. CARABOBO	MP. LOS GUAYOS	PQ. U LOS GUAYOS	LICEO BOLIVARIANO TIERRA DE ARAGUACO	927	2	9	763	473	754	0	6	0	0	275	763
EDO. CARABOBO	MP. LOS GUAYOS	PQ. U LOS GUAYOS	ESCUELA BOLIVARIANA NACIONAL LA UNIÓN	611	2	8	506	400	498	0	5	0	0	93	506
EDO. CARABOBO	MP. LOS GUAYOS	PQ. U LOS GUAYOS	PRE ESCOLAR TACARIGUA I	1647	3	15	1314	865	1299	0	6	1	0	427	1314
EDO. CARABOBO	MP. BEJUMA	PQ. CANOABO	ESCUELA TECNICA AGROPECUARIA CARLOS SANDA	559	1	8	445	210	437	1	1	1	2	222	445
EDO. CARABOBO	MP. BEJUMA	PQ. CANOABO	CENTRO DE EDUCACION INICIAL GUINEO	48	1	0	46	37	46	0	1	0	0	8	46
EDO. CARABOBO	MP. BEJUMA	PQ. CANOABO	JARDIN DE INFANCIA BOLIVARIANO PIMENTEL CORONEL	291	1	4	253	136	249	0	1	0	0	112	253
EDO. CARABOBO	MP. BEJUMA	PQ. CANOABO	ESCUELA BOLIVARIANA VALLE HONDO	467	1	7	336	221	329	0	0	1	0	107	336
EDO. CARABOBO	MP. BEJUMA	PQ. CANOABO	ESCUELA BASICA ESTADAL DON VIVIANO VARGAS	656	2	12	485	269	473	0	3	0	2	199	485
EDO. CARABOBO	MP. BEJUMA	PQ. CANOABO	ESCUELA BASICA LA BELEN NUMERO 74	944	2	15	747	531	732	1	4	0	0	196	747
EDO. CARABOBO	MP. BEJUMA	PQ. CANOABO	ESCUELA BASICA PIMENTEL CORONEL	1907	4	21	1520	664	1499	0	0	1	0	834	1520
EDO. CARABOBO	MP. BEJUMA	PQ. CANOABO	UNIDAD EDUCATIVA AGUA CLARA	71	1	2	63	52	61	0	0	0	0	9	63
EDO. CARABOBO	MP. BEJUMA	PQ. CANOABO	UNIDAD EDUCATIVA PALMICHAL NO 80	367	1	2	284	170	282	0	1	2	0	109	284
EDO. CARABOBO	MP. BEJUMA	PQ. SIMON BOLIVAR	UNIDAD EDUCATIVA SIMON RODRIGUEZ	621	2	10	542	299	532	0	1	0	0	232	542
EDO. CARABOBO	MP. BEJUMA	PQ. SIMON BOLIVAR	GRUPO ESCOLAR PARAMACONI	2170	4	36	1798	706	1762	1	4	1	1	1049	1798
EDO. CARABOBO	MP. BEJUMA	PQ. SIMON BOLIVAR	ESCUELA ESTATAL TORCUATO MANZO NUÑEZ	1186	2	12	981	578	969	0	2	0	0	389	981
EDO. CARABOBO	MP. BEJUMA	PQ. SIMON BOLIVAR	ESCUELA SARA DE MORENO	1052	2	7	892	431	885	1	5	0	0	448	892
EDO. CARABOBO	MP. BEJUMA	PQ. SIMON BOLIVAR	UNIDAD EDUCATIVA EDUARDO BLANCO	198	1	3	177	160	174	0	0	0	0	14	177
EDO. CARABOBO	MP. BEJUMA	PQ. SIMON BOLIVAR	UNIDAD EDUCATIVA CARIAPRIMA	611	2	11	460	247	449	0	2	0	0	200	460
EDO. CARABOBO	MP. BEJUMA	PQ. BEJUMA	ESCUELA ESTADAL GRADUADA JULIAN MELLADO	2855	5	35	2249	1115	2214	0	6	0	1	1092	2249
EDO. CARABOBO	MP. BEJUMA	PQ. BEJUMA	ESCUELA BASICA CRESPO GARROTE	2465	5	28	1973	1094	1945	1	9	0	2	839	1973
EDO. CARABOBO	MP. BEJUMA	PQ. BEJUMA	ESCUELA ESTADAL JOSE IGNACIO PULIDO	2278	4	34	1911	659	1877	1	9	0	0	1208	1911
EDO. CARABOBO	MP. BEJUMA	PQ. BEJUMA	NUCLEO ESCOLAR NO 79	34	1	0	14	13	14	0	0	0	0	1	14
EDO. CARABOBO	MP. BEJUMA	PQ. BEJUMA	PRE ESCOLAR EL RINCON	2832	5	22	2374	1619	2352	0	11	1	0	721	2374
EDO. CARABOBO	MP. BEJUMA	PQ. BEJUMA	JARDIN DE INFANCIA LOS GATICOS	1388	3	13	1038	799	1025	0	0	1	1	224	1038
EDO. CARABOBO	MP. BEJUMA	PQ. BEJUMA	UNIDAD EDUCATIVA EL NARANJAL NUCLEO ESCOLAR RURAL Nº 009	155	1	2	81	68	79	0	0	0	0	11	81
EDO. CARABOBO	MP. BEJUMA	PQ. BEJUMA	LICEO NACIONAL ARTURO MICHELENA	3412	6	41	2658	1344	2617	0	9	3	1	1260	2658
EDO. CARABOBO	MP. BEJUMA	PQ. BEJUMA	UNIDAD EDUCATIVA INSTITUTO SAN MARTIN	1496	3	29	1258	580	1229	0	5	0	1	643	1258
EDO. CARABOBO	MP. BEJUMA	PQ. BEJUMA	ESCUELA BASICA  MIGUEL MARIN	4764	9	49	3831	1474	3782	2	15	2	1	2288	3831
EDO. CARABOBO	MP. NAGUANAGUA	PQ. NAGUANAGUA	UNIDAD EDUCATIVA JUAN ESTEBAN RODRIGUEZ DE LAMAS	491	1	10	412	258	402	1	3	0	0	140	412
EDO. CARABOBO	MP. NAGUANAGUA	PQ. NAGUANAGUA	UNIDAD EDUCATIVA NACIONAL MANUEL ANTONIO MALPICA	5283	10	66	4445	1413	4379	2	19	1	2	2942	4445
EDO. CARABOBO	MP. NAGUANAGUA	PQ. NAGUANAGUA	ESCUELA BASICA GUERE	1478	3	20	1294	681	1274	0	2	1	2	588	1294
EDO. CARABOBO	MP. NAGUANAGUA	PQ. NAGUANAGUA	UNIDAD EDUCATIVA PRIVADO COLEGIO PARROQUIAL PADRE SEIJAS	5758	10	40	4973	725	4933	0	13	0	1	4194	4973
EDO. CARABOBO	MP. NAGUANAGUA	PQ. NAGUANAGUA	LICEO MONSEÑOR GREGORIO ADAMS	2664	5	42	2282	840	2240	1	10	1	2	1386	2282
EDO. CARABOBO	MP. NAGUANAGUA	PQ. NAGUANAGUA	HOGARES CREA TARAPIO	1163	2	11	896	471	885	1	3	0	0	410	896
EDO. CARABOBO	MP. NAGUANAGUA	PQ. NAGUANAGUA	ESCUELA BASICA  ESTADAL PROFESOR JESUS BERBIN LOPEZ	2936	6	28	2388	1358	2360	1	9	2	2	988	2388
EDO. CARABOBO	MP. NAGUANAGUA	PQ. NAGUANAGUA	ESCUELA ENRIQUE BARRIOS SANCHEZ	4015	7	54	3395	1151	3341	3	16	1	2	2168	3395
EDO. CARABOBO	MP. NAGUANAGUA	PQ. NAGUANAGUA	LICEO BOLIVARIANO CAYAURIMA	2532	5	46	1934	1214	1888	1	10	2	1	660	1934
EDO. CARABOBO	MP. NAGUANAGUA	PQ. NAGUANAGUA	GRUPO ESCOLAR ATANACIO GIRARDOT	3258	6	56	2628	1123	2572	0	7	1	3	1438	2628
EDO. CARABOBO	MP. NAGUANAGUA	PQ. NAGUANAGUA	ESCUELA BOLIVARIANA MONTALBAN	6267	11	50	5200	1876	5150	1	21	3	5	3244	5200
EDO. CARABOBO	MP. NAGUANAGUA	PQ. NAGUANAGUA	ESCUELA JOSE FELIX SOSA	7941	15	85	6595	2049	6510	0	18	3	4	4436	6595
EDO. CARABOBO	MP. NAGUANAGUA	PQ. NAGUANAGUA	UNIDAD EDUCATIVA NACIONAL NUESTRA SEÑORA DE COROMOTO	3280	6	26	2632	1272	2606	1	14	1	1	1317	2632
EDO. CARABOBO	MP. NAGUANAGUA	PQ. NAGUANAGUA	ESCUELA NACIONAL RAUL LEONI	2170	4	41	1762	1282	1721	0	9	0	0	430	1762
EDO. CARABOBO	MP. NAGUANAGUA	PQ. NAGUANAGUA	UNIDAD EDUCATIVA DOCTOR JOSE MARIA GIL	4350	8	34	3616	908	3582	2	18	0	1	2653	3616
EDO. CARABOBO	MP. NAGUANAGUA	PQ. NAGUANAGUA	UNIDAD EDUCATIVA NACIONAL ABDON CALDERON	4103	8	71	3363	1752	3292	3	8	3	2	1524	3363
EDO. CARABOBO	MP. NAGUANAGUA	PQ. NAGUANAGUA	UNIDAD EDUCATIVA  MARIBEL CABALLERO DE TIRADO	2859	5	23	2433	765	2410	2	11	3	0	1629	2433
EDO. CARABOBO	MP. NAGUANAGUA	PQ. NAGUANAGUA	UNIDAD EDUCATIVA ESTADAL MANUEL CEDEÑO	1077	2	13	923	454	910	1	8	0	1	446	923
EDO. CARABOBO	MP. NAGUANAGUA	PQ. NAGUANAGUA	ESCUELA NACIONAL BARBULA	4231	8	66	3497	1805	3431	1	15	3	0	1607	3497
EDO. CARABOBO	MP. NAGUANAGUA	PQ. NAGUANAGUA	UNIDAD EDUCATIVA LAS MARIAS	189	1	3	155	130	152	0	0	0	0	22	155
EDO. CARABOBO	MP. NAGUANAGUA	PQ. NAGUANAGUA	ESCUELA NACIONAL BATALLA DE BOMBONA	3649	7	41	2961	1504	2920	1	9	1	3	1402	2961
EDO. CARABOBO	MP. NAGUANAGUA	PQ. NAGUANAGUA	ESCUELA DOCTOR LISANDRO LECUNA	5932	11	50	4848	1350	4798	0	16	2	0	3430	4848
EDO. CARABOBO	MP. NAGUANAGUA	PQ. NAGUANAGUA	UNIDAD ESCOLAR SIMON BOLIVAR	7378	14	51	6447	1280	6396	1	13	5	7	5090	6447
EDO. CARABOBO	MP. NAGUANAGUA	PQ. NAGUANAGUA	UNIDAD EDUCATIVA ESTADAL AMBROSIO PLAZA	4090	8	69	3460	1638	3391	2	11	2	1	1737	3460
EDO. CARABOBO	MP. NAGUANAGUA	PQ. NAGUANAGUA	ESCUELA  BOLIVARIANA  BARBULA II	3279	6	53	2573	1278	2520	1	10	1	0	1230	2573
EDO. CARABOBO	MP. NAGUANAGUA	PQ. NAGUANAGUA	ESCUELA MARIA TERESA CORONEL	4856	9	59	3850	1823	3791	3	12	1	2	1950	3850
EDO. CARABOBO	MP. NAGUANAGUA	PQ. NAGUANAGUA	UNIDAD EDUCATIVA CRISPINA MERCADO	3103	6	65	2569	1700	2504	0	13	3	0	788	2569
EDO. CARABOBO	MP. CARLOS ARVELO	PQ. GUIGUE	ESCUELA HERMANO GASPAR	423	1	14	359	210	345	0	4	0	1	130	359
EDO. CARABOBO	MP. CARLOS ARVELO	PQ. GUIGUE	CENTRO DE EDUCACION INICIAL. EL TROMPO	508	1	7	288	218	281	0	0	0	0	63	288
EDO. CARABOBO	MP. CARLOS ARVELO	PQ. GUIGUE	ESCUELA ESTADAL ANTONIO FERNADEZ MOSQUEDA	220	1	4	187	139	183	0	0	0	0	44	187
EDO. CARABOBO	MP. CARLOS ARVELO	PQ. GUIGUE	ESCUELA ESTADAL CONCENTRADA FERNANDO FIGUEREDO	1590	3	47	1209	840	1162	0	9	0	0	313	1209
EDO. CARABOBO	MP. CARLOS ARVELO	PQ. GUIGUE	ESCUELA BASICA YUMA	1755	3	30	1344	970	1314	0	7	2	0	335	1344
EDO. CARABOBO	MP. CARLOS ARVELO	PQ. GUIGUE	UNIDAD EDUCATIVA LUIS BELTRAN PRIETO FIGUEROA	1090	2	15	919	618	904	0	2	0	0	284	919
EDO. CARABOBO	MP. CARLOS ARVELO	PQ. GUIGUE	UNIDAD EDUCATIVA  NACIONAL BOLIVARIANA COPETON	273	1	4	207	157	203	0	0	0	0	46	207
EDO. CARABOBO	MP. CARLOS ARVELO	PQ. GUIGUE	UNIDAD EDUCATIVA NACIONAL CONCENTRADA NACIONAL  COGOLLAL	491	1	6	381	300	375	2	3	1	2	67	381
EDO. CARABOBO	MP. CARLOS ARVELO	PQ. GUIGUE	UNIDAD EDUCATIVA ESTADAL CONCENTRADA LAS VEGAS	417	1	7	352	293	345	0	5	0	0	47	352
EDO. CARABOBO	MP. CARLOS ARVELO	PQ. GUIGUE	ESCUELA EL PIÑAL	715	2	11	591	380	580	0	3	0	1	196	591
EDO. CARABOBO	MP. CARLOS ARVELO	PQ. GUIGUE	UNIDAD EDUCATIVA SANTOS ANGEL DE CUSTODIOS	601	2	6	226	125	220	0	3	0	0	92	226
EDO. CARABOBO	MP. CARLOS ARVELO	PQ. GUIGUE	ESCUELA ESTADAL PATRICIO MARTINEZ	385	1	12	290	210	278	0	1	0	0	67	290
EDO. CARABOBO	MP. CARLOS ARVELO	PQ. GUIGUE	JARDIN DE INFANCIA LINO DE CLEMENTEII	723	2	5	389	269	384	0	1	0	0	114	389
EDO. CARABOBO	MP. CARLOS ARVELO	PQ. GUIGUE	ESCUELA EDAD DE ORO	681	2	10	392	312	382	0	2	0	0	68	392
EDO. CARABOBO	MP. CARLOS ARVELO	PQ. GUIGUE	ESCUELA NACIONAL EL TROMPILLO	1512	3	33	1187	789	1154	1	12	1	0	351	1187
EDO. CARABOBO	MP. CARLOS ARVELO	PQ. GUIGUE	ESCUELA GRADUADA FRANCISCO DE MIRANDA	1258	3	22	962	653	940	1	8	1	0	277	962
EDO. CARABOBO	MP. CARLOS ARVELO	PQ. GUIGUE	GRUPO ESCOLAR LINO CLEMENTE	3286	6	48	2623	1254	2575	0	16	1	2	1302	2623
EDO. CARABOBO	MP. CARLOS ARVELO	PQ. GUIGUE	ESCUELA ESTADAL TEOLINDA ROMERO DE DIAZ	2686	5	57	2154	1497	2097	0	13	3	1	583	2154
EDO. CARABOBO	MP. CARLOS ARVELO	PQ. GUIGUE	UNIDAD EDUCATIVA INICIALL BOLIVARIANA LORO PEDERNALES	344	1	7	187	139	180	0	0	0	0	41	187
EDO. CARABOBO	MP. CARLOS ARVELO	PQ. GUIGUE	ESCUELA BASICA ALTAMIRA	272	1	2	179	136	177	0	2	0	0	39	179
EDO. CARABOBO	MP. CARLOS ARVELO	PQ. GUIGUE	ESCUELA TECNICA AGROPECUARIA MIGUEL BORRAS	500	1	4	289	221	285	0	4	0	0	60	289
EDO. CARABOBO	MP. CARLOS ARVELO	PQ. GUIGUE	UNIDAD EDUCATIVA ESTADAL MONSEÑOR JESUS MARIA PELLIN	2817	5	90	2160	1525	2070	0	11	1	4	529	2160
EDO. CARABOBO	MP. CARLOS ARVELO	PQ. GUIGUE	CENTRO DE EDUCACION INICIAL BOLIVARIANO ESPECIAL 18	974	2	11	703	591	692	0	5	0	1	95	703
EDO. CARABOBO	MP. CARLOS ARVELO	PQ. GUIGUE	UNIDAD EDUCATIVA REQUENA	449	1	4	354	296	350	0	0	0	0	54	354
EDO. CARABOBO	MP. CARLOS ARVELO	PQ. GUIGUE	ESCUELA FRANCISCO ARAMENDI	3326	6	48	2618	1582	2570	2	15	2	2	967	2618
EDO. CARABOBO	MP. CARLOS ARVELO	PQ. GUIGUE	ESCUELA BOLIVARIANA BUENAVENTURA	1005	2	14	839	570	825	1	7	0	0	247	839
EDO. CARABOBO	MP. CARLOS ARVELO	PQ. GUIGUE	CENTRO DE EDUCACION INICIAL NACIONAL BOLIVARIANO TENIENTE PEDRO CAMEJO	4204	8	81	3220	2282	3139	1	19	3	1	833	3220
EDO. CARABOBO	MP. CARLOS ARVELO	PQ. GUIGUE	UNIDAD EDUCATIVA NACIONAL RURAL BOLIVARIANA SAN JUAN DE DIOS	2564	5	36	2068	1585	2032	1	7	1	1	437	2068
EDO. CARABOBO	MP. CARLOS ARVELO	PQ. GUIGUE	UNIDAD EDUCATIVA NACIONAL CONCENTRADA LA ADUANA	1942	4	34	1479	1067	1445	1	11	1	0	365	1479
EDO. CARABOBO	MP. CARLOS ARVELO	PQ. GUIGUE	LICEO CARLOS ARVELO	2795	5	68	2152	1511	2084	1	15	2	1	554	2152
EDO. CARABOBO	MP. CARLOS ARVELO	PQ. GUIGUE	UNIDAD EDUCATIVA ANTONIO RICAURTE	2324	4	38	1908	1164	1870	0	10	0	0	696	1908
EDO. CARABOBO	MP. CARLOS ARVELO	PQ. GUIGUE	ESCUELA CONCENTRADA 5 DE JULIO	2283	4	31	1805	1504	1774	0	15	2	0	253	1805
EDO. CARABOBO	MP. CARLOS ARVELO	PQ. GUIGUE	GRUPO ESCOLAR LANCASTER	3343	6	55	2754	1463	2699	0	25	1	0	1210	2754
EDO. CARABOBO	MP. CARLOS ARVELO	PQ. BELEN	FUNDACION ORFION BELEN	673	2	7	299	224	292	0	0	0	0	68	299
EDO. CARABOBO	MP. CARLOS ARVELO	PQ. BELEN	ESCUELA BASICA MANUARE	2198	4	20	1694	1397	1674	0	6	1	0	270	1694
EDO. CARABOBO	MP. CARLOS ARVELO	PQ. BELEN	UNIDAD EDUCATIVA MODULO RURAL DE BELEN	865	2	7	643	488	636	0	2	0	0	146	643
EDO. CARABOBO	MP. CARLOS ARVELO	PQ. BELEN	ESCUELA BASICA ESTADAL MANUARITO	263	1	0	196	191	196	0	0	0	0	5	196
EDO. CARABOBO	MP. CARLOS ARVELO	PQ. BELEN	ESCUELA ESTADAL GRADUADA CARABOBO	3461	6	58	2657	1521	2599	1	15	4	2	1056	2657
EDO. CARABOBO	MP. CARLOS ARVELO	PQ. BELEN	ESCUELA UNITARIA NO 155	271	1	5	203	180	198	0	2	1	0	15	203
EDO. CARABOBO	MP. CARLOS ARVELO	PQ. BELEN	UNIDAD EDUCATIVA NACIONAL MARIPA	382	1	6	300	234	294	0	1	0	0	59	300
EDO. CARABOBO	MP. CARLOS ARVELO	PQ. BELEN	ESCUELA BASICA ESTADAL CONCENTRADA SANTA ROSA DEL SUR	169	1	0	102	93	102	0	0	0	0	9	102
EDO. CARABOBO	MP. CARLOS ARVELO	PQ. BELEN	JARDIN DE INFANCIA NACIONAL DE BELEN	824	2	13	597	409	584	0	1	0	0	174	597
EDO. CARABOBO	MP. CARLOS ARVELO	PQ. BELEN	UNIDAD EDUCATIVA NACIONAL BOLIVARIANA VALLECITO	1178	2	7	881	800	874	0	2	0	0	72	881
EDO. CARABOBO	MP. CARLOS ARVELO	PQ. TACARIGUA	UNIDAD EDUCATIVA LAGO DE LOS TACARIGUAS	1230	3	19	1008	756	989	0	3	0	0	230	1008
EDO. CARABOBO	MP. CARLOS ARVELO	PQ. TACARIGUA	ESCUELA ESTADAL UNITARIA NUMERO 205	385	1	15	271	209	256	1	2	0	0	44	271
EDO. CARABOBO	MP. CARLOS ARVELO	PQ. TACARIGUA	UNIDAD EDUCATIVA VIRGEN MISIONERA ANEXO	875	2	8	285	196	277	0	3	0	0	78	285
EDO. CARABOBO	MP. CARLOS ARVELO	PQ. TACARIGUA	ESCUELA NACIONAL CONCENTRADA JAVILLAL	703	2	8	533	459	525	2	0	1	0	63	533
EDO. CARABOBO	MP. CARLOS ARVELO	PQ. TACARIGUA	ESCUELA CHAGUARAMOS II	1233	3	20	996	865	976	0	9	0	0	102	996
EDO. CARABOBO	MP. CARLOS ARVELO	PQ. TACARIGUA	ESCUELA BASICA NACIONAL LOS GARCIAS	1365	3	25	1077	833	1052	1	5	3	0	210	1077
EDO. CARABOBO	MP. CARLOS ARVELO	PQ. TACARIGUA	UNIDAD EDUCATIVA   MARIA VIRGEN MISIONERA	1920	4	37	1601	889	1564	0	10	0	1	664	1601
EDO. CARABOBO	MP. CARLOS ARVELO	PQ. TACARIGUA	UNIDAD EDUCATIVA ESTADAL  FELIPE CECILIO TOVAR	1801	4	18	1435	1061	1417	0	6	3	0	347	1435
EDO. CARABOBO	MP. CARLOS ARVELO	PQ. TACARIGUA	UNIDAD EDUCATIVA ANTONIO MINGUET LETTERON	1202	3	14	1004	677	990	0	10	2	0	301	1004
EDO. CARABOBO	MP. CARLOS ARVELO	PQ. TACARIGUA	CASA DE LA CULTURA LA VERDE CLARITA	585	1	12	300	217	288	0	3	0	0	68	300
EDO. CARABOBO	MP. CARLOS ARVELO	PQ. TACARIGUA	ESCUELA GRADUADA MANUEL GODOY	2696	5	48	2231	1386	2183	1	20	1	3	772	2231
EDO. CARABOBO	MP. CARLOS ARVELO	PQ. TACARIGUA	CENTRO DE EDUCACION INICIAL CACIQUE MARA	542	1	4	432	348	428	0	3	0	0	77	432
EDO. CARABOBO	MP. CARLOS ARVELO	PQ. TACARIGUA	ANEXO EL LAGO DE LOS TACARIGUA	262	1	5	183	128	178	0	0	0	0	50	183
EDO. CARABOBO	MP. CARLOS ARVELO	PQ. TACARIGUA	ESCUELA NACIONAL ALFREDO PIETRI	3692	7	64	2819	1955	2755	0	12	3	1	784	2819
EDO. CARABOBO	MP. CARLOS ARVELO	PQ. TACARIGUA	ESCUELA BASICA ISABEL TEREZA LEON GASIA	565	1	6	425	317	419	1	1	0	0	100	425
EDO. CARABOBO	MP. CARLOS ARVELO	PQ. TACARIGUA	ESCUELA BASICA PARIATA	1522	3	18	1253	929	1235	1	5	1	0	299	1253
EDO. CARABOBO	MP. CARLOS ARVELO	PQ. TACARIGUA	UNIDAD EDUCATIVA ESTADAL MIGUEL GONZALEZ Y PEREZ	1595	3	42	1188	814	1146	0	10	0	0	322	1188
EDO. CARABOBO	MP. CARLOS ARVELO	PQ. TACARIGUA	ESCUELA ESTADAL BOYER	753	2	16	599	489	583	0	1	1	0	92	599
EDO. CARABOBO	MP. CARLOS ARVELO	PQ. TACARIGUA	UNIDAD EDUCATIVA NACIONAL CONCENTRADA LAS TINAJAS	1600	3	39	1281	943	1242	1	7	1	4	286	1281
EDO. CARABOBO	MP. CARLOS ARVELO	PQ. TACARIGUA	CENTRO DE EDUCACION INICIAL FERNANDEZ SUARES	344	1	8	216	158	208	0	1	0	0	49	216
EDO. CARABOBO	MP. CARLOS ARVELO	PQ. TACARIGUA	CENTRO DE EDUCACION INICIAL  LOS ILUSTRE	987	2	13	753	620	740	0	4	0	0	116	753
EDO. CARABOBO	MP. CARLOS ARVELO	PQ. TACARIGUA	UNIDAD EDUCATIVA ESTADAL GHERMINA BARRAGAN	2760	5	51	2169	1536	2118	0	6	1	2	573	2169
EDO. CARABOBO	MP. CARLOS ARVELO	PQ. TACARIGUA	UNIDAD  EDUCATIVA NACIONAL  FRANCISCO JOSE CISNEROS	3396	6	80	2702	1464	2622	0	25	1	1	1131	2702
EDO. CARABOBO	MP. CARLOS ARVELO	PQ. TACARIGUA	ESCUELA NACIONAL ARTURO MICHELENA	3927	7	56	3051	2154	2995	4	18	1	0	818	3051
EDO. CARABOBO	MP. CARLOS ARVELO	PQ. TACARIGUA	ESCUELA ESTADAL GLORIA BERBECIA	324	1	5	262	193	257	1	1	0	0	62	262
EDO. CARABOBO	MP. CARLOS ARVELO	PQ. TACARIGUA	ESCUELA NACIONAL TOMAS FARRIAR	3169	6	52	2497	1857	2445	0	9	5	1	573	2497
EDO. CARABOBO	MP. CARLOS ARVELO	PQ. TACARIGUA	ESCUELA BASICA 325 EL NARANJITO	427	1	5	314	258	309	1	0	0	0	50	314
EDO. CARABOBO	MP. CARLOS ARVELO	PQ. TACARIGUA	CENTRO DE EDUCACION INICIAL CANA DULCE	483	1	5	332	230	327	0	1	0	2	94	332
EDO. CARABOBO	MP. LIBERTADOR	PQ. U INDEPENDENCIA	ESCUELA BASICA SABANITA NUCLEO ESCOLAR RURAL 148	301	1	8	255	224	247	0	1	2	0	20	255
EDO. CARABOBO	MP. LIBERTADOR	PQ. U INDEPENDENCIA	CENTRO DE EDUCACION INTEGRAL BOLIVARIANO SIMONCITO CAMPO DE CARABOBO	846	2	18	640	520	622	0	1	0	0	101	640
EDO. CARABOBO	MP. LIBERTADOR	PQ. U INDEPENDENCIA	UNIDAD EDUCATIVA LA CORTADORA NUCLEO ESCOLAR RURAL 148	437	1	6	355	306	349	2	1	2	0	38	355
EDO. CARABOBO	MP. LIBERTADOR	PQ. U INDEPENDENCIA	UNIDAD EDUCATIVA ESTADAL PADRE ALBERTO PANCIERA	1096	2	26	935	721	909	1	6	2	2	177	935
EDO. CARABOBO	MP. LIBERTADOR	PQ. U INDEPENDENCIA	UNIDAD EDUCATIVA ESTADAL JUANA GOMEZ	4264	8	62	3389	1857	3327	1	16	3	1	1449	3389
EDO. CARABOBO	MP. LIBERTADOR	PQ. U INDEPENDENCIA	UNIDAD EDUCATIVA JUAN RAMON GONZALEZ BAQUERO	3167	6	42	2635	1735	2593	2	13	1	4	838	2635
EDO. CARABOBO	MP. LIBERTADOR	PQ. U INDEPENDENCIA	UNIDAD EDUCATIVA AGUA LINDA	255	1	8	225	204	217	0	2	0	0	11	225
EDO. CARABOBO	MP. LIBERTADOR	PQ. U INDEPENDENCIA	ESCUELA BASICA NACIONAL BOLIVARIANA ALGARROBAL	882	2	13	704	555	691	1	1	1	0	133	704
EDO. CARABOBO	MP. LIBERTADOR	PQ. U INDEPENDENCIA	ESCUELA 24 DE JUNIO	2321	4	40	1841	1245	1801	0	11	1	0	544	1841
EDO. CARABOBO	MP. LIBERTADOR	PQ. U INDEPENDENCIA	ESCUELA RURAL BOLIVARIANA PIRA PIRA	1289	3	17	954	752	937	0	8	4	1	172	954
EDO. CARABOBO	MP. LIBERTADOR	PQ. U INDEPENDENCIA	ESCUELA BASICA BOLIVARIANA PUEBLO NUEVO	282	1	0	236	195	236	0	1	0	0	40	236
EDO. CARABOBO	MP. LIBERTADOR	PQ. U INDEPENDENCIA	CENTRO DE EDUCACION INICIAL ARCO DE CARABOBO	743	2	2	629	481	627	0	8	0	0	138	629
EDO. CARABOBO	MP. LIBERTADOR	PQ. U INDEPENDENCIA	UNIDAD EDUCATIVA NACIONAL BARRERITA	1324	3	18	1092	882	1074	2	4	3	0	183	1092
EDO. CARABOBO	MP. LIBERTADOR	PQ. U INDEPENDENCIA	UNIDAD EDUCATIVA EDUARDO ASSEF RAIDI	1772	4	16	1410	1111	1394	1	4	2	0	276	1410
EDO. CARABOBO	MP. LIBERTADOR	PQ. U INDEPENDENCIA	UNIDAD EDUCATIVA DIOS CON NOSOTROS	1024	2	12	760	581	748	0	4	1	0	162	760
EDO. CARABOBO	MP. LIBERTADOR	PQ. U INDEPENDENCIA	ESCUELA CAMPO DE CARABOBO	4325	8	69	3247	2330	3178	0	12	1	1	834	3247
EDO. CARABOBO	MP. LIBERTADOR	PQ. U INDEPENDENCIA	CENTRO DE EDUCACION INICIAL NACIONAL BARRERA	1262	3	13	1037	749	1024	0	6	4	1	264	1037
EDO. CARABOBO	MP. LIBERTADOR	PQ. U TOCUYITO	ESCUELA BASICA JOSE FRANCISCO FARIAS	779	2	11	626	462	615	0	5	0	1	147	626
EDO. CARABOBO	MP. LIBERTADOR	PQ. U TOCUYITO	UNIDAD EDUCATIVA PRIVADO MARISCAL AYACUCHO	2300	4	18	1980	363	1962	1	7	0	1	1590	1980
EDO. CARABOBO	MP. LIBERTADOR	PQ. U TOCUYITO	UNIDAD EDUCATIVA MUNICIPAL EL VIGIA	741	2	4	562	440	558	1	3	0	0	114	562
EDO. CARABOBO	MP. LIBERTADOR	PQ. U TOCUYITO	ESCUELA BASICA MARIA  DE NAZARETH	823	2	12	653	561	641	1	2	0	1	76	653
EDO. CARABOBO	MP. LIBERTADOR	PQ. U TOCUYITO	UNIDAD EDUCATIVA NACIONAL BATALLA DE CARABOBO	3198	6	48	2514	1461	2466	2	11	1	3	988	2514
EDO. CARABOBO	MP. LIBERTADOR	PQ. U TOCUYITO	UNIDAD EDUCATIVA FATIMA 1	1118	2	14	765	595	751	2	4	1	0	149	765
EDO. CARABOBO	MP. LIBERTADOR	PQ. U TOCUYITO	ESCUELA JUAN ESCALONA	6286	11	112	4900	3356	4788	4	19	4	2	1403	4900
EDO. CARABOBO	MP. LIBERTADOR	PQ. U TOCUYITO	UNIDAD EDUCATIVA NACIONAL SEBASTIAN ECHEVERIA LOZANO	6788	13	89	5257	2620	5168	0	24	4	2	2518	5257
EDO. CARABOBO	MP. LIBERTADOR	PQ. U TOCUYITO	ESCUELA BASICA ESTADAL BENIGNA REYES	2985	6	40	2323	1574	2283	0	5	1	0	703	2323
EDO. CARABOBO	MP. LIBERTADOR	PQ. U TOCUYITO	ESCUELA BASICA ESTADAL PEDRO BRICEÑO MENDEZ	5527	10	70	4191	2821	4121	5	23	1	6	1265	4191
EDO. CARABOBO	MP. LIBERTADOR	PQ. U TOCUYITO	ESCUELA BASICA ESTADAL JOSEFINA R MARTINEZ	2851	5	30	2260	1550	2230	2	8	2	3	665	2260
EDO. CARABOBO	MP. LIBERTADOR	PQ. U TOCUYITO	UNIDAD EDUCATIVA  ANEXO LA HONDA	1104	2	16	747	581	731	0	3	2	0	145	747
EDO. CARABOBO	MP. LIBERTADOR	PQ. U TOCUYITO	ESCUELA BASICA ESTADAL PROFESORA OFELIA MATUTE	3541	7	37	2974	1349	2937	0	14	2	0	1572	2974
EDO. CARABOBO	MP. LIBERTADOR	PQ. U TOCUYITO	ESCUELA BASICA NACIONAL PRESBITERO CRISPIN PEREZ	1518	3	21	1170	575	1149	1	8	1	0	564	1170
EDO. CARABOBO	MP. LIBERTADOR	PQ. U TOCUYITO	CARCEL DE TOCUYITO	703	2	5	190	138	185	0	1	2	0	44	190
EDO. CARABOBO	MP. LIBERTADOR	PQ. U TOCUYITO	UNIDAD EDUCATIVA CRISPIN PEREZ (ANEXO)	3015	6	59	2143	1379	2084	0	8	0	1	696	2143
EDO. CARABOBO	MP. LIBERTADOR	PQ. U TOCUYITO	UNIDAD EDUCATIVA EL LIBERTADOR	2551	5	40	2076	1401	2036	1	16	0	0	618	2076
EDO. CARABOBO	MP. LIBERTADOR	PQ. U TOCUYITO	ESCUELA BASICA ESTADAL CLEOPATRA CASANOVA	5867	11	99	4616	3125	4517	0	19	2	2	1369	4616
EDO. CARABOBO	MP. LIBERTADOR	PQ. U TOCUYITO	UNIDAD EDUCATIVA PRIVADO LA TRINIDAD	1724	3	21	1435	640	1414	0	2	1	0	771	1435
EDO. CARABOBO	MP. LIBERTADOR	PQ. U TOCUYITO	UNIDAD EDUCATIVA ESTADAL FUNDACION 5 DE JULIO	1686	3	31	1298	932	1267	1	1	1	0	332	1298
EDO. CARABOBO	MP. LIBERTADOR	PQ. U TOCUYITO	CENTRO DE EDUCACION INICIAL JIPIJAPA	1149	2	15	781	596	766	1	2	0	1	166	781
EDO. CARABOBO	MP. LIBERTADOR	PQ. U TOCUYITO	CENTRO DE EDUCACION INICIAL EL JUNCAL	1139	2	14	887	695	873	2	6	1	1	168	887
EDO. CARABOBO	MP. LIBERTADOR	PQ. U TOCUYITO	UNIDAD EDUCATIVA LOS CARDONES	1531	3	21	1263	760	1242	2	5	0	0	475	1263
EDO. CARABOBO	MP. LIBERTADOR	PQ. U TOCUYITO	UNIDAD EDUCATIVA ESTADAL ISABEL TERESA DE BELLERA	3008	6	53	2454	1125	2401	0	11	2	4	1259	2454
EDO. CARABOBO	MP. LIBERTADOR	PQ. U TOCUYITO	UNIDAD EDUCATIVA NACIONAL LA INDIA	1052	2	6	862	661	856	1	6	0	1	187	862
EDO. CARABOBO	MP. LIBERTADOR	PQ. U TOCUYITO	ESCUELA EFRAIN PEREZ PEREZ	1126	2	13	874	682	861	0	2	2	0	175	874
EDO. CARABOBO	MP. LIBERTADOR	PQ. U TOCUYITO	UNIDAD EDUCATIVA LA YAGUARA	2689	5	54	2128	1525	2074	0	11	1	0	537	2128
EDO. CARABOBO	MP. LIBERTADOR	PQ. U TOCUYITO	ESCUELA EULALIO TOLEDO TOVAR	1791	3	35	1431	1176	1396	2	5	0	0	213	1431
EDO. CARABOBO	MP. LIBERTADOR	PQ. U TOCUYITO	UNIDAD EDUCATIVA COLEGIO PIO TAMAYO	2178	4	30	1740	1000	1710	0	8	0	1	701	1740
EDO. CARABOBO	MP. LIBERTADOR	PQ. U TOCUYITO	ESCUELA NACIONAL SAN JOSE LOS CHORRITOS	7358	13	108	5682	3248	5574	5	32	4	5	2280	5682
EDO. CARABOBO	MP. LIBERTADOR	PQ. U TOCUYITO	CENTRO DE EDUCACION INICIAL NACIONAL CRISPIN PEREZ	4764	9	67	3687	1870	3620	1	15	2	1	1731	3687
EDO. CARABOBO	MP. MIRANDA	PQ. MIRANDA	UNIDAD EDUCATIVA ESTADAL BOLIVARIANA ANTONIA PEREZ DE FEATHERTON	747	2	7	616	325	609	0	0	0	0	284	616
EDO. CARABOBO	MP. MIRANDA	PQ. MIRANDA	ESCUELA UNITARIA NACIONAL S N	162	1	2	49	42	47	0	1	0	0	4	49
EDO. CARABOBO	MP. MIRANDA	PQ. MIRANDA	CENTRO DE EDUCACION INICIAL SIMONCITO	921	2	14	786	586	772	0	1	1	1	183	786
EDO. CARABOBO	MP. MIRANDA	PQ. MIRANDA	ESCUELA BASICA ESTADAL SABANETA SUR	444	1	7	353	221	346	0	0	0	0	125	353
EDO. CARABOBO	MP. MIRANDA	PQ. MIRANDA	CENTRO EDUCATIVO INICIAL LAS NARANJITAS	2223	4	44	1773	1082	1729	0	8	1	1	637	1773
EDO. CARABOBO	MP. MIRANDA	PQ. MIRANDA	UNIDAD EDUCATIVA BOLIVARIANA EL CEMENTERIO	2150	4	17	1702	1276	1685	1	7	2	1	398	1702
EDO. CARABOBO	MP. MIRANDA	PQ. MIRANDA	CENTRO DE EDUCACION INICIAL BOLIVARIANO CONCENTRADA 77	688	2	4	576	403	572	0	1	0	0	168	576
EDO. CARABOBO	MP. MIRANDA	PQ. MIRANDA	ESCUELA DANIEL MENDOZA	3381	6	47	2676	1534	2629	0	7	1	1	1086	2676
EDO. CARABOBO	MP. MIRANDA	PQ. MIRANDA	CENTRO EDUCATIVO INICIAL FRANCISCO DE MIRANDA	1143	2	15	917	662	902	0	5	0	0	235	917
EDO. CARABOBO	MP. MIRANDA	PQ. MIRANDA	CENTRO EDUCACION INICIAL BOLIVARIANO SIMONCITO MIRANDITA	345	1	1	236	181	235	0	2	0	0	52	236
EDO. CARABOBO	MP. MIRANDA	PQ. MIRANDA	ESCUELA SANTO TOMAS	1666	3	24	1249	896	1225	1	7	0	0	321	1249
EDO. CARABOBO	MP. MIRANDA	PQ. MIRANDA	ESCUELA BASICA BOLIVARIANA DOCTOR SIMON AROCHA PINTO	5008	9	90	4083	2472	3993	0	25	0	1	1495	4083
EDO. CARABOBO	MP. MIRANDA	PQ. MIRANDA	ESCUELA BOLIVARIANA GRACIELA DE MEJIAS	238	1	0	172	149	172	0	0	0	0	23	172
EDO. CARABOBO	MP. SAN JOAQUIN	PQ. SAN JOAQUIN	ESCUELA 5 DE JULIO	1292	3	22	959	699	937	0	9	1	0	228	959
EDO. CARABOBO	MP. SAN JOAQUIN	PQ. SAN JOAQUIN	ESCUELA PRIMARIA BOLIVARIANA LA PRADERA	4919	9	48	4400	1439	4352	0	18	3	8	2884	4400
EDO. CARABOBO	MP. SAN JOAQUIN	PQ. SAN JOAQUIN	ESCUELA CECILIO ACOSTA	4242	8	63	3480	2401	3417	1	14	3	3	995	3480
EDO. CARABOBO	MP. SAN JOAQUIN	PQ. SAN JOAQUIN	CASA COMUNAL	1012	2	24	858	650	834	0	5	0	0	179	858
EDO. CARABOBO	MP. SAN JOAQUIN	PQ. SAN JOAQUIN	UNIDAD EDUCATIVA MONSEÑOR MONTES DE OCA	1416	3	31	1115	811	1084	1	7	2	0	263	1115
EDO. CARABOBO	MP. SAN JOAQUIN	PQ. SAN JOAQUIN	ESCUELA GRADUADA PEDRO GUAL	3274	6	40	2615	1445	2575	2	11	2	2	1113	2615
EDO. CARABOBO	MP. SAN JOAQUIN	PQ. SAN JOAQUIN	ESCUELA RECEPTORIA	1783	4	30	1464	823	1434	2	6	1	2	600	1464
EDO. CARABOBO	MP. SAN JOAQUIN	PQ. SAN JOAQUIN	ESCUELA BASICA FE Y ALEGRIA SIMON RODRIGUEZ	1178	2	25	971	644	946	0	4	0	0	298	971
EDO. CARABOBO	MP. SAN JOAQUIN	PQ. SAN JOAQUIN	ESCUELA ESTADAL ALEJO ZULOAGA	1035	2	13	807	672	794	0	4	0	0	118	807
EDO. CARABOBO	MP. SAN JOAQUIN	PQ. SAN JOAQUIN	ESCUELA ESTADAL NO 16 HACIENDA CURA	418	1	8	343	217	335	0	1	0	1	116	343
EDO. CARABOBO	MP. SAN JOAQUIN	PQ. SAN JOAQUIN	ESCUELA BASICA NACIONAL CONCENTRADA BOLIVARIANA LA ESTACION	1644	3	26	1384	732	1358	0	5	0	1	620	1384
EDO. CARABOBO	MP. SAN JOAQUIN	PQ. SAN JOAQUIN	GRUPO ESCOLAR DR RAFAEL PEREZ	3356	6	50	2787	1192	2737	0	15	1	1	1528	2787
EDO. CARABOBO	MP. SAN JOAQUIN	PQ. SAN JOAQUIN	ESCUELA BOLIVARIANA ROMERO GARCIA	2399	5	36	1964	888	1928	0	7	1	0	1032	1964
EDO. CARABOBO	MP. SAN JOAQUIN	PQ. SAN JOAQUIN	ESCUELA GRADUADA ANTONIO JOSE DE SUCRE	4417	8	69	3565	2558	3496	1	21	2	2	912	3565
EDO. CARABOBO	MP. SAN JOAQUIN	PQ. SAN JOAQUIN	LICEO ALFREDO PIETRI	2061	4	30	1572	910	1542	2	7	1	2	620	1572
EDO. CARABOBO	MP. SAN JOAQUIN	PQ. SAN JOAQUIN	UNIDAD EDUCATIVA MONSEÑOR JACINTO SOTO LAYA	1278	3	21	1067	903	1046	0	6	1	0	136	1067
EDO. CARABOBO	MP. SAN JOAQUIN	PQ. SAN JOAQUIN	LICEO JOSE FELIX RIVAS	2572	5	37	2280	1029	2243	0	11	0	1	1202	2280
EDO. CARABOBO	MP. DIEGO IBARRA	PQ. AGUAS CALIENTES	UNIDAD EDUCATIVA AMADA MARTINEZ PARRA	1632	3	37	1372	1083	1335	1	7	0	1	243	1372
EDO. CARABOBO	MP. DIEGO IBARRA	PQ. AGUAS CALIENTES	ESCUELA JORGELINA GARAY SANCHEZ	5361	10	80	4296	3152	4216	2	30	6	1	1025	4296
EDO. CARABOBO	MP. DIEGO IBARRA	PQ. AGUAS CALIENTES	181 ANIVERSARIO BATALLA DE CARABOBO	2073	4	45	1758	1349	1713	1	8	1	0	354	1758
EDO. CARABOBO	MP. DIEGO IBARRA	PQ. AGUAS CALIENTES	ESCUELA BASICA LA GUARICHA	1990	4	49	1644	1334	1595	0	11	0	1	249	1644
EDO. CARABOBO	MP. DIEGO IBARRA	PQ. AGUAS CALIENTES	CENTRO DE EDUCACION INTEGRAL VISTA ALEGRE	1777	3	32	1358	1064	1326	0	6	0	1	255	1358
EDO. CARABOBO	MP. DIEGO IBARRA	PQ. AGUAS CALIENTES	CENTRO DE EDUCACION INICIAL NACIONA ABDON CALDARON	519	1	5	411	325	406	0	6	0	1	74	411
EDO. CARABOBO	MP. DIEGO IBARRA	PQ. AGUAS CALIENTES	NUCLEO ESCOLAR RURAL 262 TEQUENDAMA	512	1	19	454	325	435	0	2	1	0	107	454
EDO. CARABOBO	MP. DIEGO IBARRA	PQ. AGUAS CALIENTES	ESCUELA BASICA NUCLEO ESCOLAR RURAL 262, PUNTA PALMITA	490	1	8	405	308	397	0	1	0	0	88	405
EDO. CARABOBO	MP. DIEGO IBARRA	PQ. AGUAS CALIENTES	ESCUELA BASICA ESTADAL MONSEÑOR GREGORIO ADAM	3703	7	68	2950	2083	2882	1	9	5	2	782	2950
EDO. CARABOBO	MP. DIEGO IBARRA	PQ. AGUAS CALIENTES	ESCUELA BASICA BOLIVARIANA. PADRE DEHON	981	2	16	814	625	798	0	3	0	0	170	814
EDO. CARABOBO	MP. DIEGO IBARRA	PQ. AGUAS CALIENTES	CENTRO DE EDUCACION INICIAL BOLIVARIANO EL BOSQUE	761	2	14	622	537	608	0	4	0	0	67	622
EDO. CARABOBO	MP. DIEGO IBARRA	PQ. AGUAS CALIENTES	ESCUELA RAMON DIAZ SANCHEZ	4507	8	65	3705	2709	3640	1	19	2	1	908	3705
EDO. CARABOBO	MP. DIEGO IBARRA	PQ. AGUAS CALIENTES	ESCUELA BASICA ESTADAL ANTONIO GUTIERREZ PEREZ	2903	5	67	2168	1636	2101	0	16	0	2	447	2168
EDO. CARABOBO	MP. DIEGO IBARRA	PQ. AGUAS CALIENTES	CENTRO DE EDUCACION INICIAL LA CABRERA	864	2	24	693	547	669	0	4	0	0	118	693
EDO. CARABOBO	MP. DIEGO IBARRA	PQ. AGUAS CALIENTES	CENTRO DE EDUCACION INICIAL SIMONCITO EL DELEITE	807	2	10	692	565	682	0	3	0	0	114	692
EDO. CARABOBO	MP. DIEGO IBARRA	PQ. AGUAS CALIENTES	ESCUELA BASICA MARISCAL SUCRE	2141	4	33	1838	1386	1805	0	7	1	0	411	1838
EDO. CARABOBO	MP. DIEGO IBARRA	PQ. AGUAS CALIENTES	UNIDAD EDUCATIVA NACIONAL 28 DE OCTUBRE	598	1	14	457	372	443	0	2	0	0	69	457
EDO. CARABOBO	MP. DIEGO IBARRA	PQ. AGUAS CALIENTES	UNIDAD EDUCATIVA EL DELEITE	1590	3	24	1359	1116	1335	1	9	1	1	207	1359
EDO. CARABOBO	MP. DIEGO IBARRA	PQ. AGUAS CALIENTES	CENNTRO DE EDUCACION INICIAL DOCTOR JOSE MARIA VARGAR	687	2	14	579	486	565	1	1	1	0	76	579
EDO. CARABOBO	MP. DIEGO IBARRA	PQ. MARIARA	LICEO ANIBAL PARADISI	3509	6	50	2850	1772	2800	0	18	4	1	1005	2850
EDO. CARABOBO	MP. DIEGO IBARRA	PQ. MARIARA	ALDEA UNIVERSITARIA MARIARHA	874	2	22	730	539	708	0	3	1	1	164	730
EDO. CARABOBO	MP. DIEGO IBARRA	PQ. MARIARA	ESCUELA NACIONAL EL DIVIDIVE	5219	10	96	4095	2633	3999	2	22	5	3	1334	4095
EDO. CARABOBO	MP. DIEGO IBARRA	PQ. MARIARA	ESCUELA BASICA DOCTOR RAUL LEONI	2133	4	33	1866	1386	1833	0	3	3	0	441	1866
EDO. CARABOBO	MP. DIEGO IBARRA	PQ. MARIARA	CENTRO DE CAPACITACION MARIARA	2926	5	50	2341	1369	2291	0	8	0	2	912	2341
EDO. CARABOBO	MP. DIEGO IBARRA	PQ. MARIARA	UNIDAD EDUCATIVA NUESTRA SEÑORA DEL CAMINO	4524	8	68	3564	1775	3496	1	25	3	2	1690	3564
EDO. CARABOBO	MP. DIEGO IBARRA	PQ. MARIARA	CENTRO EDUCACION INICIAL LAS BRISAS	1071	2	14	879	772	865	0	3	2	1	87	879
EDO. CARABOBO	MP. DIEGO IBARRA	PQ. MARIARA	ESCUELA BOLIVARIANA GUAMACHO	2061	4	39	1697	1313	1658	0	7	1	0	337	1697
EDO. CARABOBO	MP. DIEGO IBARRA	PQ. MARIARA	ESCUELA DE MEDICINA	1407	3	32	1185	739	1153	0	4	1	1	408	1185
EDO. CARABOBO	MP. DIEGO IBARRA	PQ. MARIARA	ESCUELA BASICA MARIA CLEMENCIA CAMARAN	2220	4	39	1898	1440	1859	1	4	1	0	413	1898
EDO. CARABOBO	MP. DIEGO IBARRA	PQ. MARIARA	ESCUELA NACIONAL MARIARA	4783	9	78	3909	2439	3831	0	19	0	2	1371	3909
EDO. CARABOBO	MP. DIEGO IBARRA	PQ. MARIARA	INSTITUTO MUNICIPAL DE LA CULTURA DIEGO IBARRA, MARIARA	1524	3	32	1258	784	1226	0	7	2	0	433	1258
EDO. CARABOBO	MP. DIEGO IBARRA	PQ. MARIARA	ESCUELA BASICA ESTADAL ALEJANDRO DE HUMBOLDT	521	1	7	435	327	428	0	2	1	0	98	435
EDO. CARABOBO	CE. VALENCIA	PQ. SANTA ROSA	ESCUELA GONZALEZ GUINAND	2505	5	26	2026	733	2000	1	8	1	2	1255	2026
EDO. CARABOBO	CE. VALENCIA	PQ. SANTA ROSA	ESCUELA BASICA ESTADAL MONSEÑOR BELLERA AROCHA	3173	6	44	2558	1353	2514	2	18	1	2	1138	2558
EDO. CARABOBO	CE. VALENCIA	PQ. SANTA ROSA	ESCUELA CARMEN NORTE	1648	3	29	1333	628	1304	0	3	1	2	670	1333
EDO. CARABOBO	CE. VALENCIA	PQ. SANTA ROSA	ESCUELA ESTADAL ANTONIO RANGEL	2159	4	35	1786	1028	1751	2	16	0	4	701	1786
EDO. CARABOBO	CE. VALENCIA	PQ. SANTA ROSA	ESCUELA ANTONIO JOSE DE SUCRE	3527	6	91	2830	1867	2739	0	10	2	2	858	2830
EDO. CARABOBO	CE. VALENCIA	PQ. SANTA ROSA	CENTRO INTEGRAL SIMONCITO	1301	3	20	1072	719	1052	1	3	2	0	327	1072
EDO. CARABOBO	CE. VALENCIA	PQ. SANTA ROSA	CICLO BASICO RAFAEL GUERRA MENDEZ	3278	6	74	2408	1030	2334	1	13	0	1	1289	2408
EDO. CARABOBO	CE. VALENCIA	PQ. SANTA ROSA	ESCUELA FELIX MANUEL LUCES	3647	7	82	2789	1799	2707	0	28	0	1	879	2789
EDO. CARABOBO	CE. VALENCIA	PQ. SANTA ROSA	ESCUELA RAFAEL SATURNO GUERRA	4611	9	85	3748	2360	3663	2	22	3	4	1272	3748
EDO. CARABOBO	CE. VALENCIA	PQ. SANTA ROSA	ESCUELA FE Y ALEGRIA	4637	9	84	3662	2077	3578	0	24	0	2	1475	3662
EDO. CARABOBO	CE. VALENCIA	PQ. SANTA ROSA	UNIDAD EDUCATIVA PRIVADO ARTESANAL LA SALLE	1529	3	30	1305	484	1275	2	8	0	1	780	1305
EDO. CARABOBO	CE. VALENCIA	PQ. SANTA ROSA	ESCUELA ANTONIO JOSE DE SUCRE SUR	3627	7	70	2815	1770	2745	1	23	3	1	947	2815
EDO. CARABOBO	CE. VALENCIA	PQ. SANTA ROSA	ESCUELA TECNICA COMERCIAL FERMIN TORO	1814	4	29	1274	565	1245	0	13	0	2	665	1274
EDO. CARABOBO	CE. VALENCIA	PQ. SANTA ROSA	UNIDAD EDUCATIVA ESPECIAL AUDIOFONOLOGIA CARABOBO	1330	3	16	987	605	971	0	4	1	1	360	987
EDO. CARABOBO	CE. VALENCIA	PQ. SANTA ROSA	ESCUELA BASICA FRANCISCO JOSE CISNEROS	288	1	6	245	143	239	0	1	0	0	95	245
EDO. CARABOBO	CE. VALENCIA	PQ. SANTA ROSA	UNIDAD EDUCATIVA NACIONAL MANUEL RODRIGUEZ VASQUEZ	3725	7	43	2773	1623	2730	2	12	3	2	1088	2773
EDO. CARABOBO	CE. VALENCIA	PQ. SANTA ROSA	UNIDAD EDUCATIVA LUIS BELTRAN DIAZ	745	2	25	601	394	576	0	4	0	0	178	601
EDO. CARABOBO	CE. VALENCIA	PQ. SANTA ROSA	COLEGIO NACIONAL DEL PERIODISTA	3745	7	67	2909	1721	2842	2	16	0	3	1100	2909
EDO. CARABOBO	CE. VALENCIA	PQ. SANTA ROSA	GRUPO ESCOLAR BEJUMA	4312	8	59	3428	2074	3369	1	24	1	3	1266	3428
EDO. CARABOBO	CE. VALENCIA	PQ. SANTA ROSA	UNIDAD EDUCATIVA LA UNIDAD	950	2	11	693	460	682	0	6	0	0	216	693
EDO. CARABOBO	CE. VALENCIA	PQ. CATEDRAL	GRUPO ESCOLAR RAFAEL ARVELO	4206	8	45	3119	1275	3074	1	17	4	1	1776	3119
EDO. CARABOBO	CE. VALENCIA	PQ. NEGRO PRIMERO	ESCUELA BASICA ESTADAL SANTA MARIA	141	1	0	126	126	126	0	0	0	0	0	126
EDO. CARABOBO	CE. VALENCIA	PQ. NEGRO PRIMERO	ESCUELA BASICA LUIS MARIANO CASTRO	120	1	0	99	98	99	0	0	0	0	1	99
EDO. CARABOBO	CE. VALENCIA	PQ. NEGRO PRIMERO	ESCUELA BASICA ESTADAL MANIROTE.	215	1	2	182	177	180	0	0	0	0	3	182
EDO. CARABOBO	CE. VALENCIA	PQ. NEGRO PRIMERO	ESCUELA BASICA ESTADAL LAS TUNAS	330	1	4	201	162	197	2	1	0	0	32	201
EDO. CARABOBO	CE. VALENCIA	PQ. NEGRO PRIMERO	ESCUELA BASICA ESTADAL LAS PALMAS.	158	1	0	99	95	99	0	2	0	0	2	99
EDO. CARABOBO	CE. VALENCIA	PQ. NEGRO PRIMERO	ESCUELA BASICA ESTADAL LAGUNITA.	341	1	6	288	253	282	0	1	0	0	28	288
EDO. CARABOBO	CE. VALENCIA	PQ. NEGRO PRIMERO	ESCUELA BASICA ESTADAL EL ALGARROBO.	145	1	3	115	99	112	0	1	0	0	12	115
EDO. CARABOBO	CE. VALENCIA	PQ. NEGRO PRIMERO	ESCUELA BASICA ESTADAL ALFARO.	160	1	2	119	90	117	0	2	0	0	25	119
EDO. CARABOBO	CE. VALENCIA	PQ. NEGRO PRIMERO	ESCUELA BASICA ESTADAL EL JENGIBRE.	187	1	1	162	150	161	0	1	1	0	9	162
EDO. CARABOBO	CE. VALENCIA	PQ. NEGRO PRIMERO	ESCUELA BASICA EL BARRIAL	415	1	6	283	255	277	1	3	0	0	18	283
EDO. CARABOBO	CE. VALENCIA	PQ. NEGRO PRIMERO	ESCUELA BASICA COGOLLAL	217	1	0	157	152	157	0	1	0	0	4	157
EDO. CARABOBO	CE. VALENCIA	PQ. NEGRO PRIMERO	ESCUELA BASICA ESTADAL LOS CARACAROS.	159	1	6	127	98	121	0	1	1	0	21	127
EDO. CARABOBO	CE. VALENCIA	PQ. NEGRO PRIMERO	ESCUELA BASICA ESTADAL  AGUA HONDA	345	1	7	247	174	240	0	3	0	0	63	247
EDO. CARABOBO	CE. VALENCIA	PQ. NEGRO PRIMERO	ESCUELA BASICA ESTADAL LUIS MARIA SUCRE	1369	3	18	965	739	947	0	6	4	1	197	965
EDO. CARABOBO	CE. VALENCIA	PQ. NEGRO PRIMERO	ESCUELA BASICA EL CUMBOTO	417	1	3	252	233	249	0	1	0	0	15	252
EDO. CARABOBO	CE. VALENCIA	PQ. NEGRO PRIMERO	ESCUELA BASICA NACIONAL BOLIVARIANA LOS MANGOS	512	1	7	356	305	349	0	3	1	0	40	356
EDO. CARABOBO	CE. VALENCIA	PQ. NEGRO PRIMERO	ESCUELA UNITARIA LAS DOS BOCAS	864	2	21	579	472	558	2	2	3	1	78	579
EDO. CARABOBO	CE. VALENCIA	PQ. SAN BLAS	GRUPO ESCOLAR JESUS GRANADOS CASARES	2675	5	24	2186	474	2162	0	3	0	0	1685	2186
EDO. CARABOBO	CE. VALENCIA	PQ. SAN BLAS	GRUPO ESCOLAR FERMIN TORO	5380	10	65	4198	1755	4133	0	16	1	1	2360	4198
EDO. CARABOBO	CE. VALENCIA	PQ. SAN BLAS	UNIDAD EDUCATIVA MUNICIPAL SANTA ANA	1026	2	8	791	353	783	1	5	1	0	423	791
EDO. CARABOBO	CE. VALENCIA	PQ. SAN BLAS	GRUPO ESCOLAR PADRE ALEXANDER	2010	4	25	1584	581	1559	0	4	0	1	973	1584
EDO. CARABOBO	CE. VALENCIA	PQ. SAN BLAS	LICEO BOLIVARIANO NACIONAL MARTIN JOSE SANABRIA	2780	5	22	2052	670	2030	2	6	0	1	1351	2052
EDO. CARABOBO	CE. VALENCIA	PQ. SAN BLAS	UNIDAD EDUCATIVA PEDRO GUZMAN GAGO	655	2	9	604	292	595	0	4	1	0	298	604
EDO. CARABOBO	CE. VALENCIA	PQ. SAN BLAS	GRUPO ESCOLAR EDUARDO VISO	4309	8	47	3369	983	3322	2	17	0	0	2320	3369
EDO. CARABOBO	CE. VALENCIA	PQ. SAN BLAS	ESCUELA BASICA ESTADAL MARIA GORETTI	1373	3	29	1153	430	1124	0	7	1	0	686	1153
EDO. CARABOBO	CE. VALENCIA	PQ. SAN BLAS	ESCUELA CONCENTRADA 94 118	1066	2	17	800	378	783	0	2	0	2	401	800
EDO. CARABOBO	CE. VALENCIA	PQ. EL SOCORRO	COLEGIO DON BOSCO	5197	10	64	3968	1240	3904	1	20	2	2	2639	3968
EDO. CARABOBO	CE. VALENCIA	PQ. SAN JOSE	COLEGIO JUAN XXIII	7844	14	32	6231	410	6199	0	9	1	6	5773	6231
EDO. CARABOBO	CE. VALENCIA	PQ. SAN JOSE	ESCUELA BASICA NACIONAL ANTONIO HERRERA TORO	2012	4	16	1554	259	1538	0	1	0	0	1278	1554
EDO. CARABOBO	CE. VALENCIA	PQ. SAN JOSE	UNIDAD EDUCATIVA NACIONAL CIRILO ALBERTO	4112	8	15	3305	280	3290	0	7	0	2	3001	3305
EDO. CARABOBO	CE. VALENCIA	PQ. SAN JOSE	INSTITUTO MARIA MONTESSORI	3618	7	24	2885	496	2861	3	2	0	2	2358	2885
EDO. CARABOBO	CE. VALENCIA	PQ. SAN JOSE	GRUPO ESCOLAR PEDRO CASTILLO	6828	12	39	5276	587	5237	0	11	1	5	4633	5276
EDO. CARABOBO	CE. VALENCIA	PQ. SAN JOSE	INSTITUTO NACIONAL DE CAPACITACION Y EDUCACION SOCIALISTA (INCES)	4788	9	37	3804	920	3767	0	13	2	5	2827	3804
EDO. CARABOBO	CE. VALENCIA	PQ. SAN JOSE	UNIDAD EDUCATIVA INSTITUTO SAN VALENTIN	826	2	4	745	69	741	0	1	0	0	671	745
EDO. CARABOBO	CE. VALENCIA	PQ. SAN JOSE	UNIDAD EDUCATIVA CARABOBO	4919	9	29	4463	505	4434	1	7	0	1	3920	4463
EDO. CARABOBO	CE. VALENCIA	PQ. SAN JOSE	PRE ESCOLAR JULIO CASTRO.	3111	6	18	2603	342	2585	1	11	0	1	2230	2603
EDO. CARABOBO	CE. VALENCIA	PQ. SAN JOSE	COLEGIO LA SALLE	3749	7	18	3148	169	3130	0	5	1	3	2952	3148
EDO. CARABOBO	CE. VALENCIA	PQ. SAN JOSE	UNIVERSIDAD ALEJANDRO HUMBOLDT	4520	8	13	3396	214	3383	0	5	0	1	3163	3396
EDO. CARABOBO	CE. VALENCIA	PQ. SAN JOSE	UNIDAD EDUCATIVA INSTITUTO EXPERIMENTAL SIMON BOLIVAR (APUCITO)	2307	4	11	2153	227	2142	0	3	1	0	1911	2153
EDO. CARABOBO	CE. VALENCIA	PQ. SAN JOSE	LICEO MANUEL FELIPE TOVAR	6737	12	24	5362	440	5338	1	3	2	3	4889	5362
EDO. CARABOBO	CE. VALENCIA	PQ. SAN JOSE	UNIDAD ESCOLAR ALFREDO COLOMINE	3856	7	22	3420	412	3398	1	8	1	3	2973	3420
EDO. CARABOBO	CE. VALENCIA	PQ. SAN JOSE	COLEGIO NUESTRA SEÑORA DEL LOURDES	4583	8	26	3521	481	3495	0	10	1	1	3002	3521
EDO. CARABOBO	CE. VALENCIA	PQ. SAN JOSE	ESCUELA MINERVA	3108	6	29	2538	314	2509	2	6	0	0	2187	2538
EDO. CARABOBO	CE. VALENCIA	PQ. SAN JOSE	UNIDAD EDUCATIVA COLEGIO INTERNACIONAL DE CARABOBO	1600	3	10	1447	108	1437	0	1	2	2	1324	1447
EDO. CARABOBO	CE. VALENCIA	PQ. SAN JOSE	UNIDAD EDUCATIVA COLEGIO LA ESPERANZA	3212	6	7	2671	284	2664	1	4	0	1	2374	2671
EDO. CARABOBO	CE. VALENCIA	PQ. SAN JOSE	UNIDAD EDUCATIVA PRIVADO SAGRADO CORAZON	8301	15	64	6682	909	6618	0	16	2	1	5690	6682
EDO. CARABOBO	CE. VALENCIA	PQ. SAN JOSE	COLEGIO CALASANZ	4608	8	27	3691	464	3664	0	7	0	1	3192	3691
EDO. CARABOBO	CE. VALENCIA	PQ. SAN JOSE	COLEGIO SAN GABRIEL ARCANGEL	5710	11	26	4687	301	4661	0	5	0	2	4353	4687
EDO. CARABOBO	CE. VALENCIA	PQ. SAN JOSE	ESCUELA LISANDRO RAMIREZ	9198	17	64	7523	721	7459	0	14	2	5	6717	7523
EDO. CARABOBO	CE. VALENCIA	PQ. SAN JOSE	LICEO CICLO DIVERSIFICADO PEDRO GUAL	6816	13	77	5486	1338	5409	0	20	3	3	4045	5486
EDO. CARABOBO	CE. VALENCIA	PQ. CANDELARIA	GRUPO ESCOLAR EUTIMIO RIVAS	4803	9	57	3894	1697	3837	0	19	1	7	2113	3894
EDO. CARABOBO	CE. VALENCIA	PQ. CANDELARIA	ESCUELA BASICA BRIGIDA HURTADO DE MENDIRI	641	2	6	512	326	506	0	2	0	0	178	512
EDO. CARABOBO	CE. VALENCIA	PQ. CANDELARIA	UNIDAD EDUCATIVA MONSEÑOR VICTOR  BELLERA	2344	4	13	1703	594	1690	0	9	0	5	1082	1703
EDO. CARABOBO	CE. VALENCIA	PQ. CANDELARIA	GRUPO ESCOLAR JUAN ANTONIO MICHELENA	6488	12	100	5149	2677	5049	4	22	0	3	2343	5149
EDO. CARABOBO	CE. VALENCIA	PQ. CANDELARIA	GRUPO ESCOLAR REPUBLICA DEL PERU	6262	12	95	4975	1860	4880	1	27	7	2	2983	4975
EDO. CARABOBO	CE. VALENCIA	PQ. CANDELARIA	ESCUELA BASICA NACIONAL FERNANDO PEÑALVER	2042	4	22	1491	653	1469	1	13	0	1	801	1491
EDO. CARABOBO	CE. VALENCIA	PQ. CANDELARIA	GRUPO ESCOLAR JOSE GREGORIO PONCE BELLO	3065	6	35	2406	1682	2371	2	11	0	0	676	2406
EDO. CARABOBO	CE. VALENCIA	PQ. MIGUEL PE#A	UNIDAD EDUCATIVA ARTURO MICHELENA	196	1	2	150	101	148	0	0	0	0	47	150
EDO. CARABOBO	CE. VALENCIA	PQ. MIGUEL PE#A	CEIM EZEQUIEL ZAMORA	1512	3	21	1207	844	1186	0	7	1	0	334	1207
EDO. CARABOBO	CE. VALENCIA	PQ. MIGUEL PE#A	PRE ESCOLAR FEDERACION	852	2	12	745	542	733	0	4	0	1	186	745
EDO. CARABOBO	CE. VALENCIA	PQ. MIGUEL PE#A	ESCUELA FE Y ALEGRIA DOCTOR LEOPOLDO YA EZ	6494	12	115	5339	1997	5224	3	39	1	3	3181	5339
EDO. CARABOBO	CE. VALENCIA	PQ. MIGUEL PE#A	ESCUELA BASICA MONSEÑOR AROCHA	240	1	4	191	94	187	1	0	0	0	92	191
EDO. CARABOBO	CE. VALENCIA	PQ. MIGUEL PE#A	UNIDAD EDUCATIVA SIERVO DE DIOS	751	2	16	613	418	597	0	3	0	0	176	613
EDO. CARABOBO	CE. VALENCIA	PQ. MIGUEL PE#A	LICEO ALEJO ZULOAGA	6716	12	74	5301	2595	5227	2	34	1	2	2593	5301
EDO. CARABOBO	CE. VALENCIA	PQ. MIGUEL PE#A	REPUBLICA ARABE SAHARAMI DEMOCRATICA	2814	5	59	2166	1105	2107	0	12	3	0	987	2166
EDO. CARABOBO	CE. VALENCIA	PQ. MIGUEL PE#A	ESCUELA BASICA ESTADAL MONSEÑOR LUIS EDUARDO HENRIQUEZ	2751	5	45	2259	1297	2214	0	19	2	0	896	2259
EDO. CARABOBO	CE. VALENCIA	PQ. MIGUEL PE#A	COLEGIO RAMON IGNACIO MENDEZ (UNIDAD EDUCATIVA ANEXO BELLA VISTA)	1705	3	18	1261	927	1243	1	4	0	0	311	1261
EDO. CARABOBO	CE. VALENCIA	PQ. MIGUEL PE#A	LICEO PONCE BELLO	5530	10	77	4268	2607	4191	3	26	1	7	1547	4268
EDO. CARABOBO	CE. VALENCIA	PQ. MIGUEL PE#A	ESCUELA BASICA JOSE FELIX RIBAS	1006	2	3	770	554	767	0	5	0	0	208	770
EDO. CARABOBO	CE. VALENCIA	PQ. MIGUEL PE#A	FUNDACION VALENCIA 1	638	2	6	518	317	512	0	4	0	0	191	518
EDO. CARABOBO	CE. VALENCIA	PQ. MIGUEL PE#A	CENTRO DE INTREGACION MATERNAL LOMAS DE FUNVAL  PRE  ESCOLAR	1562	3	26	1290	752	1264	0	7	0	0	505	1290
EDO. CARABOBO	CE. VALENCIA	PQ. MIGUEL PE#A	GRUPO ESCOLAR NACIONAL SIMON RODRIGUEZ	5466	10	88	4310	1907	4222	1	19	0	1	2294	4310
EDO. CARABOBO	CE. VALENCIA	PQ. MIGUEL PE#A	ESCUELA RUIZ PINEDA	4950	9	53	3870	2428	3817	5	27	2	1	1354	3870
EDO. CARABOBO	CE. VALENCIA	PQ. MIGUEL PE#A	CENTRO DE EDUCACION INICIAL DON ROMULO GALLEGOS	1327	3	14	1089	737	1075	1	4	0	0	333	1089
EDO. CARABOBO	CE. VALENCIA	PQ. MIGUEL PE#A	GRUPO ESCOLAR PADRE BERGERETTI	4552	8	66	3446	2026	3380	1	20	1	2	1330	3446
EDO. CARABOBO	CE. VALENCIA	PQ. MIGUEL PE#A	ESCUELA BASICA IRMA VIVAS DE MARIN	1349	3	17	1025	789	1008	0	2	0	0	217	1025
EDO. CARABOBO	CE. VALENCIA	PQ. MIGUEL PE#A	CENTRO DE DESARROLLO COMUNAL EL CONCEJO	570	1	10	501	357	491	0	1	1	0	132	501
EDO. CARABOBO	CE. VALENCIA	PQ. MIGUEL PE#A	UNIDAD ESCOLAR DOCTOR ENRIQUE TEJERA	4558	8	54	3570	2546	3516	2	26	1	5	936	3570
EDO. CARABOBO	CE. VALENCIA	PQ. MIGUEL PE#A	ESCUELA BASICA EL SOCORRO	3863	7	79	2983	2001	2904	1	16	1	2	883	2983
EDO. CARABOBO	CE. VALENCIA	PQ. MIGUEL PE#A	ESCUELA BASICA ESTADAL DR. FRANCISCO ESPEJO	7579	14	128	5753	3545	5625	2	36	5	4	2033	5753
EDO. CARABOBO	CE. VALENCIA	PQ. MIGUEL PE#A	ESCUELA NACIONAL MANUEL ALCAZAR	5458	10	59	4279	2501	4220	1	20	0	2	1696	4279
EDO. CARABOBO	CE. VALENCIA	PQ. MIGUEL PE#A	ESCUELA BASICA BICENTENARIO III	930	2	15	730	519	715	0	6	0	0	190	730
EDO. CARABOBO	CE. VALENCIA	PQ. MIGUEL PE#A	JARDIN DE INFANCIA VENEZUELA	1389	3	27	1141	761	1114	0	10	4	0	339	1141
EDO. CARABOBO	CE. VALENCIA	PQ. MIGUEL PE#A	UNIDAD EDUCATIVA DOMINGO SAVIO	4606	8	63	3601	2193	3538	4	19	3	2	1317	3601
EDO. CARABOBO	CE. VALENCIA	PQ. MIGUEL PE#A	UNIDAD EDUCATIVA FUNDACIÓN VALENCIA II	3403	6	48	2622	1896	2574	1	29	1	0	647	2622
EDO. CARABOBO	CE. VALENCIA	PQ. MIGUEL PE#A	ESCUELA NACIONAL CONCENTRADA ANTONIO RICAURTE	5952	11	98	4521	3147	4423	0	35	2	0	1239	4521
EDO. CARABOBO	CE. VALENCIA	PQ. MIGUEL PE#A	JARDIN DE INFANCIA GUSTAVO H MACHADO	119	1	1	109	47	108	0	1	0	0	60	109
EDO. CARABOBO	CE. VALENCIA	PQ. MIGUEL PE#A	ESCUELA BASICA ESTADAL TRAPICHITO I	315	1	5	193	145	188	0	0	0	0	43	193
EDO. CARABOBO	CE. VALENCIA	PQ. MIGUEL PE#A	UNIDAD ESCOLAR NEGRO PRIMERO	5073	9	97	3895	2720	3798	2	28	2	0	1046	3895
EDO. CARABOBO	CE. VALENCIA	PQ. MIGUEL PE#A	CENTRO PRE ESCOLAR SIMON BOLIVAR	1940	4	38	1654	874	1616	0	9	3	2	728	1654
EDO. CARABOBO	CE. VALENCIA	PQ. MIGUEL PE#A	ESCUELA ESTADAL JOSE ANTONIO PAEZ	6148	11	104	4661	2687	4557	0	32	5	2	1831	4661
EDO. CARABOBO	CE. VALENCIA	PQ. MIGUEL PE#A	ESCUELA BOLIVARIANA ISABEL FERNANDEZ DE ICHAZU	3181	6	48	2510	1209	2462	1	13	1	2	1236	2510
EDO. CARABOBO	CE. VALENCIA	PQ. MIGUEL PE#A	ESCUELA NACIONAL EL PRADO	3190	6	52	2497	1335	2445	2	19	2	4	1083	2497
EDO. CARABOBO	CE. VALENCIA	PQ. MIGUEL PE#A	UNIDAD ESCOLAR LUIS BELTRAN PIETRO FIGUEROA	403	1	18	360	265	342	0	1	1	2	73	360
EDO. CARABOBO	CE. VALENCIA	PQ. MIGUEL PE#A	UNIDAD EDUCATIVA ROSALIA CAMPINS DE HERRERA	560	1	9	481	343	472	0	2	1	0	126	481
EDO. CARABOBO	CE. VALENCIA	PQ. MIGUEL PE#A	ESCUELA TRIBU DE JUDAS      (ANEXO ESCUELA BASICA LOMAS DE FUNVAL)	1026	2	24	822	553	798	0	2	1	1	241	822
EDO. CARABOBO	CE. VALENCIA	PQ. MIGUEL PE#A	UNIDAD EDUCACION INTEGRAL LOMAS DE FUNVAL	4143	8	56	3391	2049	3335	3	34	1	1	1247	3391
EDO. CARABOBO	CE. VALENCIA	PQ. MIGUEL PE#A	EULALIA BUROS	672	2	11	529	329	518	0	1	0	0	188	529
EDO. CARABOBO	CE. VALENCIA	PQ. MIGUEL PE#A	PAULA BERBECIA	504	1	8	362	279	354	1	6	0	1	67	362
EDO. CARABOBO	CE. VALENCIA	PQ. MIGUEL PE#A	ESCUELA BASICA ESTADAL GENERAL DIEGO IBARRA TRAPICHITO	506	1	7	383	275	376	0	5	0	1	95	383
EDO. CARABOBO	CE. VALENCIA	PQ. MIGUEL PE#A	ESCUELA BASICA BOLIVARIANA JOSE RAFAEL POCATERRA	3649	7	41	2967	1105	2926	0	11	1	1	1808	2967
EDO. CARABOBO	CE. VALENCIA	PQ. MIGUEL PE#A	ESCUELA 19 DE ABRIL	3548	7	61	2837	1418	2776	1	15	3	3	1336	2837
EDO. CARABOBO	CE. VALENCIA	PQ. MIGUEL PE#A	ANEXO DOCTOR RAFAEL GUERRA MENDEZ	3010	6	41	2219	1425	2178	1	13	1	0	738	2219
EDO. CARABOBO	CE. VALENCIA	PQ. MIGUEL PE#A	UNIDAD EDUCATIVA ITIEL	1251	3	14	1094	643	1080	0	8	0	0	429	1094
EDO. CARABOBO	CE. VALENCIA	PQ. MIGUEL PE#A	ESCUELA BASICA ESTADAL BELLA VISTA II	3841	7	46	2878	1881	2832	1	18	2	4	926	2878
EDO. CARABOBO	CE. VALENCIA	PQ. MIGUEL PE#A	ESCUELA BASICA ESTADAL JOSE REGINO PEÑA	10665	19	216	7957	5116	7741	3	52	4	3	2563	7957
EDO. CARABOBO	CE. VALENCIA	PQ. MIGUEL PE#A	UNIDAD ESCOLAR SANTA MARIA DE CALATRAVA	2424	5	24	2085	778	2061	1	13	0	4	1265	2085
EDO. CARABOBO	CE. VALENCIA	PQ. MIGUEL PE#A	ANEXO DE RUIZ PINEDA 1	5069	9	66	3937	2458	3871	1	18	3	2	1389	3937
EDO. CARABOBO	CE. VALENCIA	PQ. MIGUEL PE#A	COLEGIO LUISA CACERES DE ARISMENDI	4117	8	40	3353	1022	3313	0	16	3	3	2269	3353
EDO. CARABOBO	CE. VALENCIA	PQ. MIGUEL PE#A	ESCUELA BASICA BOLIVARIANA LA PAZ	2247	4	26	1863	1438	1837	0	11	2	1	385	1863
EDO. CARABOBO	CE. VALENCIA	PQ. MIGUEL PE#A	UNIDAD EDUCATIVA CORINA ROMER DE SALAS	1405	3	21	1089	789	1068	2	10	0	0	267	1089
EDO. CARABOBO	CE. VALENCIA	PQ. MIGUEL PE#A	ESCUELA BASICA EL MILAGRO DE DIOS	2563	5	66	1996	1567	1930	0	4	1	2	356	1996
EDO. CARABOBO	CE. VALENCIA	PQ. MIGUEL PE#A	CENTRO PRE ESCOLAR CONSTRUCCION FORD	741	2	12	586	414	574	0	2	0	0	158	586
EDO. CARABOBO	CE. VALENCIA	PQ. MIGUEL PE#A	UNIDAD EDUCATIVA COLEGIO LUZ DE CARABOBO	204	1	2	176	69	174	0	0	0	1	104	176
EDO. CARABOBO	CE. VALENCIA	PQ. MIGUEL PE#A	PREESCOLAR CARABOBO	235	1	3	179	135	176	1	1	1	0	38	179
EDO. CARABOBO	CE. VALENCIA	PQ. MIGUEL PE#A	UNIDAD EDUCATIVA FELIPE NERY PULIDO	1896	4	11	1486	489	1475	1	5	0	1	979	1486
EDO. CARABOBO	CE. VALENCIA	PQ. MIGUEL PE#A	UNIDAD EDUCATIVA EL MILAGROS DE DIOS 1	1389	3	21	1061	795	1040	0	7	0	1	237	1061
EDO. CARABOBO	CE. VALENCIA	PQ. MIGUEL PE#A	UNIDAD EDUCATIVA CREACION LIBERTADOR I	580	1	14	474	330	460	0	2	1	0	127	474
EDO. CARABOBO	CE. VALENCIA	PQ. MIGUEL PE#A	ESCUELA BASICA LOMAS DE FUNVAL	3190	6	42	2606	1624	2564	2	19	2	3	914	2606
EDO. CARABOBO	CE. VALENCIA	PQ. MIGUEL PE#A	JARDIN DE INFANCIA BOLIVARIANO SAN AGUSTIN	560	1	4	469	347	465	0	3	0	0	115	469
EDO. CARABOBO	CE. VALENCIA	PQ. MIGUEL PE#A	PREESCOLAR RICARDO URRIERA	4648	9	76	3781	2310	3705	3	27	1	3	1361	3781
EDO. CARABOBO	CE. VALENCIA	PQ. MIGUEL PE#A	SANTA TERESITA DE ASIS  ( FE Y ALEGRIA)	1653	3	21	1276	742	1255	0	3	2	0	508	1276
EDO. CARABOBO	CE. VALENCIA	PQ. MIGUEL PE#A	ESCUELA NACIONAL ISIDRO RAMIREZ	4640	9	62	3552	2349	3490	3	25	2	1	1110	3552
EDO. CARABOBO	CE. VALENCIA	PQ. MIGUEL PE#A	UNIDAD EDUCATIVA RAFAEL RANGEL	1502	3	37	1158	764	1121	0	5	0	0	352	1158
EDO. CARABOBO	CE. VALENCIA	PQ. MIGUEL PE#A	ESCUELA BASICA ESTADAL RAUL VILLARROEL	7095	13	147	5452	3522	5305	4	28	4	1	1746	5452
EDO. CARABOBO	CE. VALENCIA	PQ. MIGUEL PE#A	ESCUELA BASICA SOROCAIMA	1091	2	16	849	616	833	0	7	1	0	209	849
EDO. CARABOBO	CE. VALENCIA	PQ. MIGUEL PE#A	CENTRO DE EDUCACION INICIAL NACIONAL MONUMENTAL PRE ESCOLAR ALICIA FERRER	3874	7	51	3051	1833	3000	2	28	1	0	1136	3051
EDO. CARABOBO	CE. VALENCIA	PQ. MIGUEL PE#A	ESCUELA RICARDO URRIERA	2145	4	26	1783	1082	1757	0	6	0	1	668	1783
EDO. CARABOBO	CE. VALENCIA	PQ. MIGUEL PE#A	PRE ESCOLAR BOLIVARIANO EL CONCEJO	1425	3	24	1118	606	1094	0	7	0	2	479	1118
EDO. CARABOBO	CE. VALENCIA	PQ. MIGUEL PE#A	UNIDAD EDUCATIVA OBRA SOCIAL SAN JOSE DE CALAZANS	1160	2	27	952	652	925	0	5	0	0	268	952
EDO. CARABOBO	CE. VALENCIA	PQ. MIGUEL PE#A	UNIDAD EDUCATIVA OLIARI	988	2	11	752	457	741	0	3	1	0	280	752
EDO. CARABOBO	CE. VALENCIA	PQ. MIGUEL PE#A	ESCUELA BASICA RUIZ PINEDA II	4204	8	78	3345	2050	3267	0	15	2	2	1198	3345
EDO. CARABOBO	CE. VALENCIA	PQ. MIGUEL PE#A	ESCUELA BASICA ALFREDO PIETRI	2272	4	31	1738	1020	1707	1	11	0	2	673	1738
EDO. CARABOBO	CE. VALENCIA	PQ. MIGUEL PE#A	UNIDAD EDUCATIVA ROLANDO CARRILLO	1739	3	42	1420	981	1378	2	7	1	2	385	1420
EDO. CARABOBO	CE. VALENCIA	PQ. MIGUEL PE#A	UNIDAD EDUCATIVA MANUEL VICENTE ROMERO GARCIA	431	1	4	342	208	338	0	1	0	1	128	342
EDO. CARABOBO	CE. VALENCIA	PQ. MIGUEL PE#A	PRE ESCOLAR LOMAS DE FUNVAL	1063	2	22	827	518	805	0	6	0	0	281	827
EDO. CARABOBO	CE. VALENCIA	PQ. MIGUEL PE#A	LICEO BOLIVARIANO ERNESTO CHE GUEVARA	6021	11	85	4624	3218	4539	2	30	4	3	1282	4624
EDO. CARABOBO	CE. VALENCIA	PQ. MIGUEL PE#A	UNIDAD ESCOLAR CARIBAY	1216	3	21	1012	634	991	0	7	0	3	347	1012
EDO. CARABOBO	CE. VALENCIA	PQ. MIGUEL PE#A	UNIDAD EDUCATIVA DOCTOR GERMAN SUAREZ FLAMERICH	1131	2	17	869	624	852	0	6	1	1	220	869
EDO. CARABOBO	CE. VALENCIA	PQ. MIGUEL PE#A	ESCUELA BOLIVARIANA RAMON DIAZ SANCHEZ	2303	4	39	1868	932	1829	0	12	0	3	882	1868
EDO. CARABOBO	CE. VALENCIA	PQ. MIGUEL PE#A	UNIDAD DOCTOR ARISTIDES CALVANIS	479	1	1	376	323	375	0	2	0	0	50	376
EDO. CARABOBO	CE. VALENCIA	PQ. MIGUEL PE#A	ESCUELA BASICA MIGUEL ARTURO GONZALEZ  GRANADILLO	4197	8	49	3269	2122	3220	0	12	3	3	1080	3269
EDO. CARABOBO	CE. VALENCIA	PQ. RAFAEL URDANETA	UNIDAD EDUCATIVA GENERAL JOSE ANTONIO PAEZ	1407	3	28	1095	610	1067	1	5	3	1	447	1095
EDO. CARABOBO	CE. VALENCIA	PQ. RAFAEL URDANETA	ESCUELA BASICA BARRIO LA TRINIDAD	5037	9	57	4207	1417	4150	2	17	2	1	2711	4207
EDO. CARABOBO	CE. VALENCIA	PQ. RAFAEL URDANETA	ESCUELA ESTADAL HUMBERTO CELLI	2477	5	43	2085	1417	2042	0	7	0	0	618	2085
EDO. CARABOBO	CE. VALENCIA	PQ. RAFAEL URDANETA	GRUPO ESCOLAR GUACARA	4877	9	54	3894	2503	3840	1	21	3	2	1310	3894
EDO. CARABOBO	CE. VALENCIA	PQ. RAFAEL URDANETA	ESCUELA BASICA SANTA INES	5629	10	69	4646	2694	4577	1	38	3	2	1839	4646
EDO. CARABOBO	CE. VALENCIA	PQ. RAFAEL URDANETA	ESCUELA BASICA OLIMPIA BARRIOS	1547	3	26	1303	900	1277	1	11	0	0	365	1303
EDO. CARABOBO	CE. VALENCIA	PQ. RAFAEL URDANETA	ESCUELA BASICA LAS PALMITAS	6538	12	94	5211	3924	5117	2	29	2	1	1159	5211
EDO. CARABOBO	CE. VALENCIA	PQ. RAFAEL URDANETA	UNIDAD EDUCATIVA NACIONAL BOLIVARIANA  MERCEDES SANTANA	3122	6	22	2594	921	2572	0	12	2	1	1636	2594
EDO. CARABOBO	CE. VALENCIA	PQ. RAFAEL URDANETA	UNIDAD EDUCATIVA GRAN PODER DE DIOS	5016	9	61	4113	1645	4052	0	13	1	3	2390	4113
EDO. CARABOBO	CE. VALENCIA	PQ. RAFAEL URDANETA	UNIDAD EDUCATIVA TEOTISTE DE GALLEGOS	5505	10	60	4379	2899	4319	0	26	1	0	1393	4379
EDO. CARABOBO	CE. VALENCIA	PQ. RAFAEL URDANETA	JARDIN DE INFANCIA MANUELITA SAENZ	1954	4	32	1614	1091	1582	0	7	1	0	483	1614
EDO. CARABOBO	CE. VALENCIA	PQ. RAFAEL URDANETA	ESCUELA BASICA NACIONAL GENERAL RAFAEL URDANETA	4834	9	52	4010	1276	3958	0	26	3	2	2651	4010
EDO. CARABOBO	CE. VALENCIA	PQ. RAFAEL URDANETA	INCE LA ISABELICA	3899	7	44	3033	1178	2989	4	10	0	1	1796	3033
EDO. CARABOBO	CE. VALENCIA	PQ. RAFAEL URDANETA	INSTITUTO  DE EDUCACION ESPECIAL FLOR AMARILLO	1141	2	20	937	601	917	0	7	3	0	306	937
EDO. CARABOBO	CE. VALENCIA	PQ. RAFAEL URDANETA	ESCUELA JUAN JOSE RONDON	3501	7	89	2866	1315	2777	0	18	1	2	1441	2866
EDO. CARABOBO	CE. VALENCIA	PQ. RAFAEL URDANETA	UNIDAD EDUCATIVA CARABOBO	2215	4	34	1768	831	1734	0	4	1	2	896	1768
EDO. CARABOBO	CE. VALENCIA	PQ. RAFAEL URDANETA	UNIDAD EDUCATIVA COLEGIO TAMANACO	504	1	8	208	132	200	0	2	0	0	66	208
EDO. CARABOBO	CE. VALENCIA	PQ. RAFAEL URDANETA	UNIDAD EDUCATIVA CABRIALES	1003	2	15	764	543	749	0	7	1	0	198	764
EDO. CARABOBO	CE. VALENCIA	PQ. RAFAEL URDANETA	UNIDAD EDUCATIVA TERESA DE LA PARRA	2316	4	31	1917	1578	1886	2	3	0	1	302	1917
EDO. CARABOBO	CE. VALENCIA	PQ. RAFAEL URDANETA	ESCUELA BASICA ESTADAL JUANITA HERNANDEZ LEON	8628	16	113	7123	3037	7010	0	46	2	3	3922	7123
EDO. CARABOBO	CE. VALENCIA	PQ. RAFAEL URDANETA	ESCUELA JUAN USLAR	3400	6	35	2773	1577	2738	3	18	1	0	1139	2773
EDO. CARABOBO	CE. VALENCIA	PQ. RAFAEL URDANETA	ESCUELA BASICA LUIS SANOJO	5350	10	61	4509	1618	4448	1	17	1	0	2811	4509
EDO. CARABOBO	CE. VALENCIA	PQ. RAFAEL URDANETA	ESCUELA GUIGUE	2024	4	23	1590	1062	1567	0	11	1	0	493	1590
EDO. CARABOBO	CE. VALENCIA	PQ. RAFAEL URDANETA	ESCUELA ITACA	8250	15	85	6719	3418	6634	3	36	3	6	3168	6719
EDO. CARABOBO	CE. VALENCIA	PQ. RAFAEL URDANETA	ESCUELA NACIONAL MINAS DE AROA	1260	3	13	971	818	958	0	3	0	0	137	971
EDO. CARABOBO	CE. VALENCIA	PQ. RAFAEL URDANETA	UNIDAD EDUCATIVA BELLO MONTE	1437	3	10	1201	664	1191	1	8	0	0	518	1201
EDO. CARABOBO	CE. VALENCIA	PQ. RAFAEL URDANETA	PRE ESCOLAR MUNICIPAL BUCARAL SUR	2138	4	24	1776	851	1752	0	13	1	1	886	1776
EDO. CARABOBO	CE. VALENCIA	PQ. RAFAEL URDANETA	UNIDAD EDUCATIVA BOLIVARIANA BERACIERTA	4047	7	40	3361	1199	3321	0	22	3	3	2094	3361
EDO. CARABOBO	CE. VALENCIA	PQ. RAFAEL URDANETA	LICEO NACIONAL ENRIQUE BERNARDO NUÑEZ	4351	8	48	3624	1595	3576	0	23	0	0	1958	3624
EDO. CARABOBO	CE. VALENCIA	PQ. RAFAEL URDANETA	UNIDAD EDUCATIVA NACIONAL MERCEDES I DE CORRO	5795	11	71	4836	2469	4765	1	25	3	2	2265	4836
EDO. CARABOBO	CE. VALENCIA	PQ. RAFAEL URDANETA	COLEGIO NACIONAL BOLIVARIANO SIMONCITO LA TRINIDAD	871	2	8	734	540	726	0	1	1	0	184	734
EDO. CARABOBO	CE. VALENCIA	PQ. RAFAEL URDANETA	ESCUELA BASICA ASENTAMIENTO CAMPESINO	552	1	3	451	402	448	0	3	0	0	43	451
EDO. CARABOBO	CE. VALENCIA	PQ. RAFAEL URDANETA	PRE   ESCOLAR MUNICIPAL LAS PALMITAS	3863	7	67	3056	2341	2989	1	8	0	1	638	3056
EDO. CARABOBO	CE. VALENCIA	PQ. RAFAEL URDANETA	UNIDAD EDUCATIVA ESTADAL ANTONIO ALBERTO PEREZ ROMERO	2316	4	36	1841	1188	1805	2	9	2	1	603	1841
EDO. CARABOBO	CE. VALENCIA	PQ. RAFAEL URDANETA	LICEO JOSE AUSTRIA	5766	11	67	4905	1622	4838	1	15	2	1	3197	4905
EDO. CARABOBO	CE. VALENCIA	PQ. RAFAEL URDANETA	COLEGIO ISRRAEL	1588	3	22	1197	776	1175	0	9	1	0	389	1197
EDO. CARABOBO	MP. JUAN JOSE MORA	PQ. URAMA	ESCUELA BASICA DON ANDRES BELLO	444	1	4	373	330	369	0	0	0	0	39	373
EDO. CARABOBO	MP. JUAN JOSE MORA	PQ. URAMA	MEDICATURA RURAL DE URAMA	387	1	9	321	244	312	0	2	0	0	66	321
EDO. CARABOBO	MP. JUAN JOSE MORA	PQ. URAMA	ESCUELA UNITARIA NUMERO 2	579	1	5	395	294	390	0	0	0	0	96	395
EDO. CARABOBO	MP. JUAN JOSE MORA	PQ. URAMA	NUCLEO ESCOLAR RURAL 86	128	1	0	109	94	109	1	2	0	0	12	109
EDO. CARABOBO	MP. JUAN JOSE MORA	PQ. URAMA	ESCUELA BOLIVARIANA LA JOBERA	378	1	8	339	286	331	1	1	0	0	43	339
EDO. CARABOBO	MP. JUAN JOSE MORA	PQ. URAMA	ESCUELA BOLIVARIANA JOSEFINA GARCIA	1023	2	17	801	626	784	1	2	1	0	154	801
EDO. CARABOBO	MP. JUAN JOSE MORA	PQ. URAMA	ESCUELA BOLIVARIANA MANUEL MANRIQUE	1216	3	21	932	608	911	0	1	2	0	300	932
EDO. CARABOBO	MP. JUAN JOSE MORA	PQ. URAMA	CENTRO DE EDUCACION INICIAL CANOABITO DE LA COSTA	222	1	4	199	168	195	0	1	0	0	26	199
EDO. CARABOBO	MP. JUAN JOSE MORA	PQ. URAMA	ESCUELA BASICA GUAREMAL DE LA COSTA	216	1	2	182	163	180	0	1	0	0	16	182
EDO. CARABOBO	MP. JUAN JOSE MORA	PQ. URAMA	ESCUELA NACIONAL URAMA	1643	3	11	1232	932	1221	0	4	0	1	284	1232
EDO. CARABOBO	MP. JUAN JOSE MORA	PQ. MORON	ESCUELA BASICA NACIONAL LAS PARCELAS	2704	5	40	2234	1512	2194	1	8	4	0	669	2234
EDO. CARABOBO	MP. JUAN JOSE MORA	PQ. MORON	ESCUELA BASICA ESTADAL JULIO PEÑA	1727	3	27	1390	1102	1363	0	5	1	1	254	1390
EDO. CARABOBO	MP. JUAN JOSE MORA	PQ. MORON	ESCUELA TECNICA ROBINSONIANA PETROQUIMICA Y AGROAMBIENTAL ALI PRIMERA	596	1	16	480	401	464	2	0	0	0	61	480
EDO. CARABOBO	MP. JUAN JOSE MORA	PQ. MORON	ESCUELA NACIONAL BOCA DE YARACUY	448	1	2	381	308	379	0	1	0	0	70	381
EDO. CARABOBO	MP. JUAN JOSE MORA	PQ. MORON	ALDEA BOLIVARIANA MORON	1056	2	15	858	745	843	1	1	0	0	96	858
EDO. CARABOBO	MP. JUAN JOSE MORA	PQ. MORON	CASA COMUNAL JOSE FELIX MORA	490	1	6	419	367	413	0	0	0	0	46	419
EDO. CARABOBO	MP. JUAN JOSE MORA	PQ. MORON	ESCUELA NACIONAL CONCENTRADA SANTA ANA	3028	6	56	2534	1703	2478	3	22	1	3	746	2534
EDO. CARABOBO	MP. JUAN JOSE MORA	PQ. MORON	UNIDAD EDUCATIVA ESTADAL ROMULO GALLEGOS	3057	6	81	2607	1686	2526	3	10	0	2	825	2607
EDO. CARABOBO	MP. JUAN JOSE MORA	PQ. MORON	UNIDAD EDUCATIVA EDUARDO BLANCO	776	2	15	638	468	623	1	5	1	1	147	638
EDO. CARABOBO	MP. JUAN JOSE MORA	PQ. MORON	LICEO BOLIVARIANO JOSE FELIZ MORA	1796	3	19	1536	951	1517	2	9	1	2	552	1536
EDO. CARABOBO	MP. JUAN JOSE MORA	PQ. MORON	ESCUELA MUNICIPAL SAN DIEGO	1783	4	27	1467	1107	1440	2	5	0	0	326	1467
EDO. CARABOBO	MP. JUAN JOSE MORA	PQ. MORON	COMPLEJO EDUCATIVO BOLIVARIANO SIMON BOLIVAR	492	1	7	440	306	433	0	3	0	1	123	440
EDO. CARABOBO	MP. JUAN JOSE MORA	PQ. MORON	CENTRO DE EDUCACION INICIAL GLADISMAR SANTELIZ	401	1	6	363	302	357	0	0	0	0	55	363
EDO. CARABOBO	MP. JUAN JOSE MORA	PQ. MORON	ESCUELA GRADUADA UDON PEREZ	1999	4	27	1592	1271	1565	0	9	1	1	283	1592
EDO. CARABOBO	MP. JUAN JOSE MORA	PQ. MORON	UNIDAD EDUCATIVA FRANCISCO ROSA	320	1	5	277	166	272	1	1	0	0	104	277
EDO. CARABOBO	MP. JUAN JOSE MORA	PQ. MORON	LICEO AMBROSIO PLAZA	2444	5	31	1880	1213	1849	0	11	2	2	621	1880
EDO. CARABOBO	MP. JUAN JOSE MORA	PQ. MORON	ESCUELA BASICA ESTADAL MORON	1363	3	14	1161	950	1147	0	3	1	1	192	1161
EDO. CARABOBO	MP. JUAN JOSE MORA	PQ. MORON	CENTRO EDUCACION INICIAL  BOLIVARIANO. SANTA ANA    (SIMONCITO)	1203	3	18	1025	695	1007	0	0	1	0	311	1025
EDO. CARABOBO	MP. JUAN JOSE MORA	PQ. MORON	CENTRO EDUCACION INICIAL  ESTADAL  TEODOSA BENITA FLORES	1512	3	33	1177	745	1144	0	6	2	1	390	1177
EDO. CARABOBO	MP. JUAN JOSE MORA	PQ. MORON	ESCUELA TECNICA NACIONAL ALPARGATON	184	1	6	169	145	163	0	1	0	0	17	169
EDO. CARABOBO	MP. JUAN JOSE MORA	PQ. MORON	UNIDAD EDUACTIVA   BOLIVARIANO  MAHATMA GANDHI	922	2	14	817	491	803	0	3	1	0	308	817
EDO. CARABOBO	MP. JUAN JOSE MORA	PQ. MORON	UNIDAD EDUCATIVA COLEGIO EVANGELICO SADIE DE WASMLEY	1327	3	13	1093	760	1080	0	6	0	1	313	1093
EDO. CARABOBO	MP. JUAN JOSE MORA	PQ. MORON	LICEO BOLIVARIANO JESUS MANUEL SUBERO	1049	2	13	939	606	926	2	7	0	0	311	939
EDO. CARABOBO	MP. JUAN JOSE MORA	PQ. MORON	ESCUELA BASICA FELIPE CECILIO TOVAR	653	2	10	540	464	530	0	2	0	0	64	540
EDO. CARABOBO	MP. JUAN JOSE MORA	PQ. MORON	ESCUELA TRICOLOR LA PARGUITA	235	1	0	190	182	190	2	1	1	0	4	190
EDO. CARABOBO	MP. JUAN JOSE MORA	PQ. MORON	UNIDAD EDUCATIVA CREACION PALMA SOLA	1617	3	24	1288	1125	1264	0	2	0	0	137	1288
EDO. CARABOBO	MP. JUAN JOSE MORA	PQ. MORON	UNIDAD EDUCATIVA CARMEN MARIA RODRIGUEZ	990	2	19	817	697	798	0	2	2	1	96	817
EDO. CARABOBO	MP. JUAN JOSE MORA	PQ. MORON	ESCUELA BOLIVARIANA  ESTADAL MORON	2471	5	63	2077	1260	2014	4	8	0	0	742	2077
EDO. CARABOBO	MP. JUAN JOSE MORA	PQ. MORON	UNIDAD EDUCATIVA  ISABEL LA CATOLICA	678	2	10	601	438	591	0	1	0	1	151	601
EDO. CARABOBO	MP. JUAN JOSE MORA	PQ. MORON	ESCUELA BASICA SAN VICENTE FERRER	397	1	4	368	315	364	0	1	0	0	48	368
EDO. CARABOBO	MP. JUAN JOSE MORA	PQ. MORON	UNIDAD EDUCATIVA  PRIVADA MARIA AUXILIADORA	805	2	15	693	451	678	1	3	1	1	221	693
EDO. CARABOBO	MP. JUAN JOSE MORA	PQ. MORON	JARDIN DE INFANCIA VALLE VERDE	383	1	3	355	322	352	0	2	0	0	28	355
EDO. CARABOBO	MP. JUAN JOSE MORA	PQ. MORON	CENTRO INTERNACIONAL EDUCACION Y DESARROLLO  MORON	1944	4	30	1606	1155	1576	0	4	0	0	417	1606
EDO. CARABOBO	MP. JUAN JOSE MORA	PQ. MORON	UNIDAD EDUCATIVA EL JABILLO	1275	3	19	1108	893	1089	0	1	0	1	194	1108
EDO. CARABOBO	MP. GUACARA	PQ. GUACARA	UNIDAD EDUCATIVA ESTADAL CARLOS FEDERICO GROSS	3687	7	58	3043	2134	2985	0	10	1	0	840	3043
EDO. CARABOBO	MP. GUACARA	PQ. GUACARA	ESCUELA BASICA NUEVA GUACARA	5221	10	64	4315	2775	4251	1	26	2	3	1444	4315
EDO. CARABOBO	MP. GUACARA	PQ. GUACARA	ESCUELA 19 DE JULIO	1145	2	14	1006	744	992	0	10	0	1	237	1006
EDO. CARABOBO	MP. GUACARA	PQ. GUACARA	ESCUELA NAC GRADUADA VIGIRIMA	2189	4	25	1667	1110	1642	0	6	0	0	526	1667
EDO. CARABOBO	MP. GUACARA	PQ. GUACARA	ESCUELA JOSE CECILIO AVILA	6029	11	90	5029	3134	4939	2	26	1	3	1773	5029
EDO. CARABOBO	MP. GUACARA	PQ. GUACARA	UNIDAD EDUCATIVA RICARDO ALTERIO	2883	5	32	2485	1467	2453	0	10	2	0	974	2485
EDO. CARABOBO	MP. GUACARA	PQ. GUACARA	ESCUELA VICENTE WALLIS	5230	10	88	4316	1906	4228	2	33	4	5	2278	4316
EDO. CARABOBO	MP. GUACARA	PQ. GUACARA	UNIDAD EDUCATIVA EZEQUIEL ZAMORA	2632	5	55	2229	1770	2174	0	18	2	0	384	2229
EDO. CARABOBO	MP. GUACARA	PQ. GUACARA	PREESCOLAR JOSE MARIA VARGAS	2064	4	30	1814	957	1784	0	4	0	2	821	1814
EDO. CARABOBO	MP. GUACARA	PQ. GUACARA	MERCAL DE PETROCASA	649	2	14	573	485	559	0	4	1	0	69	573
EDO. CARABOBO	MP. GUACARA	PQ. GUACARA	ESCUELA NACIONAL GRADUADA LOS NARANJILLOS	2989	6	53	2517	1285	2464	0	14	4	3	1158	2517
EDO. CARABOBO	MP. GUACARA	PQ. GUACARA	PRE ESCOLAR EL SAMAN	3862	7	50	3358	1932	3308	1	26	4	3	1342	3358
EDO. CARABOBO	MP. GUACARA	PQ. GUACARA	ESCUELA ESTADAL DOMITILA FERNANDEZ	1021	2	6	886	687	880	0	5	1	0	187	886
EDO. CARABOBO	MP. GUACARA	PQ. GUACARA	UNIDAD EDUCATIVA  BOLIVARIANA   DOCTOR ANDRÉS ELOY BLANCO	1319	3	33	1091	807	1058	0	6	0	0	245	1091
EDO. CARABOBO	MP. GUACARA	PQ. GUACARA	CENTRO DE EDUCACION INICIAL NACIONAL NUEVA GUACARA	2943	6	38	2465	1609	2427	0	6	2	2	808	2465
EDO. CARABOBO	MP. GUACARA	PQ. GUACARA	ESCUELA BASICA NACIONAL ADOLFO BLONVAL LOPEZ	3961	7	29	3429	1140	3400	0	12	0	2	2246	3429
EDO. CARABOBO	MP. GUACARA	PQ. GUACARA	ESCUELA BOLIVARIANA GUAICAIPURO	902	2	26	770	621	744	0	2	0	0	121	770
EDO. CARABOBO	MP. GUACARA	PQ. GUACARA	UNIDAD EDUCATIVA NACIONAL EL TOQUITO	4967	9	54	3988	2198	3934	1	19	0	3	1713	3988
EDO. CARABOBO	MP. GUACARA	PQ. GUACARA	ESCUELA BOLIVARIANA SIMON BOLIVAR	1231	3	26	1041	772	1015	0	10	0	0	233	1041
EDO. CARABOBO	MP. GUACARA	PQ. GUACARA	UNIDAD EDUCATIVA FRANCISCO DE BERROTERAN	1144	2	18	939	360	921	0	4	1	1	555	939
EDO. CARABOBO	MP. GUACARA	PQ. GUACARA	UNIDAD EDUCATIVA   NACIONAL   LUIS AUGUSTO MACHADO CISNEROS	6911	13	110	5528	2703	5418	4	34	3	4	2670	5528
EDO. CARABOBO	MP. GUACARA	PQ. GUACARA	UNIDAD EDUCATIVA ESTADAL GRADUADA RAUL CALCAMO	2510	5	29	2052	1326	2023	2	14	1	1	679	2052
EDO. CARABOBO	MP. GUACARA	PQ. GUACARA	UNIDAD EDUACTIVA   NACIONAL JOSE GREGORIO GUITIAN E	2909	5	49	2439	1087	2390	0	10	2	0	1291	2439
EDO. CARABOBO	MP. GUACARA	PQ. GUACARA	ESCUELAS PROFESOR MANUEL AROCHA OJEDA	4898	9	92	3963	2796	3871	2	30	6	1	1036	3963
EDO. CARABOBO	MP. GUACARA	PQ. GUACARA	ESCUELA MUNICIPAL FRANCISCO ESTABA ROJAS	784	2	8	710	588	702	1	4	0	0	109	710
EDO. CARABOBO	MP. GUACARA	PQ. GUACARA	UNIDAD EDUCATIVA PRIVADA OSCAR FERNANDO BENEDETTI (FE Y ALEGRIA)	4770	9	79	4097	2723	4018	1	35	2	0	1257	4097
EDO. CARABOBO	MP. GUACARA	PQ. GUACARA	GRUPO ESCOLAR DIEGO IBARRA	6067	11	82	4849	2107	4767	0	23	3	5	2629	4849
EDO. CARABOBO	MP. GUACARA	PQ. GUACARA	ESCUELA BASICA BARTOLOME DE LAS CASA	690	2	9	597	406	588	0	3	0	0	179	597
EDO. CARABOBO	MP. GUACARA	PQ. GUACARA	ESCUELA BASICA OJO DE AGUA	952	2	11	812	645	801	1	5	0	0	150	812
EDO. CARABOBO	MP. GUACARA	PQ. CIUDAD ALIANZA	UNIDAD EDUCATIVA FELIX ROMAN DUQUE	3295	6	11	2692	555	2681	0	4	0	0	2122	2692
EDO. CARABOBO	MP. GUACARA	PQ. CIUDAD ALIANZA	GRUPO ESCOLAR ALONSO DIAZ MORENO	4415	8	39	3524	682	3485	1	5	1	2	2794	3524
EDO. CARABOBO	MP. GUACARA	PQ. CIUDAD ALIANZA	UNIDAD EDUCATIVA VIRGEN DE LAS NIEVES	2897	5	21	2472	568	2451	0	4	1	1	1877	2472
EDO. CARABOBO	MP. GUACARA	PQ. CIUDAD ALIANZA	CICLO BASICO COMUN SANTIAGO FRANCISCO MACHADO	4169	8	28	3512	835	3484	0	11	0	1	2637	3512
EDO. CARABOBO	MP. GUACARA	PQ. YAGUA	HOGAR DE ATENCION INTEGRAL AL NIÑO	1099	2	12	902	483	890	0	1	0	0	406	902
EDO. CARABOBO	MP. GUACARA	PQ. YAGUA	UNIDAD EDUCATIVA JUAN ANTONIO PEREZ BONALDE	937	2	8	828	392	820	0	3	1	0	424	828
EDO. CARABOBO	MP. GUACARA	PQ. YAGUA	ESCUELA BASICA QUEBRADA HONDA	640	2	10	531	401	521	0	7	0	0	113	531
EDO. CARABOBO	MP. GUACARA	PQ. YAGUA	ESCUELA BASICA  NACIONAL   DR. CARLOS ARVELO	969	2	8	728	425	720	0	4	0	0	291	728
EDO. CARABOBO	MP. GUACARA	PQ. YAGUA	GRUPO ESCOLAR CARLOS ARVELO	5101	9	77	4113	2194	4036	3	16	5	1	1817	4113
EDO. CARABOBO	MP. GUACARA	PQ. YAGUA	ESCUELA BASICA HENRIQUE TEJERA	4012	7	40	3228	2004	3188	1	10	1	0	1172	3228
EDO. CARABOBO	MP. MONTALBAN	PQ. MONTALBAN	UNIDAD EDUCATIVA ESTADAL LAS MATAS	611	2	7	497	276	490	0	4	0	0	210	497
EDO. CARABOBO	MP. MONTALBAN	PQ. MONTALBAN	MANUEL LATOUCHE ACOSTA	767	2	14	569	387	555	0	1	0	0	167	569
EDO. CARABOBO	MP. MONTALBAN	PQ. MONTALBAN	ESCUELA BOLIVARIANA ROMULO GALLEGOS	1642	3	22	1401	887	1379	0	5	1	0	486	1401
EDO. CARABOBO	MP. MONTALBAN	PQ. MONTALBAN	ESCUELA BASICA BOLIVARIANA  ANTONIO HERRERA TORO	3395	6	51	2693	1343	2642	1	9	0	1	1288	2693
EDO. CARABOBO	MP. MONTALBAN	PQ. MONTALBAN	ANEXO LICEO JOSE ANDRES CASTILLO	807	2	5	583	451	578	0	1	0	0	126	583
EDO. CARABOBO	MP. MONTALBAN	PQ. MONTALBAN	CENTRO EDUCATIVO Y RECREACIONAL FUNDACION DEL NIÑO PEDRO CAMEJO	2299	4	38	1951	1096	1913	0	8	1	1	807	1951
EDO. CARABOBO	MP. MONTALBAN	PQ. MONTALBAN	ESCUELA BASICA  MONSEÑOR FRANCISCO ANTONIO GRANADILLO	1678	3	23	1411	679	1388	1	4	0	0	704	1411
EDO. CARABOBO	MP. MONTALBAN	PQ. MONTALBAN	AMBULATORIO DE SALUD SABANA DE AGUIRRE	424	1	10	332	260	322	0	1	0	0	61	332
EDO. CARABOBO	MP. MONTALBAN	PQ. MONTALBAN	UNIDAD EDUCATIVA ESTADAL BERNARDINO	797	2	18	671	250	653	0	1	1	0	401	671
EDO. CARABOBO	MP. MONTALBAN	PQ. MONTALBAN	UNIDAD EDUCATIVA BOLIVARIANA SABANETA NORTE	671	2	12	482	216	470	0	1	1	0	252	482
EDO. CARABOBO	MP. MONTALBAN	PQ. MONTALBAN	UNIDAD EDUCATIVA TAMARE	1674	3	17	1348	607	1331	0	6	1	1	716	1348
EDO. CARABOBO	MP. MONTALBAN	PQ. MONTALBAN	PREESCOLAR ISABEL MARIA ORTEGA	761	2	18	609	305	591	0	0	0	0	286	609
EDO. CARABOBO	MP. MONTALBAN	PQ. MONTALBAN	JARDIN DE INFANCIA MONTALBAN	1243	3	15	1113	637	1098	0	5	0	0	456	1113
EDO. CARABOBO	MP. PUERTO CABELLO	PQ. FRATERNIDAD	ESCUELA TECNICA ROBINSONIANA MIGUEL PEÑA	700	2	12	529	293	517	0	2	0	0	222	529
EDO. CARABOBO	MP. PUERTO CABELLO	PQ. FRATERNIDAD	CICLO BASICO COMUN SIMON RODRIGUEZ	1828	4	14	1408	649	1394	2	8	0	1	734	1408
EDO. CARABOBO	MP. PUERTO CABELLO	PQ. FRATERNIDAD	UNIDAD EDUCATIVA NACIONAL COMPLEJO BOLIVARIANO SIMON RODRIGUEZ	957	2	11	725	357	714	0	1	0	0	356	725
EDO. CARABOBO	MP. PUERTO CABELLO	PQ. FRATERNIDAD	ESCUELA PRIMARIA BOLIVARIANA JUAN JOSE FLORES	3467	6	40	2746	1377	2706	1	15	2	1	1310	2746
EDO. CARABOBO	MP. PUERTO CABELLO	PQ. FRATERNIDAD	UNIDAD EDUCATIVA ESTADAL DOROTEO CENTENO	1969	4	24	1552	702	1528	1	3	0	1	821	1552
EDO. CARABOBO	MP. PUERTO CABELLO	PQ. PATANEMO	UNIDAD EDUCATIVA BOLIVARIANA  JOSE LAURENCIO SILVA	1616	3	33	1214	719	1181	0	8	1	0	453	1214
EDO. CARABOBO	MP. PUERTO CABELLO	PQ. PATANEMO	ESCUELA BOLIVARIANA PRIMAVERA	346	1	8	293	242	285	0	2	0	0	41	293
EDO. CARABOBO	MP. PUERTO CABELLO	PQ. PATANEMO	UNIDAD EDUCATIVA LOS CANEYES	912	2	13	695	379	682	0	7	0	0	296	695
EDO. CARABOBO	MP. PUERTO CABELLO	PQ. JUAN JOSE FLORES	ESCUELA EMELINA GUERRA	1543	3	18	1231	718	1213	3	3	1	0	488	1231
EDO. CARABOBO	MP. PUERTO CABELLO	PQ. JUAN JOSE FLORES	ESCUELA TECNICA ROBINSONIANA SAMUEL ROBINSON LA SALINA SUR	311	1	8	253	213	245	0	0	0	0	32	253
EDO. CARABOBO	MP. PUERTO CABELLO	PQ. JUAN JOSE FLORES	ESCUELA NACIONAL RAFAEL ANDRADE MENDOZA	2460	5	39	2009	1348	1970	2	4	1	1	614	2009
EDO. CARABOBO	MP. PUERTO CABELLO	PQ. JUAN JOSE FLORES	ESCUELA CONCENTRADA SAN JOSE	3110	6	44	2477	1869	2433	1	7	1	1	554	2477
EDO. CARABOBO	MP. PUERTO CABELLO	PQ. JUAN JOSE FLORES	ESCUELA JOSE RAFAEL POCATERRA	2408	5	32	1892	1380	1860	0	6	1	0	473	1892
EDO. CARABOBO	MP. PUERTO CABELLO	PQ. JUAN JOSE FLORES	UNIDAD EDUCATIVA ROSA OLIVEROS DE MAZA	630	2	9	459	290	450	0	0	0	0	160	459
EDO. CARABOBO	MP. PUERTO CABELLO	PQ. JUAN JOSE FLORES	UNIDAD EDUCATIVA INSTITUTO SAN JOSE OBRERO	1059	2	20	913	475	893	0	1	1	0	416	913
EDO. CARABOBO	MP. PUERTO CABELLO	PQ. JUAN JOSE FLORES	UNIDAD ESCOLAR ISABEL TERESA PONCE	2644	5	36	2226	1750	2190	0	9	0	0	431	2226
EDO. CARABOBO	MP. PUERTO CABELLO	PQ. JUAN JOSE FLORES	COLEGIO SAN JOSE LA SALLE	2595	5	37	2224	375	2187	0	8	1	0	1803	2224
EDO. CARABOBO	MP. PUERTO CABELLO	PQ. JUAN JOSE FLORES	ESCUELA PRIMARIA BOLIVARIANA  JUANA GARCIA DE LADERA	4216	8	73	3459	2391	3386	0	26	2	2	965	3459
EDO. CARABOBO	MP. PUERTO CABELLO	PQ. JUAN JOSE FLORES	ESCUELA ESTADAL CESAR AGREDA	2630	5	28	2125	1560	2097	0	9	0	0	528	2125
EDO. CARABOBO	MP. PUERTO CABELLO	PQ. JUAN JOSE FLORES	UNIDAD EDUCATIVA VISTAMAR	1478	3	27	1382	602	1355	2	1	1	2	747	1382
EDO. CARABOBO	MP. PUERTO CABELLO	PQ. JUAN JOSE FLORES	UNIDAD EDUCATIVA BOLIVARIANA NACIONAL JOSE ANTONIO MAITIN	2386	5	61	2036	1246	1975	3	7	0	3	716	2036
EDO. CARABOBO	MP. PUERTO CABELLO	PQ. JUAN JOSE FLORES	COLEGIO HERMANA DOLORES FE Y ALEGRIA	1996	4	32	1607	1004	1575	0	6	0	0	565	1607
EDO. CARABOBO	MP. PUERTO CABELLO	PQ. JUAN JOSE FLORES	ESCUELA BASICA BOLIVARIANA PROSPERO REVERON	2259	4	32	1948	1069	1916	1	7	0	2	837	1948
EDO. CARABOBO	MP. PUERTO CABELLO	PQ. JUAN JOSE FLORES	INSTITUTO UNIVERSITARIO DE TECNOLOGIA DE PUERTO CABELLO	1072	2	13	885	704	872	0	5	0	0	163	885
EDO. CARABOBO	MP. PUERTO CABELLO	PQ. JUAN JOSE FLORES	UNIDAD EDUCATIVA ESTADAL MARIA LUISA NIEVES	1176	2	18	927	683	909	0	5	0	0	221	927
EDO. CARABOBO	MP. PUERTO CABELLO	PQ. JUAN JOSE FLORES	ESCUELA BOLIVARIANA TERESITA ROSALES	3499	6	34	2994	1160	2960	1	6	1	3	1789	2994
EDO. CARABOBO	MP. PUERTO CABELLO	PQ. JUAN JOSE FLORES	ESCUELA NACIONAL BORBURATA	577	1	7	483	246	476	0	2	0	0	228	483
EDO. CARABOBO	MP. PUERTO CABELLO	PQ. JUAN JOSE FLORES	UNIDAD EDUCATIVA MUNICIPAL JOSE JUAQUIN PEREZ REINA	485	1	5	335	217	330	0	2	1	0	110	335
EDO. CARABOBO	MP. PUERTO CABELLO	PQ. JUAN JOSE FLORES	ESCUELA ESTADAL LA CRUZ	507	1	13	420	317	407	0	1	1	0	88	420
EDO. CARABOBO	MP. PUERTO CABELLO	PQ. JUAN JOSE FLORES	ESCUELA MARIA CONCEPCION DE BOLIVAR	4530	8	45	3519	1837	3474	2	16	3	3	1613	3519
EDO. CARABOBO	MP. PUERTO CABELLO	PQ. JUAN JOSE FLORES	UNIDAD EDUCATIVA MUNICIPAL ROMULO GALLEGOS	973	2	13	814	552	801	0	4	0	0	245	814
EDO. CARABOBO	MP. PUERTO CABELLO	PQ. JUAN JOSE FLORES	UNIDAD EDUCATIVA PUENTE LOS ESPAÑOLES	555	1	3	451	360	448	0	1	0	0	87	451
EDO. CARABOBO	MP. PUERTO CABELLO	PQ. GOAIGOAZA	UNIDAD EDUCATIVA MIQUIJA	993	2	12	753	551	741	0	1	0	0	189	753
EDO. CARABOBO	MP. PUERTO CABELLO	PQ. GOAIGOAZA	ESCUELA BASICA ESTADAL FRANCISCO FARFAN	2409	5	39	1881	1146	1842	1	6	3	2	684	1881
EDO. CARABOBO	MP. PUERTO CABELLO	PQ. GOAIGOAZA	UNIDAD EDUCATIVA NACIONAL CREACION LA CORINA	571	1	12	469	357	457	0	3	0	0	97	469
EDO. CARABOBO	MP. PUERTO CABELLO	PQ. GOAIGOAZA	UNIDAD EDUCATIVA INICIAL AÑO INTERNACIONAL DEL NIÑO	1882	4	36	1575	1171	1539	0	10	0	0	358	1575
EDO. CARABOBO	MP. PUERTO CABELLO	PQ. GOAIGOAZA	ESCUELA PRIMARIA BOLIVARIANA LICENCIADO CARLOS REQUENA	798	2	9	725	463	716	0	3	0	1	249	725
EDO. CARABOBO	MP. PUERTO CABELLO	PQ. GOAIGOAZA	UNIDAD EDUCATIVA ESCUELA NIÑOS ESPECIALES	1104	2	21	977	623	956	0	0	0	2	331	977
EDO. CARABOBO	MP. PUERTO CABELLO	PQ. GOAIGOAZA	ESCUELA PEDRO CAMEJO	842	2	10	739	498	729	0	6	1	0	224	739
EDO. CARABOBO	MP. PUERTO CABELLO	PQ. GOAIGOAZA	UNIDAD EDUCATIVA PRIVADA MONSEÑOR ALI LEBRUN FE Y ALEGRIA	3074	6	46	2620	1297	2574	1	7	4	2	1263	2620
EDO. CARABOBO	MP. PUERTO CABELLO	PQ. GOAIGOAZA	CICLO BASICO AGUSTIN ARMARIO	6793	12	93	5449	3467	5356	0	22	4	3	1860	5449
EDO. CARABOBO	MP. PUERTO CABELLO	PQ. GOAIGOAZA	UNIDAD EDUCATIVA MUNICIPAL RAFAEL GUTIERREZ	1741	3	25	1473	1121	1448	0	4	0	0	323	1473
EDO. CARABOBO	MP. PUERTO CABELLO	PQ. GOAIGOAZA	ESCUELA BASICA LA SALLE BALOCHE	4166	8	52	3403	1822	3351	0	9	3	1	1516	3403
EDO. CARABOBO	MP. PUERTO CABELLO	PQ. GOAIGOAZA	CENTRO EDUCACION INICIAL FELICITA BALCHE	813	2	18	670	420	652	0	3	0	1	228	670
EDO. CARABOBO	MP. PUERTO CABELLO	PQ. GOAIGOAZA	UNIDAD EDUCATIVA JESUS GUITIAN	1045	2	11	826	597	815	0	2	0	0	216	826
EDO. CARABOBO	MP. PUERTO CABELLO	PQ. GOAIGOAZA	UNIDAD EDUCATIVA MUNICIPAL CARIAPRIMA	293	1	7	233	167	226	0	0	0	0	59	233
EDO. CARABOBO	MP. PUERTO CABELLO	PQ. GOAIGOAZA	UNIDAD EDUCATIVA NACIONAL SANTA CRUZ	4713	9	59	3778	2201	3719	0	9	0	3	1506	3778
EDO. CARABOBO	MP. PUERTO CABELLO	PQ. DEMOCRACIA	UNIDAD EDUCATIVA PRIVADA JUAN MANUEL VALDEZ	343	1	2	243	216	241	0	0	0	0	25	243
EDO. CARABOBO	MP. PUERTO CABELLO	PQ. DEMOCRACIA	ESCUELA BASICA BARTOLOME SALOM	2879	5	60	2217	1489	2157	1	11	1	4	651	2217
EDO. CARABOBO	MP. PUERTO CABELLO	PQ. DEMOCRACIA	ESCUELA BASICA LAS TABLAS	670	2	6	577	458	571	1	0	0	1	111	577
EDO. CARABOBO	MP. PUERTO CABELLO	PQ. DEMOCRACIA	GRUPO ESCOLAR CARLOS FELIPE ALVIZU	2617	5	53	2013	1424	1960	0	7	3	0	526	2013
EDO. CARABOBO	MP. PUERTO CABELLO	PQ. DEMOCRACIA	GRUPO ESCOLAR TABORDA	3425	6	48	2732	2009	2684	3	12	0	0	660	2732
EDO. CARABOBO	MP. PUERTO CABELLO	PQ. DEMOCRACIA	CENTRO DE EDUCACION INICIAL TABORDA	1066	2	11	853	648	842	0	5	0	0	189	853
EDO. CARABOBO	MP. PUERTO CABELLO	PQ. DEMOCRACIA	ESCUELA NACIONAL CONCENTRADA LA PROVIDENCIA	285	1	4	210	185	206	1	0	1	0	19	210
EDO. CARABOBO	MP. PUERTO CABELLO	PQ. DEMOCRACIA	ESCUELA CONCENTRADA 29 DE NOVIEMBRE	902	2	17	686	485	669	2	1	0	0	181	686
EDO. CARABOBO	MP. PUERTO CABELLO	PQ. BORBURATA	GRUPO ESCOLAR CACHIRI	3170	6	18	2324	1160	2306	1	11	2	3	1129	2324
EDO. CARABOBO	MP. PUERTO CABELLO	PQ. BORBURATA	UNIDAD EDUCATIVA MUNICIPAL  RURAL GAÑANGO	1601	3	17	1098	821	1081	0	6	0	0	254	1098
EDO. CARABOBO	MP. PUERTO CABELLO	PQ. BORBURATA	ESCUELA BOLIVARIANA AGUSTIN ARMARIO	2062	4	30	1396	1234	1366	0	9	0	0	123	1396
EDO. CARABOBO	MP. PUERTO CABELLO	PQ. UNION	GRUPO ESCOLAR REPUBLICA DE HONDURAS	3924	7	56	2895	1507	2839	3	16	1	2	1310	2895
EDO. CARABOBO	MP. PUERTO CABELLO	PQ. UNION	UNIDAD EDUCATIVA COLEGIO EVANGELICO DE PUERTO CABELLO	547	1	6	398	264	392	0	0	1	0	127	398
EDO. CARABOBO	MP. PUERTO CABELLO	PQ. BARTOLOME SALOM	UNIDAD EDUCATIVA LIGIA DE RIOS	836	2	15	714	494	699	1	3	0	0	201	714
EDO. CARABOBO	MP. PUERTO CABELLO	PQ. BARTOLOME SALOM	JARDIN DE INFANCIA SAN ESTEBAN	2550	5	54	2109	1322	2055	1	9	1	1	721	2109
EDO. CARABOBO	MP. PUERTO CABELLO	PQ. BARTOLOME SALOM	ESCUELA BARRIO SAN ESTEBAN	5907	11	74	4910	3179	4836	4	19	0	4	1630	4910
EDO. CARABOBO	MP. PUERTO CABELLO	PQ. BARTOLOME SALOM	CICLO BASICO COMUN CARABOBO	3480	6	56	2835	1558	2779	1	9	2	4	1205	2835
EDO. CARABOBO	MP. PUERTO CABELLO	PQ. BARTOLOME SALOM	UNIDAD EDUCATIVA MANUELA SAENZ	671	2	6	512	283	506	0	3	0	0	220	512
EDO. CARABOBO	MP. PUERTO CABELLO	PQ. BARTOLOME SALOM	UNIDAD EDUCATIVA OVIDIO DE CROLY	616	2	6	523	352	517	0	4	0	0	161	523
EDO. CARABOBO	MP. PUERTO CABELLO	PQ. BARTOLOME SALOM	ESCUELA FEDERAL JOSE RAMON PELAYO	4278	8	47	3559	1309	3512	1	4	0	1	2197	3559
EDO. CARABOBO	MP. PUERTO CABELLO	PQ. BARTOLOME SALOM	UNIDAD EDUCATIVA MUNICIPAL CARLOS AUGUSTO CUBILLAN	2065	4	19	1658	645	1639	0	4	0	0	990	1658
EDO. CARABOBO	MP. PUERTO CABELLO	PQ. BARTOLOME SALOM	UNIDAD EDUCATIVA MUNICIPAL VALLE SECO	544	1	12	399	269	387	1	0	0	0	117	399
EDO. CARABOBO	MP. PUERTO CABELLO	PQ. BARTOLOME SALOM	UNIDAD EDUCATIVA MUNICIPAL DR ADOLFO PRINCE LARA	1420	3	23	1092	423	1069	0	3	0	1	642	1092
EDO. CARABOBO	MP. PUERTO CABELLO	PQ. BARTOLOME SALOM	ESCUELA GRADUADA GUILLERMO SMITH	2507	5	37	2084	1363	2047	0	7	0	2	675	2084
EDO. CARABOBO	MP. PUERTO CABELLO	PQ. BARTOLOME SALOM	UNIDAD EDUCATIVA MIS VECINOS	1348	3	18	1122	799	1104	0	8	0	0	297	1122
EDO. CARABOBO	MP. PUERTO CABELLO	PQ. BARTOLOME SALOM	ESCUELA ADOLFO PRINCE LARA	895	2	31	683	446	652	0	3	1	0	202	683
EDO. CARABOBO	MP. PUERTO CABELLO	PQ. BARTOLOME SALOM	UNIDAD EDUCATIVA VALLE VERDE	1796	4	28	1504	1249	1476	0	5	0	0	222	1504
EDO. VARGAS	CE. VARGAS	PQ. CARABALLEDA	DESARROLLO URBANISTICO CARABALLEDA IV	146	1	2	132	125	130	0	0	0	0	5	132
EDO. VARGAS	CE. VARGAS	PQ. CARABALLEDA	DESARROLLO URBANISTICO CARABALLEDA III	62	1	0	60	58	60	0	0	0	0	2	60
EDO. VARGAS	CE. VARGAS	PQ. CARABALLEDA	UNIDAD EDUCATIVA PRIVADA COLEGIO SANTO DOMINGO DE GUZMAN	1322	3	30	1092	738	1062	1	7	1	1	314	1092
EDO. VARGAS	CE. VARGAS	PQ. CARABALLEDA	ESCUELA HILDA VASQUEZ	450	1	6	405	261	399	0	2	0	0	136	405
EDO. VARGAS	CE. VARGAS	PQ. CARABALLEDA	DESARROLLO URBANISTICO CARABALLEDA VI	147	1	3	138	130	135	0	0	1	0	4	138
EDO. VARGAS	CE. VARGAS	PQ. CARABALLEDA	UNIDAD EDUCATIVA NACIONAL CORAPAL	3306	6	38	2600	1526	2562	0	12	3	3	1018	2600
EDO. VARGAS	CE. VARGAS	PQ. CARABALLEDA	UNIDAD EDUCATIVA PRIVADA VENEZUELA HEROICA	1786	4	13	1287	329	1274	0	4	0	1	940	1287
EDO. VARGAS	CE. VARGAS	PQ. CARABALLEDA	ESCUELA BASICA ESTATAL LUIS CASTRO	2393	5	49	1852	1103	1803	0	12	1	2	685	1852
EDO. VARGAS	CE. VARGAS	PQ. CARABALLEDA	JARDIN DE INFANCIA CORAPAL	1882	4	38	1473	901	1435	2	9	1	2	520	1473
EDO. VARGAS	CE. VARGAS	PQ. CARABALLEDA	INSTITUTO DE EDUCACION ESPECIAL MODELO LA GUAIRA	565	1	5	449	286	444	0	0	0	0	158	449
EDO. VARGAS	CE. VARGAS	PQ. CARABALLEDA	CASA COMUNAL EL CAIMITO	324	1	6	294	236	288	0	0	1	0	51	294
EDO. VARGAS	CE. VARGAS	PQ. CARABALLEDA	ESCUELA INTEGRAL BOLIVARIANA EZEQUIEL ZAMORA	1474	3	19	1212	751	1193	0	5	0	0	437	1212
EDO. VARGAS	CE. VARGAS	PQ. CARABALLEDA	UNIDAD EDUCATIVA PRIVADA COLEGIO LA MERCED	4571	8	48	3835	792	3787	0	15	0	0	2980	3835
EDO. VARGAS	CE. VARGAS	PQ. CARABALLEDA	CENTRO MOVIL CASA DE LA CULTURA DE TANAGUERENA	344	1	5	302	211	297	0	3	0	0	83	302
EDO. VARGAS	CE. VARGAS	PQ. CARABALLEDA	ESCUELA NACIONAL CARABALLEDA	2782	5	44	2155	1107	2111	1	8	0	1	994	2155
EDO. VARGAS	CE. VARGAS	PQ. CARABALLEDA	UNIDADAD EDUCATIVA PRIVADA TANAGUARENA	2829	5	33	2298	964	2265	0	7	1	3	1290	2298
EDO. VARGAS	CE. VARGAS	PQ. CARABALLEDA	COLEGIO LOS CORALES 2006	1157	2	33	1021	435	988	1	3	0	1	548	1021
EDO. VARGAS	CE. VARGAS	PQ. CARABALLEDA	UNIDAD EDUCATIVA SIMON BOLIVAR FE Y ALEGRIA	896	2	13	661	299	648	0	1	0	0	348	661
EDO. VARGAS	CE. VARGAS	PQ. CARABALLEDA	UNIDAD EDUCATIVA NACIONAL JUAN JOSE MENDOZA	2835	5	30	2138	948	2108	0	7	0	0	1153	2138
EDO. VARGAS	CE. VARGAS	PQ. MAIQUETIA	ESCUELA. BASICA. ESTATAL JUAN GERMAN ROSCIO	2636	5	35	2025	1246	1990	3	7	0	3	731	2025
EDO. VARGAS	CE. VARGAS	PQ. MAIQUETIA	ESCUELA MANUEL SEGUNDO SANCHEZ	3803	7	61	3048	1733	2987	2	13	1	2	1236	3048
EDO. VARGAS	CE. VARGAS	PQ. MAIQUETIA	GRUPO ESCOLAR REPUBLICA DEL SALVADOR	4122	8	62	3060	1901	2998	1	14	3	1	1078	3060
EDO. VARGAS	CE. VARGAS	PQ. MAIQUETIA	UNIDAD EDUCATIVA  BASICA NACIONAL FERNANDO TORO	1550	3	24	1196	742	1172	1	6	2	1	420	1196
EDO. VARGAS	CE. VARGAS	PQ. MAIQUETIA	ESCUELA BASICA NACIONAL EVELIA DE PIMENTEL	1285	3	32	996	589	964	0	6	0	1	368	996
EDO. VARGAS	CE. VARGAS	PQ. MAIQUETIA	UNIDAD EDUCATIVA MADRE EMILIA	1008	2	14	834	514	820	0	5	0	1	300	834
EDO. VARGAS	CE. VARGAS	PQ. MAIQUETIA	UNIDAD EDUCATIVA PRIVADA COLEGIO SAN VICENTE DE PAUL	1603	3	21	1304	497	1283	0	8	1	1	776	1304
EDO. VARGAS	CE. VARGAS	PQ. MAIQUETIA	UNIDAD EDUCATIVA PRIVADA MARACAIBO III	586	1	6	462	278	456	0	3	0	0	175	462
EDO. VARGAS	CE. VARGAS	PQ. MAIQUETIA	UNIDAD EDUCTIVA PRIVADA TOMAS ALBA EDISON	665	2	13	568	357	555	0	0	1	0	197	568
EDO. VARGAS	CE. VARGAS	PQ. MAIQUETIA	UNIDAD EDUCATIVA NACIONAL. MACUTO	2153	4	33	1687	1089	1654	0	12	1	6	546	1687
EDO. VARGAS	CE. VARGAS	PQ. MAIQUETIA	ESCUELA. BASICA. ESTATAL JUAN ARANAGA	2444	5	44	1884	1050	1840	0	14	0	1	775	1884
EDO. VARGAS	CE. VARGAS	PQ. MAIQUETIA	UNIDAD EDUCATIVA PRIVADA COLEGIO SALTO DEL ANGEL	458	1	7	377	226	370	0	1	1	0	142	377
EDO. VARGAS	CE. VARGAS	PQ. MAIQUETIA	UNIDAD EDUCATIVA. ESTADAL MARIA MAYZ	1850	4	34	1433	1110	1399	0	4	1	2	282	1433
EDO. VARGAS	CE. VARGAS	PQ. MAIQUETIA	UNIDAD EDUCATIVA PRIVADA COLEGIO JUAN ALVAREZ SUSAN	531	1	8	425	280	417	0	1	0	1	135	425
EDO. VARGAS	CE. VARGAS	PQ. MAIQUETIA	UNIDAD EDUCATIVA. PRIVADA COLEGIO SANTA ANA	2582	5	39	2134	1134	2095	1	5	1	4	950	2134
EDO. VARGAS	CE. VARGAS	PQ. MAIQUETIA	ESCUELA. TECNOLOGICA. LICENCIADO ARANDA	2691	5	39	2100	1239	2061	0	7	1	0	814	2100
EDO. VARGAS	CE. VARGAS	PQ. CARLOS SOUBLETTE	UNIDAD EDUCATIVA ESTATAL JESUS MARIA PORTILLO	4212	8	81	3454	2454	3373	1	25	5	7	881	3454
EDO. VARGAS	CE. VARGAS	PQ. CARLOS SOUBLETTE	UNIDAD EDUCATIVA PRIVADO COLEGIO MONTESANO	2122	4	37	1684	1099	1647	0	8	0	2	538	1684
EDO. VARGAS	CE. VARGAS	PQ. CARLOS SOUBLETTE	UNIDAD EDUCATIVA NACIONAL LICEO BOLIVARIANO MARIANO MONTILLA	599	1	2	430	313	428	0	1	0	0	114	430
EDO. VARGAS	CE. VARGAS	PQ. CARLOS SOUBLETTE	DESARROLLO URBANISTICO MARE ABAJO	93	1	4	83	79	79	0	0	0	0	0	83
EDO. VARGAS	CE. VARGAS	PQ. CARLOS SOUBLETTE	ESCUELA MUNICIPAL MIGUEL ZUNIAGA	2428	5	47	2014	1114	1967	0	11	0	0	842	2014
EDO. VARGAS	CE. VARGAS	PQ. CARLOS SOUBLETTE	ESCUELA BASICA ARCHIPIELAGO LOS ROQUES	1069	2	14	688	355	674	0	6	0	0	313	688
EDO. VARGAS	CE. VARGAS	PQ. CARLOS SOUBLETTE	CENTRO DE FORMACION LABORAL SAN MARTIN DE PORRAS	355	1	5	314	259	309	0	3	0	1	46	314
EDO. VARGAS	CE. VARGAS	PQ. CARLOS SOUBLETTE	UNIDAD EDUCATIVA PRIVADA FRANCISCO LINARES ALCANTARA	330	1	4	246	173	242	0	1	1	0	67	246
EDO. VARGAS	CE. VARGAS	PQ. CARLOS SOUBLETTE	LICEO BOLIVARIANO LORENZO GONZÁLEZ	613	2	4	468	372	464	0	3	0	2	87	468
EDO. VARGAS	CE. VARGAS	PQ. CARLOS SOUBLETTE	INSTITUTO NAUTICO UNIDAD EDUCATIVA JOSE MANUEL SISO MARTINEZ	2743	5	57	1985	1264	1928	0	9	0	2	653	1985
EDO. VARGAS	CE. VARGAS	PQ. CARLOS SOUBLETTE	ESCUELA MUNICIPAL ALBERTO RAVELL	2662	5	43	2138	1538	2095	2	10	1	2	542	2138
EDO. VARGAS	CE. VARGAS	PQ. CARLOS SOUBLETTE	UNIDAD EDUCATIVA. NACIONAL. BOLIVARIANA 10 DE MARZO	3329	6	61	2665	1563	2604	0	12	0	1	1028	2665
EDO. VARGAS	CE. VARGAS	PQ. CARLOS SOUBLETTE	CASA SCOUT NIQUITAO	332	1	7	269	175	262	0	0	0	0	87	269
EDO. VARGAS	CE. VARGAS	PQ. CARLOS SOUBLETTE	ESCUELA. INTEGRAL BOLIVARIANA EUGENIA MARIA DE HOSTOS	3168	6	36	2481	1249	2445	2	13	1	1	1179	2481
EDO. VARGAS	CE. VARGAS	PQ. CARLOS SOUBLETTE	ESCUELA MUNICIPAL HUGO DOMINGUEZ SANCHEZ	3181	6	66	2628	1453	2562	0	15	0	4	1090	2628
EDO. VARGAS	CE. VARGAS	PQ. CARLOS SOUBLETTE	ESCUELA NACIONAL 1136 3424 NUCLEO 370	506	1	12	452	294	440	0	3	2	0	141	452
EDO. VARGAS	CE. VARGAS	PQ. CARLOS SOUBLETTE	UNIDAD. EDUCATIVA. NACIONAL. BOLIVARIANA MARE ABAJO	1845	4	27	1511	1148	1484	0	10	0	0	326	1511
EDO. VARGAS	CE. VARGAS	PQ. CARLOS SOUBLETTE	CENTRO MOVIL MAÑONGA	312	1	5	273	215	268	0	1	0	0	52	273
EDO. VARGAS	CE. VARGAS	PQ. CARLOS SOUBLETTE	UNIDAD EDUCATIVA NACIONAL JOSE MARIA VARGAS	3230	6	43	2500	1385	2457	0	12	3	3	1054	2500
EDO. VARGAS	CE. VARGAS	PQ. CARLOS SOUBLETTE	U.E.N JOSE MARIA VARGAS (2)	518	1	5	412	257	407	0	2	0	0	148	412
EDO. VARGAS	CE. VARGAS	PQ. CARAYACA	UNIDAD EDUCATIVA ESTADAL LOURDES DE CASTILLO	659	2	17	583	482	566	0	0	0	0	84	583
EDO. VARGAS	CE. VARGAS	PQ. CARAYACA	ESCUELA UNITARIA LILIAN DE CASADO	107	1	0	84	81	84	0	0	1	0	2	84
EDO. VARGAS	CE. VARGAS	PQ. CARAYACA	DISPENSARIO DE PALO E VACA	237	1	1	198	178	197	0	2	0	0	17	198
EDO. VARGAS	CE. VARGAS	PQ. CARAYACA	UNIDAD. EDUCATIVA. NACIONAL. BOLIVARIANA PIO RENGIFO	2037	4	22	1565	1171	1543	1	7	1	0	363	1565
EDO. VARGAS	CE. VARGAS	PQ. CARAYACA	ESCUELA BASICA ESTADAL ANA DOLORES CABRERA	125	1	2	106	87	104	0	1	0	0	16	106
EDO. VARGAS	CE. VARGAS	PQ. CARAYACA	CENTRO MOVIL MODULO DE LA POLICIA	461	1	5	395	318	390	0	4	1	0	67	395
EDO. VARGAS	CE. VARGAS	PQ. CARAYACA	ESCUELA BASICA ESTADAL CONCENTRADA ALFREDO ZAMORA	369	1	15	305	261	290	1	0	1	1	26	305
EDO. VARGAS	CE. VARGAS	PQ. CARAYACA	UNITARIA ANEXO 9 PROF. YURI BERMUDEZ	213	1	3	192	153	189	0	1	0	0	35	192
EDO. VARGAS	CE. VARGAS	PQ. CARAYACA	ESCUELA BASICA ESTADAL CONCENTRADA GLORIA VARGAS	100	1	1	87	66	86	0	1	0	0	19	87
EDO. VARGAS	CE. VARGAS	PQ. CARAYACA	ESCUELA INTEGRAL BOLIVARIANA CAOMA	574	1	10	431	285	421	0	2	1	0	133	431
EDO. VARGAS	CE. VARGAS	PQ. CARAYACA	CENTRO MOVIL EL ARENAL	271	1	2	239	223	237	0	0	0	0	14	239
EDO. VARGAS	CE. VARGAS	PQ. CARAYACA	ESCUELA RURAL BOLIVARIANA EL INCIENSO	126	1	3	107	77	104	0	2	0	0	25	107
EDO. VARGAS	CE. VARGAS	PQ. CARAYACA	ESCUELA BASICA ESTADAL CONCENTRADA NATIVIDAD CARABALLO	69	1	5	54	46	49	0	0	0	0	3	54
EDO. VARGAS	CE. VARGAS	PQ. CARAYACA	ESCUELA. BASICA. ESTADAL CONCENTRADA DON PASTOR CASTRO GARCIA	721	2	6	551	425	545	1	4	3	0	112	551
EDO. VARGAS	CE. VARGAS	PQ. CARAYACA	ESCUELA. BASICA. ESTADAL CONCENTRADA ROMULO MONASTERIO	666	2	5	464	365	459	0	2	1	1	90	464
EDO. VARGAS	CE. VARGAS	PQ. CARAYACA	ESCUELA ANIBAL GARCIA	102	1	0	91	88	91	0	0	0	0	3	91
EDO. VARGAS	CE. VARGAS	PQ. CARAYACA	UNIDAD EDUCATIVA BOLIVARIANA JOSEFA JOAQUINA SANCHEZ	812	2	12	622	324	610	1	2	0	1	282	622
EDO. VARGAS	CE. VARGAS	PQ. CARAYACA	UNIDAD EDUCATIVA ESTADAL AGUARITO	439	1	9	385	351	376	0	2	0	0	23	385
EDO. VARGAS	CE. VARGAS	PQ. CARAYACA	ESCUELA. BASICA. ESTADAL CONCENTRADA FRANCISCA DE FELIBERTT	242	1	1	134	99	133	0	0	0	0	34	134
EDO. VARGAS	CE. VARGAS	PQ. CARAYACA	ESCUELA BASICA ESTADAL CONCENTRADA PUBLIO AMARYTA	267	1	5	222	185	217	1	0	0	0	31	222
EDO. VARGAS	CE. VARGAS	PQ. CARAYACA	PREESCOLAR LUISA NHAMENS	203	1	4	182	144	178	0	1	0	0	33	182
EDO. VARGAS	CE. VARGAS	PQ. CARAYACA	ESCUELA UNITARIA EUTIMIO ENRIQUE LASTRA RIBAS	159	1	2	130	110	128	0	0	1	0	17	130
EDO. VARGAS	CE. VARGAS	PQ. CARAYACA	ESCUELA. BASICA. ESTATAL TIRSO JOSE ORTIZ	411	1	5	319	297	314	0	0	0	0	17	319
EDO. VARGAS	CE. VARGAS	PQ. CARAYACA	ESCUELA KATTY PHELTS	80	1	0	59	47	59	0	1	0	0	11	59
EDO. VARGAS	CE. VARGAS	PQ. CARAYACA	ESCUELA BASICA ESTADAL BARRIO NUEVO	643	2	1	561	451	560	0	2	3	0	104	561
EDO. VARGAS	CE. VARGAS	PQ. CARAYACA	ESCUELA BÁSICA ESTADAL CONCENTRADA LUIS ANTONIO ARCIA MIRABAL	133	1	0	116	104	116	0	0	0	0	12	116
EDO. VARGAS	CE. VARGAS	PQ. CARAYACA	E.B. CONCENTRADA ANGEL ALBERTO PEREZ	353	1	3	226	198	223	0	0	0	0	25	226
EDO. VARGAS	CE. VARGAS	PQ. CARAYACA	UNIDAD EDUCATIVA. NACIONAL. GUAICAIPURO	1895	4	38	1511	1025	1473	0	5	1	2	440	1511
EDO. VARGAS	CE. VARGAS	PQ. CARAYACA	ESCUELA SAMUEL CAMARGO	113	1	0	95	95	95	0	0	0	0	0	95
EDO. VARGAS	CE. VARGAS	PQ. CARAYACA	ESCUELA BASICA BOLIVARIANA LAS SALINAS	654	2	16	534	383	518	0	4	0	0	131	534
EDO. VARGAS	CE. VARGAS	PQ. CARAYACA	ESCUELA BASICA ESTADAL CONCENTRADA ULISES MARTINEZ	447	1	5	363	281	358	0	1	1	0	75	363
EDO. VARGAS	CE. VARGAS	PQ. CARAYACA	ESCUELA.BASICA ESTADAL CONCENTRADA MARIA PIMENTEL	424	1	5	231	174	226	1	1	3	0	47	231
EDO. VARGAS	CE. VARGAS	PQ. CARAYACA	UNIDAD EDUCATIVA. PRIVADA PARROQUIAL SAN JOSE	2502	5	59	2084	1102	2025	1	8	0	3	911	2084
EDO. VARGAS	CE. VARGAS	PQ. CARAYACA	UNIDAD EDUCATIVA ESTATAL RAFAEL RANGEL	2288	4	40	1700	987	1660	1	8	1	0	663	1700
EDO. VARGAS	CE. VARGAS	PQ. CARAYACA	UNIDAD EDUCATIVA ESTATAL DOCTOR HECTOR JESUS BETANCOURT	596	1	7	435	332	428	0	2	0	0	94	435
EDO. VARGAS	CE. VARGAS	PQ. CARAYACA	UNIDAD EDUCATIVA SAN ESTEBAN
EDO. VARGAS	CE. VARGAS	PQ. CARAYACA	ESCUELA. BASICA. ESTADAL CONCENTRADA LA PEÑITA	918	2	9	543	416	534	0	3	0	2	113	543
EDO. VARGAS	CE. VARGAS	PQ. CARAYACA	U.E.E.C. LAURA DE LOVERA	191	1	3	152	132	149	0	1	0	0	16	152
EDO. VARGAS	CE. VARGAS	PQ. CARAYACA	ESCUELA. BASICA. ESTADAL CONCENTRADA. JUAN ANTONIO FONSECA	696	2	10	565	516	555	0	2	0	0	37	565
EDO. VARGAS	CE. VARGAS	PQ. CARAYACA	ESCUELA BASICA ESTADAL CONCENTRADA JOSEFINA RODRIGUEZ ALEMAN	182	1	2	161	131	159	0	3	0	0	25	161
EDO. VARGAS	CE. VARGAS	PQ. CARAYACA	ESCUELA. BASICA. NACIONAL. EL PARDILLO	2139	4	14	1708	1336	1694	1	15	2	1	339	1708
EDO. VARGAS	CE. VARGAS	PQ. NAIGUATA	ESCUELA BASICA NACIONAL CERRO COLORADO	299	1	6	256	226	250	0	1	1	0	22	256
EDO. VARGAS	CE. VARGAS	PQ. NAIGUATA	ESCUELA. INTEGRAL BOLIVARIANA GENERAL CARLOS SOUBLETTE	890	2	13	556	347	543	0	2	0	0	194	556
EDO. VARGAS	CE. VARGAS	PQ. NAIGUATA	UNIDAD EDUCATIVA ESTATAL NAIGUATA	2737	5	35	2271	1430	2236	0	14	1	4	787	2271
EDO. VARGAS	CE. VARGAS	PQ. NAIGUATA	ESCUELA INTEGRAL BOLIVARIANA NACIONAL NAIGUATA	3636	7	48	2786	1817	2738	2	9	0	2	908	2786
EDO. VARGAS	CE. VARGAS	PQ. NAIGUATA	UNIDAD EDUCATIVA INTEGRAL BOLIVARIANA LOS CARACAS	472	1	12	416	357	404	1	0	0	0	46	416
EDO. VARGAS	CE. VARGAS	PQ. NAIGUATA	LICEO BOLIVARIANO CACIQUE NAIGUATA	631	2	12	530	330	518	0	2	0	1	185	530
EDO. VARGAS	CE. VARGAS	PQ. NAIGUATA	ESCUELA. INTEGRAL BOLIVARIANA ESTATAL FRANCISCO LAZO MARTI	1312	3	28	1070	666	1042	0	3	0	0	373	1070
EDO. VARGAS	CE. VARGAS	PQ. NAIGUATA	ESCUELA BOLIVARIANA RURAL CIUDAD VACACIONAL LOS CARACAS NUCLEO NERS 397	331	1	10	288	264	278	0	0	0	0	14	288
EDO. VARGAS	CE. VARGAS	PQ. NAIGUATA	ESCUELA INTEGRAL BOLIVARIANA MARTIN LUTHER KING	781	2	13	671	509	658	0	2	1	0	146	671
EDO. VARGAS	CE. VARGAS	PQ. NAIGUATA	UNIDAD EDUCATIVA PRIVADA NUESTRA SEÑORA DE COROMOTO	2682	5	32	2271	1535	2239	0	14	2	1	687	2271
EDO. VARGAS	CE. VARGAS	PQ. MACUTO	UNIDAD EDUCATIVA SIMON RODRIGUEZ	556	1	9	438	214	429	0	2	0	1	212	438
EDO. VARGAS	CE. VARGAS	PQ. MACUTO	LICEO BOLIVARIANO PEDRO ELIAS GUTIERREZ	1370	3	7	1128	489	1121	0	6	0	0	626	1128
EDO. VARGAS	CE. VARGAS	PQ. MACUTO	ESCUELA INTEGRAL BOLIVARIANA SAN ISIDRO DE GALIPAN	854	2	9	686	381	677	0	7	0	1	288	686
EDO. VARGAS	CE. VARGAS	PQ. MACUTO	UNIDAD EDUCATIVA NACIONAL LICEO BOLIVARIANO JOSE MARIA ESPAÑA	1904	4	24	1516	485	1492	0	5	2	0	1000	1516
EDO. VARGAS	CE. VARGAS	PQ. MACUTO	ESCUELA BASICA ESTADAL CARMEN FELICIA COLON	1808	4	32	1516	739	1484	1	6	0	2	736	1516
EDO. VARGAS	CE. VARGAS	PQ. MACUTO	UNIDAD EDUCATIVA INTEGRAL BOLIVARIANA FRANCISCO FAJARDO	1623	3	19	1177	528	1158	0	7	0	0	623	1177
EDO. VARGAS	CE. VARGAS	PQ. MACUTO	UNIDAD EDUCATIVA PRIVADA BLAISE PASCAL	1306	3	15	1133	572	1118	0	7	0	1	538	1133
EDO. VARGAS	CE. VARGAS	PQ. MACUTO	ESCUELA BASICA RURALUNITARIA SAN JOSE  DE GALIPAN	316	1	1	235	150	234	0	1	0	0	83	235
EDO. VARGAS	CE. VARGAS	PQ. MACUTO	ESCUELA INTEGRAL BOLIVARIANA GUAICAMACUTO	4562	8	41	3494	1566	3453	1	9	1	2	1874	3494
EDO. VARGAS	CE. VARGAS	PQ. MACUTO	CASA COMUNAL GUAICOTO	458	1	6	380	295	374	0	1	0	2	76	380
EDO. VARGAS	CE. VARGAS	PQ. CARUAO	ESCUELA. BASICA. ESTATAL CONCENTRADA PRIMITIVA BLANCO	470	1	3	353	286	350	1	0	1	0	62	353
EDO. VARGAS	CE. VARGAS	PQ. CARUAO	PRE ESCOLAR NACIONAL BOLIVARIANO JOSEFA JOAQUINA SANCHEZ	353	1	6	312	205	306	0	0	0	0	101	312
EDO. VARGAS	CE. VARGAS	PQ. CARUAO	ESCUELA INTEGRAL BOLIVARIANA SAN JORGE	287	1	6	230	189	224	1	0	0	0	34	230
EDO. VARGAS	CE. VARGAS	PQ. CARUAO	UNIDAD EDUCATIVA. ESTATAL OSMA	447	1	3	345	270	342	0	0	0	0	72	345
EDO. VARGAS	CE. VARGAS	PQ. CARUAO	ESCUELA. BASICA. ESTATAL ELINA MARINS	676	2	20	536	342	516	0	1	1	0	172	536
EDO. VARGAS	CE. VARGAS	PQ. CARUAO	ESCUELA BASICA ESTATAL MARIA VILLALOBOS	1325	3	27	1064	603	1037	0	6	1	3	424	1064
EDO. VARGAS	CE. VARGAS	PQ. CARUAO	ESCUELA INTEGRAL BOLIVARIANA ZEA	717	2	13	545	348	532	0	7	2	0	175	545
EDO. VARGAS	CE. VARGAS	PQ. CARUAO	ESCUELA. BASICA. ESTADAL GLADYS ACOSTA BELLO	549	1	9	444	344	435	0	2	0	0	89	444
EDO. VARGAS	CE. VARGAS	PQ. URIMARE	COLEGIO CIENCIAS DEL MAR	1188	2	15	1021	535	1006	1	5	0	0	465	1021
EDO. VARGAS	CE. VARGAS	PQ. URIMARE	UNIDAD EDUCATIVA NACIONAL ARMANDO REVERON	4303	8	56	3539	1656	3483	0	18	4	2	1803	3539
EDO. VARGAS	CE. VARGAS	PQ. URIMARE	HOSP ANTIHANSENIANO MARTIN VEGAS	722	2	17	535	426	518	0	0	0	0	92	535
EDO. VARGAS	CE. VARGAS	PQ. URIMARE	CASA COMUNAL PLAYA VERDE	576	1	6	481	373	475	0	1	0	0	101	481
EDO. VARGAS	CE. VARGAS	PQ. URIMARE	UNIDAD EDUCATIVA NACIONAL BOLIVARIANA JUAN DE URPIN	2395	5	37	1976	917	1939	1	11	1	2	1007	1976
EDO. VARGAS	CE. VARGAS	PQ. URIMARE	CENTRO MOVIL LA LUCHA	461	1	5	398	273	393	0	0	0	0	120	398
EDO. VARGAS	CE. VARGAS	PQ. URIMARE	UNIDAD EDUCATIVA PRIVADA COLEGIO JOSE ATANASIO GIRARDOT	4062	7	45	3369	1184	3324	3	16	3	3	2115	3369
EDO. VARGAS	CE. VARGAS	PQ. URIMARE	PRE ESCOLAR WILLY	419	1	3	309	217	306	0	3	0	2	84	309
EDO. VARGAS	CE. VARGAS	PQ. URIMARE	UNIDAD EDUCATIVA PRIVADA COLEGIO VIRGEN DEL VALLE	1234	3	19	1036	476	1017	0	0	1	3	537	1036
EDO. VARGAS	CE. VARGAS	PQ. URIMARE	UNIDAD EDUCATIVA DIVINA PROVIDENCIA	649	2	13	571	244	558	1	2	0	0	311	571
EDO. VARGAS	CE. VARGAS	PQ. URIMARE	CASA COMUNAL BRISAS DE MAIQUETIA	723	2	7	682	646	675	1	1	0	0	27	682
EDO. VARGAS	CE. VARGAS	PQ. URIMARE	DESARROLLO URBANISTICO PLAYA GRANDE   TURQUIA	279	1	3	260	253	257	0	0	0	0	4	260
EDO. VARGAS	CE. VARGAS	PQ. URIMARE	CENTRO (MOVIL) SECTOR SANTA EDUVIGES	717	2	4	561	487	557	0	2	0	0	68	561
EDO. VARGAS	CE. VARGAS	PQ. URIMARE	ESCUELA BASICA ESTADAL JACINTO FOMBONA PACHANO	1589	3	31	1305	788	1274	3	9	1	0	473	1305
EDO. VARGAS	CE. VARGAS	PQ. URIMARE	UNIDAD EDUCATIVA NACIONAL BOLIVARIANA SANTA EDUVIGIS	5042	9	76	4087	3041	4011	5	27	3	0	935	4087
EDO. VARGAS	CE. VARGAS	PQ. CATIA LA MAR	ESCUELA BASICA ESTADAL BOLIVARIANA LAS TUNITAS	2454	5	46	1800	1092	1754	0	17	0	0	645	1800
EDO. VARGAS	CE. VARGAS	PQ. CATIA LA MAR	CENTRO DE ESPECIALIDADES LUISA ROMERO	1624	3	32	1339	657	1307	1	11	1	0	637	1339
EDO. VARGAS	CE. VARGAS	PQ. CATIA LA MAR	ESCUELA. BASICA. ESTADAL VIA ETERNA	2919	5	55	2369	1795	2314	0	14	2	0	503	2369
EDO. VARGAS	CE. VARGAS	PQ. CATIA LA MAR	UNIDAD EDUCATIVA ESTATAL DOCTOR ALFREDO MACHADO	4441	8	72	3471	2096	3399	2	10	3	0	1288	3471
EDO. VARGAS	CE. VARGAS	PQ. CATIA LA MAR	ESCUELA INTEGRAL BOLIVARIANA FE Y ESPERANZA	325	1	4	275	259	271	0	0	0	0	12	275
EDO. VARGAS	CE. VARGAS	PQ. CATIA LA MAR	COLEGIO ROMULO BETANCOURT	1758	3	22	1421	853	1399	0	6	0	2	538	1421
EDO. VARGAS	CE. VARGAS	PQ. CATIA LA MAR	JARDIN DE INFANCIA LOS OLIVOS	457	1	11	398	336	387	0	1	1	0	49	398
EDO. VARGAS	CE. VARGAS	PQ. CATIA LA MAR	UNIDAD EDUCATIVA PRIVADA GUAL Y ESPAÑA	1054	2	6	751	164	745	0	2	0	1	578	751
EDO. VARGAS	CE. VARGAS	PQ. CATIA LA MAR	ESCUELA. BASICA. ESTADAL ARRECIFE	2665	5	49	2139	1501	2090	1	13	2	1	572	2139
EDO. VARGAS	CE. VARGAS	PQ. CATIA LA MAR	UNIDAD EDUCATIVA NACIONAL DOCTOR RAFAEL VEGAS	2384	5	43	1979	1489	1936	0	13	4	2	428	1979
EDO. VARGAS	CE. VARGAS	PQ. CATIA LA MAR	UNIDAD EDUCATIVA. ESTADAL MONSEÑOR ARIAS BLANCO	1633	3	25	1331	919	1306	0	4	0	1	382	1331
EDO. VARGAS	CE. VARGAS	PQ. CATIA LA MAR	UNIVERSIDAD MARITIMA DEL CARIBE	2270	4	32	1689	1234	1657	1	6	3	4	409	1689
EDO. VARGAS	CE. VARGAS	PQ. CATIA LA MAR	UNIDAD EDUCATIVA ESTADAL FELIX MARTIN VIERA	460	1	19	406	278	387	0	1	0	0	108	406
EDO. VARGAS	CE. VARGAS	PQ. CATIA LA MAR	UNIDAD EDUCATIVA ESTADAL LEON TRUJILLO	3234	6	32	2643	1570	2611	1	14	1	1	1024	2643
EDO. VARGAS	CE. VARGAS	PQ. CATIA LA MAR	UNIDAD EDUCATIVA PRIVADA FATIMA	397	1	9	308	225	299	0	1	0	0	73	308
EDO. VARGAS	CE. VARGAS	PQ. CATIA LA MAR	ESCUELA BASICA ESTADAL NEGRO PRIMERO	311	1	7	256	205	249	0	0	0	0	44	256
EDO. VARGAS	CE. VARGAS	PQ. CATIA LA MAR	C.E.I. JOSE PEREZ CHIRINOS	330	1	4	274	195	270	0	2	0	0	73	274
EDO. VARGAS	CE. VARGAS	PQ. CATIA LA MAR	C.E.I.N. YAJAIRA CASTILLO	327	1	3	297	241	294	0	2	0	1	50	297
EDO. VARGAS	CE. VARGAS	PQ. CATIA LA MAR	ESCUELA BASICA BOLIVARIANA NACIONAL LA ESPERANZA	1894	4	30	1543	1315	1513	0	10	1	2	185	1543
EDO. VARGAS	CE. VARGAS	PQ. CATIA LA MAR	CENTRO MOVIL LA CANCHA	298	1	4	256	213	252	0	2	0	0	37	256
EDO. VARGAS	CE. VARGAS	PQ. CATIA LA MAR	ESCUELA BASICA NACIONAL VALLE LA CRUZ
EDO. VARGAS	CE. VARGAS	PQ. CATIA LA MAR	PRE ESCOLAR CRISTOBAL ROJAS	643	2	7	490	323	483	0	2	1	1	156	490
EDO. VARGAS	CE. VARGAS	PQ. CATIA LA MAR	ESCUELA BASICA NACIONAL BOLIVARIANA RAFAEL CABRICES BELTRAN	303	1	11	254	191	243	1	1	0	0	50	254
EDO. VARGAS	CE. VARGAS	PQ. CATIA LA MAR	UNIDAD EDUCATIVA ESTADAL EMILIO GIMON STERLING	4587	8	81	3478	2078	3397	0	12	3	4	1300	3478
EDO. VARGAS	CE. VARGAS	PQ. CATIA LA MAR	ESCUELA. BASICA. NACIONAL. CATIA LA MAR	3918	7	60	3068	2301	3008	0	10	2	2	693	3068
EDO. VARGAS	CE. VARGAS	PQ. CATIA LA MAR	ESCUELA. ESTATAL VICENTE LECUNA	2792	5	40	2153	1578	2113	1	12	2	2	518	2153
EDO. VARGAS	CE. VARGAS	PQ. CATIA LA MAR	ESCUELA BASICA NACIONAL BOLIVARIANA VISTA AL MAR	784	2	14	650	558	636	0	4	1	2	71	650
EDO. VARGAS	CE. VARGAS	PQ. CATIA LA MAR	U.E. ANGEL VALERO HOSTOS	1434	3	29	1265	870	1236	1	4	0	1	360	1265
EDO. VARGAS	CE. VARGAS	PQ. CATIA LA MAR	UNIDAD EDUCATIVA NACIONAL GUSTAVO OLIVARES BOSQUES	2135	4	36	1743	968	1707	0	13	0	2	724	1743
EDO. VARGAS	CE. VARGAS	PQ. CATIA LA MAR	CENTRO DE EDUCACION INTEGRAL NAC. YAJAIRA CASTILLO	326	1	8	281	204	273	0	2	0	0	67	281
EDO. VARGAS	CE. VARGAS	PQ. CATIA LA MAR	UNIDAD EDUCATIVA INSTITUTO DE CIENCIAS DEL MAR	878	2	11	633	284	622	0	1	0	1	336	633
EDO. VARGAS	CE. VARGAS	PQ. CATIA LA MAR	UNIDAD. EDUCATIVA. PRIVADA JUAN XXIII TACAGUA	1138	2	11	933	292	922	0	2	1	0	627	933
EDO. VARGAS	CE. VARGAS	PQ. CATIA LA MAR	UNIDAD EDUCATIVA PRIVADA COLEGIO SAN JOSE DE CATIA LA MAR	1967	4	18	1612	390	1594	1	7	1	1	1194	1612
EDO. VARGAS	CE. VARGAS	PQ. CATIA LA MAR	UNIDAD EDUCATIVA ESTADAL  EMILIO GIMON STERLING (2)	866	2	10	700	455	690	0	0	1	0	234	700
EDO. VARGAS	CE. VARGAS	PQ. CATIA LA MAR	UNIDAD EDUCATIVA. NACIONAL NARCISO GONELL	4680	9	58	3752	2412	3694	1	13	2	3	1263	3752
EDO. VARGAS	CE. VARGAS	PQ. CATIA LA MAR	UNIDAD EDUCATIVA ESTADAL MARAPA	2904	5	35	2271	1614	2236	2	18	2	1	599	2271
EDO. VARGAS	CE. VARGAS	PQ. CATIA LA MAR	UNIDAD EDUCATIVA PRIVADA COLEGIO SAN FRANCISCO DE ASIS	450	1	7	362	286	355	0	2	0	1	66	362
EDO. VARGAS	CE. VARGAS	PQ. CATIA LA MAR	ESCUELA TECNICA INDUSTRIAL ROBINSONIANA CARLOS FIOLL	2370	5	18	1828	772	1810	0	9	0	1	1028	1828
EDO. VARGAS	CE. VARGAS	PQ. CATIA LA MAR	ESCUELA. ESTATAL GUARDERIA INFANTIL CATIA LA MAR	975	2	17	823	486	806	0	9	0	1	310	823
EDO. VARGAS	CE. VARGAS	PQ. EL JUNKO	UNIDAD EDUCATIVA ESTADAL PAULO FREIRE	215	1	0	181	144	181	1	0	0	0	36	181
EDO. VARGAS	CE. VARGAS	PQ. EL JUNKO	CENTRO MOVIL ESTACION DE BOMBEROS NUMERO : 4 HUMBERTO GERARDO OVALLES	1556	3	34	1197	538	1163	2	8	1	2	612	1197
EDO. VARGAS	CE. VARGAS	PQ. EL JUNKO	UNIDAD EDUCATIVA ESTADAL CONCENTRADA MAGALY ESPINOZA	939	2	40	772	547	732	0	1	1	0	183	772
EDO. VARGAS	CE. VARGAS	PQ. EL JUNKO	UNIDAD EDUCATIVA NACIONAL BOLIVARIANA EL JUNKO	1836	4	25	1482	620	1457	0	11	2	0	824	1482
EDO. VARGAS	CE. VARGAS	PQ. EL JUNKO	ESCUELA BASICA NACIONAL RURAL PETAQUIRE	633	2	16	446	304	430	1	4	2	1	118	446
EDO. VARGAS	CE. VARGAS	PQ. EL JUNKO	ESCUELA BASICA ESTADAL UNITARIA  TIBRONCITO	737	2	16	548	335	532	0	0	4	0	193	548
EDO. VARGAS	CE. VARGAS	PQ. EL JUNKO	UNIDAD EDUCATIVA LUISA AMALIA VEGAS DE VEGAS	599	1	10	481	272	471	0	5	0	0	194	481
EDO. VARGAS	CE. VARGAS	PQ. EL JUNKO	ESCUELA ANGEL QUINTANA	291	1	6	230	155	224	0	1	0	0	68	230
EDO. VARGAS	CE. VARGAS	PQ. EL JUNKO	UNIDAD EDUCATIVA ESTATAL CONCENTRADA LICENCIADO OCTAVIO BETANCOURT	327	1	4	251	198	247	0	2	0	0	47	251
EDO. VARGAS	CE. VARGAS	PQ. LA GUAIRA	ESCUELA INTEGRAL BOLIVARIANA REPUBLICA DE PANAMA	5160	9	128	4006	2282	3878	1	27	2	3	1563	4006
EDO. VARGAS	CE. VARGAS	PQ. LA GUAIRA	ESCUELA RURAL PROFESORA CARMEN RIÓ BUENO	325	1	4	293	237	289	0	1	0	0	51	293
EDO. VARGAS	CE. VARGAS	PQ. LA GUAIRA	ESCUELA  BOLIVARIANA EL TANQUE	437	1	3	381	283	378	0	0	0	0	95	381
EDO. VARGAS	CE. VARGAS	PQ. LA GUAIRA	UNIDAD EDUCATIVA NACIONAL SERGIO MARIA RECAGNO	1310	3	19	1058	645	1039	0	4	1	2	387	1058
EDO. VARGAS	CE. VARGAS	PQ. LA GUAIRA	ESCUELA MUNICIPAL LA GUAIRA	815	2	28	636	357	608	0	3	0	0	248	636
EDO. VARGAS	CE. VARGAS	PQ. LA GUAIRA	ANEXO DEL INSTITUTO UNIVERSITARIO DE TECNOLOGIA INDUSTRIAL RODOLFO LOERO ARISMENDI (IUTIRLA)	989	2	20	762	403	742	0	4	1	2	332	762
EDO. VARGAS	CE. VARGAS	PQ. LA GUAIRA	INSTITUTO UNIVERSITARIO DE TECNOLOGIA INDUSTRIAL RODOLFO LOERO ARISMENDI (IUTIRLA)	3118	6	56	2380	1130	2324	1	20	0	0	1173	2380
EDO. VARGAS	CE. VARGAS	PQ. LA GUAIRA	CASA COMUNAL GUANAPE II	337	1	3	293	208	290	0	0	1	0	81	293
EDO. VARGAS	CE. VARGAS	PQ. LA GUAIRA	ESCUELA MUNICIPAL LUISA CASTILLO	4398	8	112	3470	1987	3358	1	23	1	3	1343	3470
EDO. VARGAS	CE. VARGAS	PQ. LA GUAIRA	UNIDAD EDUCATIVA ESTADAL GENERAL AMBROSIO PLAZA	1300	3	24	976	587	952	0	6	1	0	358	976
EDO. VARGAS	CE. VARGAS	PQ. LA GUAIRA	PRE ESCOLAR LUISA CASTILLO	340	1	5	282	219	277	0	1	0	0	57	282
EDO. ZULIA	MP. LA CA#ADA DE U.	PQ. ANDRES BELLO (KM 48)	ESCUELA BASICA BOLIVARIANA LA PIÑATA	869	2	7	588	379	581	0	0	0	0	202	588
EDO. ZULIA	MP. LA CA#ADA DE U.	PQ. ANDRES BELLO (KM 48)	ESCUELA BOLIVARIANA LA CEPEDA	105	1	1	87	52	86	0	1	0	0	33	87
EDO. ZULIA	MP. LA CA#ADA DE U.	PQ. ANDRES BELLO (KM 48)	UNIDAD EDUCATIVA ESTADAL BETHY RIOS	2977	6	24	2285	1439	2261	0	5	0	2	815	2285
EDO. ZULIA	MP. LA CA#ADA DE U.	PQ. ANDRES BELLO (KM 48)	UNIDAD EDUCATIVA ESTADAL MAESTRA ELISA FARIA	2242	4	20	1657	1165	1637	0	3	0	0	469	1657
EDO. ZULIA	MP. LA CA#ADA DE U.	PQ. EL CARMELO	UNIDAD EDUCATIVA SEÑOR FEBRES NAVA	947	2	8	773	410	765	0	3	0	0	352	773
EDO. ZULIA	MP. LA CA#ADA DE U.	PQ. EL CARMELO	UNIDAD EDUCATIVA NACIONAL ROBERTO GONZALEZ	5213	9	26	4431	2258	4405	0	3	1	0	2143	4431
EDO. ZULIA	MP. LA CA#ADA DE U.	PQ. CHIQUINQUIRA	CENTRO EDUCATIVO INICIAL SIMONCITO URDANETA	1513	3	13	1169	839	1156	0	2	0	0	315	1169
EDO. ZULIA	MP. LA CA#ADA DE U.	PQ. CHIQUINQUIRA	ESCUELA  BASICA ESTADAL GIRALDOT	3499	6	30	2788	1727	2758	1	3	1	0	1026	2788
EDO. ZULIA	MP. LA CA#ADA DE U.	PQ. CHIQUINQUIRA	UNIDAD EDUCATIVA ESTADAL MAESTRO FRANCISCO ESPARZA	3034	6	16	2433	1321	2417	0	7	0	0	1089	2433
EDO. ZULIA	MP. LA CA#ADA DE U.	PQ. POTRERITOS	UNIDAD EDUCATIVA NACIONAL CACIQUE MARA	3519	6	17	2867	1522	2850	0	2	0	0	1326	2867
EDO. ZULIA	MP. LA CA#ADA DE U.	PQ. POTRERITOS	UNIDAD EDUCATIVA  LOURDES  RINCON	1085	2	6	918	741	912	0	1	0	0	170	918
EDO. ZULIA	MP. LA CA#ADA DE U.	PQ. CONCEPCION	ESCUELA BASICA. EL ZABILAR	1401	3	8	1185	818	1177	0	2	1	1	355	1185
EDO. ZULIA	MP. LA CA#ADA DE U.	PQ. CONCEPCION	UNIDAD EDUCATIVA NACIONAL CARACCIOLO PARRA LEON	2725	5	25	2337	1028	2312	0	6	0	0	1278	2337
EDO. ZULIA	MP. LA CA#ADA DE U.	PQ. CONCEPCION	UNIDAD EDUCATIVA BOLIVARIANA LOS POZOS	2669	5	18	2154	971	2136	0	4	0	0	1161	2154
EDO. ZULIA	MP. LA CA#ADA DE U.	PQ. CONCEPCION	JARDIN DE  INFACIA NACIONAL SILVIO GALVIZ	1925	4	14	1528	821	1514	0	6	0	0	687	1528
EDO. ZULIA	MP. LA CA#ADA DE U.	PQ. CONCEPCION	PREESCOLAR NACIONAL LA CONCEPCION	1420	3	17	1163	461	1146	0	2	0	0	683	1163
EDO. ZULIA	MP. LA CA#ADA DE U.	PQ. CONCEPCION	ESCUELA BASICA ESTADAL SILVIO GALVIZ	4424	8	18	3323	1649	3305	0	2	1	0	1653	3323
EDO. ZULIA	MP. LA CA#ADA DE U.	PQ. CONCEPCION	PRESCOLAR NACIONAL RIVERAS DEL LAGO	1045	2	9	883	377	874	0	0	1	0	496	883
EDO. ZULIA	MP. LA CA#ADA DE U.	PQ. CONCEPCION	ESCUELA BASICA NACIONAL DOCTOR OLEGARIO HERNANDEZ	3628	7	31	2931	1121	2900	0	4	0	2	1773	2931
EDO. ZULIA	MP. LA CA#ADA DE U.	PQ. CONCEPCION	UNIDAD EDUCATIVA MAESTRO AUDIO URDANETA	2556	5	28	2179	918	2151	0	6	0	0	1227	2179
EDO. ZULIA	MP. COLON	PQ. SAN CARLOS DEL ZULIA	ESCUELA BASICA NACIONAL LA CULEBRA	166	1	1	126	76	125	0	1	1	0	47	126
EDO. ZULIA	MP. COLON	PQ. SAN CARLOS DEL ZULIA	ESCUELA BASICA NACIONAL SANTA CRUZ	4496	8	72	3801	1828	3729	0	13	1	1	1886	3801
EDO. ZULIA	MP. COLON	PQ. SAN CARLOS DEL ZULIA	ESCUELA BASICA NACIONAL CATATUMBO	1387	3	27	1179	523	1152	0	7	1	1	620	1179
EDO. ZULIA	MP. COLON	PQ. SAN CARLOS DEL ZULIA	UNIDAD EDUCATIVA CURVA DE COLON	1732	3	13	1410	1149	1397	0	3	0	0	245	1410
EDO. ZULIA	MP. COLON	PQ. SAN CARLOS DEL ZULIA	UNIDAD EDUCATIVA ESTADAL CARMELITA ROLDAN PORTILLO (E.Z.A)	3171	6	46	2600	1009	2554	0	10	0	0	1535	2600
EDO. ZULIA	MP. COLON	PQ. SANTA CRUZ DEL ZULIA	E.B. EST. ATACOSO	390	1	0	275	175	275	1	0	0	0	99	275
EDO. ZULIA	MP. COLON	PQ. SANTA CRUZ DEL ZULIA	ESCUELA BASICA ESTATAL EL REMOLINO	3329	6	22	2608	1119	2586	0	2	1	0	1464	2608
EDO. ZULIA	MP. COLON	PQ. SANTA CRUZ DEL ZULIA	ESCUELA BASICA ESTADAL  BOBURE	543	1	10	428	239	418	0	1	0	0	178	428
EDO. ZULIA	MP. COLON	PQ. SANTA CRUZ DEL ZULIA	UNIDAD EDUCATIVA CREACION ZULIA	1422	3	26	1188	667	1162	0	1	0	0	494	1188
EDO. ZULIA	MP. COLON	PQ. URRIBARRI	ESCUELA BOLIVARIANA LA CONCHA	1937	4	9	1473	939	1464	1	6	0	0	518	1473
EDO. ZULIA	MP. COLON	PQ. URRIBARRI	ESCUELA CREACION PUERTO CHAMA	381	1	4	287	200	283	0	0	0	0	83	287
EDO. ZULIA	MP. COLON	PQ. URRIBARRI	ESCUELA TRES PIPAS SE LLAMA AHORA UNIDAD EDUCATIVA BOLIVARIANA JUAN VICENTE BOLIVAR PALACIOS	281	1	2	233	185	231	0	1	0	0	45	233
EDO. ZULIA	MP. COLON	PQ. URRIBARRI	UNIDAD EDUCATIVA NACIONAL CAÑO BLANCO	1571	3	10	1201	636	1191	0	2	1	0	552	1201
EDO. ZULIA	MP. COLON	PQ. URRIBARRI	ESCUELA BOLIVARIANA CAÑO MUERTO ARRIBA LE CAMBIARON EL NOMBRE A ESCUELA BOLIVARIANA JUANA BOLIVAR PALACIOS	357	1	3	279	208	276	0	0	0	0	68	279
EDO. ZULIA	MP. COLON	PQ. URRIBARRI	ESCUELA BASICA BOLIVARIANA SANTA MARIA DE JANEIRO	227	1	3	183	135	180	0	0	1	0	44	183
EDO. ZULIA	MP. COLON	PQ. URRIBARRI	UNIDAD EDUCATIVA ESTADAL SAN ANTONIO	1113	2	11	824	486	813	0	7	0	0	320	824
EDO. ZULIA	MP. COLON	PQ. URRIBARRI	ESCUELA BOLIVARIANA CAÑO MUERTO	598	1	9	467	301	458	1	3	0	0	153	467
EDO. ZULIA	MP. COLON	PQ. URRIBARRI	UNIDAD EDUCATIVA ESTADAL LA FORTUNA	700	2	7	544	341	537	0	2	1	0	193	544
EDO. ZULIA	MP. COLON	PQ. URRIBARRI	ESCUELA BOLIVARIANA MEDIO CUARTO LE CAMBIARON EL NOMBRE A UNIDAD BASICA BOLIVARIANA JOSE LEONARDO CHIRINOS	549	1	6	425	228	419	0	2	0	1	188	425
EDO. ZULIA	MP. COLON	PQ. SANTA BARBARA	UNIDAD EDUCATIVA ESTADAL  MARISCAL ANTONIO JOSE DE SUCRE	5831	11	73	4676	2200	4603	1	18	0	2	2382	4676
EDO. ZULIA	MP. COLON	PQ. SANTA BARBARA	LICEO FRANCISCO JAVIER PULGAR	3722	7	59	3158	1636	3099	0	6	1	0	1456	3158
EDO. ZULIA	MP. COLON	PQ. SANTA BARBARA	UNIDAD EDUCATIVA BOLIVARIANA DOCTOR DOMINGO LABARC	1482	3	11	1228	957	1217	1	2	0	0	257	1228
EDO. ZULIA	MP. COLON	PQ. SANTA BARBARA	ESCUELA BASICA NACIONAL LAS DELICIAS	2245	4	49	1805	1171	1756	1	4	1	0	579	1805
EDO. ZULIA	MP. COLON	PQ. SANTA BARBARA	ESCUELA BASICA NACIONAL ALMIRANTE PADILLA	4991	9	34	3992	1722	3958	0	12	0	0	2224	3992
EDO. ZULIA	MP. COLON	PQ. SANTA BARBARA	ESCUELA PRIMARIA BOLIVARIANA GENERALA MANUELA SAENZ	440	1	5	343	183	338	0	1	0	0	154	343
EDO. ZULIA	MP. COLON	PQ. SANTA BARBARA	ESCUELA BASICA NACIONAL ALMIRANTE PADILLA (ANEXO 1	503	1	11	424	180	413	1	0	0	0	232	424
EDO. ZULIA	MP. COLON	PQ. SANTA BARBARA	ESCUELA BASICA PROFESIONAL MIGUEL LEON	1174	2	6	1037	696	1031	0	2	0	1	332	1037
EDO. ZULIA	MP. COLON	PQ. SANTA BARBARA	ESCUELA BASICA ARTESANAL CIRA VEGA	2024	4	25	1719	805	1694	0	5	0	0	884	1719
EDO. ZULIA	MP. COLON	PQ. SANTA BARBARA	ESCUELA BOLIVARIANA SIMON BOLIVAR	993	2	25	804	635	779	0	0	0	0	144	804
EDO. ZULIA	MP. COLON	PQ. SANTA BARBARA	ESCUELA NACIONAL CONCENTRADA LA VICTORIA	1031	2	16	806	577	790	0	5	0	0	208	806
EDO. ZULIA	MP. COLON	PQ. SANTA BARBARA	ESCUELA ENCONTRADOS	5147	10	77	4174	2322	4097	2	14	1	2	1756	4174
EDO. ZULIA	MP. COLON	PQ. SANTA BARBARA	ESCUELA TECNICA AGROPECUARIA SANTA BARBARA	1829	4	33	1575	722	1542	0	7	1	1	811	1575
EDO. ZULIA	MP. COLON	PQ. SANTA BARBARA	ESCUELA BASICA NACIONAL. LAS CASAS	324	1	5	239	117	234	0	1	0	0	116	239
EDO. ZULIA	MP. COLON	PQ. MORALITO	ESCUELA BASICA ESTADAL TUNANA	85	1	0	44	12	44	0	0	0	0	32	44
EDO. ZULIA	MP. COLON	PQ. MORALITO	ESCUELA BASICA NACIONAL EL CASTILLO	440	1	5	356	241	351	0	1	1	0	108	356
EDO. ZULIA	MP. COLON	PQ. MORALITO	ESCUELA BOLIVARIANA LOS CAÑITOS	514	1	9	403	255	394	0	0	0	0	139	403
EDO. ZULIA	MP. COLON	PQ. MORALITO	ESCUELA BOLIVARIANA EL ABANICO	632	2	16	503	308	487	0	2	0	0	177	503
EDO. ZULIA	MP. COLON	PQ. MORALITO	ESCUELA BASICA ESTADAL KILOMETRO 12	554	1	10	390	262	380	0	0	0	0	118	390
EDO. ZULIA	MP. COLON	PQ. MORALITO	ESCUELA BASICA BOLIVARIANA KILOMETRO 41
EDO. ZULIA	MP. COLON	PQ. MORALITO	ESCUELA BOLIVARIANA EL LABERINTO LE CAMBIARON EL NOMBRE A ESCUELA BOLIVARIANA JOSE RICARDO SALAZAR	715	2	9	559	404	550	0	0	2	0	144	559
EDO. ZULIA	MP. COLON	PQ. MORALITO	ESCUELA BOLIVARIANA EL GUAIMARO	544	1	4	445	240	441	0	0	0	0	201	445
EDO. ZULIA	MP. COLON	PQ. MORALITO	ESCUELA BASICA PRE VACACIONAL EL PARAISO	492	1	6	431	311	425	0	5	0	0	109	431
EDO. ZULIA	MP. COLON	PQ. MORALITO	ESCUELA BOLIVARIANA EL UVITO LE CAMBIARON EL NOMBRE A DOCTOR LUIS RAMON PARADA	345	1	4	271	210	267	0	1	0	0	56	271
EDO. ZULIA	MP. COLON	PQ. MORALITO	UNIDAD EDUCATIVA ESTADAL BANCADA DE LIMONES	359	1	1	275	186	274	0	0	0	0	88	275
EDO. ZULIA	MP. COLON	PQ. MORALITO	ESCUELA BOLIVARIANA KILOMETRO 15	638	2	3	469	306	466	0	0	1	0	159	469
EDO. ZULIA	MP. COLON	PQ. MORALITO	ESCUELA BASICA NACIONAL EL MORALITO	3164	6	51	2445	1309	2394	0	10	1	0	1074	2445
EDO. ZULIA	MP. COLON	PQ. MORALITO	ESCUELA BASICA ESTADAL KILOMETRO 24	454	1	2	353	207	351	0	0	0	0	144	353
EDO. ZULIA	MP. COLON	PQ. MORALITO	ESCUELA BOLIVARIANA CAÑO NEGRO LE CAMBIARON EL NOMBRE A UNIDAD EDUCATIVA BOLIVARIANA FRANCISCO SILVESTRE ESPEJO CAMA#O	383	1	3	306	225	303	0	1	0	0	77	306
EDO. ZULIA	MP. COLON	PQ. MORALITO	ESCUELA UNITARIA EL QUESITO NO EXISTE Y UTILIZAN LA ESCUELA 5 Y 6	211	1	3	154	80	151	0	0	0	0	71	154
EDO. ZULIA	MP. COLON	PQ. MORALITO	ESCUELA BASICA NACIONAL EL CARACOLI	576	1	8	434	305	426	0	1	0	0	120	434
EDO. ZULIA	MP. COLON	PQ. MORALITO	ESCUELA BASICA BOLIVARIANA KILOMETRO 35	936	2	12	756	487	744	0	0	0	0	257	756
EDO. ZULIA	MP. COLON	PQ. MORALITO	ESCUELA BASICA NACIONAL UNIT 27 47	170	1	1	129	75	128	0	0	0	0	53	129
EDO. ZULIA	MP. COLON	PQ. MORALITO	LICEO EL MORALITO	597	1	14	495	317	481	1	1	0	0	162	495
EDO. ZULIA	MP. JESUS E LOSSADA	PQ. SAN JOSE	ESCUELA  BASICA ESTADAL SIMON BOLIVAR	2037	4	16	1511	919	1495	0	2	1	0	573	1511
EDO. ZULIA	MP. JESUS E LOSSADA	PQ. SAN JOSE	UNIDAD EDUCATIVA NACIONAL BOLIVARIANA EL MILAGRO	315	1	1	264	221	263	0	0	0	1	41	264
EDO. ZULIA	MP. JESUS E LOSSADA	PQ. SAN JOSE	UNIDAD EDUCATIVA  ESTADAL RAFAEL MARIA BARALT  (ANEXO 1)	353	1	4	260	187	256	0	1	0	0	68	260
EDO. ZULIA	MP. JESUS E LOSSADA	PQ. SAN JOSE	ESCUELA  BASICA NACIONAL  NOVENTA 548	246	1	0	175	112	175	1	0	0	0	62	175
EDO. ZULIA	MP. JESUS E LOSSADA	PQ. SAN JOSE	ESCUELA BASICA NACIONAL MANUEL MONTERO	575	1	7	521	455	514	0	0	0	0	59	521
EDO. ZULIA	MP. JESUS E LOSSADA	PQ. SAN JOSE	ESCUELA BASICA BOLIVARIANA CARMELO FERNANDEZ PAEZ	498	1	5	428	330	423	0	1	0	0	92	428
EDO. ZULIA	MP. JESUS E LOSSADA	PQ. SAN JOSE	UNIDAD EDUCATIVA  ESTADAL RAFAEL MARIA BARALT	871	2	12	634	424	622	0	2	1	0	195	634
EDO. ZULIA	MP. JESUS E LOSSADA	PQ. SAN JOSE	ESCUELA BOLIVARIANA CANDELARIO REYES MEDINA	1655	3	27	1232	900	1205	0	4	1	0	300	1232
EDO. ZULIA	MP. JESUS E LOSSADA	PQ. SAN JOSE	ESCUELA  BASICA CAÑA FRESCA	1872	4	18	1444	823	1426	0	4	1	0	598	1444
EDO. ZULIA	MP. JESUS E LOSSADA	PQ. LA CONCEPCION	ESCUELA BASICA ESTADAL MARIA ANDRADE	5008	9	100	3942	1709	3842	3	10	0	1	2119	3942
EDO. ZULIA	MP. JESUS E LOSSADA	PQ. LA CONCEPCION	ESCUELA  BASICA  NACIONAL  BACHILLER FRANCISCO ARAUJO GARCIA	2239	4	30	1824	879	1794	0	8	0	1	906	1824
EDO. ZULIA	MP. JESUS E LOSSADA	PQ. LA CONCEPCION	GRUPO ESCOLAR NACIONAL RAMON ESPINOZA	4971	9	59	3592	2310	3533	0	21	8	0	1194	3592
EDO. ZULIA	MP. JESUS E LOSSADA	PQ. LA CONCEPCION	UNIDAD EDUCATIVA  ESTADAL SANTIAGO QUINTERO	1013	2	15	801	508	786	0	2	0	1	275	801
EDO. ZULIA	MP. JESUS E LOSSADA	PQ. LA CONCEPCION	ESCUELA  BOLIVARIANA JOSE ANTONIO VALECILLOS	1071	2	16	926	651	910	0	0	0	0	259	926
EDO. ZULIA	MP. JESUS E LOSSADA	PQ. LA CONCEPCION	UNIDAD EDUCATIVA ESTADAL MTRA MARIA CANGA	1744	3	20	1327	887	1307	1	2	2	0	415	1327
EDO. ZULIA	MP. JESUS E LOSSADA	PQ. LA CONCEPCION	ESCUELA BASICA NACIONAL DOCTOR CRISTOBAL MENDOZA	4177	8	47	3224	1273	3177	0	9	2	5	1888	3224
EDO. ZULIA	MP. JESUS E LOSSADA	PQ. LA CONCEPCION	ESCUELA BASICA NACIONAL JOSE DOMINGO MORALES	1274	3	21	1069	687	1048	0	3	0	0	358	1069
EDO. ZULIA	MP. JESUS E LOSSADA	PQ. LA CONCEPCION	ESCUELA BASICA NACIONAL CREACION 8	769	2	11	656	287	645	0	1	0	1	356	656
EDO. ZULIA	MP. JESUS E LOSSADA	PQ. LA CONCEPCION	UNIDAD EDUCATIVA ESTADAL EMETERIO RIVAS	2036	4	29	1294	812	1265	1	3	0	0	449	1294
EDO. ZULIA	MP. JESUS E LOSSADA	PQ. LA CONCEPCION	UNIDAD EDUCATIVA  NACIONAL  EFRAIN SEGUNDO PEREZ	1196	3	11	992	655	981	0	5	1	0	320	992
EDO. ZULIA	MP. JESUS E LOSSADA	PQ. LA CONCEPCION	UNIDAD EDUCATIVA  NACIONAL ANA MARIA CAMPOS	4206	8	64	3344	1484	3280	2	9	0	1	1784	3344
EDO. ZULIA	MP. JESUS E LOSSADA	PQ. LA CONCEPCION	UE NACIONAL BOLIVARIANA DOÑA GRACIELA DE TETER	1000	2	14	873	676	859	0	0	0	0	183	873
EDO. ZULIA	MP. JESUS E LOSSADA	PQ. LA CONCEPCION	UNIDAD EDUCATIVA  CARMELO URDANETA	4267	8	78	3101	2059	3023	0	14	1	0	949	3101
EDO. ZULIA	MP. JESUS E LOSSADA	PQ. LA CONCEPCION	ESCUELA BASICA NACIONAL BOLIVARIANA LOS ANGELES	677	2	24	591	523	567	1	3	0	0	40	591
EDO. ZULIA	MP. JESUS E LOSSADA	PQ. LA CONCEPCION	ESCUELA BASICA ESTADAL NUTIBARA	1048	2	33	840	468	807	0	6	0	0	333	840
EDO. ZULIA	MP. JESUS E LOSSADA	PQ. LA CONCEPCION	UNIDAD EDUCATIVA MANUEL VICENTE ROMERO GARCIA	2346	5	53	1935	777	1882	0	1	2	2	1100	1935
EDO. ZULIA	MP. JESUS E LOSSADA	PQ. MARIANO PARRA LEON	ESCUELA NACIONAL CONCENTRADA 234	2647	5	34	2093	1220	2059	0	2	0	0	837	2093
EDO. ZULIA	MP. JESUS E LOSSADA	PQ. MARIANO PARRA LEON	UNIDAD EDUCATIVA ESTADAL ABDENAGO AVILA	2099	4	26	1587	959	1561	0	2	1	0	599	1587
EDO. ZULIA	MP. JESUS E LOSSADA	PQ. JOSE RAMON YEPEZ	CENTRO DE EDUCACION INICIAL BOLIVARIANO MENCA DE LEONI	1695	3	27	1330	751	1303	0	2	2	0	548	1330
EDO. ZULIA	MP. JESUS E LOSSADA	PQ. JOSE RAMON YEPEZ	UNIDAD EDUCATIVA  MIGUEL JOSE SANZ	1014	2	15	778	416	763	0	0	1	0	346	778
EDO. ZULIA	MP. JESUS E LOSSADA	PQ. JOSE RAMON YEPEZ	ESCUELA BASICA NACIONAL LA PAZ	4386	8	79	3271	1774	3192	0	4	1	0	1413	3271
EDO. ZULIA	MP. JESUS E LOSSADA	PQ. JOSE RAMON YEPEZ	UNIDAD EDUCATIVA  ESTADAL LUISA CASERE DE ARISMENDI	787	2	11	535	390	524	0	2	0	0	132	535
EDO. ZULIA	MP. JESUS E LOSSADA	PQ. JOSE RAMON YEPEZ	ESCUELA NACIONAL PARCELAS DE LA PAZ	1080	2	5	765	456	760	0	1	0	0	303	765
EDO. ZULIA	MP. JESUS E LOSSADA	PQ. JOSE RAMON YEPEZ	UNIDAD EDUCATIVA ESTADAL LAS MARIA	892	2	9	705	421	696	0	2	0	0	273	705
EDO. ZULIA	MP. JESUS E LOSSADA	PQ. JOSE RAMON YEPEZ	UNIDAD FORMATIVA LOS VIVITOS	179	1	1	115	106	114	0	0	0	0	8	115
EDO. ZULIA	MP. JESUS E LOSSADA	PQ. JOSE RAMON YEPEZ	UE CHE GUEVARA	1377	3	5	1223	1212	1218	0	0	0	0	6	1223
EDO. ZULIA	MP. JESUS E LOSSADA	PQ. JOSE RAMON YEPEZ	ESCUELA  BASICA  NACIONAL  BOLIVARIANA  NOTEREY	788	2	13	556	312	543	0	2	1	0	228	556
EDO. ZULIA	MP. SIMON BOLIVAR	PQ. RAFAEL MARIA BARALT	JARDIN DE INFANCIA. NACIONAL MARIA ANTONIA GARCIA DE PACHECO	1580	3	21	1301	803	1280	0	3	2	1	471	1301
EDO. ZULIA	MP. SIMON BOLIVAR	PQ. RAFAEL MARIA BARALT	UNIDAD EDUCATIVA MANUEL MANRIQUE	1692	3	26	1409	1059	1383	1	5	2	1	315	1409
EDO. ZULIA	MP. SIMON BOLIVAR	PQ. RAFAEL MARIA BARALT	UNIDAD  EDUCATIVA  ESTADAL ALICIA MARCANO	1378	3	25	1163	638	1138	3	2	2	0	493	1163
EDO. ZULIA	MP. SIMON BOLIVAR	PQ. RAFAEL MARIA BARALT	LICEO BOLIVARIANO EL INSIGNE SIMON BOLIVAR	1373	3	17	1224	929	1207	0	1	1	0	276	1224
EDO. ZULIA	MP. SIMON BOLIVAR	PQ. RAFAEL MARIA BARALT	UNIDAD EDUCATIVA LUIS BELTRAN PRIETO FIGUEROA	2390	5	56	2024	887	1968	1	4	0	0	1076	2024
EDO. ZULIA	MP. SIMON BOLIVAR	PQ. RAFAEL MARIA BARALT	ESCUELA BASICA ESTADAL DOCTOR RAFAEL CALDERA	2252	4	42	1789	1032	1747	0	7	1	2	705	1789
EDO. ZULIA	MP. SIMON BOLIVAR	PQ. RAFAEL MARIA BARALT	UEN COLINAS DE BELLO MONTE	586	1	8	482	327	474	0	1	0	0	146	482
EDO. ZULIA	MP. SIMON BOLIVAR	PQ. MANUEL MANRIQUE	LICEO APALICO SANCHEZ
EDO. ZULIA	MP. SIMON BOLIVAR	PQ. MANUEL MANRIQUE	ESCUELA BASICA ANDRES BELLO
EDO. ZULIA	MP. SIMON BOLIVAR	PQ. MANUEL MANRIQUE	UNIDAD EDUCATIVA ESTADAL SARA MONTIEL DE URRIBARRI (EZA)
EDO. ZULIA	MP. SIMON BOLIVAR	PQ. MANUEL MANRIQUE	ESCUELA CAMPO VERDE
EDO. ZULIA	MP. SIMON BOLIVAR	PQ. MANUEL MANRIQUE	LICEO  BOLIVARIANO  CARACCIOLO PARRA LEON
EDO. ZULIA	MP. SIMON BOLIVAR	PQ. RAFAEL URDANETA	ESCUELA BASICA NACIONAL DIOSELINA LUQUE DIAZ	2502	5	57	1971	1313	1914	1	9	2	1	588	1971
EDO. ZULIA	MP. SIMON BOLIVAR	PQ. RAFAEL URDANETA	UNIDAD EDUCATIVA BOLIVARIANA RIVERA	918	2	12	734	415	722	1	2	0	1	303	734
EDO. ZULIA	MP. SUCRE	PQ. ROMULO GALLEGOS	ESCUELA BASICA ESTADAL DON MARIO BRICEÑO IRAGORRY	4823	9	77	3698	1977	3621	0	18	5	1	1620	3698
EDO. ZULIA	MP. SUCRE	PQ. ROMULO GALLEGOS	ESCUELA BASICA ESTADAL RAMON ESPINOZA	1163	2	18	988	681	970	1	2	0	0	286	988
EDO. ZULIA	MP. SUCRE	PQ. ROMULO GALLEGOS	UNIDAD EDUCATIVA ESTADAL CAPIU ARRIBA	1163	2	16	945	520	929	0	2	0	0	407	945
EDO. ZULIA	MP. SUCRE	PQ. ROMULO GALLEGOS	ESCUELA BASICA ESTADAL CAPUI MEDIO	594	1	9	481	278	472	0	4	0	0	190	481
EDO. ZULIA	MP. SUCRE	PQ. ROMULO GALLEGOS	UNIDAD EDUCATIVA ESTADAL EL BRILLANTE	450	1	13	331	156	318	0	3	0	1	158	331
EDO. ZULIA	MP. SUCRE	PQ. ROMULO GALLEGOS	UE NACIONAL CREACION V CAJA SECA	2529	5	49	2084	1290	2035	0	6	0	0	739	2084
EDO. ZULIA	MP. SUCRE	PQ. ROMULO GALLEGOS	UNIDAD EDUCATIVA ESTADAL DON SIMON RODRIGUEZ	3563	7	56	2728	1673	2672	1	11	1	1	985	2728
EDO. ZULIA	MP. SUCRE	PQ. EL BATEY	ESC BOLIVARIANA PREVOCACIONAL GIBRALTAR	1361	3	19	1078	795	1059	0	0	0	1	263	1078
EDO. ZULIA	MP. SUCRE	PQ. EL BATEY	ESCUELA BOLIVARIANA PALO DE FLORES	378	1	9	260	193	251	0	1	0	0	57	260
EDO. ZULIA	MP. SUCRE	PQ. EL BATEY	UNIDAD EDUCATIVA ESTADAL CECILIO ACOSTA	2808	5	34	2221	1482	2187	3	10	1	0	691	2221
EDO. ZULIA	MP. SUCRE	PQ. GIBRALTAR	ESCUELA BASICA NACIONAL JOSEFINA ARAUJO DE LOPEZ	917	2	9	730	523	721	1	0	0	0	197	730
EDO. ZULIA	MP. SUCRE	PQ. GIBRALTAR	UNIDAD EDUCATIVA ESTADAL LAS VELITAS	911	2	6	703	406	697	0	1	0	0	290	703
EDO. ZULIA	MP. SUCRE	PQ. GIBRALTAR	UNIDAD EDUCATIVA CONCENTRADA JOSE RUBEN MOLINA	207	1	1	187	154	186	0	0	0	0	32	187
EDO. ZULIA	MP. SUCRE	PQ. GIBRALTAR	ESCUELA BOLIVARIANA SAN RAFAEL	562	1	16	431	242	415	0	0	0	0	173	431
EDO. ZULIA	MP. SUCRE	PQ. GIBRALTAR	UNIDAD EDUCATIVA ESTADAL LA DIFICULTAD	447	1	4	331	181	327	0	2	0	0	144	331
EDO. ZULIA	MP. SUCRE	PQ. GIBRALTAR	ESCUELA BASICA BOLIVARIANA MARIA CONCEPCION  ANTUNEZ	684	2	11	553	396	542	0	3	0	0	143	553
EDO. ZULIA	MP. SUCRE	PQ. GIBRALTAR	ESCUELA RAFAEL MOLERO PEREIRA	624	2	8	473	319	465	0	1	0	0	145	473
EDO. ZULIA	MP. SUCRE	PQ. GIBRALTAR	UNIDAD EDUCATIVA JOHNY BRICE#O	490	1	8	379	271	371	0	0	2	0	98	379
EDO. ZULIA	MP. SUCRE	PQ. GIBRALTAR	UNIDAD EDUCATIVA NELSON RODOLFO BRICE#O CONTRERAS	772	2	4	583	471	579	0	1	0	0	107	583
EDO. ZULIA	MP. SUCRE	PQ. GIBRALTAR	ESCUELA RURAL DE EDUCACION BASICA MARIA ROSARIO	1150	2	31	811	531	780	0	0	0	0	249	811
EDO. ZULIA	MP. SUCRE	PQ. GIBRALTAR	ESCUELA BOLIVARIANA CANO EL PADRE	262	1	5	194	110	189	0	0	0	0	79	194
EDO. ZULIA	MP. SUCRE	PQ. BOBURES	ESCUELA BOLIVARIANA LA GUAIRA	256	1	3	204	157	201	0	1	0	0	43	204
EDO. ZULIA	MP. SUCRE	PQ. BOBURES	ESCUELA BASICA BOLIVARIANA CANDELARIA BARRIGA	730	2	5	559	399	554	1	0	0	1	153	559
EDO. ZULIA	MP. SUCRE	PQ. BOBURES	ESCUELA BASICA BOLIVARIANA SAN MIGUEL	679	2	14	497	404	483	0	1	0	0	78	497
EDO. ZULIA	MP. SUCRE	PQ. BOBURES	ESCUELA BASICA NACIONAL BOBURES	2524	5	44	1979	1091	1935	0	1	0	1	842	1979
EDO. ZULIA	MP. SUCRE	PQ. HERAS	UNIDAD EDUCATIVA CONCENTRADA DOCTOR ALI GUILLERMO SIBULO SANCHEZ	319	1	4	221	128	217	0	0	0	0	89	221
EDO. ZULIA	MP. SUCRE	PQ. HERAS	UNIDAD EDUCATIVA NACIONAL PLAYA GRANDE	1201	3	36	818	430	782	0	2	0	1	349	818
EDO. ZULIA	MP. SUCRE	PQ. HERAS	UNIDAD EDUCATIVA ESTADAL JUAN PEDRO CHOURIO LEON	674	2	12	522	359	510	0	1	0	0	150	522
EDO. ZULIA	MP. SUCRE	PQ. HERAS	ESCUELA BASICA BOLIVARIANA JUAN BAUTISTA GONZALEZ	1289	3	10	995	758	985	1	4	0	0	222	995
EDO. ZULIA	MP. SUCRE	PQ. HERAS	UNIDAD EDUCATIVA ESTADAL EFRAIN CARRASQUERO	659	2	5	478	269	473	1	0	0	0	203	478
EDO. ZULIA	MP. SUCRE	PQ. M.ARTURO CELESTINO A	ESCULA BASICA NACINAL CHIMOMO	580	1	8	465	315	457	0	0	0	0	142	465
EDO. ZULIA	MP. SUCRE	PQ. M.ARTURO CELESTINO A	UNIDAD EDUCATIVA ESTADAL LUIS ATTOW	1158	2	12	878	574	866	1	1	1	1	288	878
EDO. ZULIA	MP. SUCRE	PQ. M.ARTURO CELESTINO A	UNIDAD EDUCATIVA ESTADAL LA SABANA	929	2	20	760	419	740	0	2	1	0	318	760
EDO. ZULIA	MP. SUCRE	PQ. M.ARTURO CELESTINO A	ESCUELA BOLIVARIANA EL PINO	932	2	10	683	418	673	0	2	0	0	253	683
EDO. ZULIA	MP. SUCRE	PQ. M.ARTURO CELESTINO A	ESCUELA BASICA BOLIVARIANA LA CHIQUINQUIRA	1255	3	19	1007	561	988	1	1	0	0	425	1007
EDO. ZULIA	MP. MIRANDA	PQ. SAN ANTONIO	UNIDAD EDUCATIVA ESTADAL LAS CORIANAS	148	1	3	137	57	134	0	0	1	0	76	137
EDO. ZULIA	MP. MIRANDA	PQ. SAN ANTONIO	UNIDAD EDUCATIVA ESTADAL EL GUANABANO	624	2	4	456	298	452	0	0	0	0	154	456
EDO. ZULIA	MP. MIRANDA	PQ. SAN ANTONIO	ESCUELA BOLIVARIANA LUIS MARIA MORENO CARABALLO	116	1	3	112	85	109	0	0	0	0	24	112
EDO. ZULIA	MP. MIRANDA	PQ. SAN ANTONIO	ESCUELA  BASICA CONCENTRADA EL MUÑECO	783	2	19	559	353	540	1	6	1	0	179	559
EDO. ZULIA	MP. MIRANDA	PQ. SAN ANTONIO	UNIDAD EDUCATIVA SAN JOAQUIN DE LA VEGA	712	2	7	606	346	599	0	2	0	0	251	606
EDO. ZULIA	MP. MIRANDA	PQ. SAN ANTONIO	UNIDAD EDUCATIVA SEÑOR PILAR PEROZO	507	1	9	417	283	408	0	0	0	0	125	417
EDO. ZULIA	MP. MIRANDA	PQ. SAN ANTONIO	UNIDAD EDUCATIVA ESTADAL QUIROZ	439	1	6	326	216	320	0	0	0	0	104	326
EDO. ZULIA	MP. MIRANDA	PQ. SAN ANTONIO	UNIIDAD EDUCATIVA BOLIVARIANA SAN ANTONIO	306	1	6	276	196	270	0	0	0	0	74	276
EDO. ZULIA	MP. MIRANDA	PQ. SAN ANTONIO	GRUPO ESCOLAR MIRANDA	2540	5	46	2097	1123	2051	1	9	2	2	914	2097
EDO. ZULIA	MP. MIRANDA	PQ. ANA MARIA CAMPOS	UNIDAD  EDUCATIVA CONCENTRADA EL RODEO	661	2	7	571	350	564	0	1	0	0	213	571
EDO. ZULIA	MP. MIRANDA	PQ. ANA MARIA CAMPOS	UNIDAD  EDUCATIVA CONCENTRADA LA QUEBRADA	335	1	3	273	182	270	0	2	0	0	86	273
EDO. ZULIA	MP. MIRANDA	PQ. ANA MARIA CAMPOS	ESCUELA  BASICA NACIONAL BOLIVARIANA EL CRESPO	647	2	6	559	447	553	0	3	0	0	103	559
EDO. ZULIA	MP. MIRANDA	PQ. ANA MARIA CAMPOS	UNIDAD EDUCATIVA CARMEN QUIVAS DE GONZALEZ	315	1	6	289	189	283	1	0	0	0	93	289
EDO. ZULIA	MP. MIRANDA	PQ. ANA MARIA CAMPOS	ESCUELA BASICA ESTADAL CONCENTRADA KM. 42 AHORA UNIDAD EDUCATIVA ESTADAL AMBROSIO ALFINGER	452	1	5	363	198	358	0	1	0	0	159	363
EDO. ZULIA	MP. MIRANDA	PQ. ANA MARIA CAMPOS	ESCUELA BASICA NACIONAL LAS CATANEJAS	768	2	15	595	305	580	0	2	1	0	272	595
EDO. ZULIA	MP. MIRANDA	PQ. ANA MARIA CAMPOS	UNIDAD EDUCATIVA NACIONAL GENERAL FRANCISCO  DE MIRANDA	2167	4	29	1715	937	1686	0	15	1	1	732	1715
EDO. ZULIA	MP. MIRANDA	PQ. SAN JOSE	UNIDAD EDUCATIVA ESTADAL BELLA VISTA DE LA CANDELARIA	1381	3	9	1120	874	1111	1	1	0	0	235	1120
EDO. ZULIA	MP. MIRANDA	PQ. SAN JOSE	UNIDA EDUCATIVA ESTDAL JUAN VICENTE GONZALEZ BASICA	530	1	11	490	416	479	0	1	0	0	62	490
EDO. ZULIA	MP. MIRANDA	PQ. SAN JOSE	LICEO JOSE CENOVIO URRIBARRI	1059	2	12	980	758	968	0	3	0	0	207	980
EDO. ZULIA	MP. MIRANDA	PQ. SAN JOSE	UNIDAD EDUCATIVA NACIONAL JOSE TRINO ROMAY NAVA	385	1	3	334	298	331	0	1	1	0	31	334
EDO. ZULIA	MP. MIRANDA	PQ. SAN JOSE	CENTRO DE EDUCACION INICIAL RAMONA DE JESUS PAZ DELGADO	560	1	7	518	443	511	0	4	0	0	64	518
EDO. ZULIA	MP. MIRANDA	PQ. SAN JOSE	ESCUELA BASICA ESTADAL LA BAJADITA	165	1	1	161	143	160	0	2	0	0	15	161
EDO. ZULIA	MP. MIRANDA	PQ. SAN JOSE	UNIDAD EDUCATIVA ESTADAL JOSE TRINIDAD JIMENEZ	2469	5	16	2030	1267	2014	0	3	0	0	744	2030
EDO. ZULIA	MP. MIRANDA	PQ. SAN JOSE	UNIDAD EDUCATIVA ESTADAL JUAN VICENTE GONZALEZ	2595	5	34	2082	1486	2048	0	0	0	1	561	2082
EDO. ZULIA	MP. MIRANDA	PQ. SAN JOSE	ESCUELA BASICA NACIONAL ALIRIO REYES	2151	4	22	1745	1077	1723	0	3	0	1	642	1745
EDO. ZULIA	MP. MIRANDA	PQ. SAN JOSE	UNIDAD EDUCATIVA ESTADAL VICENTA BELLOSO	1652	3	16	1307	1040	1291	0	2	0	1	248	1307
EDO. ZULIA	MP. MIRANDA	PQ. FARIA	UNIDAD EDUCATIVA CONCENTRADA NACIONAL COOPERATIVA MAUROA  UNIDAD EDUCATIVA NACIONAL EVARISTO RAFAEL CHIRINOS	374	1	5	320	235	315	0	1	0	0	79	320
EDO. ZULIA	MP. MIRANDA	PQ. FARIA	UNIDAD EDUCATIVA ESTADAL JAJATAL	565	1	6	485	368	479	0	0	1	0	110	485
EDO. ZULIA	MP. MIRANDA	PQ. FARIA	ESCUELA BASICA ESTADAL BOCA  DEL PALMAR	748	2	6	604	469	598	0	2	0	0	127	604
EDO. ZULIA	MP. MIRANDA	PQ. FARIA	ESCUELA BASICA NACIONAL  AHORA  UNIDAD EDUCATIVA MAESTRO MANUEL CUEVA SIBADA
EDO. ZULIA	MP. MIRANDA	PQ. FARIA	UNIDAD EDUCATIVA NACIONAL EULALIA SOTO	210	1	8	200	170	192	0	0	0	0	22	200
EDO. ZULIA	MP. MIRANDA	PQ. FARIA	ESCUELA  BASICA ESTADAL MAESTRO ALEJANDRO INCIARTE	218	1	2	169	119	167	0	0	0	1	47	169
EDO. ZULIA	MP. MIRANDA	PQ. FARIA	UNIDAD EDUCATIVA NACIONAL LISANDRO FARIA	1887	4	34	1641	858	1607	0	1	0	0	748	1641
EDO. ZULIA	MP. MIRANDA	PQ. ALTAGRACIA	ESCUELA BASICA NACIONAL  SAN JUAN DE  GENIBERA	554	1	6	478	374	472	0	0	0	0	98	478
EDO. ZULIA	MP. MIRANDA	PQ. ALTAGRACIA	ESCUELA BASICA BOLIVARIANA ZONIA MEDINA	642	2	8	453	396	445	0	3	0	0	46	453
EDO. ZULIA	MP. MIRANDA	PQ. ALTAGRACIA	ESCUELA BASICA NACIONAL PROFESOR ARMANDO CEPEDA	1851	4	20	1554	1027	1534	0	4	2	1	500	1554
EDO. ZULIA	MP. MIRANDA	PQ. ALTAGRACIA	CENTRO DE EDUCACION INICIAL MAESTRO ALFREDO ALVARADO	877	2	13	784	576	771	0	0	0	0	195	784
EDO. ZULIA	MP. MIRANDA	PQ. ALTAGRACIA	ESCUELA BASICA NACIONAL MAESTRO MARCOS PEREIRA  OLIVARES	2608	5	30	2200	1584	2170	0	4	1	0	581	2200
EDO. ZULIA	MP. MIRANDA	PQ. ALTAGRACIA	UNIDAD EDUCATIVA ANGELA DE MAIZ	509	1	0	469	277	469	0	3	0	0	189	469
EDO. ZULIA	MP. MIRANDA	PQ. ALTAGRACIA	GRUPO ESCOLAR NACIONAL ALEJANDRO FUENMAYOR	2758	5	50	2326	1136	2276	1	8	1	0	1130	2326
EDO. ZULIA	MP. MIRANDA	PQ. ALTAGRACIA	UNIDAD EDUCATIVA ESTADAL LEON  DE FEBRES CORDERO	2560	5	27	2137	1522	2110	0	3	2	0	583	2137
EDO. ZULIA	MP. MIRANDA	PQ. ALTAGRACIA	UNIDAD EDUCATIVA BASICA NACIONAL CONCENTRADA BALLENA	351	1	2	318	227	316	0	0	0	0	89	318
EDO. ZULIA	MP. MIRANDA	PQ. ALTAGRACIA	UNIDAD EDUCATIVA LISANDRO PUCHE  GARIA	2600	5	15	2219	1306	2204	0	10	0	1	887	2219
EDO. ZULIA	MP. MIRANDA	PQ. ALTAGRACIA	CENTRO DE EDUCACION INICIAL CELEDONIA PAZ DE VEGA	358	1	2	340	232	338	0	0	0	0	106	340
EDO. ZULIA	MP. MIRANDA	PQ. ALTAGRACIA	ESCUELA BASICA BOLIVARIANA  SIMON BOLIVAR	1296	3	26	1131	776	1105	0	1	0	0	328	1131
EDO. ZULIA	MP. MIRANDA	PQ. ALTAGRACIA	ESCUELA BASICA NACIONAL CONCENTRADA ISAURA PORTILLO MATASECA	722	2	20	599	424	579	0	0	0	0	155	599
EDO. ZULIA	MP. MIRANDA	PQ. ALTAGRACIA	UNIDAD EDUCATIVA ESTADAL LUIS CELIZ	1778	3	16	1437	894	1421	0	8	1	0	518	1437
EDO. ZULIA	MP. MIRANDA	PQ. ALTAGRACIA	UNIDAD EDUCATIVA BOLIVARIANA EL ARAGUANEY	484	1	3	404	309	401	1	1	0	0	90	404
EDO. ZULIA	MP. MIRANDA	PQ. ALTAGRACIA	PREESCOLAR ESTADAL  CELIA OLIVARES	1294	3	23	1121	581	1098	0	0	0	2	515	1121
EDO. ZULIA	MP. MIRANDA	PQ. ALTAGRACIA	UNIDAD EDUCATIVA NACIONAL HERNESTO FLORES FUENMAYOR	2559	5	38	2239	1492	2201	0	10	0	0	699	2239
EDO. ZULIA	MP. MIRANDA	PQ. ALTAGRACIA	CENTRO DE EDUCACION INTEGRAL MAESTRA NELLY JOSEFINA RINCON PADRON	729	2	14	662	478	648	0	2	1	0	167	662
EDO. ZULIA	MP. MIRANDA	PQ. ALTAGRACIA	ESCUELA BASICA NACIONAL BOLIVARIANA LOS OLIVOS  WAYUU	167	1	1	155	139	154	0	1	0	0	14	155
EDO. ZULIA	MP. MIRANDA	PQ. ALTAGRACIA	ESCUELA BASICA ESTADAL JOSE ANTONIO CHAVEZ	2742	5	42	2164	1134	2122	0	3	0	0	985	2164
EDO. ZULIA	MP. MIRANDA	PQ. ALTAGRACIA	ESCUELA BASICA SAN CRISPULO AHORA UNIDAD EDUCATIVA ESTADAL MAESTRO EUGENIO BRACHO	750	2	14	644	431	630	0	7	0	0	192	644
EDO. ZULIA	MP. MIRANDA	PQ. ALTAGRACIA	ESCUELA  BASICA  ESTADAL LUIS ALFONZO LUZARDO	1316	3	7	1075	770	1068	0	5	0	1	292	1075
EDO. ZULIA	MP. MIRANDA	PQ. ALTAGRACIA	ESCUELA BASICA NACIONAL EL TABLAZO	1002	2	18	882	578	864	0	0	0	0	286	882
EDO. ZULIA	MP. MIRANDA	PQ. ALTAGRACIA	CENTRO DE EDUCACIÓN INICIAL ANA MARIA CAMPOS	1332	3	19	1177	760	1158	1	2	1	0	394	1177
EDO. ZULIA	MP. MIRANDA	PQ. ALTAGRACIA	UNIDAD EDUCATIVA NACIONAL JOSE PAZ GONZALEZ	3150	6	46	2638	1688	2592	1	9	1	1	892	2638
EDO. ZULIA	MP. MIRANDA	PQ. ALTAGRACIA	UNIDAD EDUCATIVA NACIONAL CONCENTRADA MAESTRA EMELINA GONZALEZ	493	1	2	458	359	456	0	3	0	0	94	458
EDO. ZULIA	MP. MIRANDA	PQ. ALTAGRACIA	UNIDAD EDUCATIVA NACIONAL MARIA BARRERA FERRER	649	2	10	559	400	549	0	1	0	0	148	559
EDO. ZULIA	MP. LAGUNILLAS	PQ. LIBERTAD	ESCUELA BASICA NACIONAL JOSE MARIA VARGAS	3379	6	63	2795	1291	2732	0	13	0	1	1427	2795
EDO. ZULIA	MP. LAGUNILLAS	PQ. LIBERTAD	ESCUELA BASICA NACIONAL GENERAL ISAIAS MEDINA ANGARITA	6700	12	93	5379	2654	5286	2	26	3	2	2599	5379
EDO. ZULIA	MP. LAGUNILLAS	PQ. LIBERTAD	UNIDAD EDUCATIVA NACIONAL LA VICTORIA	1789	4	18	1395	891	1377	1	9	1	0	475	1395
EDO. ZULIA	MP. LAGUNILLAS	PQ. LIBERTAD	CENTRO DE EDUCACION INICIAL MAMA ROSA	3331	6	60	2831	1343	2771	0	16	0	0	1412	2831
EDO. ZULIA	MP. LAGUNILLAS	PQ. LIBERTAD	UNIDAD EDUCATIVA PRIVADA NACIONAL FRAY LUIS DE LEON	3854	7	44	3233	979	3189	0	5	1	2	2202	3233
EDO. ZULIA	MP. LAGUNILLAS	PQ. LIBERTAD	UNIDAD EDUCATIVA COLEGIO JUAN XXIII FE Y ALEGRIA	2409	5	36	2053	1115	2017	0	7	2	0	893	2053
EDO. ZULIA	MP. LAGUNILLAS	PQ. LIBERTAD	ESCUELA  ESTADAL CONCENTRADA NUMERO 90	1027	2	15	874	426	859	0	1	1	1	430	874
EDO. ZULIA	MP. LAGUNILLAS	PQ. LIBERTAD	GRUPO ESCOLAR MARIA DOLORES DE CASTRO	2257	4	52	1807	1058	1755	0	13	0	0	684	1807
EDO. ZULIA	MP. LAGUNILLAS	PQ. ELEAZAR LOPEZ C	ESCUELA  BOLIVARIANA PICA PICA	1187	2	25	937	586	912	1	0	0	0	325	937
EDO. ZULIA	MP. LAGUNILLAS	PQ. ELEAZAR LOPEZ C	UNIDAD EDUCATIVA NACIONAL COMBINADA MONTE OSCURO	1012	2	17	854	544	837	0	3	0	0	290	854
EDO. ZULIA	MP. LAGUNILLAS	PQ. ALONSO DE OJEDA	UNIDAD EDUCATIVA PROFESOR MIGUEL ACOSTA SAIGNES	2737	5	49	2412	942	2363	1	6	3	1	1410	2412
EDO. ZULIA	MP. LAGUNILLAS	PQ. ALONSO DE OJEDA	ESCUELA BASICA NACIONAL CREACION BARRIO NUEVO	1598	3	34	1376	595	1342	0	3	0	1	743	1376
EDO. ZULIA	MP. LAGUNILLAS	PQ. ALONSO DE OJEDA	ESCUELA BASICA NACIONAL LIBERTADOR	2596	5	33	2181	1037	2148	2	2	0	2	1105	2181
EDO. ZULIA	MP. LAGUNILLAS	PQ. ALONSO DE OJEDA	LICEO NACIONAL DOCTOR. RAUL CUENCA	3379	6	63	2870	1228	2807	1	9	0	1	1568	2870
EDO. ZULIA	MP. LAGUNILLAS	PQ. ALONSO DE OJEDA	UNIDAD EDUCATIVA ESTADAL ANDRES BELLO (E.Z.A)	4818	9	83	3811	1157	3728	1	8	2	1	2559	3811
EDO. ZULIA	MP. LAGUNILLAS	PQ. ALONSO DE OJEDA	ESCUELA BASICA ESTADAL PEDRO JULIO MANINAT	3440	6	49	2572	965	2523	0	6	4	3	1545	2572
EDO. ZULIA	MP. LAGUNILLAS	PQ. ALONSO DE OJEDA	UNIDAD EDUCATIVA BOLIVARIANA SAN BENITO	1444	3	16	1225	804	1209	0	5	1	2	397	1225
EDO. ZULIA	MP. LAGUNILLAS	PQ. ALONSO DE OJEDA	UNIDAD EDUCATIVA MUNICIPAL VENEZUELA	2426	5	29	2077	697	2048	0	8	2	1	1340	2077
EDO. ZULIA	MP. LAGUNILLAS	PQ. ALONSO DE OJEDA	ESCUELA NACIONAL LOS SAMANES	5187	10	97	4260	2296	4163	1	22	5	5	1834	4260
EDO. ZULIA	MP. LAGUNILLAS	PQ. ALONSO DE OJEDA	CENTRO DE EDUCACION INICIAL SIMONCITO  JEAN PIAGEP	805	2	13	735	359	722	0	1	0	0	362	735
EDO. ZULIA	MP. LAGUNILLAS	PQ. ALONSO DE OJEDA	ESCUELA BASICA BOLIVARIANA DOCTOR. ALBERTO CARNAVALI	3275	6	50	2723	1587	2673	1	14	1	0	1070	2723
EDO. ZULIA	MP. LAGUNILLAS	PQ. ALONSO DE OJEDA	GRUPO ESCUELA NACIONAL VENEZUELA	3445	6	61	2813	1550	2752	3	15	0	0	1184	2813
EDO. ZULIA	MP. LAGUNILLAS	PQ. ALONSO DE OJEDA	ESCUELA BASICA NACIONAL NUEVA LAGUNILLAS	4710	9	71	3733	1836	3662	1	13	3	1	1808	3733
EDO. ZULIA	MP. LAGUNILLAS	PQ. ALONSO DE OJEDA	ESCUELA  BASICA NACIONAL DOCTOR BLAS VALBUENA	1191	2	16	1044	505	1028	0	4	1	0	518	1044
EDO. ZULIA	MP. LAGUNILLAS	PQ. ALONSO DE OJEDA	UNIDAD EDUCATIVA PRIVADA NACIONAL JUAN BOSCO	2861	5	29	2503	716	2474	0	11	1	0	1746	2503
EDO. ZULIA	MP. LAGUNILLAS	PQ. ALONSO DE OJEDA	UNIDAD EDUCATIVA ESTADAL NEGRA MATEA	2891	5	37	2484	920	2447	1	9	0	1	1516	2484
EDO. ZULIA	MP. LAGUNILLAS	PQ. ALONSO DE OJEDA	ESCUELA BASICA NACIONAL CIUDAD OJEDA	4669	9	115	3837	1444	3722	2	7	6	3	2260	3837
EDO. ZULIA	MP. LAGUNILLAS	PQ. ALONSO DE OJEDA	UNIDAD EDUCATIVA ESTADAL PROFESOR ESTADAL HERNANDEZ TORO	1502	3	29	1269	613	1240	1	3	0	0	623	1269
EDO. ZULIA	MP. LAGUNILLAS	PQ. ALONSO DE OJEDA	ESCUELA BASICA. NACIONAL. BACHILLER. TORIBIO URDANETA	4244	8	72	3495	1637	3423	0	9	0	0	1777	3495
EDO. ZULIA	MP. LAGUNILLAS	PQ. ALONSO DE OJEDA	ESCUELA BASICA NACIONAL FRANCISCO ANTONIO ZEA	3922	7	51	3241	1335	3190	1	15	3	2	1834	3241
EDO. ZULIA	MP. LAGUNILLAS	PQ. ALONSO DE OJEDA	ESCUELA ESTADAL MAESTRO. ADALBERTO GUTIERREZ	2025	4	67	1685	881	1618	1	7	1	1	727	1685
EDO. ZULIA	MP. LAGUNILLAS	PQ. ALONSO DE OJEDA	LICEO ANDRES BELLO	986	2	12	843	527	831	0	5	0	0	299	843
EDO. ZULIA	MP. LAGUNILLAS	PQ. ALONSO DE OJEDA	ESCUELA ELEAZAR LOPEZ CONTRERAS	1809	4	29	1557	710	1528	1	4	1	0	812	1557
EDO. ZULIA	MP. LAGUNILLAS	PQ. ALONSO DE OJEDA	LICEO NACIONAL BOLIVARIANO PROFESOR CESAR MARTINEZ VALERO	3225	6	60	2541	1573	2481	1	10	4	2	891	2541
EDO. ZULIA	MP. LAGUNILLAS	PQ. VENEZUELA	ESCUELA NACIONAL TURIACA	2094	4	35	1609	966	1574	1	9	2	1	595	1609
EDO. ZULIA	MP. LAGUNILLAS	PQ. VENEZUELA	UNIDAD EDUCATIVA PRIVADA NACIONAL ANNE FORMER DE OMAÑA	1032	2	28	805	469	777	0	4	0	0	304	805
EDO. ZULIA	MP. LAGUNILLAS	PQ. VENEZUELA	ESCUELA ESTADAL MAESTRO PASCUAL IGNACIO VILLASMIL	3934	7	71	3373	1679	3302	0	24	2	0	1597	3373
EDO. ZULIA	MP. LAGUNILLAS	PQ. VENEZUELA	UNIDAD EDUCATIVA PRIVADA NACIONAL SAN JOSE	2524	5	28	2063	510	2035	0	4	2	0	1519	2063
EDO. ZULIA	MP. LAGUNILLAS	PQ. VENEZUELA	ESCUELA  BASICA  NACIONAL  BOLIVARIANA MARIA MORENO DE LOPEZ	3940	7	62	3106	1894	3044	4	16	3	1	1126	3106
EDO. ZULIA	MP. LAGUNILLAS	PQ. VENEZUELA	ESCUELA BASICA NACIONAL CARLOS EMILIANO SALOM	1775	3	18	1485	496	1467	0	1	0	0	970	1485
EDO. ZULIA	MP. LAGUNILLAS	PQ. VENEZUELA	UNIDAD EDUCATIVA NACIONAL AYACUCHO	2604	5	41	2260	662	2219	1	3	0	1	1552	2260
EDO. ZULIA	MP. LAGUNILLAS	PQ. VENEZUELA	ESCUELA CONCENTRADA 375 2529	879	2	17	753	517	736	0	2	0	0	217	753
EDO. ZULIA	MP. LAGUNILLAS	PQ. VENEZUELA	UNIDAD EDUCATIVA NACIONAL ANTONIA ESTELLER	4115	8	34	3503	1245	3469	1	4	0	3	2216	3503
EDO. ZULIA	MP. LAGUNILLAS	PQ. CAMPO LARA	ESCUELA  SOCIAL DE AVANZADA CAMPO LARA  (ANEXO)	1742	3	25	1453	808	1428	0	3	0	0	617	1453
EDO. ZULIA	MP. LAGUNILLAS	PQ. CAMPO LARA	ESCUELA BOLIVARIANA RAFAEL MARIA BARALT	885	2	28	733	400	705	0	2	0	1	302	733
EDO. ZULIA	MP. LAGUNILLAS	PQ. CAMPO LARA	ESCUELA  SOCIAL DE AVANZADA CAMPO LARA	1149	2	12	901	529	889	0	2	0	0	358	901
EDO. ZULIA	MP. CATATUMBO	PQ. UDON PEREZ	ESCUELA BASICA ESTADAL UDON PEREZ	1027	2	5	793	449	788	0	3	1	1	334	793
EDO. ZULIA	MP. CATATUMBO	PQ. UDON PEREZ	ESCUELA BOLIVARIANA SAN RAFAEL	763	2	5	509	275	504	1	1	0	1	226	509
EDO. ZULIA	MP. CATATUMBO	PQ. UDON PEREZ	ESCUELA BOLIVARIANA JOSE FELIX RIVAS	636	2	6	505	252	499	0	0	0	0	247	505
EDO. ZULIA	MP. CATATUMBO	PQ. UDON PEREZ	ESCUELA NACIONAL CAÑO DEL MEDIO	250	1	2	202	146	200	0	0	0	0	54	202
EDO. ZULIA	MP. CATATUMBO	PQ. UDON PEREZ	ESCUELA BASICA NACIONAL DOCTOR. RAUL CUENCA	5385	10	63	3987	1882	3924	0	13	0	0	2029	3987
EDO. ZULIA	MP. CATATUMBO	PQ. ENCONTRADOS	UNIDAD EDUCATIVA ESTADAL DOCTOR. ALBERTO RONCAJOLO	5837	11	48	4449	2118	4401	0	10	2	0	2271	4449
EDO. ZULIA	MP. CATATUMBO	PQ. ENCONTRADOS	ESCUELA BOLIVARIANA CAMPO ALEGRE	323	1	1	267	174	266	0	2	0	0	90	267
EDO. ZULIA	MP. CATATUMBO	PQ. ENCONTRADOS	ESCUELA BASICA ESTADAL CONGO MIRADOR
EDO. ZULIA	MP. CATATUMBO	PQ. ENCONTRADOS	ESCUELA BOLIVARIANA VALDERRAMA	743	2	5	563	369	558	0	1	0	1	187	563
EDO. ZULIA	MP. CATATUMBO	PQ. ENCONTRADOS	UNIDAD EDUCATIVA ESTADAL PANPANITO	728	2	15	585	296	570	0	1	0	0	273	585
EDO. ZULIA	MP. CATATUMBO	PQ. ENCONTRADOS	ESCUELA BASICA ESTADAL MARIA AUXILIADORA	394	1	4	272	195	268	0	0	1	0	72	272
EDO. ZULIA	MP. CATATUMBO	PQ. ENCONTRADOS	ESCUELA BASICA ESTADAL CAÑO DE LIMONES	358	1	1	245	162	244	0	0	0	0	82	245
EDO. ZULIA	MP. CATATUMBO	PQ. ENCONTRADOS	UNIDAD EDUCATIVA ESTADAL CHONA MOCHILERO	277	1	4	219	94	215	0	0	0	0	121	219
EDO. ZULIA	MP. CATATUMBO	PQ. ENCONTRADOS	ESCUELA BASICA ESTADAL ROMULO GALLEGOS	1230	3	16	921	523	905	0	2	0	0	380	921
EDO. ZULIA	MP. CATATUMBO	PQ. ENCONTRADOS	UNIDAD EDUCATIVA ESTADAL RODOLFO SEGUNDO VALBUENA	296	1	5	208	144	203	0	1	0	0	58	208
EDO. ZULIA	MP. CATATUMBO	PQ. ENCONTRADOS	UNIDAD EDUCATIVA NACIONAL BENITO PUCHE	1460	3	17	1196	703	1179	0	4	0	0	472	1196
EDO. ZULIA	MP. MACHIQUES DE P	PQ. SAN JOSE DE PERIJA	ESCUELA BASICA NACIONAL GENERAL DESIDERIO TRIA	2555	5	25	1795	1064	1770	0	3	1	1	701	1795
EDO. ZULIA	MP. MACHIQUES DE P	PQ. SAN JOSE DE PERIJA	ESCUELA BASICA NACIONAL SAN JOSE	3477	6	22	2296	1060	2274	0	10	0	0	1204	2296
EDO. ZULIA	MP. MACHIQUES DE P	PQ. SAN JOSE DE PERIJA	ESCUELA  SOCIAL DE AVANZADA  EDUARDO HEVIA	4331	8	25	3097	962	3072	1	10	2	0	2097	3097
EDO. ZULIA	MP. MACHIQUES DE P	PQ. SAN JOSE DE PERIJA	ESCUELA BASICA NACIONAL SAN FELIPE	584	1	4	456	246	452	0	0	0	0	206	456
EDO. ZULIA	MP. MACHIQUES DE P	PQ. SAN JOSE DE PERIJA	UNIDAD EDUCATIVA ESTADAL JOSE GONZALEZ CASTELLANO	1840	4	26	1343	723	1317	0	1	0	0	593	1343
EDO. ZULIA	MP. MACHIQUES DE P	PQ. RIO NEGRO	UNIDAD EDUCATIVA CACHAMANA	445	1	15	370	259	355	0	2	0	0	94	370
EDO. ZULIA	MP. MACHIQUES DE P	PQ. RIO NEGRO	ESCUELA BOLIVARIANA NACIONAL LAS LOLAS	1124	2	20	828	632	808	0	5	0	0	171	828
EDO. ZULIA	MP. MACHIQUES DE P	PQ. RIO NEGRO	CENTRO DE EDUCACION INICIAL  RIO NEGRO	690	2	8	451	328	443	0	0	0	0	115	451
EDO. ZULIA	MP. MACHIQUES DE P	PQ. RIO NEGRO	UNIDAD EDUCATIVA RAFAEL REYES	212	1	3	176	159	173	0	0	0	0	14	176
EDO. ZULIA	MP. MACHIQUES DE P	PQ. RIO NEGRO	ESCUELA  BASICA BOLIVARIANA RIO NEGRO	1795	4	11	1025	657	1014	0	1	4	0	352	1025
EDO. ZULIA	MP. MACHIQUES DE P	PQ. LIBERTAD	ESCUELA TECNICA AGROPECUARIA MACHIQUES	1590	3	29	1191	717	1162	0	8	1	0	436	1191
EDO. ZULIA	MP. MACHIQUES DE P	PQ. LIBERTAD	ESCUELA BASICA BOLIVARIANA BACHILLER ARMADO COLINA	775	2	3	592	219	589	0	0	0	0	370	592
EDO. ZULIA	MP. MACHIQUES DE P	PQ. LIBERTAD	PREESCOLAR PARMALAT	1645	3	21	1201	806	1180	1	1	0	0	372	1201
EDO. ZULIA	MP. MACHIQUES DE P	PQ. LIBERTAD	UNIDAD EDUCATIVA NACIONAL MONSEÑOR SANTIAGO PEREZ	2066	4	23	1350	740	1327	0	8	1	0	578	1350
EDO. ZULIA	MP. MACHIQUES DE P	PQ. LIBERTAD	ESCUELA BASICA.ESTADAL . ALTO VIENTO	1953	4	26	1296	909	1270	0	3	0	0	358	1296
EDO. ZULIA	MP. MACHIQUES DE P	PQ. LIBERTAD	UNIDAD EDUCATIVA NACIONAL PRIVADA SAN ANTONIO	2680	5	35	1684	900	1649	1	8	1	0	739	1684
EDO. ZULIA	MP. MACHIQUES DE P	PQ. LIBERTAD	UNIDAD  EDUCATIVA  NACIONAL  MANUEL FELIPE RUGELES	3999	8	42	2963	1378	2921	2	11	0	0	1530	2963
EDO. ZULIA	MP. MACHIQUES DE P	PQ. LIBERTAD	ESCUELA  BOLIVARIANA EL LLANO	945	2	21	665	397	644	0	3	4	0	240	665
EDO. ZULIA	MP. MACHIQUES DE P	PQ. LIBERTAD	ESCUELA  BOLIVARIANA ORANGEL ROMERO	1003	2	17	747	334	730	0	3	1	1	391	747
EDO. ZULIA	MP. MACHIQUES DE P	PQ. LIBERTAD	UNIDAD EDUCATIVA MAESTRA FRANCISCA GARCIA	1314	3	26	882	479	856	0	3	0	0	374	882
EDO. ZULIA	MP. MACHIQUES DE P	PQ. LIBERTAD	ESCUELA TECNICA INDIGENA TOROMO	661	2	5	526	495	521	0	0	0	0	26	526
EDO. ZULIA	MP. MACHIQUES DE P	PQ. LIBERTAD	UNIDAD EDUCATIVA NACIONAL PRIVADA COLEGIO SAN PABLO	3014	6	38	1841	888	1803	1	13	1	0	900	1841
EDO. ZULIA	MP. MACHIQUES DE P	PQ. LIBERTAD	GRUPO ESCOLAR FUNDA PERIJA	3518	7	54	2816	1251	2762	0	16	1	0	1494	2816
EDO. ZULIA	MP. MACHIQUES DE P	PQ. LIBERTAD	UNIDAD EDUCATIVA NUESTRA SEÑORA DEL CARMEN	1280	3	18	1084	399	1066	0	0	1	0	666	1084
EDO. ZULIA	MP. MACHIQUES DE P	PQ. LIBERTAD	ESCUELA BASICA BOLIVARIANA SHIRAPTA	717	2	5	633	560	628	0	0	0	0	68	633
EDO. ZULIA	MP. MACHIQUES DE P	PQ. LIBERTAD	UNIDAD EDUCATIVA NACIONAL LA SAGRADA FAMILIA	2479	5	7	1711	1492	1704	0	0	0	0	212	1711
EDO. ZULIA	MP. MACHIQUES DE P	PQ. LIBERTAD	UNIDAD  EDUCATIVA  MACHIQUES	2183	4	37	1852	885	1815	2	7	3	0	918	1852
EDO. ZULIA	MP. MACHIQUES DE P	PQ. LIBERTAD	UNIDAD EDUCATIVA NACIONAL LAS GUARDIAS	2985	6	31	2367	1329	2336	1	10	0	0	996	2367
EDO. ZULIA	MP. MACHIQUES DE P	PQ. LIBERTAD	ESCUELA BACHICHIDA	63	1	0	58	56	58	0	0	0	0	2	58
EDO. ZULIA	MP. MACHIQUES DE P	PQ. LIBERTAD	ESCUELA BOLIVARIANA SAYMADOYI	268	1	1	239	230	238	0	0	0	0	8	239
EDO. ZULIA	MP. MACHIQUES DE P	PQ. LIBERTAD	FUNDACION SAN PABLO	1578	3	29	1200	707	1171	1	5	1	0	457	1200
EDO. ZULIA	MP. MACHIQUES DE P	PQ. LIBERTAD	ESCUELA BASICA NACIONAL LA PASTORA	1052	2	15	735	547	720	1	2	0	0	170	735
EDO. ZULIA	MP. MACHIQUES DE P	PQ. LIBERTAD	UNIDAD EDUCATIVA NACIONAL ANTONIO JOSE DE SUCRE	2074	4	16	1584	561	1568	0	6	0	0	1001	1584
EDO. ZULIA	MP. MACHIQUES DE P	PQ. LIBERTAD	UNIDAD EDUCATIVA NACIONAL ANDRES BELLO	2988	6	45	2301	1339	2256	1	8	1	0	907	2301
EDO. ZULIA	MP. MACHIQUES DE P	PQ. LIBERTAD	UNIDAD EDUCATIVA NACIONAL JULIO ARRAGA	2352	5	33	1861	781	1828	1	8	2	1	1035	1861
EDO. ZULIA	MP. MACHIQUES DE P	PQ. LIBERTAD	UNIDAD EDUCATIVA NACIONAL ISMAEL URDANETA	2937	6	44	2282	749	2238	0	9	2	0	1478	2282
EDO. ZULIA	MP. MACHIQUES DE P	PQ.BARTOLOME DE LAS CASAS	ESCUELA BASICA NACIONAL CREACION LAS PIEDRAS	2255	4	26	1638	711	1612	0	2	2	0	897	1638
EDO. ZULIA	MP. MACHIQUES DE P	PQ.BARTOLOME DE LAS CASAS	UNIDAD EDUCATIVA. ESTADAL MAESTRO JESUS VILCHEZ	1781	3	23	1237	711	1214	0	3	0	0	500	1237
EDO. ZULIA	MP. MACHIQUES DE P	PQ.BARTOLOME DE LAS CASAS	ESCUELA BASICA NACIONAL LOS CHICHIES	1419	3	15	1075	619	1060	0	1	0	0	440	1075
EDO. ZULIA	MP. MACHIQUES DE P	PQ.BARTOLOME DE LAS CASAS	ESCUELA BASICA BOLIVARIANA MACOA	944	2	3	675	487	672	0	3	0	0	182	675
EDO. ZULIA	MP. MACHIQUES DE P	PQ.BARTOLOME DE LAS CASAS	UNIDAD EDUCATIVA NACIONAL DOCTOR EMILIO OSORIO BARROSO	3349	6	49	2418	940	2369	0	10	1	0	1418	2418
EDO. ZULIA	MP. CABIMAS	PQ. ARISTIDES CALVANI	ESCUELA BASICA NACIONAL CONCENTRADA LA MEZA	285	1	4	234	115	230	0	0	0	0	115	234
EDO. ZULIA	MP. CABIMAS	PQ. ARISTIDES CALVANI	CENTRO DE EDUCACION INICIAL LAS PIEDRITAS	176	1	4	164	105	160	0	0	0	0	55	164
EDO. ZULIA	MP. CABIMAS	PQ. ARISTIDES CALVANI	UNIDAD EDUCATIVA ESTADAL ALIRIO JOSE GONZALEZ	686	2	11	549	349	538	0	0	1	0	188	549
EDO. ZULIA	MP. CABIMAS	PQ. ARISTIDES CALVANI	ESCUELA PRIMARIA BOLIVARIANA LA WILLIAMS	284	1	4	254	218	250	0	0	1	0	31	254
EDO. ZULIA	MP. CABIMAS	PQ. ARISTIDES CALVANI	ESCUELA CONCENTRADA CHURUGUARITA	208	1	1	140	84	139	0	1	0	0	54	140
EDO. ZULIA	MP. CABIMAS	PQ. ARISTIDES CALVANI	ESCUELA  BASICA NACIONAL  BOLIVARIANA EL PENSAO	187	1	2	162	117	160	0	0	0	0	43	162
EDO. ZULIA	MP. CABIMAS	PQ. ARISTIDES CALVANI	UNIDAD EDUCATIVA BOLIVARIANA AGUA SANTA	719	2	12	572	379	560	0	1	1	0	179	572
EDO. ZULIA	MP. CABIMAS	PQ. ARISTIDES CALVANI	ESCUELA BASICA NACIONAL BOLIVARIANA JOSE FELIX RIBAS	740	2	8	587	349	579	0	3	0	0	227	587
EDO. ZULIA	MP. CABIMAS	PQ. ARISTIDES CALVANI	ESCUELA BASICA ESTADAL CURAZAITO	780	2	12	605	347	593	0	3	0	0	243	605
EDO. ZULIA	MP. CABIMAS	PQ. JORGE HERNANDEZ	ESCUELA BASICA NACIONAL ALIDA  DE ROMERO	2744	5	39	2386	1314	2347	1	12	1	1	1018	2386
EDO. ZULIA	MP. CABIMAS	PQ. JORGE HERNANDEZ	ESCUELA ESTADAL EL PORVENIR	941	2	20	861	613	841	0	2	0	0	226	861
EDO. ZULIA	MP. CABIMAS	PQ. JORGE HERNANDEZ	ESCUELA BASICA ESTADAL SALOMON GARCIA SIERRA	2498	5	51	2115	1119	2064	1	6	3	1	934	2115
EDO. ZULIA	MP. CABIMAS	PQ. JORGE HERNANDEZ	PRRESCOLAR PROFESOR NELSON GONZALEZ	1594	3	28	1446	1032	1418	0	3	0	0	383	1446
EDO. ZULIA	MP. CABIMAS	PQ. JORGE HERNANDEZ	UNIDAD EDUCATIVA ESTADAL MANUEL MARIA PADRON	3875	7	69	3231	1935	3162	1	6	1	1	1218	3231
EDO. ZULIA	MP. CABIMAS	PQ. JORGE HERNANDEZ	LICEO BOLIVARIANO NACIONAL JORGE RODRIGUEZ	718	2	24	628	476	604	0	1	0	0	127	628
EDO. ZULIA	MP. CABIMAS	PQ. JORGE HERNANDEZ	ESCUELA BASICA ESTADAL MAESTRO DANIEL NAVEA	2743	5	55	2176	1366	2121	0	4	0	1	750	2176
EDO. ZULIA	MP. CABIMAS	PQ. JORGE HERNANDEZ	ESCUELA NACIONAL DIULIS GOMEZ DE ORTIZ	661	2	8	625	478	617	0	2	0	0	137	625
EDO. ZULIA	MP. CABIMAS	PQ. JORGE HERNANDEZ	UNIDAD EDUCATIVA NACIONAL EMERIO LUNAR GONZALEZ	1452	3	21	1263	682	1242	0	10	4	0	546	1263
EDO. ZULIA	MP. CABIMAS	PQ. JORGE HERNANDEZ	ESCUELA BASICA NACIONAL DOCTOR. RAUL OSORIO LAZO	3481	6	55	2889	1961	2834	1	8	2	3	859	2889
EDO. ZULIA	MP. CABIMAS	PQ. JORGE HERNANDEZ	ESCUELA BASICA NACIONAL JORGE  ROTHE	1879	4	26	1659	888	1633	0	3	1	0	741	1659
EDO. ZULIA	MP. CABIMAS	PQ. JORGE HERNANDEZ	ESCUELA NACIONAL JOSE ANGEL LAMAS	2087	4	29	1846	1255	1817	1	5	1	1	554	1846
EDO. ZULIA	MP. CABIMAS	PQ. JORGE HERNANDEZ	PREESCOLAR NACIONAL LAGUNITA	1393	3	14	1151	775	1137	0	5	0	0	357	1151
EDO. ZULIA	MP. CABIMAS	PQ. JORGE HERNANDEZ	JARDIN DE INFANCIA NACIONAL TEREPAIMA	1261	3	24	1017	616	993	0	4	0	0	373	1017
EDO. ZULIA	MP. CABIMAS	PQ. JORGE HERNANDEZ	ESCUELA BASICA NACIONAL DON ROMULO GALLEGOS	2133	4	17	1712	1118	1695	0	4	0	0	573	1712
EDO. ZULIA	MP. CABIMAS	PQ. JORGE HERNANDEZ	JARDIN DE INFANCIA CRISTOBAL COLON I	539	1	6	477	413	471	0	0	0	0	58	477
EDO. ZULIA	MP. CABIMAS	PQ. AMBROSIO	UNIDAD EDUCATIVA NACIONAL DR. RAMON REYNOSO NUÑEZ	2471	5	33	2065	1090	2032	0	9	1	0	932	2065
EDO. ZULIA	MP. CABIMAS	PQ. AMBROSIO	ESCUELA BASICA NACIONAL MANUEL MENDEZ	2344	4	28	1949	785	1921	0	13	0	3	1120	1949
EDO. ZULIA	MP. CABIMAS	PQ. AMBROSIO	UNIDAD EDUCATIVA NACIONAL ESTEBAN HERRERA	1690	3	29	1442	721	1413	0	6	0	0	686	1442
EDO. ZULIA	MP. CABIMAS	PQ. AMBROSIO	ESCUELA BASICA NACIONAL FRANCISCO LAZO MARTI	3518	7	40	2971	1638	2931	0	11	0	3	1279	2971
EDO. ZULIA	MP. CABIMAS	PQ. AMBROSIO	GRUPO ESCOLAR NACIONAL JUAN IGNACIO VALBUENA	3000	6	24	2141	908	2117	0	6	1	1	1201	2141
EDO. ZULIA	MP. CABIMAS	PQ. AMBROSIO	UNIDAD EDUCATIVA MARIA ROSA MISTICA	617	2	7	579	265	572	0	1	2	0	304	579
EDO. ZULIA	MP. CABIMAS	PQ. AMBROSIO	ESCUELA BASICA NACIONAL RAFAEL MARIA BARALT	2621	5	21	2351	843	2330	1	6	2	1	1477	2351
EDO. ZULIA	MP. CABIMAS	PQ. AMBROSIO	ESCUELA BASICA NACIONAL PEDRO LUCAS URRIBARRI	3670	7	53	2984	1406	2931	1	18	2	0	1504	2984
EDO. ZULIA	MP. CABIMAS	PQ. AMBROSIO	UNIDAD EDUCATIVA YOLY TERESA MURCI	684	2	6	637	254	631	0	2	0	0	375	637
EDO. ZULIA	MP. CABIMAS	PQ. AMBROSIO	ESCUELA BASICA NACIONAL JUAN ANTONIO PEREZ BONALDE	2841	5	34	2316	986	2282	0	11	0	1	1284	2316
EDO. ZULIA	MP. CABIMAS	PQ. AMBROSIO	INSTITUTO UNIVERSITARIO DE TECNOLOGIA DE CABIMAS	3459	6	31	2906	1497	2875	2	10	2	0	1364	2906
EDO. ZULIA	MP. CABIMAS	PQ. AMBROSIO	UNIDAD EDUCATIVA MUNICIPAL PRIVADA VIRGEN DEL ROSARIO	1232	3	13	1012	363	999	0	2	1	0	633	1012
EDO. ZULIA	MP. CABIMAS	PQ. AMBROSIO	ESCUELA  BASICA PRIMARIA BOLIVARIANA BOMPLAND	3585	7	31	2920	1447	2889	0	16	3	2	1421	2920
EDO. ZULIA	MP. CABIMAS	PQ. AMBROSIO	CENTRO DE FORMACION SOCIALISTA CABIMAS	1648	3	14	1371	607	1357	0	7	0	0	743	1371
EDO. ZULIA	MP. CABIMAS	PQ. AMBROSIO	LICEO NACIONAL HERMAGORAS CHAVEZ	2837	5	27	2430	1003	2403	2	8	1	1	1388	2430
EDO. ZULIA	MP. CABIMAS	PQ. LA ROSA	ESCUELA BASICA ESTADAL VALMORE RODRIGUEZ	2798	5	37	2378	1344	2341	1	16	1	1	978	2378
EDO. ZULIA	MP. CABIMAS	PQ. LA ROSA	UNIDAD EDUCATIVA SANTA MARTA	1295	3	21	1079	523	1058	0	2	0	0	533	1079
EDO. ZULIA	MP. CABIMAS	PQ. LA ROSA	UNIDAD EDUCATIVA JESUS ANIBAL ALFONSO	1104	2	14	919	478	905	1	4	1	1	420	919
EDO. ZULIA	MP. CABIMAS	PQ. LA ROSA	ESCUELA BASICA ESTADAL GUSTAVO FUENMAYOR	3165	6	45	2448	1426	2403	0	10	0	0	967	2448
EDO. ZULIA	MP. CABIMAS	PQ. LA ROSA	UNIDAD EDUCATIVA JESUS SEMPRUN	834	2	20	769	503	749	0	1	0	0	245	769
EDO. ZULIA	MP. CABIMAS	PQ. LA ROSA	UNIDAD EDUCATIVA ESTADAL JESUS ENRIQUE LOSSADA	2507	5	29	2040	1018	2011	0	9	1	1	982	2040
EDO. ZULIA	MP. CABIMAS	PQ. LA ROSA	ESCUELA BASICA NACIONAL RAFAEL URDANETA	2736	5	35	2270	1007	2235	0	4	1	0	1223	2270
EDO. ZULIA	MP. CABIMAS	PQ. LA ROSA	INSTITUTO DE EDUCACION ESPECIAL SAN JUAN  BAUTISTA	453	1	3	394	280	391	0	2	0	0	109	394
EDO. ZULIA	MP. CABIMAS	PQ. LA ROSA	ESCUELA BASICA NACIONAL R5	2203	4	31	1888	1131	1857	0	8	0	1	717	1888
EDO. ZULIA	MP. CABIMAS	PQ. LA ROSA	UNIDAD EDUCATIVA PROFESOR HERBERTO QUINTERO	2054	4	28	1784	773	1756	0	9	1	1	972	1784
EDO. ZULIA	MP. CABIMAS	PQ. LA ROSA	UNIDAD EDUCATIVA NACIONAL PRIVADA ADVENTISTA LIBERTADOR	3019	6	43	2579	1145	2536	0	3	0	2	1386	2579
EDO. ZULIA	MP. CABIMAS	PQ. LA ROSA	LICEO ALFREDO JAHN	815	2	4	739	458	735	1	3	0	1	272	739
EDO. ZULIA	MP. CABIMAS	PQ. GERMAN RIOS LINARES	UNIVERSIDAD NACIONAL EXPERIMENTAL RAFAEL MARIA BARALT	3453	7	48	2941	1730	2893	1	9	2	3	1148	2941
EDO. ZULIA	MP. CABIMAS	PQ. GERMAN RIOS LINARES	CENTRO DE EDUCACION INICIAL BOLIVARIANO LOS LAURELES	440	1	11	414	282	403	0	0	0	0	121	414
EDO. ZULIA	MP. CABIMAS	PQ. GERMAN RIOS LINARES	UNIDAD EDUCATIVA BOLIVARIANA ANGEL EMIRO ARAUJO ORTEGA	212	1	3	202	162	199	0	1	0	0	36	202
EDO. ZULIA	MP. CABIMAS	PQ. GERMAN RIOS LINARES	CENTRO DE EDUCACION  INICIAL ARIANI CUMARE	534	1	3	506	422	503	0	1	0	0	80	506
EDO. ZULIA	MP. CABIMAS	PQ. GERMAN RIOS LINARES	CENTRO DE EDUCACION INICIAL  MARISCAL SUCRE	424	1	7	391	311	384	0	0	0	0	73	391
EDO. ZULIA	MP. CABIMAS	PQ. GERMAN RIOS LINARES	UNIDAD EDUCATIVA MARANATA	462	1	8	394	234	386	0	3	0	0	149	394
EDO. ZULIA	MP. CABIMAS	PQ. GERMAN RIOS LINARES	ESCUELA BASICA NACIONAL DON SIMON RODRIGUEZ	1885	4	19	1512	967	1493	0	7	0	0	519	1512
EDO. ZULIA	MP. CABIMAS	PQ. GERMAN RIOS LINARES	INCE LOS LAURELES	1431	3	20	1195	707	1175	0	6	0	2	460	1195
EDO. ZULIA	MP. CABIMAS	PQ. GERMAN RIOS LINARES	ESCUELA CONCENTRADA PRIMARIA BOLIVARIANA H7	242	1	2	227	189	225	0	1	1	0	34	227
EDO. ZULIA	MP. CABIMAS	PQ. GERMAN RIOS LINARES	UNIDAD EDUCATIVA NACIONAL MANUEL BELLOSO	2601	5	41	2248	1255	2207	2	6	0	0	944	2248
EDO. ZULIA	MP. CABIMAS	PQ. GERMAN RIOS LINARES	LICEO BOLIVARIANO ARISTIDEZ URDANETA	553	1	1	492	312	491	1	0	0	0	178	492
EDO. ZULIA	MP. CABIMAS	PQ. GERMAN RIOS LINARES	CENTRO DE EDCUACION INICIAL CIUDAD SUCRE	876	2	10	789	550	779	0	1	0	0	228	789
EDO. ZULIA	MP. CABIMAS	PQ. GERMAN RIOS LINARES	UNIDAD EDUCATIVA ESTADAL JONH KENNEDY	2062	4	35	1734	976	1699	0	6	2	0	715	1734
EDO. ZULIA	MP. CABIMAS	PQ. GERMAN RIOS LINARES	ESCUELA  SOCIAL DE AVANZADA  BELLO MONTE	5145	9	79	4204	2687	4125	0	18	3	2	1415	4204
EDO. ZULIA	MP. CABIMAS	PQ. GERMAN RIOS LINARES	ESCUELA BOLIVARIANA FRANCISCO DE MIRANDA	1181	2	18	1057	643	1039	0	2	0	0	394	1057
EDO. ZULIA	MP. CABIMAS	PQ. GERMAN RIOS LINARES	ESCUELA BASICA NACIONAL LOS LAURELES	3407	6	42	2848	1718	2806	0	10	1	1	1076	2848
EDO. ZULIA	MP. CABIMAS	PQ. GERMAN RIOS LINARES	JARDIN DE INFANCIA NACIONAL JOSE FELIX RIBAS	1621	3	26	1385	928	1359	0	4	0	1	426	1385
EDO. ZULIA	MP. CABIMAS	PQ. CARMEN HERRERA	UNIDAD EDUCATIVA ESTADAL JOSE ENRIQUE RODO	2802	5	25	2251	960	2226	1	14	2	1	1248	2251
EDO. ZULIA	MP. CABIMAS	PQ. CARMEN HERRERA	UNIDAD EDUCATIVA NACIONAL MAESTRO VICENTE ROJAS	3027	6	25	2475	885	2450	0	8	0	0	1557	2475
EDO. ZULIA	MP. CABIMAS	PQ. CARMEN HERRERA	KINDER GUAICAIPURO	1834	4	28	1641	1006	1613	0	4	1	1	601	1641
EDO. ZULIA	MP. CABIMAS	PQ. CARMEN HERRERA	JARDIN DE INFANCIA EL BRILLANTE	1656	3	26	1495	888	1469	0	4	0	0	577	1495
EDO. ZULIA	MP. CABIMAS	PQ. CARMEN HERRERA	INSTITUTO UNIVERSITARIO POLITECNICO SANTIAGO MARIÑO	1638	3	20	1368	511	1348	0	3	1	0	833	1368
EDO. ZULIA	MP. CABIMAS	PQ. CARMEN HERRERA	ESCUELA BASICA NACIONAL ANDRES ELOY BLANCO	2455	5	30	2146	869	2116	0	6	2	1	1238	2146
EDO. ZULIA	MP. CABIMAS	PQ. CARMEN HERRERA	ESCUELA BASICA NACIONAL PEDRO JULIO MANINAT	2564	5	23	2235	827	2212	0	5	0	0	1380	2235
EDO. ZULIA	MP. CABIMAS	PQ. CARMEN HERRERA	ESCUELA BASICA ESTADAL ELECTO DE JESUS PIÑA	1877	4	26	1538	605	1512	0	3	3	0	901	1538
EDO. ZULIA	MP. CABIMAS	PQ. CARMEN HERRERA	ESCUELA BASICA NACIONAL JULIA AÑEZ GABALDON	4111	8	64	3455	1444	3391	2	14	0	1	1930	3455
EDO. ZULIA	MP. CABIMAS	PQ. CARMEN HERRERA	UNIDAD EDUCATIVA MONSEÑOR GUILLERMO BRIÑEZ (E.Z.A)	2342	4	33	1958	964	1925	0	1	0	3	957	1958
EDO. ZULIA	MP. CABIMAS	PQ. PUNTA GORDA	LICEO BOLIVARIANO GRAN MARISCAL  ANTONIO JOSE DE SUCRE	818	2	20	750	518	730	0	3	0	0	209	750
EDO. ZULIA	MP. CABIMAS	PQ. PUNTA GORDA	UNIDAD EDUCATIVA ESTADAL CAMPO UNIDO	1016	2	8	868	670	860	0	5	0	0	185	868
EDO. ZULIA	MP. CABIMAS	PQ. PUNTA GORDA	JARDIN DE INFANCIA NACIONAL BLANCA DE CABALLERO	1305	3	9	1068	657	1059	0	5	0	1	396	1068
EDO. ZULIA	MP. CABIMAS	PQ. PUNTA GORDA	UNIDAD EDUCATIVA NACIONAL DOCTOR RAMON HERNANDEZ	3280	6	43	2679	1647	2636	1	12	0	2	974	2679
EDO. ZULIA	MP. CABIMAS	PQ. PUNTA GORDA	UNIDAD EDUCATIVA BOLIVARIANA JOSE RAFAEL PRIMERA ( LAS MAJAGUAS )	155	1	2	148	125	146	0	0	0	0	21	148
EDO. ZULIA	MP. CABIMAS	PQ. SAN BENITO	ESCUELA BASICA NACIONAL CABIMAS	2268	4	30	1912	963	1882	0	7	1	0	911	1912
EDO. ZULIA	MP. CABIMAS	PQ. SAN BENITO	UNIDAD EDUCATIVA VICTOR LINO GOMEZ	1439	3	23	1173	708	1150	0	4	0	0	438	1173
EDO. ZULIA	MP. CABIMAS	PQ. SAN BENITO	ESCUELA BASICA NACIONAL CONCENTRADA LAS HUERTAS	422	1	5	326	248	321	0	1	0	0	72	326
EDO. ZULIA	MP. CABIMAS	PQ. SAN BENITO	ESCUELA BASICA NACIONAL FEDERACION VENEZOLANA DE MAESTROS	1876	4	31	1730	913	1699	0	3	2	2	779	1730
EDO. ZULIA	MP. CABIMAS	PQ. SAN BENITO	ESCUELA BASICA NACIONAL ANDRES ELOY BLANCO	3028	6	37	2383	1618	2346	1	19	0	1	707	2383
EDO. ZULIA	MP. CABIMAS	PQ. SAN BENITO	CENTRO DE EDUCACION INICIAL SANTO DOMINGO SABIO	404	1	7	372	311	365	0	1	1	0	52	372
EDO. ZULIA	MP. CABIMAS	PQ. SAN BENITO	CENTRO EDUCACION INICIAL BOLIVARIANO BELLA VISTA	488	1	15	445	346	430	0	0	0	0	84	445
EDO. ZULIA	MP. CABIMAS	PQ. SAN BENITO	ESCUELA BASICA CONCENTRADA FEDERACION	1719	3	23	1566	1197	1543	0	4	0	0	342	1566
EDO. ZULIA	MP. CABIMAS	PQ. SAN BENITO	UNIDAD EDUCATIVA ESTADAL VICTOR LINO GOMEZ (ANEXO 1)	2802	5	36	2315	1417	2279	1	9	3	3	846	2315
EDO. ZULIA	MP. CABIMAS	PQ. SAN BENITO	UNIDAD EDUCATIVA SAN PATRICIO	427	1	8	380	279	372	0	2	0	0	91	380
EDO. ZULIA	MP. CABIMAS	PQ. ROMULO BETANCOURT	UNIDAD EDUCATIVA NACIONAL VICTOR CAPO	3564	7	37	2891	1879	2854	1	6	0	2	966	2891
EDO. ZULIA	MP. CABIMAS	PQ. ROMULO BETANCOURT	UNIDAD EDUCATIVA LAS ACACIAS	808	2	5	735	541	730	0	7	0	0	182	735
EDO. ZULIA	MP. CABIMAS	PQ. ROMULO BETANCOURT	ESCUELA NACIONAL SAN JOSE	914	2	15	784	606	769	0	1	1	0	161	784
EDO. ZULIA	MP. CABIMAS	PQ. ROMULO BETANCOURT	ESCUELA BASICA ESTADAL MARIA CHIQUINQUIRA BAEZ GUERRA	2948	6	32	2444	1354	2412	0	9	2	0	1047	2444
EDO. ZULIA	MP. CABIMAS	PQ. ROMULO BETANCOURT	JARDIN DE INFANCIA LOS MEDANOS	1301	3	26	1203	766	1177	1	4	1	1	404	1203
EDO. ZULIA	MP. CABIMAS	PQ. ROMULO BETANCOURT	PREESCOLAR NACIONAL SIMON BOLIVAR	1610	3	19	1382	857	1363	1	2	0	0	503	1382
EDO. ZULIA	MP. CABIMAS	PQ. ROMULO BETANCOURT	ESCUELA BASICA NACIONAL RAMON OCANDO PEREZ	3411	6	31	2743	1759	2712	0	15	0	1	937	2743
EDO. ZULIA	MP. CABIMAS	PQ. ROMULO BETANCOURT	UNIDAD EDUCASTIVA FELIX MANUEL LUCES	1146	2	16	1051	736	1035	0	4	0	0	295	1051
EDO. ZULIA	MP. CABIMAS	PQ. ROMULO BETANCOURT	PREESCOLAR SIMON BOLIVAR II	851	2	15	760	543	745	0	4	0	0	198	760
EDO. ZULIA	MP. BLVNO GUAJIRA	PQ. ELIAS SANCHEZ RUBIO	ESCUELA BASICA NACIONAL EL MOLINETE	2433	5	29	1605	1023	1576	0	11	1	0	541	1605
EDO. ZULIA	MP. BLVNO GUAJIRA	PQ. ELIAS SANCHEZ RUBIO	ESCUELA BASICA NACIONAL LAS HUERTAS	1736	3	9	1110	874	1101	0	4	1	0	222	1110
EDO. ZULIA	MP. BLVNO GUAJIRA	PQ. ELIAS SANCHEZ RUBIO	UNIDAD EDUCATIVA ESTADAL EL ESCONDIDO	977	2	12	658	306	646	0	0	0	0	340	658
EDO. ZULIA	MP. BLVNO GUAJIRA	PQ. ELIAS SANCHEZ RUBIO	LICEO BOLIVARIANO EL MOLINETE	205	1	5	165	113	160	0	0	0	0	47	165
EDO. ZULIA	MP. BLVNO GUAJIRA	PQ. ELIAS SANCHEZ RUBIO	ESCUELA BASICA NACIONAL SIERRA MAESTRA	108	1	0	89	89	89	0	0	0	0	0	89
EDO. ZULIA	MP. BLVNO GUAJIRA	PQ. ELIAS SANCHEZ RUBIO	ESCUELA EL TAMARAL	479	1	5	367	262	362	0	0	0	0	100	367
EDO. ZULIA	MP. BLVNO GUAJIRA	PQ. ELIAS SANCHEZ RUBIO	CENTRO DE EDUCACION INICIAL SANTA MARÍA DE GUANA	655	2	11	408	276	397	0	0	0	0	121	408
EDO. ZULIA	MP. BLVNO GUAJIRA	PQ. ELIAS SANCHEZ RUBIO	UNIDAD EDUCATIVA MUNICIPAL BARTOLO ABREU	557	1	1	318	187	317	0	4	0	0	126	318
EDO. ZULIA	MP. BLVNO GUAJIRA	PQ. ALTA GUAJIRA	ESCUELA BASICA ESTADAL COJORO	2065	4	10	923	769	913	0	2	0	0	142	923
EDO. ZULIA	MP. BLVNO GUAJIRA	PQ. ALTA GUAJIRA	ESCUELA BASICA ESTADAL JASAY	864	2	3	279	211	276	0	0	0	0	65	279
EDO. ZULIA	MP. BLVNO GUAJIRA	PQ. ALTA GUAJIRA	ESCUELA BASICA DOLORES FERNANDEZ JAYARIYU (PORSHOURE)	355	1	4	216	195	212	0	1	0	0	16	216
EDO. ZULIA	MP. BLVNO GUAJIRA	PQ. ALTA GUAJIRA	UNIDAD EDUCATIVA ESTADAL SICHIPES	1200	3	14	458	266	444	0	1	0	0	177	458
EDO. ZULIA	MP. BLVNO GUAJIRA	PQ. ALTA GUAJIRA	CENTRO DE EDUCACION INICIAL WAPULEE	154	1	0	123	112	123	0	0	0	0	11	123
EDO. ZULIA	MP. BLVNO GUAJIRA	PQ. ALTA GUAJIRA	ESCUELA BASICA NACIONAL UNITARIA CUSIA	1235	3	11	461	338	450	1	3	0	0	108	461
EDO. ZULIA	MP. BLVNO GUAJIRA	PQ. ALTA GUAJIRA	ESCUELA BASICA NACIONAL UNITARIA NEIMA	799	2	16	352	247	336	0	1	1	0	87	352
EDO. ZULIA	MP. BLVNO GUAJIRA	PQ. SINAMAICA	U.E.N.BOL. CAMPO ALEGRE	98	1	2	84	75	82	0	2	1	0	4	84
EDO. ZULIA	MP. BLVNO GUAJIRA	PQ. SINAMAICA	UNIDAD EDUCATIVA LICEO BOLIVARIANO CARMEN FERRER ORTIZ	1080	2	26	877	540	851	0	3	1	0	307	877
EDO. ZULIA	MP. BLVNO GUAJIRA	PQ. SINAMAICA	ESCUELA BASICA BOLIVARIANA EL BOTONCILLO	285	1	1	186	133	185	0	0	0	0	52	186
EDO. ZULIA	MP. BLVNO GUAJIRA	PQ. SINAMAICA	ESCUELA BASICA BOLIVARIANA NUEVO MUNDO	1538	3	1	1001	789	1000	0	4	1	0	206	1001
EDO. ZULIA	MP. BLVNO GUAJIRA	PQ. SINAMAICA	ESCUELA BASICA BOLIVARIANA LOS ROBLES	928	2	9	606	404	597	0	2	1	0	190	606
EDO. ZULIA	MP. BLVNO GUAJIRA	PQ. SINAMAICA	ESCUELA BASICA BOLIVARIANA LOS HERMANITOS	1509	3	20	1030	569	1010	2	5	1	0	433	1030
EDO. ZULIA	MP. BLVNO GUAJIRA	PQ. SINAMAICA	ESCUELA BASICA NAC. CONC. EL GUANABANO	357	1	2	202	115	200	0	0	0	0	85	202
EDO. ZULIA	MP. BLVNO GUAJIRA	PQ. SINAMAICA	ESCUELA BOLIVARIANA LOS RANCHOS	466	1	6	389	318	383	0	0	0	0	65	389
EDO. ZULIA	MP. BLVNO GUAJIRA	PQ. SINAMAICA	UNIDAD EDUCATIVA BOLIVARIANA MARIA ANTONIA RINCON LUGO	854	2	11	575	373	564	0	2	1	0	188	575
EDO. ZULIA	MP. BLVNO GUAJIRA	PQ. SINAMAICA	ESCUELA BASICA ESTADAL SAN FRANCISCO DE ASIS	2654	5	36	1981	1118	1945	0	17	0	0	810	1981
EDO. ZULIA	MP. BLVNO GUAJIRA	PQ. SINAMAICA	ESCUELA BASICA NACIONAL EL CALABOZO	493	1	8	341	194	333	0	3	0	0	136	341
EDO. ZULIA	MP. BLVNO GUAJIRA	PQ. SINAMAICA	E.B.N.BOL. SINAMAICA	324	1	1	254	239	253	0	0	0	0	14	254
EDO. ZULIA	MP. BLVNO GUAJIRA	PQ. SINAMAICA	ESCUELA BASICA NACIONAL CONCENTRADA LOS PUERTECITOS	448	1	1	313	257	312	0	2	0	0	53	313
EDO. ZULIA	MP. BLVNO GUAJIRA	PQ. SINAMAICA	UNIDAD EDUCATIVA ESTADAL LA RITA	275	1	1	193	168	192	0	0	0	0	24	193
EDO. ZULIA	MP. BLVNO GUAJIRA	PQ. GUAJIRA	ESCUELA BASICA NACIONAL UNITARIA ALPAMATE	625	2	1	320	211	319	0	1	1	0	106	320
EDO. ZULIA	MP. BLVNO GUAJIRA	PQ. GUAJIRA	ESCUELA BASICA ESTADAL LAGUNA DE PAJARO	843	2	8	414	315	406	1	1	1	1	87	414
EDO. ZULIA	MP. BLVNO GUAJIRA	PQ. GUAJIRA	ESCUELA BASICA NACIONAL YANAMA	3434	6	22	1624	1207	1602	1	11	0	1	382	1624
EDO. ZULIA	MP. BLVNO GUAJIRA	PQ. GUAJIRA	ESCUELA BASICA BOLIVARIANA YAGUASIRU	710	2	13	337	253	324	0	1	1	0	69	337
EDO. ZULIA	MP. BLVNO GUAJIRA	PQ. GUAJIRA	ESCUELA BOLIVARIANA BELLA VISTA	739	2	6	488	338	482	0	2	0	0	142	488
EDO. ZULIA	MP. BLVNO GUAJIRA	PQ. GUAJIRA	UNIDAD EDUCATIVA ESTADAL EL CARRETAL  (ANEXO 1)	572	1	1	274	189	273	0	1	0	0	83	274
EDO. ZULIA	MP. BLVNO GUAJIRA	PQ. GUAJIRA	ESCUELA BASICA NACIONAL UNITARIA URACHIPE
EDO. ZULIA	MP. BLVNO GUAJIRA	PQ. GUAJIRA	UNIDAD EDUCATIVA ESTADAL EL CARRETAL	756	2	8	374	245	366	0	0	0	0	121	374
EDO. ZULIA	MP. BLVNO GUAJIRA	PQ. GUAJIRA	ESCUELA BASICA NACIONAL  PREBISTERO FRANCISCO BABINE	2720	5	30	1470	1030	1440	1	7	2	0	400	1470
EDO. ZULIA	MP. BLVNO GUAJIRA	PQ. GUAJIRA	ESCUELA UNITARIA CAUJARITO	1566	3	7	824	551	817	0	2	0	0	264	824
EDO. ZULIA	MP. BLVNO GUAJIRA	PQ. GUAJIRA	LICEO ORANGEL ABREU SEMPRUN	3324	6	42	1713	1207	1671	2	8	3	0	451	1713
EDO. ZULIA	MP. BLVNO GUAJIRA	PQ. GUAJIRA	ESCUELA BASICA BOLIVARIANA   JUAN  EVANGELISTA ALONSO	1442	3	19	827	644	808	0	5	0	0	159	827
EDO. ZULIA	MP. BLVNO GUAJIRA	PQ. GUAJIRA	ESCUELA ESTADAL LUIS EMIRO PALMAR	312	1	5	228	173	223	0	2	0	0	48	228
EDO. ZULIA	MP. BLVNO GUAJIRA	PQ. GUAJIRA	ESCUELA BASICA NACIONAL JURUBA	1423	3	10	849	640	839	0	1	0	0	198	849
EDO. ZULIA	MP. BLVNO GUAJIRA	PQ. GUAJIRA	ESCUELA NACIONAL SAN RAFAEL DE PARAGUACHON	1418	3	5	669	468	664	0	2	0	0	194	669
EDO. ZULIA	MP. BLVNO GUAJIRA	PQ. GUAJIRA	ESCUELA BOLIVARIANA MIRALEJOS	451	1	6	354	308	348	1	0	0	0	39	354
EDO. ZULIA	MP. BLVNO GUAJIRA	PQ. GUAJIRA	CEIN CALIE	159	1	3	138	104	135	0	0	0	0	31	138
EDO. ZULIA	MP. BLVNO GUAJIRA	PQ. GUAJIRA	ESCUELA MACUCUTAO	400	1	6	308	269	302	0	0	0	0	33	308
EDO. ZULIA	MP. BLVNO GUAJIRA	PQ. GUAJIRA	ESCUELA BASICA NACIONAL CONCENTRADA CAMAMA	924	2	39	532	300	493	0	3	0	0	190	532
EDO. ZULIA	MP. BLVNO GUAJIRA	PQ. GUAJIRA	U. E. N. BOL. CANO CABEZON	221	1	2	118	106	116	0	0	1	0	9	118
EDO. ZULIA	MP. BLVNO GUAJIRA	PQ. GUAJIRA	ESCUELA BASICA NACIONAL UNITARIA LA CANDELARIA	255	1	0	140	125	140	0	1	0	0	14	140
EDO. ZULIA	MP. BLVNO GUAJIRA	PQ. GUAJIRA	ESCUELA BOLIVARIANA RAFAEL URIANA	490	1	7	307	227	300	1	0	3	0	69	307
EDO. ZULIA	MP. BLVNO GUAJIRA	PQ. GUAJIRA	ESCUELA UNITARIA COLOPONTAIN	291	1	1	132	94	131	0	0	0	0	37	132
EDO. ZULIA	MP. BLVNO GUAJIRA	PQ. GUAJIRA	ESCUELA BOLIVARIANA LA PUNTA	186	1	2	164	147	162	0	1	0	0	14	164
EDO. ZULIA	MP. BLVNO GUAJIRA	PQ. GUAJIRA	ESCUELA BOLIVARIANA EL ARROLLO	269	1	1	184	154	183	0	0	0	0	29	184
EDO. ZULIA	MP. BLVNO GUAJIRA	PQ. GUAJIRA	UNIDAD EDUCATIVA ESTADAL LAS GUARDIAS	1097	2	16	664	480	648	0	0	0	0	168	664
EDO. ZULIA	MP. BLVNO GUAJIRA	PQ. GUAJIRA	ESCUELA BASICA ESTADAL EL CAÑITO	1144	2	6	722	540	716	0	9	1	0	166	722
EDO. ZULIA	MP. BLVNO GUAJIRA	PQ. GUAJIRA	UNIDAD EDUCATIVA ESTADAL AMERICA LOPEZ DE VARGAS	2733	5	13	1263	867	1250	0	5	1	0	377	1263
EDO. ZULIA	MP. BLVNO GUAJIRA	PQ. GUAJIRA	ESCUELA BASICA NACIONAL PUERTO ALERAMO	1326	3	4	725	515	721	0	3	0	1	202	725
EDO. ZULIA	MP. BLVNO GUAJIRA	PQ. GUAJIRA	FE Y ALEGRIA	2787	5	47	1653	1092	1606	1	5	1	0	507	1653
EDO. ZULIA	MP. BLVNO GUAJIRA	PQ. GUAJIRA	GRUPO ESCOLAR NACIONAL GUAJIRA	3690	7	30	2152	1344	2122	1	19	2	0	756	2152
EDO. ZULIA	MP. BLVNO GUAJIRA	PQ. GUAJIRA	ESCUELA BASICA NACIONAL CONCENTRADA MARICHIPAY	961	2	6	519	421	513	0	0	1	0	91	519
EDO. ZULIA	MP. JESUS M SEMPRUN	PQ. JESUS M SEMPRUN	ESCUELA BOLIVARIANA RAFAEL MARIA BARALT (SARDINATA)	1220	3	13	994	595	981	0	5	1	0	380	994
EDO. ZULIA	MP. JESUS M SEMPRUN	PQ. JESUS M SEMPRUN	ESCUELA BASICA NACIONAL EZEQUIEL ZAMORA	121	1	0	89	72	89	0	0	0	0	17	89
EDO. ZULIA	MP. JESUS M SEMPRUN	PQ. JESUS M SEMPRUN	LICEO  BOLIVARIANO  PEDRO LUCAS URRIBARRI	1788	3	20	1436	1027	1416	0	6	0	0	383	1436
EDO. ZULIA	MP. JESUS M SEMPRUN	PQ. JESUS M SEMPRUN	ESCUELA BASICA NACIONAL ARENALES	104	1	1	71	57	70	0	0	0	0	13	71
EDO. ZULIA	MP. JESUS M SEMPRUN	PQ. JESUS M SEMPRUN	EB PUERTO PALOMA	632	2	8	544	490	536	0	3	0	0	43	544
EDO. ZULIA	MP. JESUS M SEMPRUN	PQ. JESUS M SEMPRUN	ESC BOLIVARIANA PUENTE PERU	214	1	0	181	173	181	0	1	0	0	7	181
EDO. ZULIA	MP. JESUS M SEMPRUN	PQ. JESUS M SEMPRUN	ESCUELA BASICA NACIONAL EL MIRADOR	334	1	5	282	250	277	0	1	0	0	26	282
EDO. ZULIA	MP. JESUS M SEMPRUN	PQ. JESUS M SEMPRUN	ESCUELA BOLIVARIANA  EL CARMELO	786	2	23	647	356	624	0	2	0	0	266	647
EDO. ZULIA	MP. JESUS M SEMPRUN	PQ. JESUS M SEMPRUN	ESC BOLIVARIANA SAN BENITO	384	1	5	284	235	279	0	0	0	0	44	284
EDO. ZULIA	MP. JESUS M SEMPRUN	PQ. JESUS M SEMPRUN	ESCUELA BOLIVARIANA  NACIONAL  JOSE MARIA VARGAS	1250	3	22	1008	678	986	0	5	0	1	302	1008
EDO. ZULIA	MP. JESUS M SEMPRUN	PQ. JESUS M SEMPRUN	ESCUELA BASICA CONCENTRADA  ESTADAL NUESTRA SEÑORA DEL PILAR	208	1	0	125	99	125	0	0	0	0	26	125
EDO. ZULIA	MP. JESUS M SEMPRUN	PQ. JESUS M SEMPRUN	UNIDAD EDUCATIVA ESTADAL GENERAL RAFAEL URDANETA	4764	9	53	3765	2013	3712	0	17	1	0	1681	3765
EDO. ZULIA	MP. JESUS M SEMPRUN	PQ. BARI	ESCUELA BASICA NACIONAL EL CRUCE	2884	5	30	2142	1713	2112	1	12	0	0	386	2142
EDO. ZULIA	MP. JESUS M SEMPRUN	PQ. BARI	ESC BOLIVARIANA ARUUTATAKAE	256	1	0	225	196	225	0	1	0	0	28	225
EDO. ZULIA	MP. JESUS M SEMPRUN	PQ. BARI	ESCUELA ANA MARIA CAMPOS	216	1	0	153	152	153	0	0	0	0	1	153
EDO. ZULIA	MP. JESUS M SEMPRUN	PQ. BARI	ESCUELA BASICA NACIONAL ARQUIDOCESANA BOCKSI	273	1	6	173	103	167	1	0	0	0	63	173
EDO. ZULIA	MP. JESUS M SEMPRUN	PQ. BARI	ESCUELA CONCENTRADA  ESTADAL JOSE GREGORIO HERNANDEZ	361	1	2	214	181	212	0	1	0	0	30	214
EDO. ZULIA	MP. JESUS M SEMPRUN	PQ. BARI	UNIDAD EDUCATIVA 12 DE FEBRERO	43	1	0	26	26	26	0	0	0	0	0	26
EDO. ZULIA	MP. JESUS M SEMPRUN	PQ. BARI	ESCUELA SIMON BOLIVAR	54	1	1	39	38	38	0	0	0	0	0	39
EDO. ZULIA	CE. MARACAIBO	PQ. CHIQUINQUIRA	ESCUELA BASICA NACIONAL MONSEÑOR GODOY (ANEXO 1)	1259	3	12	1068	429	1056	0	7	0	0	620	1068
EDO. ZULIA	CE. MARACAIBO	PQ. CHIQUINQUIRA	INSTITUTO UNIVERSITARIO TECNOLOGICO JUAN PABLO PEREZ ALFONZO	4500	8	33	3431	920	3398	0	8	2	2	2466	3431
EDO. ZULIA	CE. MARACAIBO	PQ. CHIQUINQUIRA	UNIDAD EDUCATIVA NACIONAL DR ADOLFO COLINA	3045	6	52	2477	867	2425	2	10	1	0	1545	2477
EDO. ZULIA	CE. MARACAIBO	PQ. CHIQUINQUIRA	ESCUELA BASICA ESTADAL J A ROMAN VALECILLOS	3632	7	52	2743	1078	2691	2	16	0	1	1594	2743
EDO. ZULIA	CE. MARACAIBO	PQ. CHIQUINQUIRA	UNIDAD EDUCATIVA NACIONAL RAFAEL MARIA BARALT (ANEXO 1)	353	1	4	287	59	283	0	1	0	0	223	287
EDO. ZULIA	CE. MARACAIBO	PQ. CHIQUINQUIRA	UNIDAD EDUCATIVA  NACIONAL DR CRISTOVAL MENDOZA	4201	8	49	3373	1118	3324	0	5	0	1	2200	3373
EDO. ZULIA	CE. MARACAIBO	PQ. CHIQUINQUIRA	JARDIN DE INFANCIA CHIQUINQUIRA	535	1	8	469	299	461	0	0	1	0	161	469
EDO. ZULIA	CE. MARACAIBO	PQ. CHIQUINQUIRA	ESCUELA BASICA ESTADAL JUAN ANTONIO ROMAN VALECILLOS (ANEXO 1)	926	2	10	783	349	773	0	4	0	0	420	783
EDO. ZULIA	CE. MARACAIBO	PQ. CHIQUINQUIRA	UNIDAD EDUCATIVA NACIONAL  CARMEN AMERICA DE LEONI	1130	2	13	901	308	888	0	2	1	0	577	901
EDO. ZULIA	CE. MARACAIBO	PQ. CHIQUINQUIRA	ESCUELA BASICA ESTADAL CARLOS LUIS RINCON LUBO	1918	4	23	1520	443	1497	3	6	0	2	1043	1520
EDO. ZULIA	CE. MARACAIBO	PQ. CHIQUINQUIRA	COLEGIO LA EPIFANIA	6965	13	50	5467	1197	5417	1	13	1	5	4200	5467
EDO. ZULIA	CE. MARACAIBO	PQ. CHIQUINQUIRA	COLEGIO SANTA ANGELA	3520	7	40	2986	877	2946	0	9	0	3	2057	2986
EDO. ZULIA	CE. MARACAIBO	PQ. CHIQUINQUIRA	ESCUELA BASICA NACIONAL MONSEÑOR GODOY	3821	7	64	3157	1216	3093	0	9	2	3	1863	3157
EDO. ZULIA	CE. MARACAIBO	PQ. CHIQUINQUIRA	UNIDAD EDUCATIVA ESTADAL DR JOAQUIN ESTEVA	3965	7	60	3130	991	3070	0	8	1	1	2069	3130
EDO. ZULIA	CE. MARACAIBO	PQ. CHIQUINQUIRA	UNIDAD EDUCATIVA NACIONAL RAFAEL MARIA BARALT	4747	9	53	3392	580	3339	0	5	1	0	2753	3392
EDO. ZULIA	CE. MARACAIBO	PQ. CHIQUINQUIRA	UNIDAD EDUCATIVA NACIONAL DOCTOR CRISTOBAL MENDOZA (ANEXO 1)	1226	3	13	1084	372	1071	0	2	1	0	696	1084
EDO. ZULIA	CE. MARACAIBO	PQ. CRISTO DE ARANZA	ESCUELA BASICA ESTADAL ORANGEL RODRIGUEZ	3518	7	36	2787	924	2751	0	3	1	1	1822	2787
EDO. ZULIA	CE. MARACAIBO	PQ. CRISTO DE ARANZA	ESCUELA BASICA NACIONAL BARRIO EL PROGRESO	3274	6	56	2621	1298	2565	0	6	0	4	1257	2621
EDO. ZULIA	CE. MARACAIBO	PQ. CRISTO DE ARANZA	ESCUELA BASICA NACIONAL DOCTOR FRANCISCO OCHOA (ANEXO 1)	341	1	3	232	89	229	0	0	1	0	139	232
EDO. ZULIA	CE. MARACAIBO	PQ. CRISTO DE ARANZA	ESCUELA BASICA NACIONAL MARIA CAMARGO DE ALVAREZ	3602	7	40	2970	1257	2930	0	5	4	0	1664	2970
EDO. ZULIA	CE. MARACAIBO	PQ. CRISTO DE ARANZA	UNIDAD EDUCATIVA ESTADAL DR CARRACCIOLO PARRA LEON	3175	6	31	2549	1200	2518	1	7	0	1	1309	2549
EDO. ZULIA	CE. MARACAIBO	PQ. CRISTO DE ARANZA	ESCUELA BASICA ESTADAL LUIS ARRIETA ACOSTA (ANEXO 1)	546	1	6	432	171	426	0	1	0	0	254	432
EDO. ZULIA	CE. MARACAIBO	PQ. CRISTO DE ARANZA	CENTRO MOVIL CANCHA ALTAMIRA SUR	2808	5	43	2111	1106	2068	0	5	1	1	955	2111
EDO. ZULIA	CE. MARACAIBO	PQ. CRISTO DE ARANZA	UNIDAD EDUCATIVA NACIONAL LEONARDO RUIZ PINEDA	3557	7	44	2926	1680	2882	0	8	1	0	1193	2926
EDO. ZULIA	CE. MARACAIBO	PQ. CRISTO DE ARANZA	UNIDAD EDUCATIVA NACIONAL VALERO TOLEDO	2879	5	26	2358	905	2332	0	7	0	1	1419	2358
EDO. ZULIA	CE. MARACAIBO	PQ. CRISTO DE ARANZA	ESCUELA ESTADAL CRISTOBAL COLON	3604	7	50	2970	1582	2920	0	4	1	3	1330	2970
EDO. ZULIA	CE. MARACAIBO	PQ. CRISTO DE ARANZA	UNIDAD EDUCATIVA NACIONAL PRIVADA EVANGELICA ROSA DE SARON	2032	4	19	1672	797	1653	0	3	0	0	853	1672
EDO. ZULIA	CE. MARACAIBO	PQ. CRISTO DE ARANZA	ESCUELA NACIONAL MARACAIBO	3367	6	38	2809	1402	2771	2	4	1	2	1360	2809
EDO. ZULIA	CE. MARACAIBO	PQ. CRISTO DE ARANZA	COLEGIO SANTA RITA	3415	6	17	2938	793	2921	0	7	2	1	2118	2938
EDO. ZULIA	CE. MARACAIBO	PQ. CRISTO DE ARANZA	JARDIN DE INFANCIA LA FUNDACION	2686	5	30	2223	931	2193	0	2	0	0	1260	2223
EDO. ZULIA	CE. MARACAIBO	PQ. CRISTO DE ARANZA	CENTRO DE CULTURA VIDAL CALDERON	1998	4	37	1678	684	1641	0	2	0	0	955	1678
EDO. ZULIA	CE. MARACAIBO	PQ. CRISTO DE ARANZA	UNIDAD EDUCATIVA NACIONAL FRANCISCO ESPARZA GARCIA	2183	4	23	1756	570	1733	0	6	0	0	1157	1756
EDO. ZULIA	CE. MARACAIBO	PQ. CRISTO DE ARANZA	UNIDAD EDUCATIVA ESTADAL ADELA LOZANO	1436	3	21	1221	534	1200	1	3	0	0	662	1221
EDO. ZULIA	CE. MARACAIBO	PQ. CRISTO DE ARANZA	UE RAFAEL ARVELO RODRIGUEZ	443	1	4	316	165	312	0	1	0	0	146	316
EDO. ZULIA	CE. MARACAIBO	PQ. CRISTO DE ARANZA	UNIDAD EDUCATIVA NUESRA SEÑORA DEL VALLE	1975	4	23	1644	799	1621	0	5	3	0	814	1644
EDO. ZULIA	CE. MARACAIBO	PQ. CRISTO DE ARANZA	ESCUELA BASICA ESTADAL DON ROMULO GALLEGOS (EZA)	3019	6	29	2412	925	2383	1	6	0	1	1450	2412
EDO. ZULIA	CE. MARACAIBO	PQ. CRISTO DE ARANZA	IVA ANTONIO HERRERA	2895	5	25	2412	1268	2387	0	2	3	0	1114	2412
EDO. ZULIA	CE. MARACAIBO	PQ. CRISTO DE ARANZA	ESCUELA ARTESANAL ESTADAL MARIA TERESA DEL TORO	1513	3	23	1227	589	1204	0	4	0	0	611	1227
EDO. ZULIA	CE. MARACAIBO	PQ. CRISTO DE ARANZA	ESCUELA BASICA NACIONAL EL BRILLANTE	2422	5	21	2000	981	1979	0	7	0	0	991	2000
EDO. ZULIA	CE. MARACAIBO	PQ. CRISTO DE ARANZA	ESCUELA BASICA NACIONAL JOSE IGNACIO NACIONAL	2287	4	36	1894	834	1858	0	4	1	0	1019	1894
EDO. ZULIA	CE. MARACAIBO	PQ. CRISTO DE ARANZA	ESCUELA BASICA NACIONAL DR FRANCISCO OCHOA	4881	9	54	3903	1978	3849	1	5	1	2	1862	3903
EDO. ZULIA	CE. MARACAIBO	PQ. CRISTO DE ARANZA	ESCUELA BASICA ESTADAL LCDO LUIS ARRIETA ACOSTA	5056	9	61	3975	1664	3914	0	15	1	0	2234	3975
EDO. ZULIA	CE. MARACAIBO	PQ. CRISTO DE ARANZA	ESCUELA BASICA NACIONAL DR SEVERIANO RODRIGUEZ	2585	5	30	2155	981	2125	0	9	1	0	1134	2155
EDO. ZULIA	CE. MARACAIBO	PQ. CRISTO DE ARANZA	LICEO NACIONAL DR JESUS ENRIQUE LOSSADA	4459	8	68	3651	1948	3583	2	7	1	2	1623	3651
EDO. ZULIA	CE. MARACAIBO	PQ. CRISTO DE ARANZA	ESCUELA BASICA ESTADAL ORANGEL RODRIGUEZ (ANEXO 1)	791	2	6	692	265	686	0	1	0	0	420	692
EDO. ZULIA	CE. MARACAIBO	PQ. CRISTO DE ARANZA	ESCUELA BASICA NACIONAL MAGDALENA OCANDO	1975	4	17	1669	874	1652	0	5	1	0	772	1669
EDO. ZULIA	CE. MARACAIBO	PQ. JUANA DE AVILA	GRUPO ESCOLAR  NACIONAL  DR MARCIAL HERNANDEZ	3626	7	44	2643	1358	2599	0	2	3	3	1233	2643
EDO. ZULIA	CE. MARACAIBO	PQ. JUANA DE AVILA	ESCUELA BASICA NACIONAL JUANA DE AVILA	5538	10	67	4474	1552	4407	1	12	3	1	2838	4474
EDO. ZULIA	CE. MARACAIBO	PQ. JUANA DE AVILA	ESCUELA BASICA NACIONAL JUANA DE AVILA (ANEXO 1)	599	1	2	509	157	507	0	0	0	0	350	509
EDO. ZULIA	CE. MARACAIBO	PQ. JUANA DE AVILA	OBRA SOCIAL DE LA MADRE Y EL NIÑO	2493	5	33	1953	945	1920	0	8	0	1	966	1953
EDO. ZULIA	CE. MARACAIBO	PQ. JUANA DE AVILA	JARDIN DE INFANCIA MARIA MOÑITOS (ANEXO 1)	1390	3	4	1304	219	1300	0	2	0	1	1078	1304
EDO. ZULIA	CE. MARACAIBO	PQ. JUANA DE AVILA	UNIDAD EDUCATIVA LUIS BELTRAN RAMOS (ANEXO 1)	576	1	2	492	137	490	0	1	0	0	352	492
EDO. ZULIA	CE. MARACAIBO	PQ. JUANA DE AVILA	ESCUELA BASICA JUAN BESON	2604	5	15	2179	478	2164	1	5	1	0	1679	2179
EDO. ZULIA	CE. MARACAIBO	PQ. JUANA DE AVILA	JARDIN DE INFANCIA NACIONAL R 4 SAN JACINTO	2439	5	35	2091	907	2056	0	6	2	1	1140	2091
EDO. ZULIA	CE. MARACAIBO	PQ. JUANA DE AVILA	ESCUELA BASICA DOCTOR MARCIAL HERNANDEZ (ANEXO 1)	893	2	12	742	375	730	0	2	0	0	353	742
EDO. ZULIA	CE. MARACAIBO	PQ. JUANA DE AVILA	ESCUELA  BASICA MAESTRO LUIS BELTRAN PRIETO FIGUEROA	5572	10	34	4508	865	4474	0	11	2	3	3593	4508
EDO. ZULIA	CE. MARACAIBO	PQ. JUANA DE AVILA	LICEO LUIS BELTRAN RAMOS	4576	8	28	3746	1218	3718	0	7	1	1	2491	3746
EDO. ZULIA	CE. MARACAIBO	PQ. JUANA DE AVILA	IPASME	2060	4	25	1742	536	1717	0	3	0	0	1178	1742
EDO. ZULIA	CE. MARACAIBO	PQ. JUANA DE AVILA	ESCUELA BASICA NACIONAL NORMAN PRIETO RAMOS	4237	8	23	3437	703	3414	0	8	0	0	2703	3437
EDO. ZULIA	CE. MARACAIBO	PQ. JUANA DE AVILA	UNIDAD EDUCATIVA GENERAL EDUARDO PEREZ	1664	3	7	1447	630	1440	0	2	2	0	806	1447
EDO. ZULIA	CE. MARACAIBO	PQ. JUANA DE AVILA	ESCUELA BASICA NACIONAL LUISA CACERES DE ARISMENDI (ANEXO 1)	421	1	5	348	85	343	0	2	0	0	256	348
EDO. ZULIA	CE. MARACAIBO	PQ. JUANA DE AVILA	GRUPO ESCOLAR LUIS BELTRAN PRIETO FIGUEROA (ANEXO 1)	343	1	2	309	53	307	0	1	0	1	252	309
EDO. ZULIA	CE. MARACAIBO	PQ. JUANA DE AVILA	JARDIN DE INFANCIA NACIONAL MARIA MOÑITOS	4447	8	14	3662	587	3648	0	5	1	1	3054	3662
EDO. ZULIA	CE. MARACAIBO	PQ. JUANA DE AVILA	ESCUELA BASICA NACIONAL NORMAN PRIETO RAMOS (ANEXO 1)	248	1	2	222	35	220	0	0	0	0	185	222
EDO. ZULIA	CE. MARACAIBO	PQ. JUANA DE AVILA	ESCUELA DE FORMACION ARTESANAL NACIONAL DON GUILLERMO ATENCIO	2458	5	35	2088	718	2053	0	8	0	1	1326	2088
EDO. ZULIA	CE. MARACAIBO	PQ. JUANA DE AVILA	JARDIN DE INFANCIA NACIONAL LOMA LINDA	2266	4	15	2019	399	2004	0	2	1	0	1602	2019
EDO. ZULIA	CE. MARACAIBO	PQ. JUANA DE AVILA	FUNDACION DE PADRES Y AMIGOS DE ADOLESCENTES Y O ADULTOS CON RETARDO MENTAL (FUNPARM)	1356	3	19	1139	385	1120	0	1	0	1	733	1139
EDO. ZULIA	CE. MARACAIBO	PQ. JUANA DE AVILA	ESCUELA BASICA NACIONAL LUISA CACERES DE ARISMENDI	3944	7	35	3252	1113	3217	0	12	3	0	2089	3252
EDO. ZULIA	CE. MARACAIBO	PQ. ANTONIO BORJAS ROMERO	ESCUELA BASICA NACIONAL FRANCISCO VALERA	3525	7	45	2642	1513	2597	0	12	1	0	1071	2642
EDO. ZULIA	CE. MARACAIBO	PQ. ANTONIO BORJAS ROMERO	UNIDAD EDUCATIVA DOCTOR LUIS HOMEZ	1762	4	22	1375	890	1353	0	2	0	1	460	1375
EDO. ZULIA	CE. MARACAIBO	PQ. ANTONIO BORJAS ROMERO	ESCUELA BASICA ESTADAL EL LIBERTADOR	3617	7	60	2724	1339	2664	0	8	0	2	1315	2724
EDO. ZULIA	CE. MARACAIBO	PQ. ANTONIO BORJAS ROMERO	ESCUELA BOLIVARIANA APOLINAR GONZALEZ	963	2	23	825	555	802	0	2	0	0	245	825
EDO. ZULIA	CE. MARACAIBO	PQ. ANTONIO BORJAS ROMERO	ESCUELA DIVERSIFICADA NACIONAL RAFAEL URDANETA	1498	3	24	1234	978	1210	3	4	1	2	222	1234
EDO. ZULIA	CE. MARACAIBO	PQ. ANTONIO BORJAS ROMERO	UNIDAD EDUCATIVA ESTADAL  MARISCAL ANTONIO JOSE DE SUCRE	3098	6	41	2058	1244	2017	0	13	1	0	759	2058
EDO. ZULIA	CE. MARACAIBO	PQ. ANTONIO BORJAS ROMERO	CENTRO DEPORTIVO CULTURAL PATRIA JOVEN	2885	5	36	2315	1190	2279	0	6	1	3	1079	2315
EDO. ZULIA	CE. MARACAIBO	PQ. ANTONIO BORJAS ROMERO	UNIDAD EDUCATIVA NACIONAL JOSE ANTONIO RINCON	908	2	9	689	447	680	0	3	0	0	230	689
EDO. ZULIA	CE. MARACAIBO	PQ. ANTONIO BORJAS ROMERO	UNIDAD EDUCATIVA VECINAL III	2854	5	41	2145	1330	2104	4	5	2	0	763	2145
EDO. ZULIA	CE. MARACAIBO	PQ. ANTONIO BORJAS ROMERO	UNIDAD EDUCATIVA NACIONAL DR. MARCIAL HERNANDEZ	4181	8	45	2882	2049	2837	0	13	1	0	774	2882
EDO. ZULIA	CE. MARACAIBO	PQ. ANTONIO BORJAS ROMERO	ESCUELA BASICA NACIONAL MERY SANCHEZ DE UGAS	551	1	7	448	319	441	0	0	0	0	122	448
EDO. ZULIA	CE. MARACAIBO	PQ. ANTONIO BORJAS ROMERO	ESCUELA BASICA NACIONAL LUIS ANGEL GARCIA	1008	2	27	827	534	800	0	1	0	0	265	827
EDO. ZULIA	CE. MARACAIBO	PQ. ANTONIO BORJAS ROMERO	UNIDAD EDUCATIVA NACIONAL ARQUIDIOCESANA MONSEÑOR OLEGARIO VILLALOBOS	6064	11	112	4456	2915	4344	0	18	2	1	1408	4456
EDO. ZULIA	CE. MARACAIBO	PQ. ANTONIO BORJAS ROMERO	UNIDAD EDUCATIVA  NACIONAL  FRANCISCO REINOSO NUÑEZ	3165	6	30	2383	1581	2353	2	4	0	0	766	2383
EDO. ZULIA	CE. MARACAIBO	PQ. ANTONIO BORJAS ROMERO	UND EDU ARQ BICENTENARIO NATALICIO DEL LIBERTADOR	1651	3	20	1184	659	1164	0	4	0	2	499	1184
EDO. ZULIA	CE. MARACAIBO	PQ. ANTONIO BORJAS ROMERO	ESCUELA BASICA NACIONAL SAN ANTONIO	1529	3	23	1182	830	1159	1	5	0	0	323	1182
EDO. ZULIA	CE. MARACAIBO	PQ. ANTONIO BORJAS ROMERO	ESCUELA BASICA ESTADAL TEPICHI TALACHI	910	2	36	771	588	735	0	0	0	1	146	771
EDO. ZULIA	CE. MARACAIBO	PQ. ANTONIO BORJAS ROMERO	ESCUELA ZULIANA DE AVANZADA LOS PROCERES	1316	3	23	1154	852	1131	0	3	0	0	276	1154
EDO. ZULIA	CE. MARACAIBO	PQ. ANTONIO BORJAS ROMERO	UNIDAD EDUCATIVA LUIS ANGEL GARCIA	408	1	6	320	181	314	0	1	0	0	132	320
EDO. ZULIA	CE. MARACAIBO	PQ. ANTONIO BORJAS ROMERO	ESCUELA BASICA ESTADAL HIJOS DE BOLIVAR	523	1	8	442	332	434	0	0	0	0	102	442
EDO. ZULIA	CE. MARACAIBO	PQ. ANTONIO BORJAS ROMERO	UNIDAD EDUCATIVA ESTADAL LICENCIADO. JOSE LUIS RAMOS	514	1	4	428	293	424	0	3	0	1	127	428
EDO. ZULIA	CE. MARACAIBO	PQ. ANTONIO BORJAS ROMERO	PRE ESCOLAR ESTADAL TILINGO TILINGO	685	2	10	589	276	579	0	1	0	0	302	589
EDO. ZULIA	CE. MARACAIBO	PQ. ANTONIO BORJAS ROMERO	ESCUELA SAN JOSE DE LA MONTAÑA	522	1	5	468	341	463	0	2	0	0	120	468
EDO. ZULIA	CE. MARACAIBO	PQ. ANTONIO BORJAS ROMERO	U EE IGNACIO HUARTE	510	1	7	436	311	429	1	1	0	0	116	436
EDO. ZULIA	CE. MARACAIBO	PQ. RAUL LEONI	UNIDAD EDUCATIVA NACIONAL ALMIRANTE PADILLA	5655	10	45	4847	1187	4802	0	7	2	4	3602	4847
EDO. ZULIA	CE. MARACAIBO	PQ. RAUL LEONI	ESC BAS BOLIVARIANA COSME GONZALEZ	576	1	1	517	125	516	0	0	0	1	390	517
EDO. ZULIA	CE. MARACAIBO	PQ. RAUL LEONI	ESCUELA BASICA NACIONAL DR OCTAVIO HERNANDEZ	4735	9	27	3852	1347	3825	0	8	2	2	2466	3852
EDO. ZULIA	CE. MARACAIBO	PQ. RAUL LEONI	ESCUELA BASICA ESTADAL MARCO TULIO ANDRADES	3338	6	45	2705	1006	2660	0	10	1	2	1641	2705
EDO. ZULIA	CE. MARACAIBO	PQ. RAUL LEONI	LICEO JOSE MARIA ANTUNEZ	6874	13	38	5947	1482	5909	1	9	0	1	4416	5947
EDO. ZULIA	CE. MARACAIBO	PQ. RAUL LEONI	ESCUELA BASICA IDELFONZO VASQUEZ	1585	3	20	1387	646	1367	0	1	0	0	720	1387
EDO. ZULIA	CE. MARACAIBO	PQ. RAUL LEONI	PREESCOLAR ESTADAL LOS ANGELITOS	4110	8	33	3461	1080	3428	1	3	1	3	2340	3461
EDO. ZULIA	CE. MARACAIBO	PQ. RAUL LEONI	ESCUELA BASICA NACIONAL JULIO CESAR BORGE	4890	9	30	4040	1135	4010	0	10	0	2	2863	4040
EDO. ZULIA	CE. MARACAIBO	PQ. RAUL LEONI	UNIDAD EDUCATIVA ESTADAL BOLIVARIANA	3838	7	42	3167	1243	3125	0	2	3	0	1877	3167
EDO. ZULIA	CE. MARACAIBO	PQ. RAUL LEONI	UNIDAD EDUCATIVA SANTA MONICA	4950	9	37	3997	1063	3960	1	7	0	1	2888	3997
EDO. ZULIA	CE. MARACAIBO	PQ. RAUL LEONI	UNIDAD EDUCATIVA SANTA VERONICA DE MILAN	4007	7	32	3266	1078	3234	1	5	0	3	2147	3266
EDO. ZULIA	CE. MARACAIBO	PQ. IDELFONZO VASQUEZ	ESCUELA BASICA BRISAS DEL NORTE	1145	2	25	905	638	880	0	2	0	0	240	905
EDO. ZULIA	CE. MARACAIBO	PQ. IDELFONZO VASQUEZ	ESCUELA BASICA NACIONAL JOSE DE LA ROSA FERNANDEZ	2747	5	31	1725	1095	1694	0	4	1	0	594	1725
EDO. ZULIA	CE. MARACAIBO	PQ. IDELFONZO VASQUEZ	ESCUELA BASICA NACIONAL 4 DE FEBRERO	883	2	26	728	564	702	0	1	1	1	135	728
EDO. ZULIA	CE. MARACAIBO	PQ. IDELFONZO VASQUEZ	CASA COMUNAL CULTURAL 4 DE ABRIL	580	1	13	490	364	477	0	2	0	0	111	490
EDO. ZULIA	CE. MARACAIBO	PQ. IDELFONZO VASQUEZ	ESCUELA ZULIANA DE AVANZADA INTERCULTURAL BILINGÜE BELLA ESPERANZA	737	2	21	537	296	516	0	0	0	0	220	537
EDO. ZULIA	CE. MARACAIBO	PQ. IDELFONZO VASQUEZ	UNIDAD EDUCATIVA NACIONAL BOLIVARIANA SOLANDA ELOINA GARCIA AREVALO	1011	2	23	718	484	695	1	0	4	0	206	718
EDO. ZULIA	CE. MARACAIBO	PQ. IDELFONZO VASQUEZ	UNIDAD EDUCATIVA BOLIVARIANA LA RESISTENCIA	1551	3	25	1212	756	1187	0	6	0	0	425	1212
EDO. ZULIA	CE. MARACAIBO	PQ. IDELFONZO VASQUEZ	UNIDAD EDUCATIVA ARQUIDIOSESANA MADRE ELISA JARAMILLO	1583	3	25	1083	709	1058	1	4	2	0	342	1083
EDO. ZULIA	CE. MARACAIBO	PQ. IDELFONZO VASQUEZ	UNIDAD EDUCATIVA ESTADAL BALMIRO LEON	1413	3	18	1117	598	1099	0	3	1	0	497	1117
EDO. ZULIA	CE. MARACAIBO	PQ. IDELFONZO VASQUEZ	ESCUELA BASICA CARDONAL GUAYU	6063	11	92	3888	2313	3796	0	17	1	1	1464	3888
EDO. ZULIA	CE. MARACAIBO	PQ. IDELFONZO VASQUEZ	ESCUELA BASICA NACIONAL OLGA MARIA ABREU	4953	9	56	3183	1974	3127	2	10	1	0	1140	3183
EDO. ZULIA	CE. MARACAIBO	PQ. IDELFONZO VASQUEZ	ESCUELA BASICA ESTADAL LAS PEONIAS N:34	3836	7	47	2446	1376	2399	2	8	3	1	1009	2446
EDO. ZULIA	CE. MARACAIBO	PQ. IDELFONZO VASQUEZ	ESCUELA BASICA ESTADAL OFELIA ALBUJA	2890	5	58	2134	1230	2076	2	5	1	0	838	2134
EDO. ZULIA	CE. MARACAIBO	PQ. IDELFONZO VASQUEZ	CENTRO CULTURAL DE CUJICITO CARLOS PARRA BERNAL	3589	7	54	2583	1540	2529	2	9	0	1	977	2583
EDO. ZULIA	CE. MARACAIBO	PQ. IDELFONZO VASQUEZ	ESCUELA BASICA NACIONAL EVELIA DE PIMENTEL	3477	6	42	2584	1322	2542	0	6	1	0	1213	2584
EDO. ZULIA	CE. MARACAIBO	PQ. IDELFONZO VASQUEZ	CENTRO DE EDUCACION INICIAL ROMULO GALLEGOS I	2857	5	27	1852	1191	1825	0	3	0	2	629	1852
EDO. ZULIA	CE. MARACAIBO	PQ. IDELFONZO VASQUEZ	UNIDAD EDUCATIVA FE Y ALEGRIA SANTA BRIGIDA	1846	4	26	1385	981	1359	1	2	1	0	374	1385
EDO. ZULIA	CE. MARACAIBO	PQ. IDELFONZO VASQUEZ	ESCUELA BASICA NACIONAL SAN JUAN (ANEXO 1)	2434	5	28	1581	968	1553	3	4	2	0	576	1581
EDO. ZULIA	CE. MARACAIBO	PQ. IDELFONZO VASQUEZ	ESCUELA BASICA BOLIVARIANA ANCON BAJO	669	2	13	465	268	452	0	1	1	0	182	465
EDO. ZULIA	CE. MARACAIBO	PQ. IDELFONZO VASQUEZ	UNIDAD EDUCATIVA NACIONAL  PROFESOR JOSE TRINIDAD MORILLO	1730	3	32	1246	843	1214	0	6	3	0	362	1246
EDO. ZULIA	CE. MARACAIBO	PQ. IDELFONZO VASQUEZ	CENTRO DE EDUCACION INICIAL TEPICHI PALAJANA 4 AJONJOLI	1074	2	15	849	563	834	0	0	1	0	270	849
EDO. ZULIA	CE. MARACAIBO	PQ. IDELFONZO VASQUEZ	ESCUELA BASICA NACIONAL JULIO GONZALEZ	4647	9	69	2819	1727	2750	1	7	1	2	1012	2819
EDO. ZULIA	CE. MARACAIBO	PQ. IDELFONZO VASQUEZ	ESCUELA ANTONIO NICOLAS BRICEÑO	845	2	5	727	554	722	0	1	0	0	167	727
EDO. ZULIA	CE. MARACAIBO	PQ. IDELFONZO VASQUEZ	JARDIN DE INFANCIA LA ESPERANZA	2880	5	32	2164	1364	2132	1	11	2	1	753	2164
EDO. ZULIA	CE. MARACAIBO	PQ. IDELFONZO VASQUEZ	CENTRO DE EDUCACION INICIAL DON ROMULOS GALLEGOS	762	2	11	640	482	629	0	4	0	0	143	640
EDO. ZULIA	CE. MARACAIBO	PQ. IDELFONZO VASQUEZ	ESCUELA BASICA NACIONAL SAN JUAN	2964	6	28	1617	917	1589	0	8	0	1	663	1617
EDO. ZULIA	CE. MARACAIBO	PQ. IDELFONZO VASQUEZ	COLEGIO SANTA MARIANA DE JESUS	6487	12	60	4968	2363	4908	1	13	1	1	2529	4968
EDO. ZULIA	CE. MARACAIBO	PQ. IDELFONZO VASQUEZ	ESCUELA RAMON PAZ IPUANA	532	1	6	427	344	421	0	0	0	0	77	427
EDO. ZULIA	CE. MARACAIBO	PQ. IDELFONZO VASQUEZ	ESCUELA BASICA NACIONAL BARRIO INDIO MARA	1828	4	32	1320	949	1288	1	10	0	1	327	1320
EDO. ZULIA	CE. MARACAIBO	PQ. IDELFONZO VASQUEZ	UNIVERSIDAD NACIONAL ABIERTA	928	2	9	796	689	787	0	2	0	0	96	796
EDO. ZULIA	CE. MARACAIBO	PQ. CACIQUE MARA	ESCUELA BASICA NACIONAL DR REGULO PACHANO AÑEZ	1752	3	8	1393	586	1385	0	7	2	4	786	1393
EDO. ZULIA	CE. MARACAIBO	PQ. CACIQUE MARA	ESCUELA BASICA NACIONAL NEPTALI RINCON URDANETA	4000	7	54	3215	1629	3161	0	13	0	1	1518	3215
EDO. ZULIA	CE. MARACAIBO	PQ. CACIQUE MARA	UNIDAD EDUCATIVA JOSE MARIA ESPAÑA	227	1	1	198	95	197	0	1	0	0	101	198
EDO. ZULIA	CE. MARACAIBO	PQ. CACIQUE MARA	UNIDAD EDUCATIVA NACIONAL ANA SANCHEZ COLINA	4063	7	48	3371	1590	3323	0	14	0	1	1718	3371
EDO. ZULIA	CE. MARACAIBO	PQ. CACIQUE MARA	INSTITUTO NIÑOS CANTORES DEL ZULIA	1648	3	17	1322	588	1305	0	3	0	1	713	1322
EDO. ZULIA	CE. MARACAIBO	PQ. CACIQUE MARA	JARDIN DE INFANCIA BRICEIDA LA CRUZ	1453	3	17	1158	593	1141	0	3	1	1	543	1158
EDO. ZULIA	CE. MARACAIBO	PQ. CACIQUE MARA	PREESCOLAR LA RONDITA	1416	3	15	1126	556	1111	0	5	0	0	550	1126
EDO. ZULIA	CE. MARACAIBO	PQ. CACIQUE MARA	UNIDAD EDUCATIVA COLEGIO NUESTRO LIBERTADOR	435	1	6	384	144	378	0	1	1	0	232	384
EDO. ZULIA	CE. MARACAIBO	PQ. CACIQUE MARA	UNIDAD EDUCATIVA ESTADAL DR JOSE ORTIZ RODRIGUEZ	2048	4	31	1608	759	1577	0	5	2	1	810	1608
EDO. ZULIA	CE. MARACAIBO	PQ. CACIQUE MARA	GRUPO ESCOLAR ESTADAL MONSEÑOR HELIMENES AÑEZ	2895	5	35	2217	1115	2182	0	2	0	0	1065	2217
EDO. ZULIA	CE. MARACAIBO	PQ. CACIQUE MARA	ESCUELA BASICA NACIONAL  PROFESOR CONSUELO NAVA TOVAR	2720	5	40	2303	1467	2263	0	1	0	0	795	2303
EDO. ZULIA	CE. MARACAIBO	PQ. CACIQUE MARA	GRUPO ESCOLAR MONSEÑOR HELIMENAS AÑEZ	1006	2	11	729	342	718	0	2	0	1	373	729
EDO. ZULIA	CE. MARACAIBO	PQ. CACIQUE MARA	ESCUELA BASICA NACIONAL BESARABIA	3240	6	35	2641	1316	2606	0	6	4	3	1277	2641
EDO. ZULIA	CE. MARACAIBO	PQ. CACIQUE MARA	UNIDAD EDUCATIVA NACIONAL COLEGIO GONZAGA	4003	7	49	3321	1560	3272	0	5	1	2	1704	3321
EDO. ZULIA	CE. MARACAIBO	PQ. CACIQUE MARA	UNIDAD EDUCATIVA NACIONAL DR VICENTE LECUNA	3164	6	34	2576	1128	2542	0	5	2	2	1405	2576
EDO. ZULIA	CE. MARACAIBO	PQ. CACIQUE MARA	UNIDAD EDUCATIVA ESTADAL GABRIELA MISTRAL	4795	9	33	3802	1263	3769	0	8	3	1	2494	3802
EDO. ZULIA	CE. MARACAIBO	PQ. CACIQUE MARA	UNIDAD EDUCATIVA NACIONAL CARLOS RINCON LUBO	3190	6	33	2686	1175	2653	0	6	0	2	1470	2686
EDO. ZULIA	CE. MARACAIBO	PQ. CACIQUE MARA	UNIDAD EDUCATIVA ESTADAL CARMELITA MORALES	3801	7	52	2976	1467	2924	0	3	1	0	1453	2976
EDO. ZULIA	CE. MARACAIBO	PQ. CACIQUE MARA	UNIDAD EDUCATIVA NACIONAL CATATUMBO	2905	5	44	2290	909	2246	0	8	0	1	1328	2290
EDO. ZULIA	CE. MARACAIBO	PQ. LUIS HURTADO HIGUERA	UNIDAD EDUCATIVA MIGUEL OTERO SILVA	1098	2	19	922	384	903	0	6	0	1	512	922
EDO. ZULIA	CE. MARACAIBO	PQ. LUIS HURTADO HIGUERA	LICEO LUIS GUILLERMO FERRER	1685	3	19	1381	1033	1362	1	1	0	0	327	1381
EDO. ZULIA	CE. MARACAIBO	PQ. LUIS HURTADO HIGUERA	ESCUELA BASICA NACIONAL CREACION LIBERTAD	4405	8	37	3443	2424	3406	1	13	0	2	966	3443
EDO. ZULIA	CE. MARACAIBO	PQ. LUIS HURTADO HIGUERA	ESCUELA ARQUIDIOCESANA MONSEÑOR ARIAS BLANCO	1518	3	37	1248	933	1211	0	1	0	0	277	1248
EDO. ZULIA	CE. MARACAIBO	PQ. LUIS HURTADO HIGUERA	ESCUELA BASICA CARDONAL SUR	1553	3	27	1352	801	1325	0	0	0	0	524	1352
EDO. ZULIA	CE. MARACAIBO	PQ. LUIS HURTADO HIGUERA	ESCUELA BASICA NACIONAL LUIS GUILLERMO SANCHEZ	6450	12	64	5206	2860	5142	1	13	2	0	2266	5206
EDO. ZULIA	CE. MARACAIBO	PQ. LUIS HURTADO HIGUERA	ESCUELA JOAQUIN COSTA	880	2	18	745	471	727	0	4	0	0	252	745
EDO. ZULIA	CE. MARACAIBO	PQ. LUIS HURTADO HIGUERA	JARDIN DE INFANCIA NACIONAL GENERAL JUAN BAUTISTA ARISMENDI	7885	15	102	6187	4360	6085	1	16	3	2	1703	6187
EDO. ZULIA	CE. MARACAIBO	PQ. LUIS HURTADO HIGUERA	ESCUELA BASICA CRISTOFONO FALCON	859	2	21	763	440	742	0	2	0	0	300	763
EDO. ZULIA	CE. MARACAIBO	PQ. LUIS HURTADO HIGUERA	ESCUELA BASICA ESTADAL EL NACIONALISTA	3576	7	39	2744	1610	2705	0	5	2	1	1087	2744
EDO. ZULIA	CE. MARACAIBO	PQ. LUIS HURTADO HIGUERA	UNIDAD EDUCATIVA FRANCISCO JOSE DELGADO	2236	4	21	1809	1150	1788	0	10	0	0	628	1809
EDO. ZULIA	CE. MARACAIBO	PQ. LUIS HURTADO HIGUERA	ESCUELA  BASICA  NACIONAL JACINTO REGINO PACHANO MUÑOZ	3124	6	27	2475	1722	2448	0	10	0	1	715	2475
EDO. ZULIA	CE. MARACAIBO	PQ. LUIS HURTADO HIGUERA	ESCUELA BASICA ARQUIDIOSESANA SAN RAFAEL	689	2	11	592	338	581	0	1	0	0	242	592
EDO. ZULIA	CE. MARACAIBO	PQ. LUIS HURTADO HIGUERA	CENTRO DE INCIACION MARIA ROSARIO CAMPOS	1678	3	15	1487	810	1472	0	0	0	0	662	1487
EDO. ZULIA	CE. MARACAIBO	PQ. MANUEL DAGNINO	JARDIN DE INFANCIA NACIONAL GABRIELA MISTRAL	2533	5	20	2201	1245	2181	0	5	1	3	927	2201
EDO. ZULIA	CE. MARACAIBO	PQ. MANUEL DAGNINO	ESCUELA BASICA ESTADAL AMANDA DE JESUS BRAVO	3026	6	30	2292	1226	2262	0	7	2	1	1026	2292
EDO. ZULIA	CE. MARACAIBO	PQ. MANUEL DAGNINO	UE ARQUIDEOSESANA NUESTRA SEÑORA DE COROMOTO	1125	2	14	1008	674	994	0	4	0	0	316	1008
EDO. ZULIA	CE. MARACAIBO	PQ. MANUEL DAGNINO	CENTRO INFANTIL PRESBITERO LISANDRO PUCHE	3586	7	45	2940	1071	2895	0	7	0	1	1816	2940
EDO. ZULIA	CE. MARACAIBO	PQ. MANUEL DAGNINO	UE DR. JUAN GERMAN ROSCIO	441	1	7	382	242	375	0	3	1	0	129	382
EDO. ZULIA	CE. MARACAIBO	PQ. MANUEL DAGNINO	ESCUELA BASICA ESTADAL PROFESOR CONSUELO NAVAS TOVAR	6417	12	69	5053	2614	4984	0	21	2	5	2342	5053
EDO. ZULIA	CE. MARACAIBO	PQ. MANUEL DAGNINO	UNIDAD EDUCATIVAMONSEÑOR JOSE LUIS CASTELLANOS	811	2	16	727	403	711	0	5	0	0	303	727
EDO. ZULIA	CE. MARACAIBO	PQ. MANUEL DAGNINO	ESCUELA ARTESANAL NACIONAL EL PILAR	3623	7	36	3059	1428	3023	1	6	2	4	1582	3059
EDO. ZULIA	CE. MARACAIBO	PQ. MANUEL DAGNINO	ESCUELA BASICA NACIONAL ZULIA	2182	4	18	1695	919	1677	0	5	0	1	752	1695
EDO. ZULIA	CE. MARACAIBO	PQ. MANUEL DAGNINO	UNIDAD EDUCATIVA NACIONAL GENERAL JUAN ANTONIO PAREDES	2101	4	18	1813	718	1795	0	4	0	0	1073	1813
EDO. ZULIA	CE. MARACAIBO	PQ. MANUEL DAGNINO	UNIDAD EDUCATIVA MARIA REINA	644	2	11	567	330	556	0	0	0	0	226	567
EDO. ZULIA	CE. MARACAIBO	PQ. MANUEL DAGNINO	ESCUELA  BASICA 15 DE ENERO	6016	11	82	4788	2422	4706	1	10	1	3	2269	4788
EDO. ZULIA	CE. MARACAIBO	PQ. MANUEL DAGNINO	UNIDAD EDUCATIVA NACIONAL HERMANO IDELFONZO GUTIERREZ	5740	11	111	4740	2572	4629	0	19	1	1	2036	4740
EDO. ZULIA	CE. MARACAIBO	PQ. MANUEL DAGNINO	UNIDAD EDUCATIVA SAN EZEQUIEL MORENO	899	2	5	851	337	846	0	1	0	0	508	851
EDO. ZULIA	CE. MARACAIBO	PQ. MANUEL DAGNINO	UNIDAD EDUCATIVA ESTADAL DON OMAR LEON SALAS	3575	7	31	2877	1602	2846	2	10	2	1	1229	2877
EDO. ZULIA	CE. MARACAIBO	PQ. MANUEL DAGNINO	UNIDAD EDUCATIVA ESTADAL CUATRICENTENARIA	752	2	7	657	333	650	0	1	1	1	314	657
EDO. ZULIA	CE. MARACAIBO	PQ. MANUEL DAGNINO	UNIDAD EDUCATIVA NACIONAL PRIVADA CORAZON DE JESUS	2707	5	35	2258	1188	2223	0	4	1	0	1030	2258
EDO. ZULIA	CE. MARACAIBO	PQ. MANUEL DAGNINO	LICEO NACIONAL COQUIVACOA	2141	4	28	1679	769	1651	0	2	1	2	877	1679
EDO. ZULIA	CE. MARACAIBO	PQ. MANUEL DAGNINO	UNIDAD EDUCATIVA VIRGEN DE LOS ANGELES	579	1	5	535	273	530	0	0	0	0	257	535
EDO. ZULIA	CE. MARACAIBO	PQ. MANUEL DAGNINO	CENTRO  DE EDUCACIÓN INICIAL SIMONCITO LOS ANGELES	533	1	11	452	260	441	0	2	0	0	179	452
EDO. ZULIA	CE. MARACAIBO	PQ. MANUEL DAGNINO	ESCUELA EGIDIO MONTESINOS	401	1	6	341	239	335	0	3	0	0	93	341
EDO. ZULIA	CE. MARACAIBO	PQ. MANUEL DAGNINO	BACHILLER EGIDIO MONTESINOS	2993	6	44	2461	1250	2417	0	9	3	2	1153	2461
EDO. ZULIA	CE. MARACAIBO	PQ. VENANCIO PULGAR	CENTRO DE EDUCACION INICIAL ALEJANDRINA MARIA DA COSTA	1007	2	6	863	505	857	0	0	0	0	352	863
EDO. ZULIA	CE. MARACAIBO	PQ. VENANCIO PULGAR	UNIDAD EDUCATIVA GABRIEL BRACHO	872	2	15	757	415	742	0	1	0	0	326	757
EDO. ZULIA	CE. MARACAIBO	PQ. VENANCIO PULGAR	UNIDAD EDUCATIVA NACIONAL PRIVADA LICENCIADA BETTY RIOS LOPEZ	1883	4	29	1474	801	1445	1	2	0	0	641	1474
EDO. ZULIA	CE. MARACAIBO	PQ. VENANCIO PULGAR	UNIDAD EDUCATIVA NACIONAL JOSE FELIX RIVAS	6232	11	90	4311	2801	4221	3	13	7	0	1397	4311
EDO. ZULIA	CE. MARACAIBO	PQ. VENANCIO PULGAR	UNIDAD EDUCATIVA ESTADAL ARMANDO REVERON	2596	5	46	2002	1134	1956	0	6	4	0	812	2002
EDO. ZULIA	CE. MARACAIBO	PQ. VENANCIO PULGAR	ESCUELA BASICA ESTADAL DR. HUMBERTO FERNANDEZ MORAN	2982	6	50	2344	1253	2294	0	3	0	0	1038	2344
EDO. ZULIA	CE. MARACAIBO	PQ. VENANCIO PULGAR	ESCUELA BASICA NACIONAL 12 DE MARZO	2537	5	26	1920	1403	1894	1	6	1	3	480	1920
EDO. ZULIA	CE. MARACAIBO	PQ. VENANCIO PULGAR	ESCUELA BASICA NACIONAL BARRIO EL DESCANSO	1398	3	18	1127	789	1109	2	4	0	0	314	1127
EDO. ZULIA	CE. MARACAIBO	PQ. VENANCIO PULGAR	ESCUELA BASICA NACIONAL MANUEL GUAL	387	1	4	322	228	318	0	1	0	0	89	322
EDO. ZULIA	CE. MARACAIBO	PQ. VENANCIO PULGAR	UNIDAD EDUCATIVA PRIVADA MARCIAL AUGUSTO NAVA	917	2	9	763	596	754	0	2	1	0	155	763
EDO. ZULIA	CE. MARACAIBO	PQ. VENANCIO PULGAR	CENTRO DE EDUCACION INICIAL SUENO DE SIMON RODRIGUEZ	260	1	7	235	156	228	0	0	0	0	72	235
EDO. ZULIA	CE. MARACAIBO	PQ. VENANCIO PULGAR	ESCUELA BASICA NACIONAL MORAL Y LUCES	2732	5	69	1967	1159	1898	1	4	2	1	731	1967
EDO. ZULIA	CE. MARACAIBO	PQ. VENANCIO PULGAR	CENTRO INFANTIL CARMELO URDANETA	2558	5	13	1997	1222	1984	1	9	0	1	751	1997
EDO. ZULIA	CE. MARACAIBO	PQ. VENANCIO PULGAR	ESCUELA BASICA NACIONAL BACHILLER RAFAEL ESCANDELA	4626	9	66	3502	1947	3436	0	6	0	1	1482	3502
EDO. ZULIA	CE. MARACAIBO	PQ. VENANCIO PULGAR	ESCUELA BASICA NACIONAL VALMORE RODRIGUEZ	3353	6	32	2657	1441	2625	0	5	0	2	1177	2657
EDO. ZULIA	CE. MARACAIBO	PQ. VENANCIO PULGAR	ESCUELA BASICA NACIONAL CHIQUINQUIRA	2965	6	31	2161	1542	2130	0	6	2	1	579	2161
EDO. ZULIA	CE. MARACAIBO	PQ. VENANCIO PULGAR	UNIDAD EDUCATIVA ARQUIDIOCESANA MARIA AUXILIADORA	2082	4	17	1778	1359	1761	2	3	1	0	396	1778
EDO. ZULIA	CE. MARACAIBO	PQ. VENANCIO PULGAR	ESCUELA BASICA NACIONAL BOLIVARIANA HATO DE TEJAS	378	1	7	316	260	309	0	0	0	0	49	316
EDO. ZULIA	CE. MARACAIBO	PQ. VENANCIO PULGAR	CENTRO DE EDUCACIÓN INICIAL ALEXANDRA USUGA	963	2	20	833	575	813	0	3	0	0	235	833
EDO. ZULIA	CE. MARACAIBO	PQ. VENANCIO PULGAR	ESCUELA BASICA ESTADAL IDELMA DE MORALES	3005	6	66	2151	1251	2085	3	5	4	0	822	2151
EDO. ZULIA	CE. MARACAIBO	PQ. VENANCIO PULGAR	CENTRO DE EDUCACIÓN INICIAL OLGA MARIA RUBIO	535	1	14	445	310	431	0	0	1	0	120	445
EDO. ZULIA	CE. MARACAIBO	PQ. VENANCIO PULGAR	UNIDAD EDUCATIVA LICENCIADO HENRY OBERTO	969	2	19	796	514	777	0	2	4	0	257	796
EDO. ZULIA	CE. MARACAIBO	PQ. VENANCIO PULGAR	CENTRO DE EDUCACION INTEGRAL MADRE EMILIA	1145	2	18	972	623	954	0	3	0	0	328	972
EDO. ZULIA	CE. MARACAIBO	PQ. VENANCIO PULGAR	UNIDAD EDUCATIVA GENERAL CARLOS SOUBLETT	4595	8	43	3402	2051	3359	1	5	1	6	1295	3402
EDO. ZULIA	CE. MARACAIBO	PQ. VENANCIO PULGAR	ESCUELA BASICA ESTADAL MAESTRO TOMAS  RAFAEL JIMENEZ	4601	9	78	3332	1783	3254	2	11	1	2	1455	3332
EDO. ZULIA	CE. MARACAIBO	PQ. VENANCIO PULGAR	CENTRO DE EDUCACIÓN INICIAL RAFAEL VILLAVICENCIO	653	2	6	569	378	563	0	1	0	0	184	569
EDO. ZULIA	CE. MARACAIBO	PQ. VENANCIO PULGAR	ESCUELA BASICA EL SEMBRADOR	983	2	20	734	392	714	2	2	1	1	316	734
EDO. ZULIA	CE. MARACAIBO	PQ. VENANCIO PULGAR	UNIDAD EDUCATIVA NACIONAL WAYUU JOSE DE LOS SANTOS MONTIEL	1375	3	26	904	577	878	0	1	1	0	299	904
EDO. ZULIA	CE. MARACAIBO	PQ. VENANCIO PULGAR	UE PRIVADA GENERAL JULIAN CASTRO	1133	2	15	973	679	958	0	2	0	0	277	973
EDO. ZULIA	CE. MARACAIBO	PQ. OLEGARIO VILLALOBOS	UNIDAD EDUCATIVA COLEGIO NUESTRA SEÑORA DE LAS MERCEDES	1878	4	18	1584	477	1566	0	4	4	1	1080	1584
EDO. ZULIA	CE. MARACAIBO	PQ. OLEGARIO VILLALOBOS	ESCUELA BASICA NACIONAL HERMAGORAS CHAVEZ	3265	6	24	2397	908	2373	0	9	1	1	1454	2397
EDO. ZULIA	CE. MARACAIBO	PQ. OLEGARIO VILLALOBOS	ESCUELA BASICA ESTADAL ANDRES ELOY BLANCO (EZA)	3465	6	33	2618	727	2585	0	7	0	2	1849	2618
EDO. ZULIA	CE. MARACAIBO	PQ. OLEGARIO VILLALOBOS	UNIDAD EDUCATIVA NACIONAL PRIVADA COLEGIO SAN VICENTE DE PAUL	6574	12	38	5250	569	5212	0	5	0	3	4635	5250
EDO. ZULIA	CE. MARACAIBO	PQ. OLEGARIO VILLALOBOS	UNIDAD EDUCATIVA DOMINGO SARMIENTO	327	1	1	289	57	288	0	1	0	0	230	289
EDO. ZULIA	CE. MARACAIBO	PQ. OLEGARIO VILLALOBOS	ESCUELA BASICANACIONAL ANSELMA PULGAR	1285	3	14	983	441	969	0	0	0	0	528	983
EDO. ZULIA	CE. MARACAIBO	PQ. OLEGARIO VILLALOBOS	ESCUELA BASICA ESTADAL LUCILA PALACIOS	6649	12	42	5115	842	5073	0	9	0	4	4218	5115
EDO. ZULIA	CE. MARACAIBO	PQ. OLEGARIO VILLALOBOS	E. NACIONAL DON BOSCO	3339	6	37	2657	999	2620	0	10	4	3	1604	2657
EDO. ZULIA	CE. MARACAIBO	PQ. OLEGARIO VILLALOBOS	ESCUELA BASICA ESTADAL DR FRANCISCO EUGENIO BUSTAMANTE	4284	8	48	3382	1386	3334	0	13	2	0	1933	3382
EDO. ZULIA	CE. MARACAIBO	PQ. OLEGARIO VILLALOBOS	UNIDAD EDUCATIVA NACIONAL UDON PEREZ	6903	13	67	5370	1332	5303	0	13	1	2	3955	5370
EDO. ZULIA	CE. MARACAIBO	PQ. OLEGARIO VILLALOBOS	UNIDAD EDUCATIVA NACIONAL PRIVADA COLEGIO CLARET	3637	7	23	2969	367	2946	0	6	1	0	2572	2969
EDO. ZULIA	CE. MARACAIBO	PQ. OLEGARIO VILLALOBOS	UNIDAD EDUCATIVA NACIONAL PRIVADA NUESTRA SEÑORA DEL PILAR	7482	14	61	6154	872	6093	0	6	2	0	5213	6154
EDO. ZULIA	CE. MARACAIBO	PQ. OLEGARIO VILLALOBOS	UNIDAD EDUCATIVA UDON PEREZ (ANEXO 1)	487	1	6	416	118	410	0	0	0	1	291	416
EDO. ZULIA	CE. MARACAIBO	PQ. OLEGARIO VILLALOBOS	ESCUELA DE ARTES PLASTICAS NACIONAL JULIO ARRAGA	2450	5	25	1772	282	1747	0	2	0	0	1463	1772
EDO. ZULIA	CE. MARACAIBO	PQ. OLEGARIO VILLALOBOS	UNIDAD EDUCATIVA MATER SALVATORIS	935	2	11	804	103	793	0	0	0	0	690	804
EDO. ZULIA	CE. MARACAIBO	PQ. OLEGARIO VILLALOBOS	UNIDAD EDUCATIVA PRIVADA COLEGIO BELLAS ARTES	5432	10	17	4200	411	4183	1	5	0	2	3764	4200
EDO. ZULIA	CE. MARACAIBO	PQ. OLEGARIO VILLALOBOS	GRUPO ESCOLAR NACIONAL PRIMERO DE AGOSTO	443	1	5	384	179	379	0	0	0	1	199	384
EDO. ZULIA	CE. MARACAIBO	PQ. OLEGARIO VILLALOBOS	UNIDAD EDUCATIVA NACIONAL ROMULO GALLEGOS	6288	11	42	4804	1139	4762	1	7	0	5	3610	4804
EDO. ZULIA	CE. MARACAIBO	PQ.CARACCIOLO PARRA PEREZ	ESCUELA BASICA ESTADAL RAMON REINOSO NUÑEZ	3998	7	37	3216	946	3179	0	5	0	5	2223	3216
EDO. ZULIA	CE. MARACAIBO	PQ.CARACCIOLO PARRA PEREZ	LICEO CARACCIOLO PARRA PEREZ	6727	12	48	5193	1313	5145	0	6	1	6	3819	5193
EDO. ZULIA	CE. MARACAIBO	PQ.CARACCIOLO PARRA PEREZ	ESCUELA BASICA ANGEL ALVAREZ DOMINGUEZ (ANEXO 1)	363	1	7	300	117	293	0	0	0	0	176	300
EDO. ZULIA	CE. MARACAIBO	PQ.CARACCIOLO PARRA PEREZ	ESCUELA BASICA NACIONAL ALONSO DE OJEDA	3531	7	50	2884	968	2834	0	12	0	1	1853	2884
EDO. ZULIA	CE. MARACAIBO	PQ.CARACCIOLO PARRA PEREZ	INSTITUTO UNIVERSITARIO SANTIAGO MARIÑO	233	1	1	199	70	198	0	0	0	0	128	199
EDO. ZULIA	CE. MARACAIBO	PQ.CARACCIOLO PARRA PEREZ	INCE CONSTRUCCION	2941	6	35	2403	851	2368	0	4	0	1	1512	2403
EDO. ZULIA	CE. MARACAIBO	PQ.CARACCIOLO PARRA PEREZ	ESCUELA BASICA NACIONAL DOCTOR JOSE MARIA VARGAS (ANEXO 1)	739	2	11	593	301	582	0	3	0	0	278	593
EDO. ZULIA	CE. MARACAIBO	PQ.CARACCIOLO PARRA PEREZ	ESCUELA BASICA ESTADAL DELIA HUERTA	4108	8	37	3180	1198	3143	1	10	0	3	1931	3180
EDO. ZULIA	CE. MARACAIBO	PQ.CARACCIOLO PARRA PEREZ	LICEO NACIONAL CARRACIOLO PARRA PEREZ (ANEXO 1)	1078	2	16	955	249	939	0	1	0	0	689	955
EDO. ZULIA	CE. MARACAIBO	PQ.CARACCIOLO PARRA PEREZ	UNIDAD EDUCATIVA NACIONAL PRIVADA DR JOSE GREGORIO HERNANDEZ	1984	4	7	1621	325	1614	0	1	0	0	1288	1621
EDO. ZULIA	CE. MARACAIBO	PQ.CARACCIOLO PARRA PEREZ	ESCUELA BASICA NACIONAL ANGEL ALVAREZ DOMINGUEZ	4824	9	74	3642	1641	3568	0	10	3	3	1911	3642
EDO. ZULIA	CE. MARACAIBO	PQ.CARACCIOLO PARRA PEREZ	ESCUELA BASICA RAMON REINOSO NUÑEZ (ANEXO 1)	306	1	4	273	86	269	0	2	0	0	181	273
EDO. ZULIA	CE. MARACAIBO	PQ.CARACCIOLO PARRA PEREZ	PREESCOLAR ESTADAL NAPUSHI TALATSI	1488	3	15	1223	436	1208	0	3	0	0	769	1223
EDO. ZULIA	CE. MARACAIBO	PQ.CARACCIOLO PARRA PEREZ	ESCUELA BASICA NACIONAL DR JOSE MARIA VARGAS	3318	6	32	2268	1102	2236	1	7	1	1	1124	2268
EDO. ZULIA	CE. MARACAIBO	PQ.CARACCIOLO PARRA PEREZ	PREESCOLAR DOLORES DE RODRIGUEZ	1607	3	22	1351	407	1329	0	2	1	0	919	1351
EDO. ZULIA	CE. MARACAIBO	PQ.CARACCIOLO PARRA PEREZ	ESCUELA BASICA NACIONAL PANAMERICANA (ANEXO 1)	373	1	8	280	121	272	0	0	0	0	151	280
EDO. ZULIA	CE. MARACAIBO	PQ.CARACCIOLO PARRA PEREZ	UNIDAD EDUCATIVA PRIVADA DON FELICIANO PALACIOS Y SOJO	869	2	9	746	390	737	0	4	0	1	342	746
EDO. ZULIA	CE. MARACAIBO	PQ.CARACCIOLO PARRA PEREZ	UNIDAD EDUCATIVA PRIVADA LA CHINITA	2059	4	12	1705	542	1693	1	3	1	1	1145	1705
EDO. ZULIA	CE. MARACAIBO	PQ.CARACCIOLO PARRA PEREZ	ESCUELA BASICA NACIONAL PANAMERICANA	7086	13	73	5211	2236	5138	1	15	0	2	2884	5211
EDO. ZULIA	CE. MARACAIBO	PQ. SAN ISIDRO	UNIDAD EDUCATIVA NACIONAL FE Y  ALEGRIA ABRAHAN REYES	2161	4	31	1591	951	1560	1	9	1	3	595	1591
EDO. ZULIA	CE. MARACAIBO	PQ. SAN ISIDRO	ESCUELA BOLIVARIANA ARCA DE NOE	1694	3	29	1235	925	1206	0	3	1	0	277	1235
EDO. ZULIA	CE. MARACAIBO	PQ. SAN ISIDRO	UNIDAD EDUCATIVA ARQUIDEOSESANA MADRE CANDELARIA	902	2	13	723	499	710	0	1	1	0	209	723
EDO. ZULIA	CE. MARACAIBO	PQ. SAN ISIDRO	PRESBISTERO ANGEL RIOS CARVAJAL	300	1	6	271	234	265	0	1	0	0	30	271
EDO. ZULIA	CE. MARACAIBO	PQ. SAN ISIDRO	CENTRO DE EDUCACION INICIAL SIMONCITO DON RAMON JOSE VELASQUEZ ORDONEZ	1086	2	7	934	693	927	0	2	0	0	232	934
EDO. ZULIA	CE. MARACAIBO	PQ. SAN ISIDRO	ESCUELA BOLIVARIANA OCTAVIO HERNANDEZ	4206	8	37	2846	1822	2809	0	10	4	0	973	2846
EDO. ZULIA	CE. MARACAIBO	PQ. SAN ISIDRO	UNIVERSIDAD BOLIVARIANA DE VENEZUELA	1565	3	37	1039	754	1002	0	3	0	2	243	1039
EDO. ZULIA	CE. MARACAIBO	PQ. SAN ISIDRO	UNIDAD EDUCATIVA SILVESTRE  SANCHEZ	4044	8	34	2916	2038	2882	1	5	0	0	838	2916
EDO. ZULIA	CE. MARACAIBO	PQ. SAN ISIDRO	UNIDAD EDUCATIVA NACIONAL CREACION GENERAL RAFAEL URDANETA	1105	2	10	791	542	781	0	2	1	0	236	791
EDO. ZULIA	CE. MARACAIBO	PQ. SAN ISIDRO	UE PRIVADA AMBROSIO PLAZA	544	1	4	429	304	425	0	0	2	0	119	429
EDO. ZULIA	CE. MARACAIBO	PQ. SAN ISIDRO	UNIDAD EDUCATIVA VILLAPOL MORALES	991	2	10	852	660	842	0	2	1	0	179	852
EDO. ZULIA	CE. MARACAIBO	PQ. FRANCISCO EUGENIO B	JARDIN DE INFANCIA LUISA E.V.	2001	4	19	1572	935	1553	0	9	1	0	608	1572
EDO. ZULIA	CE. MARACAIBO	PQ. FRANCISCO EUGENIO B	ESCUELA BASICA ESTADAL LICECIADO REINALDO MARTINEZ	1914	4	25	1637	946	1612	0	4	1	0	661	1637
EDO. ZULIA	CE. MARACAIBO	PQ. FRANCISCO EUGENIO B	UNIDAD EDUCATIVA NACIONAL MANUEL SEGUNDO SANCHEZ	5204	10	54	4399	2024	4345	0	12	3	5	2301	4399
EDO. ZULIA	CE. MARACAIBO	PQ. FRANCISCO EUGENIO B	UNIDAD EDUCATIVA PROFESOR MISAEL VILCHEZ	2415	5	36	2025	1359	1989	0	5	1	0	624	2025
EDO. ZULIA	CE. MARACAIBO	PQ. FRANCISCO EUGENIO B	DR. JOSE IGNACIO BALDO SOULES	649	2	13	543	409	530	0	3	0	0	118	543
EDO. ZULIA	CE. MARACAIBO	PQ. FRANCISCO EUGENIO B	PREESCOLAR MI MUNDO INFANTIL	560	1	8	482	357	474	0	1	1	0	115	482
EDO. ZULIA	CE. MARACAIBO	PQ. FRANCISCO EUGENIO B	PRE ESCOLAR TUCUSITO	1078	2	9	897	488	888	0	2	1	0	397	897
EDO. ZULIA	CE. MARACAIBO	PQ. FRANCISCO EUGENIO B	UNIDAD EDUCATIVA NACIONAL FE Y ALEGRIA LA CHINITA	9954	18	147	8060	4159	7913	1	11	11	4	3727	8060
EDO. ZULIA	CE. MARACAIBO	PQ. FRANCISCO EUGENIO B	UNIDAD EDUCATIVA ESTATAL DONA GRACIELA RINCON CALCANO	675	2	7	594	469	587	1	2	1	0	114	594
EDO. ZULIA	CE. MARACAIBO	PQ. FRANCISCO EUGENIO B	ESCUELA BASICA NACIONAL CARDENAL JOSE ALI LEBRUN	1168	2	11	974	821	963	0	1	1	0	140	974
EDO. ZULIA	CE. MARACAIBO	PQ. FRANCISCO EUGENIO B	ESCUELA BASICA NACIONAL MAXIMA ARTEAGA PEREZ	6625	12	86	5136	2843	5050	2	16	2	4	2183	5136
EDO. ZULIA	CE. MARACAIBO	PQ. FRANCISCO EUGENIO B	ESCUELA BASICA ESTADAL FVM	6812	13	70	5558	1685	5488	1	10	3	3	3786	5558
EDO. ZULIA	CE. MARACAIBO	PQ. FRANCISCO EUGENIO B	ESCUELA BASICA NACIONAL JOSEFINA LIZARZABAL	3213	6	46	2665	1349	2619	1	3	0	1	1265	2665
EDO. ZULIA	CE. MARACAIBO	PQ. FRANCISCO EUGENIO B	CENTRO DE EDUCACION INICIAL GENERAL RAFAEL URDANETA	2678	5	39	2177	1264	2138	2	4	5	2	861	2177
EDO. ZULIA	CE. MARACAIBO	PQ. FRANCISCO EUGENIO B	PREESCOLAR SAN ISIDRO	1493	3	29	1177	744	1148	1	1	0	0	402	1177
EDO. ZULIA	CE. MARACAIBO	PQ. FRANCISCO EUGENIO B	ESCUELA BASICA NACIONAL RURAL LAS MERCEDES	1198	3	17	998	652	981	0	3	0	0	326	998
EDO. ZULIA	CE. MARACAIBO	PQ. FRANCISCO EUGENIO B	UE PRIVADA FAVIO MOLERO ESPINOZA	609	2	13	529	250	516	0	0	0	0	266	529
EDO. ZULIA	CE. MARACAIBO	PQ. FRANCISCO EUGENIO B	UNIDAD EDUCATIVA ARQUIDIOSESANA MANOLO MUCHACHO	1554	3	22	1339	721	1317	0	2	2	1	591	1339
EDO. ZULIA	CE. MARACAIBO	PQ. FRANCISCO EUGENIO B	UNIDAD EDUCATIVA NACIONAL VIDAL CALDERON	1080	2	7	940	687	933	0	5	2	1	238	940
EDO. ZULIA	CE. MARACAIBO	PQ. FRANCISCO EUGENIO B	ESCUELA BASICA NACIONAL DR JESUS ENRIQUE LOSSADA	7202	13	83	6112	2699	6029	1	19	2	1	3307	6112
EDO. ZULIA	CE. MARACAIBO	PQ. FRANCISCO EUGENIO B	UNIDAD EDUCATIVA NACIONAL  FE Y ALEGRIA N 4 LA RINCONADA	4283	8	55	3027	1804	2972	2	10	3	4	1149	3027
EDO. ZULIA	CE. MARACAIBO	PQ. FRANCISCO EUGENIO B	UNIDAD EDUCATIVA ESTADAL SIMON BOLIVAR	3976	7	61	3243	1391	3182	0	5	2	1	1783	3243
EDO. ZULIA	CE. MARACAIBO	PQ. FRANCISCO EUGENIO B	UNIDAD EDUCATIVA ANA ELENA OSORIO	2750	5	34	2256	1453	2222	0	9	0	0	760	2256
EDO. ZULIA	CE. MARACAIBO	PQ. FRANCISCO EUGENIO B	UNIDAD EDUCATIVA INTEGRAL FERDINAND DE SAUSSURE	1423	3	24	1276	952	1252	0	5	0	0	295	1276
EDO. ZULIA	CE. MARACAIBO	PQ. FRANCISCO EUGENIO B	UNIDAD EDUCATIVA LIC. JACOBO OCTAVIO MONTERO	615	2	8	539	308	531	0	2	0	0	221	539
EDO. ZULIA	CE. MARACAIBO	PQ. FRANCISCO EUGENIO B	FE Y ALEGRIA RUTILIO GRANDE	1991	4	30	1586	1107	1556	0	5	1	0	443	1586
EDO. ZULIA	CE. MARACAIBO	PQ. FRANCISCO EUGENIO B	ESCUELA BASICA BOLIVARIANA LEONCIO QUINTANA	3607	7	39	3184	1879	3145	1	7	0	5	1253	3184
EDO. ZULIA	CE. MARACAIBO	PQ. FRANCISCO EUGENIO B	JARDIN DE INFANCIA GLADYS DE C	3855	7	34	3282	1567	3248	0	6	1	0	1674	3282
EDO. ZULIA	CE. MARACAIBO	PQ. FRANCISCO EUGENIO B	EBB LUIS HOMEZ	1448	3	16	1284	863	1268	0	6	0	2	397	1284
EDO. ZULIA	CE. MARACAIBO	PQ. FRANCISCO EUGENIO B	UE ROMULO BETANCOURT	613	2	5	546	354	541	0	0	4	0	183	546
EDO. ZULIA	CE. MARACAIBO	PQ. FRANCISCO EUGENIO B	CENTRO DE EDUCACION INICIAL ARCO IRIS	1125	2	18	946	664	928	0	3	0	0	261	946
EDO. ZULIA	CE. MARACAIBO	PQ. FRANCISCO EUGENIO B	UNIDAD EDUCATIVA ESTADAL OCTAVIO PORTILLO	777	2	14	638	405	624	0	2	0	0	217	638
EDO. ZULIA	CE. MARACAIBO	PQ. FRANCISCO EUGENIO B	CENTRO DE EDUCACION INFANTIL MIGUEL SUNIAGA	2110	4	18	1704	829	1686	0	3	0	0	854	1704
EDO. ZULIA	CE. MARACAIBO	PQ. FRANCISCO EUGENIO B	ESCUELA BASICAESTADAL EL ROSARIO	3875	7	42	3035	1805	2993	0	10	0	2	1176	3035
EDO. ZULIA	CE. MARACAIBO	PQ. FRANCISCO EUGENIO B	CENTRO PRESCOLAR MARACAIBO	1659	3	23	1358	788	1335	0	2	2	0	543	1358
EDO. ZULIA	CE. MARACAIBO	PQ. FRANCISCO EUGENIO B	UNIDAD EDUCATIVA NACIONAL 1 DE MAYO	1041	2	25	923	707	898	2	4	2	0	183	923
EDO. ZULIA	CE. MARACAIBO	PQ. FRANCISCO EUGENIO B	ESCUELA BASICA NACIONAL CUATRICENTENARIA	6544	12	99	5225	2864	5126	0	12	1	4	2245	5225
EDO. ZULIA	CE. MARACAIBO	PQ. SANTA LUCIA	ESCUELA  BASICA  BOLIVARIANA ALONSO DE OJEDA	1813	4	19	1395	478	1376	2	3	0	1	892	1395
EDO. ZULIA	CE. MARACAIBO	PQ. SANTA LUCIA	UNIDAD EDUCATIVA ESTADAL OCTAVIO HERNANDEZ	2604	5	35	1926	670	1891	0	3	1	1	1216	1926
EDO. ZULIA	CE. MARACAIBO	PQ. SANTA LUCIA	ESCUELA BASICA PICHINCHA	3889	7	43	3080	1110	3037	0	7	1	1	1918	3080
EDO. ZULIA	CE. MARACAIBO	PQ. SANTA LUCIA	ESCUELA BASICA NACIONAL DOMINGO BRICEÑO	2697	5	38	2223	894	2185	0	5	0	2	1284	2223
EDO. ZULIA	CE. MARACAIBO	PQ. SANTA LUCIA	ESCUELA BASICA ESTADAL NESTOR LUIS PEREZ	3764	7	33	3154	1055	3121	0	8	1	3	2054	3154
EDO. ZULIA	CE. MARACAIBO	PQ. SANTA LUCIA	ESCUELA BASICA NACIONAL SIMON RODRIGUEZ	2101	4	28	1752	590	1724	0	7	0	1	1126	1752
EDO. ZULIA	CE. MARACAIBO	PQ. SANTA LUCIA	UNIDAD EDUCATIVA NACIONAL JOSE RAMON YEPEZ	2537	5	27	1940	515	1913	0	4	0	1	1393	1940
EDO. ZULIA	CE. MARACAIBO	PQ. SANTA LUCIA	UNIDAD EDUCATIVA PRIVADA NUESTRA SEÑORA DE CHIQUINQUIRA (ANEXO 1)	414	1	3	383	57	380	0	0	0	0	323	383
EDO. ZULIA	CE. MARACAIBO	PQ. SANTA LUCIA	ESCUELA  BASICA  NACIONAL BOLIVARIANA DR GUSTAVO RISQUEZ	1689	3	20	1372	604	1352	0	2	2	1	743	1372
EDO. ZULIA	CE. MARACAIBO	PQ. SANTA LUCIA	UNIDAD EDUCATIVA ESTADAL PRIVADA NUESTRA SEÑORA DE CHIQUINQUIRA	3892	7	26	3008	614	2982	0	6	0	0	2362	3008
EDO. ZULIA	CE. MARACAIBO	PQ. SANTA LUCIA	ESCUELA BASICA NACIONAL DR IDELFONSO VASQUEZ	3255	6	27	2681	921	2654	1	1	2	1	1728	2681
EDO. ZULIA	CE. MARACAIBO	PQ. SANTA LUCIA	CENTRO DE EDUCACION INICIAL   NACIONAL ANGELITOS NEGRO	1340	3	7	1034	379	1027	0	3	0	0	645	1034
EDO. ZULIA	CE. MARACAIBO	PQ. COQUIVACOA	ESCUELA BASICA NACIONAL DR JESUS MARIA PORTILLO	3689	7	52	3072	2098	3020	0	5	0	0	917	3072
EDO. ZULIA	CE. MARACAIBO	PQ. COQUIVACOA	ESCUELA BASICA NACIONAL JUAN PABLO PEREZ ALFONSO	2608	5	35	2085	1297	2050	0	3	1	1	748	2085
EDO. ZULIA	CE. MARACAIBO	PQ. COQUIVACOA	UNIDAD EDUCATIVA NACIONAL COLEGIO SALTO ANGEL	1319	3	15	1057	321	1042	0	0	0	1	720	1057
EDO. ZULIA	CE. MARACAIBO	PQ. COQUIVACOA	ESCUELA BASICA NACIONAL MONSEÑOR FRANCISCO ANTONIO	563	1	11	500	143	489	0	2	0	0	344	500
EDO. ZULIA	CE. MARACAIBO	PQ. COQUIVACOA	UNIDAD EDUCATIVA NACIONAL BATALLA DE CARABOBO	3314	6	42	2667	1477	2625	0	8	2	0	1138	2667
EDO. ZULIA	CE. MARACAIBO	PQ. COQUIVACOA	UNIDAD EDUCATIVA SOCIAL DE AVANZADA PROFESOR ELIO VALMORE CASTELLANOS	558	1	5	472	321	467	0	1	0	0	145	472
EDO. ZULIA	CE. MARACAIBO	PQ. COQUIVACOA	PREESCOLAR NEGRA MATEA	1309	3	13	1176	875	1163	0	2	0	0	286	1176
EDO. ZULIA	CE. MARACAIBO	PQ. COQUIVACOA	UNIDAD EDUCATIVA NACIONAL MARIA MONTESSORI	2412	5	22	1989	619	1967	0	9	0	2	1337	1989
EDO. ZULIA	CE. MARACAIBO	PQ. COQUIVACOA	ESCUELA BASICA NACIONAL RAUL CUENCA	3187	6	30	2572	1287	2542	0	9	0	1	1245	2572
EDO. ZULIA	CE. MARACAIBO	PQ. COQUIVACOA	UNIDAD EDUCATIVA NACIONAL COLEGIO ALTAMIRA	4100	8	20	3456	408	3436	1	4	0	2	3021	3456
EDO. ZULIA	CE. MARACAIBO	PQ. COQUIVACOA	GRUPO ESCOLAR NACIONAL BATALLA DE BOYACA	3288	6	36	2550	1495	2514	0	7	0	1	1011	2550
EDO. ZULIA	CE. MARACAIBO	PQ. COQUIVACOA	UNIDAD EDUCATIVA  NACIONAL FE Y ALEGRIA N°:2	2071	4	17	1688	833	1671	0	6	1	0	831	1688
EDO. ZULIA	CE. MARACAIBO	PQ. COQUIVACOA	UNIDAD EDUCATIVA NACIONAL PRIVADA ANTONIO ROSMINI	2668	5	45	2208	919	2163	0	8	0	1	1235	2208
EDO. ZULIA	CE. MARACAIBO	PQ. COQUIVACOA	UNIDAD EDUCATIVA NACIONAL COQUIVACOA	3605	7	30	2824	1001	2794	0	7	0	2	1784	2824
EDO. ZULIA	CE. MARACAIBO	PQ. COQUIVACOA	ESCUELA BASICA NACIONAL MONSEÑOR FRANCISCO ANTONIO GRANADILLO	4181	8	64	3211	920	3147	0	4	2	1	2220	3211
EDO. ZULIA	CE. MARACAIBO	PQ. COQUIVACOA	ESCUELA BASICA NACIONAL CONTRALMIRANTE RENATO BELUCHE	1345	3	28	1134	705	1106	1	2	0	1	397	1134
EDO. ZULIA	CE. MARACAIBO	PQ. COQUIVACOA	ESCUELA BASICA NACIONAL TEOTISTE DE GALLEGOS	3053	6	38	2358	1290	2320	0	3	2	1	1024	2358
EDO. ZULIA	CE. MARACAIBO	PQ. COQUIVACOA	UNIDAD EDUCATIVA NACIONAL NUESTRA SEÑORA DE LA PAZ	2532	5	36	2140	1048	2104	0	5	1	1	1049	2140
EDO. ZULIA	CE. MARACAIBO	PQ. COQUIVACOA	UNIDAD EDUCATIVA NACIONAL ELISA  FARIAS	2373	5	22	2001	857	1979	0	4	0	0	1118	2001
EDO. ZULIA	CE. MARACAIBO	PQ. COQUIVACOA	UNIDAD EDUCATIVA NACIONAL LICEO LOS ROBLES	3789	7	15	3207	300	3192	0	4	0	2	2886	3207
EDO. ZULIA	CE. MARACAIBO	PQ. COQUIVACOA	UNIDAD EDUCATIVA NACIONAL PRIVADA COLEGIO NUESTRA SEÑORA DE FATIMA	3421	6	25	2785	1009	2760	0	10	0	0	1741	2785
EDO. ZULIA	CE. MARACAIBO	PQ. COQUIVACOA	UNIDAD EDUCATIVANACIONAL ALEJANDRO FUENMAYOR	1635	3	23	1267	471	1244	0	3	2	0	768	1267
EDO. ZULIA	CE. MARACAIBO	PQ. COQUIVACOA	ESCUELA MENCA DE LEONI	1596	3	17	1303	759	1286	0	4	1	2	520	1303
EDO. ZULIA	CE. MARACAIBO	PQ. COQUIVACOA	UNIDAD GERONTOLOGICA DE MCBO	2153	4	28	1688	988	1660	0	3	1	3	665	1688
EDO. ZULIA	CE. MARACAIBO	PQ. COQUIVACOA	UNIDAD EDUCATIVA NACIONAL RAFAEL LOPEZ BARALT	2350	5	28	1896	623	1868	0	4	0	1	1240	1896
EDO. ZULIA	CE. MARACAIBO	PQ. COQUIVACOA	ESCUELA BASICA ESTADAL  23 DE ENERO	2838	5	31	2198	768	2167	0	2	0	0	1397	2198
EDO. ZULIA	CE. MARACAIBO	PQ. BOLIVAR	ESCUELA BASICA NACIONAL RAFAEL  A. BELLOSO CHACIN	2136	4	12	1704	596	1692	0	3	0	0	1093	1704
EDO. ZULIA	CE. MARACAIBO	PQ. BOLIVAR	ESCUELA BASICA NACIONAL JUAN DE MALDONADO	500	1	4	450	211	446	0	1	0	0	234	450
EDO. ZULIA	CE. MARACAIBO	PQ. BOLIVAR	UNIDAD EDUCATIVA NACIONAL  IPE	3000	6	27	2131	1016	2104	2	4	0	0	1082	2131
EDO. ZULIA	CE. MARACAIBO	PQ. BOLIVAR	ESCUELA BASICA ESTADAL PRESBITERO JOAQUIN PIÑA (AN	1024	2	13	904	185	891	0	1	2	1	702	904
EDO. ZULIA	CE. MARACAIBO	PQ. BOLIVAR	ESCUELA BASICA ESTADAL PRESBITERO JOAQUIN PIÑA	4917	9	29	3827	1005	3798	0	9	2	2	2780	3827
EDO. ZULIA	CE. MARACAIBO	PQ. BOLIVAR	HOGAR SAN JOSE DE LA MONTAÑA	1246	3	19	1039	300	1020	0	1	0	1	718	1039
EDO. ZULIA	CE. MARACAIBO	PQ. BOLIVAR	ESCUELA BASICA NACIONAL JORGE WASHINGTON (ANEXO 1)	552	1	4	484	180	480	0	0	0	0	300	484
EDO. ZULIA	CE. MARACAIBO	PQ. BOLIVAR	ESCUELA BASICANACIONAL ALONSO PACHECO	2403	5	25	1963	525	1938	0	4	0	1	1408	1963
EDO. ZULIA	CE. MARACAIBO	PQ. BOLIVAR	UNIDAD EDUCATIVA JORGE WASHINGTON	4466	8	35	3537	1244	3502	0	7	3	0	2248	3537
EDO. ZULIA	CE. MARACAIBO	PQ. CECILIO ACOSTA	UNIDAD EDUCATIVA ESTADAL JOSE FELIX RIVAS	1734	3	22	1363	635	1341	0	3	1	0	702	1363
EDO. ZULIA	CE. MARACAIBO	PQ. CECILIO ACOSTA	ESCUELA BASICA NACIONAL DR ANDRES ELOY BLANCO	2794	5	46	2380	873	2334	0	4	0	2	1455	2380
EDO. ZULIA	CE. MARACAIBO	PQ. CECILIO ACOSTA	LICEO MARIA TERESA CARREÑO	433	1	3	397	155	394	0	1	0	0	238	397
EDO. ZULIA	CE. MARACAIBO	PQ. CECILIO ACOSTA	ESCUELA BASICA NACIONAL  CARMEN ADELA PIRELA	4128	8	49	3456	1370	3407	1	8	1	3	2024	3456
EDO. ZULIA	CE. MARACAIBO	PQ. CECILIO ACOSTA	GRUPO ESCOLAR ESTADAL EDUARDO EMIRO FERRER	2915	5	25	2457	1044	2432	0	5	0	0	1383	2457
EDO. ZULIA	CE. MARACAIBO	PQ. CECILIO ACOSTA	ESCUELA BASICA ESTADAL EVELINA FERREIRA DE INCIARTE	2840	5	20	2457	923	2437	0	13	2	1	1498	2457
EDO. ZULIA	CE. MARACAIBO	PQ. CECILIO ACOSTA	UNIDAD EDUCATIVA NACIONAL INSTITUTO NIÑOS CANTORES	3156	6	18	2693	833	2675	0	1	3	2	1836	2693
EDO. ZULIA	CE. MARACAIBO	PQ. CECILIO ACOSTA	UNIDAD EDUCATIVA AGUSTIN AVELEDO TOVAR	1748	3	15	1410	538	1395	0	3	0	1	853	1410
EDO. ZULIA	CE. MARACAIBO	PQ. CECILIO ACOSTA	UNIDAD EDUCATIVA NACIONAL GENERAL RAFAEL URDANETA	4851	9	48	3986	1351	3938	1	12	2	1	2571	3986
EDO. ZULIA	CE. MARACAIBO	PQ. CECILIO ACOSTA	ESCUELA BASICA NACIONAL DIVINA PASTORA	5224	10	73	4326	1591	4253	0	14	2	1	2645	4326
EDO. ZULIA	CE. MARACAIBO	PQ. CECILIO ACOSTA	GRUPO ESCOLAR ESTADAL RICAUTER	3468	6	35	2623	1169	2588	0	4	1	0	1414	2623
EDO. ZULIA	CE. MARACAIBO	PQ. CECILIO ACOSTA	COLEGIO SAN ANTONIO DE LAS HERMANAS DE STA ANA.	1406	3	15	1203	457	1188	0	3	0	2	726	1203
EDO. ZULIA	CE. MARACAIBO	PQ. CECILIO ACOSTA	ESCUELA BASICA NACIONAL JAMES FERGUNSSON	3066	6	35	2417	1230	2382	0	5	1	0	1146	2417
EDO. ZULIA	CE. MARACAIBO	PQ. CECILIO ACOSTA	UNIDAD EDUCATIVA NACIONAL PRIVADA COLEGIO SANTA MARIA	3851	7	29	3283	921	3254	0	10	1	2	2320	3283
EDO. ZULIA	MP. ALMIRANTE P	PQ. ISLA DE TOAS	UNIDAD EDUCATIVA ESTADAL VECINAL NUMERO 8	1329	3	7	1061	789	1054	0	2	0	0	263	1061
EDO. ZULIA	MP. ALMIRANTE P	PQ. ISLA DE TOAS	ESCUELA BASICA ESTADAL DOCTOR. LUIS OQUENDO	2680	5	20	2113	1433	2093	0	5	0	0	655	2113
EDO. ZULIA	MP. ALMIRANTE P	PQ. ISLA DE TOAS	CENTRO DE EDUCACIÓN INICIAL ISLA DE TOAS	925	2	5	663	493	658	0	4	0	0	161	663
EDO. ZULIA	MP. ALMIRANTE P	PQ. ISLA DE TOAS	ESCUELA BASICA NACIONAL LAS PLAYITAS	2052	4	11	1667	1184	1656	0	4	0	0	468	1667
EDO. ZULIA	MP. ALMIRANTE P	PQ. MONAGAS	ESCUELA BASICA ESTADAL MAESTRA BLANCA GRANADILLO	2649	5	30	2115	1746	2085	0	0	0	0	339	2115
EDO. ZULIA	MP.ROSARIO DE PERIJA	PQ. EL ROSARIO	UNIDAD EDUCATIVA CANDIDA MARIA DE JESUS	467	1	5	382	239	377	0	1	0	0	137	382
EDO. ZULIA	MP.ROSARIO DE PERIJA	PQ. EL ROSARIO	UNIDAD EDUCATIVA ESTADAL CARLOTA SUAREZ	2348	4	28	1945	823	1917	0	5	1	0	1088	1945
EDO. ZULIA	MP.ROSARIO DE PERIJA	PQ. EL ROSARIO	ESCUELA  BASICA  NACIONAL   BOLIVARIANA LOS PUENTES	1139	2	20	967	485	947	0	3	1	1	457	967
EDO. ZULIA	MP.ROSARIO DE PERIJA	PQ. EL ROSARIO	LICEO NACIONAL BOLIVARIANO JULIO CESAR SALAS	4795	9	62	3252	1760	3190	0	4	0	0	1426	3252
EDO. ZULIA	MP.ROSARIO DE PERIJA	PQ. EL ROSARIO	UNIDAD EDUCATIVA MAESTRA DIONILA VELARDE	1279	3	26	1125	577	1099	0	4	0	1	517	1125
EDO. ZULIA	MP.ROSARIO DE PERIJA	PQ. EL ROSARIO	UNIDAD EDUCATIVA NACIONAL TIBALDO ALMARZA RINCON	4177	8	56	3265	1180	3209	0	12	2	0	2015	3265
EDO. ZULIA	MP.ROSARIO DE PERIJA	PQ. EL ROSARIO	ESCUELA BASICA RAUL LEONI	1471	3	12	1220	783	1208	1	4	1	0	419	1220
EDO. ZULIA	MP.ROSARIO DE PERIJA	PQ. EL ROSARIO	UNIDAD EDUCATIVA  MANUEL JESUS VILCHEZ	981	2	16	788	423	772	0	1	0	0	348	788
EDO. ZULIA	MP.ROSARIO DE PERIJA	PQ. EL ROSARIO	ESCUELA  BASICA ESTADAL JULIO FORNARI	1494	3	11	1154	837	1143	0	1	1	0	304	1154
EDO. ZULIA	MP.ROSARIO DE PERIJA	PQ. EL ROSARIO	ESCUELA BASICA BOLIVARIANA HATICOS	1943	4	24	1440	912	1416	1	4	2	0	497	1440
EDO. ZULIA	MP.ROSARIO DE PERIJA	PQ. EL ROSARIO	ESCUELA BASICA ESTADAL DOCTOR ELOY PARRAGA VILLAMARIN	3756	7	46	2913	1598	2867	1	7	1	0	1260	2913
EDO. ZULIA	MP.ROSARIO DE PERIJA	PQ. EL ROSARIO	ESCUELA BOLIVARIANA SAN JUAN	2827	5	44	2050	1327	2006	1	4	0	1	673	2050
EDO. ZULIA	MP.ROSARIO DE PERIJA	PQ. EL ROSARIO	ESCUELA BOLIVARIANA TERESA ZABALA DE MEDINA	2206	4	22	1643	1105	1621	1	2	5	0	508	1643
EDO. ZULIA	MP.ROSARIO DE PERIJA	PQ. EL ROSARIO	PREESCOLAR NACIONAL MONSEÑOR OLEGARIO VILLALOBOS	2045	4	32	1652	571	1620	0	5	0	0	1044	1652
EDO. ZULIA	MP.ROSARIO DE PERIJA	PQ. EL ROSARIO	ESCUELA BOLIVARIANA VILLA DEL ROSARIO	1465	3	27	1157	798	1130	0	3	0	1	328	1157
EDO. ZULIA	MP.ROSARIO DE PERIJA	PQ. EL ROSARIO	ESCUELA BOLIVARIANA AMPARO	2126	4	25	1663	768	1638	0	1	1	0	868	1663
EDO. ZULIA	MP.ROSARIO DE PERIJA	PQ. EL ROSARIO	ESCUELA BASICA NACIONAL ZIRUMA	4965	9	63	3797	1517	3734	2	10	0	0	2205	3797
EDO. ZULIA	MP.ROSARIO DE PERIJA	PQ. EL ROSARIO	ESCUELA NACIONAL FELICITA DE ESPINOZA	5181	9	53	3724	2146	3671	0	15	2	0	1508	3724
EDO. ZULIA	MP.ROSARIO DE PERIJA	PQ. SIXTO ZAMBRANO	UNIDAD EDUCATIVA BOLIVARIANA LA MATICA	1521	3	16	973	721	957	0	1	0	0	235	973
EDO. ZULIA	MP.ROSARIO DE PERIJA	PQ. SIXTO ZAMBRANO	ESCUELA  SOCIAL DE AVANZADA DON SIMON RODRIGUEZ	3626	7	23	2256	1199	2233	0	2	0	0	1032	2256
EDO. ZULIA	MP.ROSARIO DE PERIJA	PQ. SIXTO ZAMBRANO	UNIDAD EDUCATIVA ESTADAL SALTANEJO	675	2	10	451	255	441	0	0	0	0	186	451
EDO. ZULIA	MP.ROSARIO DE PERIJA	PQ. SIXTO ZAMBRANO	UNIDAD ESTADAL FIDELIA URDANETA	1078	2	9	758	304	749	0	1	0	0	444	758
EDO. ZULIA	MP.ROSARIO DE PERIJA	PQ. SIXTO ZAMBRANO	UNIDAD EDUCATIVA SAN IGNACIO DE LOYOLA	526	1	2	401	292	399	0	0	0	0	107	401
EDO. ZULIA	MP.ROSARIO DE PERIJA	PQ. DONALDO GARCIA	UNIDAD EDUCATIVA NACIONAL DON JUAN VICENTE BOLIVAR	2275	4	6	1633	1397	1627	0	1	0	0	229	1633
EDO. ZULIA	MP.ROSARIO DE PERIJA	PQ. DONALDO GARCIA	CENTRO DE REFLEXIONES COMUNATARIAS DE BARRANQUITAS	769	2	2	584	505	582	0	0	0	0	77	584
EDO. ZULIA	MP. SAN FRANCISCO	PQ. LOS CORTIJOS	ESCUELA BOLIVARIANA VICTOR RAUL SOTO	1647	3	20	1261	874	1241	0	5	3	2	357	1261
EDO. ZULIA	MP. SAN FRANCISCO	PQ. LOS CORTIJOS	ESCUELA BASICA ESTADAL TERESA LOPEZ BUSTAMANTE (EZA)	2924	6	31	2074	1372	2043	0	7	1	1	662	2074
EDO. ZULIA	MP. SAN FRANCISCO	PQ. LOS CORTIJOS	UE NACIONAL SILVERIO CUBILLAN	579	1	7	500	423	493	0	0	0	0	70	500
EDO. ZULIA	MP. SAN FRANCISCO	PQ. LOS CORTIJOS	ESCUELA BASICA ESTADAL TERESA LOPEZ BUSTAMANTE (ANEXO 1)	1803	4	18	1363	945	1345	0	3	0	0	397	1363
EDO. ZULIA	MP. SAN FRANCISCO	PQ. LOS CORTIJOS	UNIDAD EDUCATIVA TULIO FEBRES CORDERO	615	2	4	513	307	509	0	3	0	0	199	513
EDO. ZULIA	MP. SAN FRANCISCO	PQ. LOS CORTIJOS	UNIDAD EDUCATIVA NACIONAL DOCTOR ELIO EVELIO SUAREZ ROMERO	657	2	7	534	384	527	0	2	0	0	141	534
EDO. ZULIA	MP. SAN FRANCISCO	PQ. LOS CORTIJOS	ESCUELA  BASICA  NACIONAL SISOES FINOL	1981	4	34	1515	1218	1481	1	2	0	0	260	1515
EDO. ZULIA	MP. SAN FRANCISCO	PQ. LOS CORTIJOS	ESCUELA BASICA NACIONAL ALI PRIMERA	868	2	11	748	563	737	1	1	1	0	171	748
EDO. ZULIA	MP. SAN FRANCISCO	PQ. LOS CORTIJOS	ESCUELA BASICA ESTADAL JOBO BAJO	1539	3	21	1118	749	1097	0	3	0	0	345	1118
EDO. ZULIA	MP. SAN FRANCISCO	PQ. LOS CORTIJOS	UNIDAD EDUCATIVA ESTADAL RURAL BATALLA DE CARABOBO	963	2	13	761	557	748	0	3	0	0	188	761
EDO. ZULIA	MP. SAN FRANCISCO	PQ. LOS CORTIJOS	UNIDAD  EDUCATIVA  DOCTOR NERIO ADRIANZA GONZALEZ	4993	9	91	4001	2584	3910	1	13	0	2	1310	4001
EDO. ZULIA	MP. SAN FRANCISCO	PQ. LOS CORTIJOS	ESCUELA BOLIVARIANA HUMBERTO GOTERO	1742	3	21	1524	789	1503	0	8	1	0	705	1524
EDO. ZULIA	MP. SAN FRANCISCO	PQ. LOS CORTIJOS	ESCUELA BASICA NACIONAL ANGEL QUINTERO	4394	8	53	3665	2068	3612	1	14	2	4	1523	3665
EDO. ZULIA	MP. SAN FRANCISCO	PQ. LOS CORTIJOS	ESCUELA  BOLIVARIANA  MACHIQUES DE PERIJA	3851	7	63	2915	2251	2852	0	6	1	0	594	2915
EDO. ZULIA	MP. SAN FRANCISCO	PQ. DOMITILA FLORES	ESCUELA BASICA BOLIVARIANA EL RODEO	2368	5	35	1882	1388	1847	0	6	0	0	453	1882
EDO. ZULIA	MP. SAN FRANCISCO	PQ. DOMITILA FLORES	ESCUELA BASICA PRIVADA NACIONAL NUEVA VENEZUELA ( FE Y ALEGRIA)	4379	8	70	3398	2093	3328	0	12	1	1	1221	3398
EDO. ZULIA	MP. SAN FRANCISCO	PQ. DOMITILA FLORES	ESCUELA BASICA NACIONAL VICTOR SANDOVAL	2959	6	40	2218	1456	2178	0	9	0	0	713	2218
EDO. ZULIA	MP. SAN FRANCISCO	PQ. DOMITILA FLORES	ESCUELA BASICA NACIONAL SATURNO MEDINA OVALLES	587	1	12	465	321	453	0	0	0	1	131	465
EDO. ZULIA	MP. SAN FRANCISCO	PQ. DOMITILA FLORES	UNIDAD EDUCATIVA NACIONAL GONZALO RINCON GUTIERREZ (ANEXO 1)	475	1	7	394	263	387	0	1	0	0	123	394
EDO. ZULIA	MP. SAN FRANCISCO	PQ. DOMITILA FLORES	CENTRO CULTURAL DALIA FERNANDEZ	2619	5	42	2147	1257	2105	0	9	2	0	837	2147
EDO. ZULIA	MP. SAN FRANCISCO	PQ. DOMITILA FLORES	CASA COMUNAL POLAR 2	328	1	6	265	170	259	0	0	0	0	89	265
EDO. ZULIA	MP. SAN FRANCISCO	PQ. DOMITILA FLORES	UNIDAD EDUCATIVA SAN IGNACIO (FE Y ALEGRIA)	741	2	4	638	419	634	0	6	0	0	209	638
EDO. ZULIA	MP. SAN FRANCISCO	PQ. DOMITILA FLORES	CENTRO DE EDUCACION INICIAL AMOR Y ALEGRIA	444	1	1	403	239	402	0	2	0	0	161	403
EDO. ZULIA	MP. SAN FRANCISCO	PQ. DOMITILA FLORES	ESCUELA BASICA.NACIONAL ABRAHAM BELLOSO	2079	4	27	1677	898	1650	0	3	2	1	746	1677
EDO. ZULIA	MP. SAN FRANCISCO	PQ. DOMITILA FLORES	ESCUELA BASICA NACIONAL PROFESOR RAFAEL SEGUNDO BOSCANO	2165	4	31	1703	1255	1672	0	12	1	0	404	1703
EDO. ZULIA	MP. SAN FRANCISCO	PQ. DOMITILA FLORES	ESCUELA BASICA.ESTADAL GUANIPA MATOS	2224	4	37	1697	1075	1660	0	2	0	0	583	1697
EDO. ZULIA	MP. SAN FRANCISCO	PQ. DOMITILA FLORES	ESCUELA BASICA ESTADAL VENEZUELA	1041	2	15	918	672	903	0	2	0	0	229	918
EDO. ZULIA	MP. SAN FRANCISCO	PQ. DOMITILA FLORES	ESCUELA BASICA ESTADAL 24 DE JULIO (EZA)	1896	4	33	1484	882	1451	1	8	1	0	559	1484
EDO. ZULIA	MP. SAN FRANCISCO	PQ. DOMITILA FLORES	UNIDAD  EDUCATIVA   ARQUIDIOCESANA MONSEÑOR  JUAN HILAR	2204	4	44	1739	999	1695	0	13	2	0	681	1739
EDO. ZULIA	MP. SAN FRANCISCO	PQ. DOMITILA FLORES	ESCUELA BASICA ESTADAL ARQUIDIOCESANA PABLO SEXTO	3915	7	44	3062	2038	3018	1	12	0	0	967	3062
EDO. ZULIA	MP. SAN FRANCISCO	PQ. DOMITILA FLORES	ESCUELA BASICA NACIONAL BATALLA NAVAL LAGO	2416	5	26	1972	1098	1946	0	13	0	1	834	1972
EDO. ZULIA	MP. SAN FRANCISCO	PQ. DOMITILA FLORES	CENTRO DE EDUCACION INICIAL NEGRA HIPOLITA	1086	2	10	887	548	877	1	2	0	0	326	887
EDO. ZULIA	MP. SAN FRANCISCO	PQ. DOMITILA FLORES	UE PRIVADA MIXTA BATALLA DE CARABOBO	831	2	9	685	508	676	0	2	0	0	166	685
EDO. ZULIA	MP. SAN FRANCISCO	PQ. DOMITILA FLORES	UNIDAD  EDUCATIVA  ARQUIDIOCESANA MADRE LAURA	6171	11	112	4857	2542	4745	0	14	5	0	2184	4857
EDO. ZULIA	MP. SAN FRANCISCO	PQ. DOMITILA FLORES	ESCUELA BASICA NACIONAL CARMEN AMERICA DE LEONI	4584	9	70	3467	2100	3397	0	15	2	1	1279	3467
EDO. ZULIA	MP. SAN FRANCISCO	PQ. DOMITILA FLORES	CENTRO DE EDUCACIÓN INICIAL ZULIA	467	1	3	389	297	386	0	0	0	0	89	389
EDO. ZULIA	MP. SAN FRANCISCO	PQ. DOMITILA FLORES	ESCUELA BASICA ESTADAL ABSALON BRACHO	5766	11	95	4657	2655	4562	0	20	2	1	1884	4657
EDO. ZULIA	MP. SAN FRANCISCO	PQ. DOMITILA FLORES	CENTRO DE EDUCACION INTEGRAL MARACAIBO	1061	2	18	911	615	893	0	3	0	0	275	911
EDO. ZULIA	MP. SAN FRANCISCO	PQ. DOMITILA FLORES	UNIDAD EDUCATIVA NACIONAL GONZALO RINCON GUTIERREZ	4612	9	70	3732	2048	3662	0	15	3	1	1595	3732
EDO. ZULIA	MP. SAN FRANCISCO	PQ. DOMITILA FLORES	ESCUELA ESTADAL NIÑO JESUS	1614	3	12	1294	757	1282	0	3	0	1	521	1294
EDO. ZULIA	MP. SAN FRANCISCO	PQ. DOMITILA FLORES	UNIDAD EDUCATIVA MARTIN TOVAR Y TOVAR	952	2	9	780	572	771	0	1	0	0	198	780
EDO. ZULIA	MP. SAN FRANCISCO	PQ. DOMITILA FLORES	UNIDAD  EDUCATIVA   ARQUIDIOCESANA. MADRE LAURA	725	2	6	599	303	593	0	1	1	0	288	599
EDO. ZULIA	MP. SAN FRANCISCO	PQ. DOMITILA FLORES	UNIDAD  EDUCATIVA  NACIONAL  JUAN RODRIGUEZ	2337	4	17	1946	1046	1929	0	12	0	1	870	1946
EDO. ZULIA	MP. SAN FRANCISCO	PQ. DOMITILA FLORES	UNIDAD EDUCATIVA PRIVADA NACIONAL FRAY JUNIPERO DE ESCALADA	2649	5	23	2189	1196	2166	0	7	3	0	960	2189
EDO. ZULIA	MP. SAN FRANCISCO	PQ. DOMITILA FLORES	UNIDAD EDUCATINA NACIONAL MAGISTER. SERVANDO PEÑA	1927	4	25	1561	1203	1536	1	3	1	0	328	1561
EDO. ZULIA	MP. SAN FRANCISCO	PQ. DOMITILA FLORES	ESCUELA BASICA NACIONAL DOCTOR JESUS RAMON AMADO	1063	2	7	930	663	923	0	7	0	0	253	930
EDO. ZULIA	MP. SAN FRANCISCO	PQ. DOMITILA FLORES	UNIDAD  EDUCATIVA  FE Y ALEGRIA NUEVA AMERICA	5435	10	56	4347	2554	4291	0	14	4	3	1716	4347
EDO. ZULIA	MP. SAN FRANCISCO	PQ. DOMITILA FLORES	ESCUELA BASICA NACIONAL SISO MARTINEZ (ANEXO 1)	627	2	4	524	321	520	1	0	0	0	198	524
EDO. ZULIA	MP. SAN FRANCISCO	PQ. DOMITILA FLORES	ESCUELA BASICA NACIONAL LOS CORTIJOS	2385	5	28	1814	1259	1786	0	13	0	0	514	1814
EDO. ZULIA	MP. SAN FRANCISCO	PQ. DOMITILA FLORES	UE INTEGRAL HOGAR LUZ CLARITA	257	1	1	230	166	229	0	0	0	0	63	230
EDO. ZULIA	MP. SAN FRANCISCO	PQ. DOMITILA FLORES	CENTRO DE EDUCACION INICIAL FRANCISCO DE MIRANDA	804	2	5	707	472	702	0	4	0	0	226	707
EDO. ZULIA	MP. SAN FRANCISCO	PQ. DOMITILA FLORES	ESCUELA BASICA ARQUIDIOCESANA DON CECILIO ACOSTA	733	2	8	638	353	630	0	3	1	0	273	638
EDO. ZULIA	MP. SAN FRANCISCO	PQ. DOMITILA FLORES	UNIDAD  EDUCATIVA  NUEVA VENEZUELA FE Y ALEGRIA	370	1	4	300	207	296	0	1	0	0	88	300
EDO. ZULIA	MP. SAN FRANCISCO	PQ. DOMITILA FLORES	ESCUELA BASICA NACIONAL SISO MARTINEZ	5581	10	61	4484	2477	4423	1	13	3	3	1926	4484
EDO. ZULIA	MP. SAN FRANCISCO	PQ. MARCIAL HERNANDEZ	UNIDAD POLIVALENTE INCE SAN FRANCISCO	2326	4	25	1793	1312	1768	1	5	2	0	448	1793
EDO. ZULIA	MP. SAN FRANCISCO	PQ. MARCIAL HERNANDEZ	UNIDAD EDUCATIVA ESTADAL ROMULO BETANCOURT	2891	5	25	2362	1551	2337	1	5	0	0	780	2362
EDO. ZULIA	MP. SAN FRANCISCO	PQ. MARCIAL HERNANDEZ	UNIDAD EDUCATIVA NACIONAL PRIVADA JOSE GREGORIO MONAGAS	1249	3	18	956	560	938	0	2	0	0	376	956
EDO. ZULIA	MP. SAN FRANCISCO	PQ. MARCIAL HERNANDEZ	ESCUELA BASICA NACIONAL SANTIAGO RAMON Y CAJAL	1747	3	15	1367	1035	1352	0	2	1	0	314	1367
EDO. ZULIA	MP. SAN FRANCISCO	PQ. MARCIAL HERNANDEZ	UNIDAD EDUCATIVA NACIONAL PRIVADA MADRE MERCEDES MOLINA	2377	5	28	1924	1207	1896	0	4	1	0	684	1924
EDO. ZULIA	MP. SAN FRANCISCO	PQ. MARCIAL HERNANDEZ	ESCUELA BASICA NACIONAL MONTE RICO	607	2	7	506	429	499	0	1	1	1	67	506
EDO. ZULIA	MP. SAN FRANCISCO	PQ. MARCIAL HERNANDEZ	UNIDAD EDUCATIVA ESTADAL ARQUIDIOCESANA NUESTRA SEÑORA DEL CARMEN	5211	9	70	4248	2530	4178	0	9	1	1	1637	4248
EDO. ZULIA	MP. SAN FRANCISCO	PQ. SAN FRANCISCO	ESCUELA  BASICA ESTADAL DOCTOR JESUS ENRIQUE LOSSADA	2279	4	21	1976	1242	1955	1	5	0	0	707	1976
EDO. ZULIA	MP. SAN FRANCISCO	PQ. SAN FRANCISCO	PREESCOLAR ANA GRACIELA DE HINESTROZA	3666	7	36	3258	1410	3222	0	8	2	2	1800	3258
EDO. ZULIA	MP. SAN FRANCISCO	PQ. SAN FRANCISCO	UNIDAD EDUCATIVA DON FELIPE RINALDI	1588	3	19	1365	688	1346	0	2	0	0	656	1365
EDO. ZULIA	MP. SAN FRANCISCO	PQ. SAN FRANCISCO	ESCUELA BOLIVARIANA MANUEL JOSÉ RODRIGUEZ	998	2	3	843	648	840	0	1	0	0	191	843
EDO. ZULIA	MP. SAN FRANCISCO	PQ. SAN FRANCISCO	UNIDAD EDUCATIVA NACIONAL PRIVADA COLEGIO CRISTO REY	5059	9	34	4289	921	4255	0	7	1	1	3325	4289
EDO. ZULIA	MP. SAN FRANCISCO	PQ. SAN FRANCISCO	UNIDAD EDUCATIVA MUNICIPAL PRIVADA LUZ DEL SABER	2796	5	25	2353	1406	2328	0	6	1	2	913	2353
EDO. ZULIA	MP. SAN FRANCISCO	PQ. SAN FRANCISCO	UNIDAD EDUCATIVA NACIONAL PRIVADA PEDRO CAMEJO	3761	7	48	2829	1943	2781	0	8	1	0	829	2829
EDO. ZULIA	MP. SAN FRANCISCO	PQ. SAN FRANCISCO	UNIDAD EDUCATIVA SAN MARTIN DE PORRAS	1030	2	12	912	375	900	0	6	0	0	519	912
EDO. ZULIA	MP. SAN FRANCISCO	PQ. SAN FRANCISCO	UNIDAD EDUCATIVA ESTADAL HERMOGENEZ MENDEZ	2258	4	25	1940	1286	1915	1	5	0	0	623	1940
EDO. ZULIA	MP. SAN FRANCISCO	PQ. SAN FRANCISCO	UNIDAD EDUCATIVA ESTADAL EUGUENIO SANCHEZ GARCIA	3057	6	28	2574	1659	2546	0	10	0	2	875	2574
EDO. ZULIA	MP. SAN FRANCISCO	PQ. SAN FRANCISCO	U E ARQUIDEOSESANA SAN JUAN LEONARDI	665	2	12	556	362	544	0	0	0	0	182	556
EDO. ZULIA	MP. SAN FRANCISCO	PQ. SAN FRANCISCO	ESCUELA BASICA ARQUIDIOCESANO DIVINO NIÑO	2299	4	26	1940	732	1914	0	7	0	0	1175	1940
EDO. ZULIA	MP. SAN FRANCISCO	PQ. SAN FRANCISCO	ESCUELA BOLIVARIANA EDUARDO EMIRO FERRER	4608	9	48	3793	1603	3745	0	9	0	1	2132	3793
EDO. ZULIA	MP. SAN FRANCISCO	PQ. SAN FRANCISCO	UNIDAD EDUCATIVA NACIONAL PRIVADA COLEGIO CRISTO REY (ANEXO1)	353	1	3	311	62	308	0	0	1	0	245	311
EDO. ZULIA	MP. SAN FRANCISCO	PQ. SAN FRANCISCO	LICEO NACIONAL EDUARDO MATIAS LOSSADA	5509	10	43	4627	2113	4584	0	9	1	2	2459	4627
EDO. ZULIA	MP. SAN FRANCISCO	PQ. SAN FRANCISCO	ESCUELA BASICA NACIONAL DOCTOR JESUS MUÑOZ TEBAR	4924	9	51	4017	1892	3966	0	17	2	2	2053	4017
EDO. ZULIA	MP. SAN FRANCISCO	PQ. SAN FRANCISCO	GRUPO ESCOLAR  SAN FRANCISCO	3764	7	42	3152	1155	3110	0	8	1	1	1945	3152
EDO. ZULIA	MP. SAN FRANCISCO	PQ. SAN FRANCISCO	ESCUELA  BASICA BOLIVARIANA  PADRE DELGADO	2657	5	29	2278	1125	2249	0	5	0	1	1118	2278
EDO. ZULIA	MP. SAN FRANCISCO	PQ. SAN FRANCISCO	CENTRO DE EDUCACION INICIAL BRISAS DEL ZULIA	811	2	8	726	283	718	0	1	0	1	433	726
EDO. ZULIA	MP. SAN FRANCISCO	PQ. SAN FRANCISCO	ESCUELA BASICA.NACIONAL EVARISTO FERNANDEZ	3144	6	31	2595	1133	2564	0	6	1	2	1422	2595
EDO. ZULIA	MP. SAN FRANCISCO	PQ. SAN FRANCISCO	ESCUELA BASICA NACIONAL BOLIVARIANA JESUS OBRERO	880	2	20	778	493	758	0	5	0	0	260	778
EDO. ZULIA	MP. SAN FRANCISCO	PQ. SAN FRANCISCO	UNIDAD  EDUCATIVA  COLEGIO SAN FRANCISCO (PADRE VILCHEZ)	3632	7	28	2958	1714	2930	0	3	0	0	1213	2958
EDO. ZULIA	MP. SAN FRANCISCO	PQ. SAN FRANCISCO	ESCUELA BASICA NACIONAL EULADIMIRA GUANIPA	3360	6	20	2829	1180	2809	0	12	0	2	1615	2829
EDO. ZULIA	MP. SAN FRANCISCO	PQ. SAN FRANCISCO	UNIDAD EDUCATIVA SAN JUDAS TADEO	974	2	17	877	381	860	0	2	0	0	477	877
EDO. ZULIA	MP. SAN FRANCISCO	PQ. SAN FRANCISCO	ESCUELA BASICA BICENTENARIO JOSE ANTONIO PAEZ	3838	7	37	3298	1928	3261	3	12	4	1	1313	3298
EDO. ZULIA	MP. SAN FRANCISCO	PQ. SAN FRANCISCO	UNIDAD  EDUCATIVA  ESTATAL SAN FRANCISCO	4082	8	40	3261	1676	3221	0	13	1	1	1530	3261
EDO. ZULIA	MP. SAN FRANCISCO	PQ. SAN FRANCISCO	JARDIN DE INFANCIA NACIONAL VILLA BOLIVARIANA	2867	5	28	2448	894	2420	0	9	0	2	1515	2448
EDO. ZULIA	MP. SAN FRANCISCO	PQ. SAN FRANCISCO	ESCUELA BASICA NACIONAL JOSE ANTONIO CALCAÑO	4512	8	40	3816	2152	3776	1	9	0	3	1611	3816
EDO. ZULIA	MP. SAN FRANCISCO	PQ. EL BAJO	CICLO BASICO JOSE ANONIO CHAVEZ	2212	4	29	1857	1117	1828	0	7	0	0	704	1857
EDO. ZULIA	MP. SAN FRANCISCO	PQ. EL BAJO	ESCUELA BOLIVARIANA NORMALISTA DESIDELIO VILCHEZ	1139	2	16	957	678	941	0	0	3	0	260	957
EDO. ZULIA	MP. SAN FRANCISCO	PQ. EL BAJO	ESCUELA BASICA NACIONAL FELIPE NERI SANDREA	1447	3	12	1242	882	1230	1	1	1	0	345	1242
EDO. ZULIA	MP. SAN FRANCISCO	PQ. EL BAJO	JARDIN DE INFANCIA. ANDRES ELOY BLANCO	1428	3	10	1158	710	1148	0	4	0	0	434	1158
EDO. ZULIA	MP. SAN FRANCISCO	PQ. EL BAJO	ESCUELA BASICA NACIONAL CARMELA QUINTERO	4235	8	49	3558	2026	3509	1	10	3	2	1467	3558
EDO. ZULIA	MP. SAN FRANCISCO	PQ. EL BAJO	JARDIN DE INFANCIA NACIONAL ANDRES ELOY BLANCO	1252	3	12	1026	585	1014	0	5	0	0	424	1026
EDO. ZULIA	MP. SAN FRANCISCO	PQ. FRANCISCO OCHOA	ESCUELA  SOCIAL DE AVANZADA 19 DE ABRIL	3765	7	37	3112	1362	3075	0	11	6	2	1694	3112
EDO. ZULIA	MP. SAN FRANCISCO	PQ. FRANCISCO OCHOA	ESCUELA BASICA NACIONAL 19 DE ABRIL	5023	9	53	3912	1597	3859	3	12	3	1	2243	3912
EDO. ZULIA	MP. SAN FRANCISCO	PQ. FRANCISCO OCHOA	JARD DE INFANCIA DOÑA JULIA RODRIGUEZ DE PEREZ	1588	3	19	1362	758	1343	0	7	1	0	577	1362
EDO. ZULIA	MP. SAN FRANCISCO	PQ. FRANCISCO OCHOA	UNIDAD EDUCATIVA NACIONAL PRIVADA JOSE PIO TAMAYO	1400	3	8	1099	633	1091	0	0	0	1	457	1099
EDO. ZULIA	MP. SAN FRANCISCO	PQ. FRANCISCO OCHOA	COLEGIO MARIA S DE OQUENDO	670	2	6	598	332	592	0	3	0	0	257	598
EDO. ZULIA	MP. SAN FRANCISCO	PQ. FRANCISCO OCHOA	ESCUELA BASICA NACIONAL GENERAL RAFAEL URDANETA (FE Y ALEGRIA)	4266	8	53	3396	1644	3343	0	13	3	1	1682	3396
EDO. ZULIA	MP. SAN FRANCISCO	PQ. FRANCISCO OCHOA	ESCUELA TECNICA INDUSTRIAL NACIONAL ANSELMO BELLOSO	1998	4	23	1658	776	1635	1	3	0	0	855	1658
EDO. ZULIA	MP. SAN FRANCISCO	PQ. FRANCISCO OCHOA	JARDIN DE INFANCIA JUANA DE AVILA	768	2	19	668	489	649	0	1	1	0	158	668
EDO. ZULIA	MP. SAN FRANCISCO	PQ. FRANCISCO OCHOA	ESCUELA BASICA NACIONAL BENILDA AVILA DE MORENO	3012	6	39	2525	1095	2486	0	13	2	1	1375	2525
EDO. ZULIA	MP. SAN FRANCISCO	PQ. FRANCISCO OCHOA	UNIDAD EDUCATIVA NACIONAL PRIVADA NATALICIO DEL LIBERTADOR	2756	5	23	2199	881	2176	0	4	0	0	1291	2199
EDO. ZULIA	MP. SAN FRANCISCO	PQ. FRANCISCO OCHOA	JARD INFANCIA NACIONAL MORITA CARRILLO	1098	2	7	855	408	848	0	3	0	0	437	855
EDO. ZULIA	MP. SAN FRANCISCO	PQ. FRANCISCO OCHOA	UNIDAD EDUCATIVA NACIONAL PRIVADA SAN JOSE DE CALASANZ	2076	4	33	1699	698	1666	0	6	0	2	960	1699
EDO. ZULIA	MP. SAN FRANCISCO	PQ. FRANCISCO OCHOA	ESCUELA BASICA NACIONAL 19 DE ABRIL (ANEXO 1)	1483	3	18	1221	632	1203	0	7	0	0	564	1221
EDO. ZULIA	MP. SAN FRANCISCO	PQ. FRANCISCO OCHOA	UNIDAD EDUCATIVA NACIONAL RAUL OSORIO	3386	6	35	2720	1535	2685	0	6	0	0	1144	2720
EDO. ZULIA	MP. SAN FRANCISCO	PQ. FRANCISCO OCHOA	ESCUELA  SOCIAL DE AVANZADA JOSEFA DE MORALES	1223	3	18	1006	589	988	0	2	1	1	395	1006
EDO. ZULIA	MP. SAN FRANCISCO	PQ. FRANCISCO OCHOA	ESCUELA BASICA NACIONAL 12 DE OCTUBRE	3449	6	48	2845	1557	2797	1	12	1	1	1225	2845
EDO. ZULIA	MP. SAN FRANCISCO	PQ. FRANCISCO OCHOA	ESCUELA BASICA NACIONAL PRIVADA MARIE POUSSEPIN	2064	4	18	1706	655	1688	0	3	1	0	1029	1706
EDO. ZULIA	MP. SAN FRANCISCO	PQ. FRANCISCO OCHOA	JARDIN DE INFANCIA CARMELITA GARCIA	475	1	7	405	214	398	0	4	0	0	180	405
EDO. ZULIA	MP. SAN FRANCISCO	PQ. FRANCISCO OCHOA	ESCUELA BASICA NACIONAL JOSEFINA DE ACOSTA	4567	8	52	3816	1930	3764	0	4	1	0	1829	3816
EDO. ZULIA	MP. SAN FRANCISCO	PQ. FRANCISCO OCHOA	ESCUELA BASICA NACIONAL BARRIO STHORMES	2569	5	29	2109	1131	2080	0	2	1	1	945	2109
EDO. ZULIA	MP. SAN FRANCISCO	PQ. FRANCISCO OCHOA	ESCUELA BASICA NACIONAL DOCTOR JUAN SABA RIVERO	2161	4	24	1749	989	1725	0	6	3	4	723	1749
EDO. ZULIA	MP. SAN FRANCISCO	PQ. FRANCISCO OCHOA	UNIDAD EDUCATIVA COLEGIO JAVIER	808	2	13	702	377	689	0	0	0	0	312	702
EDO. ZULIA	MP. SANTA RITA	PQ. PEDRO LUCAS URRIBARRI	ESCUELA RURAL BOLIVARIANA TOLOSA	916	2	10	719	413	709	0	1	0	0	295	719
EDO. ZULIA	MP. SANTA RITA	PQ. PEDRO LUCAS URRIBARRI	UNIDAD EDUCATIVA ESTADAL.266 KILOMETRO.28	421	1	5	338	190	333	0	0	0	0	143	338
EDO. ZULIA	MP. SANTA RITA	PQ. PEDRO LUCAS URRIBARRI	ESCUELA BASICA BOLIVARIANA EL GUANABANO	1525	3	24	1213	718	1189	0	3	0	0	468	1213
EDO. ZULIA	MP. SANTA RITA	PQ. PEDRO LUCAS URRIBARRI	UNIDAD EDUCATIVA SENOR PEDRO AZUAJE	124	1	5	115	90	110	0	0	0	0	20	115
EDO. ZULIA	MP. SANTA RITA	PQ. PEDRO LUCAS URRIBARRI	UNIDAD EDUCATIVA ESTADAL PROFESOR NOEL DE JESUS CRESPO EL GAMELOTAL	452	1	11	347	246	336	0	1	0	0	89	347
EDO. ZULIA	MP. SANTA RITA	PQ. JOSE CENOVIO URRIBARR	ESCUELA BASICA ANA ISABEL MARQUEZ	1592	3	13	1327	775	1314	0	5	0	0	534	1327
EDO. ZULIA	MP. SANTA RITA	PQ. JOSE CENOVIO URRIBARR	ESCUELA BASICA NACIONAL SANTIAGO AGUERREVERE	2685	5	44	2264	1076	2220	2	2	0	0	1140	2264
EDO. ZULIA	MP. SANTA RITA	PQ. JOSE CENOVIO URRIBARR	JARDIN DE INFANCIA BATALLA NAVAL DE MARACAIBO	771	2	6	673	384	667	0	0	0	0	283	673
EDO. ZULIA	MP. SANTA RITA	PQ. JOSE CENOVIO URRIBARR	ESCUELA  BASICA ESTADAL  DON RENATO GONZALEZ	1662	3	11	1331	821	1320	1	7	0	1	490	1331
EDO. ZULIA	MP. SANTA RITA	PQ. JOSE CENOVIO URRIBARR	ESCUELA BASICA NACIONAL PUNTA IGUANA	2900	5	42	2298	1317	2256	2	3	0	1	933	2298
EDO. ZULIA	MP. SANTA RITA	PQ. JOSE CENOVIO URRIBARR	JARDIN DE INFANCIA NEREIDA CUENCAS DE A.	1195	3	15	1005	547	990	0	11	2	0	430	1005
EDO. ZULIA	MP. SANTA RITA	PQ. EL MENE	ESCUELA PRIMARIA BOLIVARIANA RURAL LAS  MUCURITAS	1251	3	12	1034	580	1022	0	2	1	1	438	1034
EDO. ZULIA	MP. SANTA RITA	PQ. EL MENE	UNIDAD EDUCATIVA NACIONAL JOSE CENOBIO URRIBARRI	2848	5	30	2364	1352	2334	1	14	0	2	965	2364
EDO. ZULIA	MP. SANTA RITA	PQ. SANTA RITA	PREESC.BOLIVARIANA.ANA GRACIELA DE HINESTROZA	884	2	11	759	412	748	0	2	0	0	334	759
EDO. ZULIA	MP. SANTA RITA	PQ. SANTA RITA	UNIDAD EDUCATIVA CRISTOBAL ROJAS	1105	2	5	901	448	896	0	5	0	1	442	901
EDO. ZULIA	MP. SANTA RITA	PQ. SANTA RITA	J.I. NAC. MARIA NAVA DE JIMENEZ	1157	2	10	1013	629	1003	0	6	0	0	368	1013
EDO. ZULIA	MP. SANTA RITA	PQ. SANTA RITA	UE.SIMON RODRIQUEZ	1335	3	35	1134	960	1099	0	1	0	0	138	1134
EDO. ZULIA	MP. SANTA RITA	PQ. SANTA RITA	ESCUELA BASICA BOLIVARIANA LUCRECIA NOVO DE PARRA	1698	3	19	1349	733	1330	0	7	1	0	589	1349
EDO. ZULIA	MP. SANTA RITA	PQ. SANTA RITA	JARDIN DE INFANCIA BELINDA DE MORENO	1135	2	16	931	499	915	0	3	0	0	413	931
EDO. ZULIA	MP. SANTA RITA	PQ. SANTA RITA	UNIDAD EDUCATIVA ISOLA PRIETO DE URDANETA	1854	4	33	1577	832	1544	0	4	0	0	708	1577
EDO. ZULIA	MP. SANTA RITA	PQ. SANTA RITA	ESCUELA BOLIVARIANA SAN BENITO	840	2	10	723	521	713	1	0	0	1	190	723
EDO. ZULIA	MP. SANTA RITA	PQ. SANTA RITA	U.E. NAC. JOSE ISIDRO SILVA	1331	3	18	1098	620	1080	2	5	0	2	451	1098
EDO. ZULIA	MP. SANTA RITA	PQ. SANTA RITA	UNIDAD EDUCATIVA MARIA AUXILIADORA	582	1	8	508	323	500	1	0	0	0	176	508
EDO. ZULIA	MP. SANTA RITA	PQ. SANTA RITA	UNIDAD EDUCATIVA ESTADAL DR. ANTONIO JOSE URQUINAONA	2933	6	35	2418	1160	2383	0	9	1	0	1213	2418
EDO. ZULIA	MP. SANTA RITA	PQ. SANTA RITA	ESCUELA NACIONAL SANTA RITA	2453	5	30	2015	1121	1985	0	8	1	1	854	2015
EDO. ZULIA	MP. SANTA RITA	PQ. SANTA RITA	INST. DE EDUCACION ESPECIAL, SANTA RITA	658	2	7	527	308	520	0	0	1	0	211	527
EDO. ZULIA	MP. SANTA RITA	PQ. SANTA RITA	ESCUELA BASICA NACIONAL ANTONIO MARIA PIRELA	2760	5	31	2224	1347	2193	0	10	1	0	835	2224
EDO. ZULIA	MP. BARALT	PQ. GENERAL URDANETA	UNIDAD EDUCATIVA ESTADAL JOSE TADEO MONAGAS	365	1	3	268	132	265	0	0	0	0	133	268
EDO. ZULIA	MP. BARALT	PQ. GENERAL URDANETA	UNIDAD EDUCATIVA ESTADAL MAESTRO VICTOR BALLESTRINI	1015	2	10	784	620	774	0	0	0	1	153	784
EDO. ZULIA	MP. BARALT	PQ. GENERAL URDANETA	UNIDAD EDUCATIVA NACIONAL EL TORO	170	1	2	152	135	150	0	0	0	0	15	152
EDO. ZULIA	MP. BARALT	PQ. GENERAL URDANETA	UNIDAD EDUCATIVA ESTADAL ALTO VIENTO	490	1	6	381	284	375	0	2	1	0	88	381
EDO. ZULIA	MP. BARALT	PQ. GENERAL URDANETA	ESCUELA NACIONAL SIN NUEMRO	479	1	1	394	331	393	0	1	0	0	61	394
EDO. ZULIA	MP. BARALT	PQ. GENERAL URDANETA	ESCUELA TECNICA ROBINSONIANA ZAMORANA SEGUNDO ANTONIO ALVAREZ	403	1	9	345	296	336	0	1	0	0	39	345
EDO. ZULIA	MP. BARALT	PQ. GENERAL URDANETA	UNIDAD EDUCATIVA ESTADAL SR ANTONIO MOSQUERA	590	1	7	475	374	468	0	1	0	0	93	475
EDO. ZULIA	MP. BARALT	PQ. GENERAL URDANETA	UNIDAD EDUCATIVA ESTADAL OLIMPIA MENDOZA	981	2	8	786	504	778	0	6	0	0	268	786
EDO. ZULIA	MP. BARALT	PQ. GENERAL URDANETA	ESCUELA NACIONAL SAN ISIDRO	798	2	6	629	415	623	0	2	0	0	206	629
EDO. ZULIA	MP. BARALT	PQ. GENERAL URDANETA	UNIDAD EDUCATIVA ESTADAL DR.GUILLERMO QUINTERO LUZARDO	1905	4	8	1414	1047	1406	0	6	1	0	352	1414
EDO. ZULIA	MP. BARALT	PQ. GENERAL URDANETA	UNIDAD EDUCATIVA ESTADAL OMAIRA BARRUETA	201	1	1	183	164	182	0	2	0	0	16	183
EDO. ZULIA	MP. BARALT	PQ. GENERAL URDANETA	UNIDAD EDUCATIVA ESTADAL  CONCENTRADA MARIA SENAIR DE ROA	688	2	12	569	438	557	0	2	0	0	117	569
EDO. ZULIA	MP. BARALT	PQ. MARCELINO BRICE#O	ESCUELA UNITARIA CREACION EL GUAIMARAL	409	1	1	324	249	323	0	2	0	0	72	324
EDO. ZULIA	MP. BARALT	PQ. MARCELINO BRICE#O	ESCUELA BASICA NACIONAL EL BATATAL	1062	2	9	807	531	798	0	0	0	0	267	807
EDO. ZULIA	MP. BARALT	PQ. MARCELINO BRICE#O	CENTRO DE EDUCACION INICIAL DON JOSE MARIANO NUNEZ	388	1	3	328	287	325	0	0	0	0	38	328
EDO. ZULIA	MP. BARALT	PQ. MARCELINO BRICE#O	UNIDAD EDUCATIVA ESTADAL HILARION ALBERTO VILORIA	1488	3	14	979	620	965	1	1	0	0	343	979
EDO. ZULIA	MP. BARALT	PQ. MARCELINO BRICE#O	UNIDAD EDUCATIVA ESTADAL CONCENTRADA. DON RAFAEL BRICEÑO	257	1	3	186	127	183	0	0	0	0	56	186
EDO. ZULIA	MP. BARALT	PQ. PUEBLO NUEVO	E.B. NAC. GALANDA ROJAS DE CONTRERAS	4563	8	60	3525	2033	3465	1	20	2	1	1408	3525
EDO. ZULIA	MP. BARALT	PQ. PUEBLO NUEVO	UNIDAD EDUCATIVA MUNICIPAL DR HUMBERTO FERNANDEZ MORAN	354	1	1	278	185	277	0	5	0	0	87	278
EDO. ZULIA	MP. BARALT	PQ. PUEBLO NUEVO	ESCUELA NACIONAL LOMA LINDA	181	1	3	164	137	161	0	0	0	0	24	164
EDO. ZULIA	MP. BARALT	PQ. PUEBLO NUEVO	ESCUELA BASICA ESTADAL TIERRA BARQUI	601	2	6	490	234	484	0	1	0	0	249	490
EDO. ZULIA	MP. BARALT	PQ. PUEBLO NUEVO	UNIDAD EDUCATIVA NACIONAL  BOLIVARIANA CAFE NEGRO	169	1	2	156	132	154	0	0	0	0	22	156
EDO. ZULIA	MP. BARALT	PQ. PUEBLO NUEVO	CENTRO DE EDUCACION INICIAL JOSE ANTONIO PAEZ	448	1	5	420	287	415	0	2	0	0	126	420
EDO. ZULIA	MP. BARALT	PQ. PUEBLO NUEVO	LICEO JUAN PABLO PEREZ ALFONZO	2901	5	45	2476	1286	2431	1	19	2	1	1122	2476
EDO. ZULIA	MP. BARALT	PQ. PUEBLO NUEVO	UNIDAD EDUCATIVA NACIONAL CONCENTRADA RAYA ABAJO	392	1	5	362	292	357	0	2	0	0	63	362
EDO. ZULIA	MP. BARALT	PQ. PUEBLO NUEVO	UNIDAD EDUCATIVA ESTADAL AGUA NEGRA	479	1	5	357	258	352	0	3	0	0	91	357
EDO. ZULIA	MP. BARALT	PQ. PUEBLO NUEVO	UNIDAD EDUCATIVA ESTADAL JOSE GONZALO MENDEZ	825	2	17	615	361	598	0	1	1	0	235	615
EDO. ZULIA	MP. BARALT	PQ. PUEBLO NUEVO	UNIDAD EDUCATIVA NACIONAL SANTA BARBARA	132	1	3	117	77	114	0	0	0	0	37	117
EDO. ZULIA	MP. BARALT	PQ. PUEBLO NUEVO	UNIDAD EDUCATIVA NUESTRA SEÑORA DE COROMOTO	1488	3	23	1268	679	1245	0	7	1	0	558	1268
EDO. ZULIA	MP. BARALT	PQ. PUEBLO NUEVO	E.B. NAC. BR. MARCOS TULIO ANDRADE	3172	6	64	2407	1338	2343	0	12	2	0	991	2407
EDO. ZULIA	MP. BARALT	PQ. PUEBLO NUEVO	ESCUELA BASICA BOLIVARIANA SABANA DE RAYA	1006	2	13	769	449	756	0	6	0	0	301	769
EDO. ZULIA	MP. BARALT	PQ. PUEBLO NUEVO	CENTRO DE EDUCACION INICIAL EVENCIO SOTO OCANTO	463	1	4	413	346	409	0	4	0	0	59	413
EDO. ZULIA	MP. BARALT	PQ. MANUEL GUANIPA MATOS	ESCUELA BÁSICA ESTADAL CONCENTRADA 341 204 ? MADRE TERESA DE CALCUTA	404	1	6	344	249	338	0	2	0	0	87	344
EDO. ZULIA	MP. BARALT	PQ. MANUEL GUANIPA MATOS	UNIDAD EDUCATIVA MARIA NATIVIDAD FARIA	768	2	18	600	320	582	0	1	0	1	260	600
EDO. ZULIA	MP. BARALT	PQ. MANUEL GUANIPA MATOS	UNIDAD EDUCATIVA LIBERATO ANTONIO LAMEDA	481	1	4	397	247	393	0	0	0	0	146	397
EDO. ZULIA	MP. BARALT	PQ. MANUEL GUANIPA MATOS	UNIDAD BASICA SIMON BOLIVAR	3063	6	36	2401	1175	2365	0	9	0	0	1181	2401
EDO. ZULIA	MP. BARALT	PQ. MANUEL GUANIPA MATOS	LICEO BOLIVARIANO BR JOSE AGUSTIN LOPEZ	1767	3	18	1487	874	1469	0	2	0	0	593	1487
EDO. ZULIA	MP. BARALT	PQ. MANUEL GUANIPA MATOS	UNIDAD EDUCATIVA MARDI DEL CARMEN LABOIN	686	2	5	579	357	574	1	1	1	0	214	579
EDO. ZULIA	MP. BARALT	PQ. MANUEL GUANIPA MATOS	UNIDAD EDUCATIVA DONA MARIA ACURERO	590	1	5	523	385	518	0	1	0	0	132	523
EDO. ZULIA	MP. BARALT	PQ. SAN TIMOTEO	ESCUELA MUNICIPAL ABDENAGO MUJICA	302	1	5	251	216	246	0	0	0	0	30	251
EDO. ZULIA	MP. BARALT	PQ. SAN TIMOTEO	UNIDAD EDUCATIVA ESTADAL RAFAEL MARIA BARALT	3253	6	27	2707	1587	2680	0	11	0	0	1082	2707
EDO. ZULIA	MP. BARALT	PQ. SAN TIMOTEO	ESCUELA BOLIVARIANA 5 DE JULIO	398	1	1	367	306	366	0	0	0	0	60	367
EDO. ZULIA	MP. BARALT	PQ. SAN TIMOTEO	U.E. EST.CONC. UNEVE 11	988	2	7	809	551	802	0	6	0	1	244	809
EDO. ZULIA	MP. BARALT	PQ. SAN TIMOTEO	UNIDAD EDUCATIVA NACIONAL BARALT I	427	1	7	393	292	386	0	3	0	0	91	393
EDO. ZULIA	MP. BARALT	PQ. LIBERTADOR	E.B. BOLIVARIANA SAN JOAQUIN	623	2	15	441	243	426	0	1	0	0	182	441
EDO. ZULIA	MP. BARALT	PQ. LIBERTADOR	UNIVERSIDAD NACIONAL EXPERIMENTAL RAFAEL MARIA BARALT	1027	2	10	902	435	892	0	3	0	1	453	902
EDO. ZULIA	MP. BARALT	PQ. LIBERTADOR	ESCUELA BOLIVARIANA EL MILAGRO CONCESIÓN 7	545	1	2	486	399	484	0	2	0	0	83	486
EDO. ZULIA	MP. BARALT	PQ. LIBERTADOR	UNIDAD BASICA ESTADAL ANDRES BELLO	4033	7	64	3249	1506	3185	0	11	2	0	1666	3249
EDO. ZULIA	MP. BARALT	PQ. LIBERTADOR	UNIDAD EDUCATIVA ESTADAL CIPRIANO BARRIOS	2552	5	22	1912	1290	1890	0	7	1	0	592	1912
EDO. ZULIA	MP. BARALT	PQ. LIBERTADOR	UNIDAD EDUCATIVA PROFESOR RAFAEL ANGEL GARCIA	857	2	15	730	493	715	0	5	0	0	217	730
EDO. ZULIA	MP. BARALT	PQ. LIBERTADOR	ESCUELA NACIONAL 465, CURVA DE SAN JUAN	389	1	9	347	288	338	0	0	0	0	50	347
EDO. ZULIA	MP. BARALT	PQ. LIBERTADOR	UNIDAD EDUCATIVA ESTADAL MAESTRO JOSE ANTONIO VELAZCO MALDONADO	1444	3	18	1053	547	1035	0	3	0	0	485	1053
EDO. ZULIA	MP. BARALT	PQ. LIBERTADOR	LICEO JESUS MARIA PORTILLO	1786	4	21	1508	846	1487	1	10	3	0	627	1508
EDO. ZULIA	MP. BARALT	PQ. LIBERTADOR	UNIDAD EDUCATIVA ESTADAL CONCENTRADA. MAESTRA. GRACIELA MONTILLA	322	1	3	225	150	222	0	0	0	0	72	225
EDO. ZULIA	MP.VALMORE RODRIGUEZ	PQ. LA VICTORIA	JARDIN DE INFANCIA BOLIVARIANA ARTURO MICHELENA	2121	4	49	1756	1007	1707	1	13	0	0	686	1756
EDO. ZULIA	MP.VALMORE RODRIGUEZ	PQ. LA VICTORIA	UNIDAD EDUCATIVA CONCENTRADA  LOS TEQUES	1051	2	11	807	556	796	0	3	3	1	233	807
EDO. ZULIA	MP.VALMORE RODRIGUEZ	PQ. LA VICTORIA	UNIDAD EDUCATIVA  NACIONAL  DORA DE ARO	1158	2	20	771	482	751	0	6	0	0	263	771
EDO. ZULIA	MP.VALMORE RODRIGUEZ	PQ. LA VICTORIA	UNIDAD EDUCATIVA NACIONAL RAFAEL URDANETA	2721	5	27	2338	868	2311	0	8	2	1	1432	2338
EDO. ZULIA	MP.VALMORE RODRIGUEZ	PQ. LA VICTORIA	ESCUELA BASICA NACIONAL JOHN DEWEY	2234	4	29	1782	900	1753	0	6	1	0	846	1782
EDO. ZULIA	MP.VALMORE RODRIGUEZ	PQ. LA VICTORIA	ESCUELA BASICA NACIONAL LAGUNILLAS	2307	4	58	1877	891	1819	0	9	2	0	917	1877
EDO. ZULIA	MP.VALMORE RODRIGUEZ	PQ. LA VICTORIA	UNIDAD EDUCATIVA  24 DE JULIO	434	1	6	338	180	332	1	5	1	0	145	338
EDO. ZULIA	MP.VALMORE RODRIGUEZ	PQ. LA VICTORIA	UNIDAD EDUCATIVA ESTADAL EL CINCO	550	1	6	409	285	403	0	2	0	0	116	409
EDO. ZULIA	MP.VALMORE RODRIGUEZ	PQ. LA VICTORIA	PREESCOLAR PRIVADO NACIONAL BLANCA NIEVES	1022	2	22	900	312	878	1	2	0	0	563	900
EDO. ZULIA	MP.VALMORE RODRIGUEZ	PQ. LA VICTORIA	CENTRO DE EDUCACION INICIAL  ANA MARIA CAMPOS	972	2	31	792	390	761	0	2	0	1	368	792
EDO. ZULIA	MP.VALMORE RODRIGUEZ	PQ. LA VICTORIA	UNIDAD EDUCATIVA  NACIONAL COMUNITARIA VIRGEN DEL  CARMEN	736	2	11	675	355	664	0	3	0	1	305	675
EDO. ZULIA	MP.VALMORE RODRIGUEZ	PQ. LA VICTORIA	UNIDAD EDUCATIVA ARQUIDIOCESANA MONSEÑOR EMILIO	1125	2	18	967	552	949	0	2	0	0	395	967
EDO. ZULIA	MP.VALMORE RODRIGUEZ	PQ. LA VICTORIA	UNIDAD EDUCATIVA NACIONAL NESTOR LUIS NEGRON	3017	6	64	2418	1069	2354	1	13	2	0	1269	2418
EDO. ZULIA	MP.VALMORE RODRIGUEZ	PQ. RAFAEL URDANETA	UNIDAD EDUCATIVA ESTADAL INTEGRAL DON PEDRO BAUTISTA	1617	3	17	1344	508	1327	0	2	0	1	816	1344
EDO. ZULIA	MP.VALMORE RODRIGUEZ	PQ. RAFAEL URDANETA	UNIDAD EDUCATIVA BOLIVARIANA EL MURO	1340	3	43	1064	576	1021	0	13	0	0	432	1064
EDO. ZULIA	MP.VALMORE RODRIGUEZ	PQ. RAFAEL URDANETA	CENTRO DE A. INTEGRAL RAFAEL URDANETA.	1193	3	17	956	520	939	1	1	0	0	417	956
EDO. ZULIA	MP.VALMORE RODRIGUEZ	PQ. RAFAEL URDANETA	UNIDAD EDUCATIVA  CONCENTRADA CURVA DEL INDIO	746	2	21	506	312	485	0	2	0	1	170	506
EDO. ZULIA	MP.VALMORE RODRIGUEZ	PQ. RAFAEL URDANETA	UNIDAD EDUCATIVA ESTADAL CRISTOBAL ROJAS (E.Z.A)	2710	5	60	2189	1145	2129	0	14	2	0	968	2189
EDO. ZULIA	MP.VALMORE RODRIGUEZ	PQ. RAUL CUENCA	ESCUELA BASICA NACIONAL PLAN BONITO (MIGUEL ARCANGEL MARQUEZ)	1626	3	56	1388	820	1332	0	5	0	0	507	1388
EDO. ZULIA	MP.VALMORE RODRIGUEZ	PQ. RAUL CUENCA	UNIDAD EDUCATIVA  BOLIVARIANA DANIEL MAVARES	759	2	9	587	396	578	0	1	0	0	181	587
EDO. ZULIA	MP.VALMORE RODRIGUEZ	PQ. RAUL CUENCA	UNIDAD EDUCATIVA BOLIVARIANA ZIPAYARE	1429	3	20	1141	774	1121	0	3	4	0	340	1141
EDO. ZULIA	MP.VALMORE RODRIGUEZ	PQ. RAUL CUENCA	UNIDAD EDUCATIVA  EL COROZO	2636	5	43	2193	1328	2150	1	10	3	0	808	2193
EDO. ZULIA	MP.VALMORE RODRIGUEZ	PQ. RAUL CUENCA	UNIDAD EDUCATIVA  LICEO BOLIVARIANO EL REMOLINO	1397	3	18	1172	807	1154	0	6	1	0	340	1172
EDO. ZULIA	MP.VALMORE RODRIGUEZ	PQ. RAUL CUENCA	ESCUELA  BOLIVARIANA LEONCIO MARTINEZ	1391	3	15	1134	675	1119	0	2	1	1	440	1134
EDO. ZULIA	MP.VALMORE RODRIGUEZ	PQ. RAUL CUENCA	UNIDAD EDUCATIVA  BOLIVARIANA LAS DELICIAS	534	1	9	474	335	465	0	3	1	0	126	474
EDO. ZULIA	MP. FRANCISCO J PULG	PQ. SIMON RODRIGUEZ	ESCUELA BOLIVARIANA SANTO DOMINGO	223	1	9	191	119	182	0	0	0	0	63	191
EDO. ZULIA	MP. FRANCISCO J PULG	PQ. SIMON RODRIGUEZ	UNIDAD EDUCATIVA SANTA BARBARA	3752	7	101	2795	1351	2694	0	3	3	0	1337	2795
EDO. ZULIA	MP. FRANCISCO J PULG	PQ. SIMON RODRIGUEZ	ESCUELA BASICA BOLIVARIANA GUAMO GAVILANES	208	1	2	155	73	153	0	1	0	0	79	155
EDO. ZULIA	MP. FRANCISCO J PULG	PQ. SIMON RODRIGUEZ	ESCUELA BOLIVARIANA BURRA MOCHA	297	1	6	124	104	118	0	1	0	0	13	124
EDO. ZULIA	MP. FRANCISCO J PULG	PQ. SIMON RODRIGUEZ	ESCUELA BOLIVARIANA CLEVER QUINTERO	1144	2	22	886	505	864	0	0	0	0	359	886
EDO. ZULIA	MP. FRANCISCO J PULG	PQ. SIMON RODRIGUEZ	UNIDAD EDUCATIVA NACIONAL BERNARDO VILLASMIL	3064	6	38	2416	1259	2378	0	4	0	1	1114	2416
EDO. ZULIA	MP. FRANCISCO J PULG	PQ. SIMON RODRIGUEZ	ESCUELA BOLIVARIANA LA MONTAÑA	261	1	3	218	152	215	0	3	0	0	60	218
EDO. ZULIA	MP. FRANCISCO J PULG	PQ. SIMON RODRIGUEZ	ESCUELA BASICA BOLIVARIANA GUAMO EL PINO	462	1	10	377	155	367	0	2	0	0	210	377
EDO. ZULIA	MP. FRANCISCO J PULG	PQ. SIMON RODRIGUEZ	ESCUELA BOLIVARIANA EL PORVENIR	282	1	2	235	181	233	0	0	0	0	52	235
EDO. ZULIA	MP. FRANCISCO J PULG	PQ. SIMON RODRIGUEZ	ESCUELA BOLIVARIANA SANTA ROSA	287	1	6	246	168	240	1	0	0	0	71	246
EDO. ZULIA	MP. FRANCISCO J PULG	PQ. SIMON RODRIGUEZ	ESCUELA PRIMARIA BOLIVARINA CAÑO PITAL	641	2	4	496	325	492	0	1	0	0	166	496
EDO. ZULIA	MP. FRANCISCO J PULG	PQ. CARLOS QUEVEDO	ESCUELA BOLIVARIANA LA RANCHERIA	571	1	6	450	257	444	0	1	0	0	186	450
EDO. ZULIA	MP. FRANCISCO J PULG	PQ. CARLOS QUEVEDO	ESCUELA BOLIVARIANA LA GRAN PARADA	480	1	9	392	190	383	0	1	0	0	192	392
EDO. ZULIA	MP. FRANCISCO J PULG	PQ. CARLOS QUEVEDO	UNIDAD EDUCATIVA NACIONAL NICOLAS ARAMBULO	4440	8	83	3423	1995	3340	2	6	4	1	1332	3423
EDO. ZULIA	MP. FRANCISCO J PULG	PQ. CARLOS QUEVEDO	ESCUELA BOLIVARIANA CAÑO DE MUJERES	276	1	1	219	157	218	0	0	0	0	61	219
EDO. ZULIA	MP. FRANCISCO J PULG	PQ. FRANCISCO J PULGAR	UNIDAD EDUCATIVA ESTADAL LUISA CACERES DE ARISMENDI	2019	4	30	1642	808	1612	0	4	0	0	800	1642
EDO. ZULIA	MP. FRANCISCO J PULG	PQ. FRANCISCO J PULGAR	ESCUELA BOLIVARIANA LAS PALMERAS	503	1	5	381	210	376	0	0	0	0	166	381
EDO. ZULIA	MP. MARA	PQ. LAS PARCELAS	UNIDAD EDUCATIVA ESTADAL BLANCA ROSA  URQUIAGA	2606	5	19	2090	1561	2071	0	2	2	0	506	2090
EDO. ZULIA	MP. MARA	PQ. LAS PARCELAS	UNIDAD EDUCATIVA MARCELINO SANCHEZ	1060	2	5	958	809	953	0	0	0	0	144	958
EDO. ZULIA	MP. MARA	PQ. LAS PARCELAS	ESCUELA BOLIVARIANA LOS MAYALES	560	1	6	486	413	480	0	2	0	0	65	486
EDO. ZULIA	MP. MARA	PQ. LAS PARCELAS	ESCUELA BASICA NACIONAL LA  ENEITA	1968	4	14	1535	1116	1521	0	4	4	0	397	1535
EDO. ZULIA	MP. MARA	PQ. LAS PARCELAS	UNIDAD EDUCATIVA ESTADAL PROFESORA VERONICA MORILLO DE GONZALEZ	1633	3	20	1202	853	1182	2	7	2	1	317	1202
EDO. ZULIA	MP. MARA	PQ. LAS PARCELAS	UNIDAD EDUCATIVA ESTADAL EL PIACHE	1240	3	13	954	787	941	0	1	0	0	153	954
EDO. ZULIA	MP. MARA	PQ. LAS PARCELAS	ESCUELA BASICA NACIONAL INDIO MANAURE	554	1	4	518	468	514	0	0	0	0	46	518
EDO. ZULIA	MP. MARA	PQ. MONS.MARCOS SERGIO G	ESCUELA  BOLIVARIANA CACHIRI	1999	4	6	1430	1142	1424	0	1	0	0	281	1430
EDO. ZULIA	MP. MARA	PQ. MONS.MARCOS SERGIO G	ESCUELA BASICA NACIONAL. LOS CAÑOS	925	2	12	617	496	605	0	0	0	0	109	617
EDO. ZULIA	MP. MARA	PQ. LA SIERRITA	ESCUELA BASICA NACIONAL LOS CANAMOS	403	1	3	330	275	327	0	1	0	0	51	330
EDO. ZULIA	MP. MARA	PQ. LA SIERRITA	ESCUELA BASICA BOLIVARIANA CEMIDA CARMONA	599	1	5	461	285	456	0	2	1	0	168	461
EDO. ZULIA	MP. MARA	PQ. LA SIERRITA	UE. PRIVADA JOSE IGNACIO PULIDO	539	1	8	338	204	330	0	1	0	0	125	338
EDO. ZULIA	MP. MARA	PQ. LA SIERRITA	UNIDAD EDUCATIVA ESTADAL CECILIA  NUÑES  SUCRE	2499	5	37	1897	1364	1860	0	5	1	0	490	1897
EDO. ZULIA	MP. MARA	PQ. LA SIERRITA	UNIDAD EDUCATIVA PRESBITERO ENDER ENRIQUE AVILA	1014	2	15	795	592	780	0	6	0	0	182	795
EDO. ZULIA	MP. MARA	PQ. LA SIERRITA	CENTRO EDUCACION INICIAL SIMONCITO CHIQUINQUIRA	382	1	2	347	321	345	0	1	0	0	23	347
EDO. ZULIA	MP. MARA	PQ. LA SIERRITA	ESCUELA  BASICA  BOLIVARIANA JOSE DOMINGO MORALES	387	1	4	234	151	230	0	1	2	0	76	234
EDO. ZULIA	MP. MARA	PQ. LA SIERRITA	ESCUELA BOLIVARIANA CIENAGUITA	430	1	9	380	315	371	0	0	0	0	56	380
EDO. ZULIA	MP. MARA	PQ. LA SIERRITA	ESCUELA   BOLIVARIANA JOSE LUGO RIVAS	2095	4	27	1564	1057	1537	0	11	2	0	467	1564
EDO. ZULIA	MP. MARA	PQ. LA SIERRITA	ESCUELA   BOLIVARIANA MARCELINO 2	1615	3	17	1173	687	1156	1	1	0	0	467	1173
EDO. ZULIA	MP. MARA	PQ. LA SIERRITA	UNIDAD EDUCATIVA SOCIAL DE AVANZADA ARMANDO MOLERO	761	2	10	514	400	504	0	2	2	1	99	514
EDO. ZULIA	MP. MARA	PQ. LA SIERRITA	ESCUELA NACIONAL ANA MARIA CAMPOS	3567	7	55	2563	1622	2508	0	6	1	1	878	2563
EDO. ZULIA	MP. MARA	PQ. LA SIERRITA	UNIDAD EDUCATIVA ESTADAL CIENAGA DE REYES	973	2	11	710	525	699	0	0	0	0	174	710
EDO. ZULIA	MP. MARA	PQ. LA SIERRITA	ESCUELA   BOLIVARIANA ROMULO BETANCOURT	1516	3	13	1173	823	1160	2	7	0	0	328	1173
EDO. ZULIA	MP. MARA	PQ. LA SIERRITA	UNIDAD EDUCATIVA ESTADAL FUERTE MARA	2397	5	13	1551	1133	1538	0	7	1	0	397	1551
EDO. ZULIA	MP. MARA	PQ. LA SIERRITA	ESCUELA BOLIVARIANA CAÑA FRESCA	427	1	5	365	266	360	0	1	0	0	93	365
EDO. ZULIA	MP. MARA	PQ. LA SIERRITA	ESCUELA BOLIVARIANO RAMON TROCONIS VALE	243	1	3	227	200	224	0	0	0	0	24	227
EDO. ZULIA	MP. MARA	PQ. LA SIERRITA	ESCUELA BASICA NACIONAL LA BOTELLA	1339	3	13	1026	754	1013	0	2	0	0	257	1026
EDO. ZULIA	MP. MARA	PQ. LA SIERRITA	UNIDAD EDUCATIVA BOLIVARIANA BACHILLER JOSE MARIA OSORIO	2538	5	22	1847	1191	1825	0	1	1	0	632	1847
EDO. ZULIA	MP. MARA	PQ. LA SIERRITA	ESCUELA BASICA NACIONAL ANA SARA HERNANDEZ DE TORRES	888	2	4	797	642	793	0	1	0	0	150	797
EDO. ZULIA	MP. MARA	PQ. LA SIERRITA	ESCUELA BASICA NACIONAL ANDRES FLEIRE	568	1	12	487	399	475	0	1	0	1	74	487
EDO. ZULIA	MP. MARA	PQ. LA SIERRITA	ESCUELA BASICA EL CERRITO	542	1	7	454	345	447	0	0	0	0	102	454
EDO. ZULIA	MP. MARA	PQ. LA SIERRITA	UNIDAD EDUCATIVA LICEO BOLIVARIANA TAMARE	922	2	12	752	571	740	0	5	0	1	163	752
EDO. ZULIA	MP. MARA	PQ. SAN RAFAEL	ESCUELA BOLIVARIANA CARRIZAL	496	1	3	455	395	452	0	3	0	0	54	455
EDO. ZULIA	MP. MARA	PQ. SAN RAFAEL	UNIDAD EDUCATIVANIXON MEJIAS ROMERO	1168	2	13	1069	620	1056	0	2	0	0	434	1069
EDO. ZULIA	MP. MARA	PQ. SAN RAFAEL	ESCUELA BASICA BOLIVARIANA CIRUELO BAJO	1068	2	4	918	798	914	0	3	0	0	113	918
EDO. ZULIA	MP. MARA	PQ. SAN RAFAEL	ESCUELA BASICA NACIONAL NAZARET	4384	8	33	3616	2782	3583	0	7	1	0	793	3616
EDO. ZULIA	MP. MARA	PQ. SAN RAFAEL	ESCUELA BASICA ESTADAL SIXTO D` VICENTE	4376	8	23	3472	1948	3449	0	7	1	1	1492	3472
EDO. ZULIA	MP. MARA	PQ. SAN RAFAEL	ESCUELA  BASICA ESTADAL MARIA LOURDES SUAREZ DE SOTO	1110	2	8	879	687	871	1	0	1	0	182	879
EDO. ZULIA	MP. MARA	PQ. SAN RAFAEL	ESCUELA BASICA NACIONAL JESUS MARIA SISTIAGA	2911	5	33	2387	1489	2354	0	5	1	0	859	2387
EDO. ZULIA	MP. MARA	PQ. SAN RAFAEL	ESCUELA MAESTRA ELENA SULBARAN	714	2	2	651	582	649	0	0	0	0	67	651
EDO. ZULIA	MP. MARA	PQ. SAN RAFAEL	ESCUELA BASICA BOLIVARIANA PRESBITERO LUIS DE VICENTE	998	2	6	668	485	662	0	0	0	0	177	668
EDO. ZULIA	MP. MARA	PQ. SAN RAFAEL	UNIDAD EDUCATIVA ESTADAL ROMULO GALLEGOS	2563	5	11	2071	1633	2060	0	3	1	0	423	2071
EDO. ZULIA	MP. MARA	PQ. SAN RAFAEL	UNIDAD EDUCATIVA ESTADAL INMACULADA CONCEPCION	1335	3	12	1059	827	1047	1	2	1	0	216	1059
EDO. ZULIA	MP. MARA	PQ. SAN RAFAEL	ESCUELA BASICA BOLIVARIANA PRESBITERO MANUEL MARIA PADRON	2025	4	10	1678	1371	1668	2	4	1	0	290	1678
EDO. ZULIA	MP. MARA	PQ. SAN RAFAEL	CENTRO DE EDUCACION INICIAL EL SOCUY	1041	2	7	882	716	875	0	0	0	0	159	882
EDO. ZULIA	MP. MARA	PQ. SAN RAFAEL	ESCUELA BASICA NACIONAL ELEAZAR AÑEZ GRANADILLO	2121	4	14	1624	1261	1610	1	2	0	3	343	1624
EDO. ZULIA	MP. MARA	PQ. SAN RAFAEL	ESCUELA BASICA NACIONAL 25 DE AGOSTO	3936	7	41	3250	1992	3209	0	8	0	2	1207	3250
EDO. ZULIA	MP. MARA	PQ. LUIS DE VICENTE	ESCUELA BOLIVARIANA LOS TISONES	287	1	6	247	163	241	0	1	0	0	77	247
EDO. ZULIA	MP. MARA	PQ. LUIS DE VICENTE	UNIDAD EDUCATIVA JUAN PABLO II	853	2	4	688	556	684	0	0	1	0	127	688
EDO. ZULIA	MP. MARA	PQ. LUIS DE VICENTE	UNIDAD EDUCATIVA CAÑO NEGRO	736	2	9	562	402	553	0	3	0	0	148	562
EDO. ZULIA	MP. MARA	PQ. LUIS DE VICENTE	UNIDAD EDUCATIVA JESUS CARRERA EL PASO	351	1	1	265	214	264	0	1	1	0	48	265
EDO. ZULIA	MP. MARA	PQ. LUIS DE VICENTE	ESCUELA  BOLIVARIANA JOSE ANTONIO URIANA	1200	3	16	994	666	978	0	3	1	0	308	994
EDO. ZULIA	MP. MARA	PQ. LUIS DE VICENTE	UNIDAD EDUCATIVA ARCANJEL SAN MIGUEL	938	2	6	715	520	709	0	1	1	0	187	715
EDO. ZULIA	MP. MARA	PQ. LUIS DE VICENTE	UNIDAD EDUCATIVA ESTADAL MONSEÑOR ALVAREZ	4892	9	44	3881	2051	3837	0	10	2	0	1774	3881
EDO. ZULIA	MP. MARA	PQ. LUIS DE VICENTE	UNIDAD EDUCATIVA ESTADAL SAN FELIPE DE GUASARE	309	1	3	150	116	147	0	1	0	0	30	150
EDO. ZULIA	MP. MARA	PQ. LUIS DE VICENTE	ESCUELA NACIONAL GRADUADA SILOE	1947	4	17	1509	939	1492	0	6	2	0	545	1509
EDO. ZULIA	MP. MARA	PQ. RICAURTE	CENTRO DE EDUCACIÓN INICIAL SANTA CRUZ DE MARA	1408	3	13	1143	711	1130	1	2	1	0	415	1143
EDO. ZULIA	MP. MARA	PQ. RICAURTE	ESCUELA INTERCULTURAL BILINGUE MANUEL ANGEL LUZARDO	653	2	32	566	474	534	0	0	2	0	58	566
EDO. ZULIA	MP. MARA	PQ. RICAURTE	ESCUELA INTERCULTURAL BILINGUE MIRIAN RUBIO	1098	2	16	898	790	882	0	1	2	0	89	898
EDO. ZULIA	MP. MARA	PQ. RICAURTE	ESCUELA BASICA NAC. CONCENTRADA. LOS MEMBRILLOS	834	2	10	604	435	594	0	4	0	1	154	604
EDO. ZULIA	MP. MARA	PQ. RICAURTE	UNIDAD EDUCATIVA GUAREIRA II	2234	4	32	1735	1198	1703	1	8	0	1	495	1735
EDO. ZULIA	MP. MARA	PQ. RICAURTE	ESCUELA BASICA BOLIVARIANA  FRANCISCO ARAUJO GARCIA	5126	9	65	3879	2454	3814	1	12	2	0	1345	3879
EDO. ZULIA	MP. MARA	PQ. RICAURTE	LICEO JOSE ANTONIO ALMARZA	6805	12	149	5284	3422	5135	0	13	1	1	1698	5284
EDO. ZULIA	MP. MARA	PQ. RICAURTE	UNIDAD EDUCATIVA LEONOR DE FERNANDEZ	1563	3	45	1286	857	1241	0	4	0	0	380	1286
EDO. ZULIA	MP. MARA	PQ. RICAURTE	ESCUELA BASICA ESTADAL DR. PEDRO LUENGO	5055	9	55	3695	2056	3640	3	17	4	3	1557	3695
EDO. ZULIA	MP. MARA	PQ. RICAURTE	UNIDAD EDUCATIVA ESTADAL LA LOMA I	1464	3	16	1130	737	1114	0	9	0	0	368	1130
EDO. ZULIA	MP. MARA	PQ. RICAURTE	ESCUELA BASICA NACIONAL JOSE ANGEL HUERTA	440	1	3	401	381	398	0	0	0	0	17	401
EDO. ZULIA	MP. MARA	PQ. RICAURTE	ESCUELA BOLIVARIANA MONTE VERDE	359	1	5	328	267	323	0	1	0	0	55	328
EDO. ZULIA	MP. MARA	PQ. RICAURTE	JARDIN DE INFANCIA NACIONAL MARIA DEVIS DE FUENMAYOR	2343	4	36	1842	1037	1806	2	10	0	0	757	1842
EDO. ZULIA	MP. MARA	PQ. RICAURTE	ALDEA UNIVERSITARIA NUEVA LUCHA FUNDACION MISION SUCRE	1211	3	8	990	710	982	1	5	1	0	265	990
EDO. ZULIA	MP. MARA	PQ. TAMARE	UNIDAD EDUCATIVA ESTADAL MADRE MARIA AUXILIADORA	1159	2	6	788	458	782	0	1	0	0	323	788
EDO. ZULIA	MP. MARA	PQ. TAMARE	ESCUELA BOLIVARIANA LA REPELONA	1081	2	10	914	820	904	0	4	0	0	80	914
EDO. ZULIA	MP. MARA	PQ. TAMARE	ESCUELA BASICA NACIONAL LOS LECHOSOS	549	1	8	474	432	466	0	0	0	0	34	474
EDO. ZULIA	MP. MARA	PQ. TAMARE	ESCUELA BASICA RICARDO AGUIRRE	1453	3	6	1157	802	1151	0	6	1	0	342	1157
EDO. ZULIA	MP. MARA	PQ. TAMARE	ESCUELA BOLIVARIANA TAMARE VIVIENDA RURAL	1225	3	17	1022	772	1005	0	2	1	0	230	1022
EDO. ZULIA	MP. MARA	PQ. TAMARE	ESCUELA BOLIVARIANA HERNAN POCATERRA	433	1	4	372	307	368	0	0	0	0	61	372
EDO. ZULIA	MP. MARA	PQ. TAMARE	UNIDAD EDUCATIVA ESTADAL TENIENTE PEDRO CAMEJO	4242	8	47	3134	1891	3087	1	11	2	1	1181	3134
EDO. ANZOATEGUI	MP. INDEPENDENCIA	PQ. MAMO	ESCUELA ESTADAL NUMERO  68	543	1	4	425	328	421	1	2	1	0	89	425
EDO. ANZOATEGUI	MP. INDEPENDENCIA	PQ. MAMO	ESCUELA MUNICIPAL MACAPAIMA	252	1	28	219	147	191	0	4	0	0	40	219
EDO. ANZOATEGUI	MP. INDEPENDENCIA	PQ. MAMO	ESCUELA BOLIVARIANA PRIMARIA CARAPA	599	1	9	437	315	428	0	3	2	0	108	437
EDO. ANZOATEGUI	MP. INDEPENDENCIA	PQ. MAMO	ESCUELA RURAL BOLIVARIANA DEL ACEITAL DE YABO	858	2	23	783	687	760	0	5	2	1	65	783
EDO. ANZOATEGUI	MP. INDEPENDENCIA	PQ. MAMO	ESCUELA MUNICIPAL JUAN PEDRO
EDO. ANZOATEGUI	MP. INDEPENDENCIA	PQ. MAMO	ESCUELA CONCENTRADA NACIONAL NUMERO 1035  JUASJUILLAR	426	1	8	367	315	359	0	0	0	0	44	367
EDO. ANZOATEGUI	MP. INDEPENDENCIA	PQ. MAMO	ESCUELA INTEGRAL BOLIVARIANA PALITAL	1246	3	16	1003	863	987	0	2	1	0	121	1003
EDO. ANZOATEGUI	MP. INDEPENDENCIA	PQ. MAMO	ESCUELA NACIONAL BOLIVARIANA MAMO ARRIBA	1145	2	32	902	690	870	0	3	0	1	176	902
EDO. ANZOATEGUI	MP. INDEPENDENCIA	CM. SOLEDAD	NUCLEO EDUCACION RURAL 321 TAMARINDO	218	1	11	171	105	160	0	2	1	0	52	171
EDO. ANZOATEGUI	MP. INDEPENDENCIA	CM. SOLEDAD	ESCUELA BOLIVARIANA MALPICA	194	1	1	119	94	118	0	0	0	0	24	119
EDO. ANZOATEGUI	MP. INDEPENDENCIA	CM. SOLEDAD	ESCUELA NACIONAL UNITARIA NUMERO 1	424	1	3	322	298	319	0	0	1	1	19	322
EDO. ANZOATEGUI	MP. INDEPENDENCIA	CM. SOLEDAD	ESCUELA BASICA EZEQUIEL ZAMORA	505	1	9	386	300	377	0	2	1	0	74	386
EDO. ANZOATEGUI	MP. INDEPENDENCIA	CM. SOLEDAD	ESCUELA NACIONAL CONCENTRADA NUMERO 58 195	450	1	10	306	232	296	0	2	0	1	61	306
EDO. ANZOATEGUI	MP. INDEPENDENCIA	CM. SOLEDAD	ESCUELA INTEGRAL BOLIVARIANA DE EDUACACION ESPECIAL SOLEDAD	1669	3	43	1309	798	1266	1	7	0	0	460	1309
EDO. ANZOATEGUI	MP. INDEPENDENCIA	CM. SOLEDAD	ESCUELA ESTADAL NUMERO 67	498	1	3	396	351	393	0	0	0	0	42	396
EDO. ANZOATEGUI	MP. INDEPENDENCIA	CM. SOLEDAD	UNIDAD EDUCATIVA LA ALDEA	240	1	8	210	181	202	0	0	1	0	20	210
EDO. ANZOATEGUI	MP. INDEPENDENCIA	CM. SOLEDAD	GRUPO ESCOLAR TOMAS MONTILLA	2403	5	49	1907	1192	1858	1	11	0	1	653	1907
EDO. ANZOATEGUI	MP. INDEPENDENCIA	CM. SOLEDAD	ESCUELA UNITARIA NACIONAL NUMERO 416	497	1	7	331	244	324	0	2	0	0	78	331
EDO. ANZOATEGUI	MP. INDEPENDENCIA	CM. SOLEDAD	GRUPO ESCOLAR DOCTOR JOSÉ MARIA RODRÍGUEZ ARMAS	1495	3	22	1187	703	1165	0	8	0	1	453	1187
EDO. ANZOATEGUI	MP. INDEPENDENCIA	CM. SOLEDAD	ESCUELA BOLIVARIANA SANTA CRUZ DEL TIGRE	145	1	1	78	60	77	0	0	0	0	17	78
EDO. ANZOATEGUI	MP. INDEPENDENCIA	CM. SOLEDAD	ESCUELA BOLIVARIANA LAS CURAGUAS	154	1	7	139	111	132	0	0	0	0	21	139
EDO. ANZOATEGUI	MP. INDEPENDENCIA	CM. SOLEDAD	GRUPO ESCOLAR JOSE ANTONIO ANZOATEGUI	3605	7	36	2816	1888	2780	1	22	0	1	868	2816
EDO. ANZOATEGUI	MP. INDEPENDENCIA	CM. SOLEDAD	GRUPO ESCOLAR FRAY NICOLAS DE ODENA	3281	6	68	2358	1356	2290	0	15	4	0	915	2358
EDO. ANZOATEGUI	MP. INDEPENDENCIA	CM. SOLEDAD	ESCUELA BOLIVARIANA LA ENCARAMADA	171	1	5	153	100	148	0	2	0	0	46	153
EDO. ANZOATEGUI	MP. INDEPENDENCIA	CM. SOLEDAD	ESCUELA ESTADAL SIMON RODRIGUEZ	596	1	19	503	371	484	0	3	1	0	109	503
EDO. ANZOATEGUI	MP. INDEPENDENCIA	CM. SOLEDAD	ESCUELA INTEGRAL BOLIVARIANA EL LINDERO	312	1	12	238	187	226	0	0	0	0	39	238
EDO. ANZOATEGUI	MP. INDEPENDENCIA	CM. SOLEDAD	UNIDAD EDUCATIVA TEMISTOCLES MAZA	1337	3	24	1083	766	1059	0	5	0	1	287	1083
EDO. ANZOATEGUI	MP. ARAGUA	CM. ARAGUA DE BARCELONA	ESCUELA ESTADAL CONCENTRADA NUMERO 5 Y 2095	276	1	3	178	149	175	1	2	0	0	23	178
EDO. ANZOATEGUI	MP. ARAGUA	CM. ARAGUA DE BARCELONA	ESCUELA HERMANOS MONAGAS	750	2	9	653	495	644	0	1	0	0	148	653
EDO. ANZOATEGUI	MP. ARAGUA	CM. ARAGUA DE BARCELONA	ESCUELA BOLIVARIANA BARRIO LA CRUZ	973	2	22	865	581	843	1	5	0	0	256	865
EDO. ANZOATEGUI	MP. ARAGUA	CM. ARAGUA DE BARCELONA	ESCUELA CONCENTRADA CACHIMIRA	250	1	1	224	158	223	1	1	1	0	62	224
EDO. ANZOATEGUI	MP. ARAGUA	CM. ARAGUA DE BARCELONA	ESCUELA NACIONAL NUMERO 53 2004	430	1	6	326	248	320	0	2	0	0	70	326
EDO. ANZOATEGUI	MP. ARAGUA	CM. ARAGUA DE BARCELONA	ESCUELA CONCENTRADA MIXTA NUMERO 1 SIN NUMERO	408	1	9	322	182	313	0	7	1	0	123	322
EDO. ANZOATEGUI	MP. ARAGUA	CM. ARAGUA DE BARCELONA	ESCUELA CONCENTRADA NUMERO 2084 1852	241	1	5	170	125	165	0	3	0	0	37	170
EDO. ANZOATEGUI	MP. ARAGUA	CM. ARAGUA DE BARCELONA	ESCUELA ESTADAL CONCENTRADA NUMERO 130 SIN NUMERO	453	1	6	348	279	342	0	2	0	0	61	348
EDO. ANZOATEGUI	MP. ARAGUA	CM. ARAGUA DE BARCELONA	ESCUELA BASICA NACIONAL 2901 LA GLORIA	140	1	3	120	63	117	0	5	1	1	47	120
EDO. ANZOATEGUI	MP. ARAGUA	CM. ARAGUA DE BARCELONA	ESCUELA NACIONAL UNITARIA NUMERO 1859	229	1	2	155	94	153	0	0	0	0	59	155
EDO. ANZOATEGUI	MP. ARAGUA	CM. ARAGUA DE BARCELONA	ESCUELA NACIONAL GUACAMAYO	38	1	2	35	33	33	0	0	0	0	0	35
EDO. ANZOATEGUI	MP. ARAGUA	CM. ARAGUA DE BARCELONA	ESCUELA NACIONAL CONCENTRADA VENTORRILLO	152	1	4	141	101	137	0	3	0	0	33	141
EDO. ANZOATEGUI	MP. ARAGUA	CM. ARAGUA DE BARCELONA	ESCUELA BUENOS AIRES NUCLEO ESCOLAR RURAL 001	437	1	20	383	266	363	0	3	0	0	94	383
EDO. ANZOATEGUI	MP. ARAGUA	CM. ARAGUA DE BARCELONA	ESCUELA LAS PALMITAS	306	1	2	203	184	201	0	3	0	0	14	203
EDO. ANZOATEGUI	MP. ARAGUA	CM. ARAGUA DE BARCELONA	ESCUELA MANZANARES	238	1	0	199	157	199	0	0	1	0	41	199
EDO. ANZOATEGUI	MP. ARAGUA	CM. ARAGUA DE BARCELONA	ESCUELA CONCENTRADA NUMERO 1882 2152	726	2	14	581	360	567	1	2	0	0	204	581
EDO. ANZOATEGUI	MP. ARAGUA	CM. ARAGUA DE BARCELONA	ESCUELA BOLIVARIANA BARRIO SUCRE	586	1	9	512	361	503	0	4	0	0	138	512
EDO. ANZOATEGUI	MP. ARAGUA	CM. ARAGUA DE BARCELONA	ESCUELA NACIONAL CONCENTRADA LAS PIÑAS	295	1	8	257	185	249	0	0	1	0	63	257
EDO. ANZOATEGUI	MP. ARAGUA	CM. ARAGUA DE BARCELONA	UNIDAD EDUCATIVA CREACION ARAGUA	1816	4	16	1397	755	1381	1	7	1	1	616	1397
EDO. ANZOATEGUI	MP. ARAGUA	CM. ARAGUA DE BARCELONA	UNIDAD EDUCATIVA DOMINGO GUZMÁN BASTARDO	2839	5	33	2217	1129	2184	2	21	2	0	1030	2217
EDO. ANZOATEGUI	MP. ARAGUA	CM. ARAGUA DE BARCELONA	UNIDAD EDUCATIVA NARCISO FRAGACHAN	2526	5	44	2041	1044	1997	1	12	2	0	938	2041
EDO. ANZOATEGUI	MP. ARAGUA	CM. ARAGUA DE BARCELONA	UNIDAD EDUCATIVA NUESTRA SEÑORA DEL CARMEN	2668	5	37	2335	914	2298	0	10	1	1	1372	2335
EDO. ANZOATEGUI	MP. ARAGUA	CM. ARAGUA DE BARCELONA	ESCUELA CONCENTRADA LA FUNDACION NUMERO 20 94	173	1	6	162	135	156	0	0	0	0	21	162
EDO. ANZOATEGUI	MP. ARAGUA	CM. ARAGUA DE BARCELONA	UNIDAD EDUCATIVA  DOCTOR ALIRIO ARREAZA	2582	5	23	2038	989	2015	2	13	3	0	1008	2038
EDO. ANZOATEGUI	MP. ARAGUA	CM. ARAGUA DE BARCELONA	ESCUELA NACIONAL LOS CONEJOS	151	1	5	142	107	137	0	1	0	0	29	142
EDO. ANZOATEGUI	MP. ARAGUA	CM. ARAGUA DE BARCELONA	ESCUELA MANAPOCO	287	1	8	249	207	241	0	0	0	1	33	249
EDO. ANZOATEGUI	MP. ARAGUA	CM. ARAGUA DE BARCELONA	UNIDAD EDUCATIVA DOCTOR CESAR RODRIGUEZ	453	1	8	396	236	388	0	2	0	0	150	396
EDO. ANZOATEGUI	MP. ARAGUA	PQ. CACHIPO	UNIDAD EDUCATIVA CAICO SECO	464	1	14	404	322	390	1	3	0	0	64	404
EDO. ANZOATEGUI	MP. ARAGUA	PQ. CACHIPO	ESCUELA NACIONAL CONCENTRADA NUMERO 629 630 668 2168	467	1	7	345	219	338	0	1	0	1	117	345
EDO. ANZOATEGUI	MP. MC GREGOR	PQ.TOMAS ALFARO CALATRAVA	ESCUELA UNITARIA NUCLEO EDUCACION RURAL  LAS RUYAS	595	1	4	424	367	420	1	2	2	0	48	424
EDO. ANZOATEGUI	MP. MC GREGOR	PQ.TOMAS ALFARO CALATRAVA	ESCUELA CONCENTRADA NUMERO 1836 128	1113	2	11	819	667	808	0	7	1	0	133	819
EDO. ANZOATEGUI	MP. MC GREGOR	PQ. EL CHAPARRO	ESCUELA MANUALIDADES TOMAS ALFARO CALATRAVA	1214	3	23	977	667	954	0	3	0	0	284	977
EDO. ANZOATEGUI	MP. MC GREGOR	PQ. EL CHAPARRO	ESCUELA UNITARIA ESTADAL NUMERO 129	412	1	2	308	288	306	0	2	0	0	16	308
EDO. ANZOATEGUI	MP. MC GREGOR	PQ. EL CHAPARRO	ESCUELA UNITARIA NUMERO. 2687	307	1	5	237	166	232	0	3	3	0	60	237
EDO. ANZOATEGUI	MP. MC GREGOR	PQ. EL CHAPARRO	UNIDAD EDUCATIVA AUGUSTO D'AUBETERRE	3195	6	45	2440	1585	2395	1	9	1	0	799	2440
EDO. ANZOATEGUI	MP. MC GREGOR	PQ. EL CHAPARRO	ESCUELA  NACIONAL UNITARIA NUMERO 2163	320	1	2	215	149	213	0	0	0	0	64	215
EDO. ANZOATEGUI	MP. MC GREGOR	PQ. EL CHAPARRO	LICEO ALIRIO ARREAZA ARREAZA	427	1	11	357	231	346	0	1	0	0	114	357
EDO. ANZOATEGUI	MP. PE#ALVER	CM. PUERTO PIRITU	ESCUELA BÁSICA EZEQUIEL ZAMORA	3740	7	63	3174	1809	3111	1	26	3	0	1272	3174
EDO. ANZOATEGUI	MP. PE#ALVER	CM. PUERTO PIRITU	INSTITUTO UNIVERSITARIO DE ADMINISTRACIÓN INDUSTRIAL (IUTA)	3365	6	63	2702	1117	2639	2	22	1	2	1495	2702
EDO. ANZOATEGUI	MP. PE#ALVER	CM. PUERTO PIRITU	ESCUELA BOLIVARIANA PACHAQUITO	1105	2	15	962	641	947	1	10	0	1	294	962
EDO. ANZOATEGUI	MP. PE#ALVER	CM. PUERTO PIRITU	UNIDAD EDUCATIVA NACIONAL CAYAURIMA	3876	7	88	3117	1316	3029	0	26	3	2	1682	3117
EDO. ANZOATEGUI	MP. PE#ALVER	CM. PUERTO PIRITU	UNIDAD EDUCATIVA NACIONAL BICENTENARIO 5 DE JULIO DE 1811	649	2	18	564	267	546	0	2	0	0	277	564
EDO. ANZOATEGUI	MP. PE#ALVER	CM. PUERTO PIRITU	INSTITUTO UNIVERSITARIO TECNOLOGICO JUAN PABLO PEREZ ALFONZO IUTEPAL	1830	4	24	1520	729	1496	1	13	0	0	753	1520
EDO. ANZOATEGUI	MP. PE#ALVER	CM. PUERTO PIRITU	INSTITUTO UNIVERSITARIO PRIVADO PUERTO PIRITU	2273	4	37	1925	896	1888	1	13	3	0	975	1925
EDO. ANZOATEGUI	MP. PE#ALVER	PQ. SUCRE	UNIDAD EDUCATIVA PIÓ CEBALLOS	1536	3	17	1220	653	1203	0	5	0	0	545	1220
EDO. ANZOATEGUI	MP. PE#ALVER	PQ. SUCRE	ESCUELA BOLIVARIANA AGUAS CALIENTE	393	1	7	311	229	304	0	3	0	0	72	311
EDO. ANZOATEGUI	MP. PE#ALVER	PQ. SUCRE	ESCUELA NACIONAL UNITARIA NUMERO 1290 NUEVO UNARE	143	1	9	125	73	116	0	0	0	0	43	125
EDO. ANZOATEGUI	MP. PE#ALVER	PQ. SAN MIGUEL	UNIDAD EDUCATIVA BOLIVARIANA  DIEGO ARREAZA MONAGAS	2589	5	56	2100	1190	2044	0	14	0	0	840	2100
EDO. ANZOATEGUI	MP. MIRANDA	CM. PARIAGUAN	ESCUELA NACIONAL NUMERO 78, LA PETERA	2325	4	29	1767	1073	1738	0	16	0	1	648	1767
EDO. ANZOATEGUI	MP. MIRANDA	CM. PARIAGUAN	ESCUELA RAMON POMPILIO OROPEZA	2181	4	56	1749	917	1693	1	11	3	0	761	1749
EDO. ANZOATEGUI	MP. MIRANDA	CM. PARIAGUAN	GRUPO ESCOLAR ROMUALDO GOMEZ	3084	6	66	2449	1124	2383	0	17	0	0	1242	2449
EDO. ANZOATEGUI	MP. MIRANDA	CM. PARIAGUAN	GRUPO ESCOLAR BOLET PERAZA	3957	7	58	3069	1786	3011	0	17	5	1	1202	3069
EDO. ANZOATEGUI	MP. MIRANDA	CM. PARIAGUAN	INSTITUTO EDUCACIONAL PARIAGUAN	3320	6	62	2802	1462	2740	0	27	3	3	1245	2802
EDO. ANZOATEGUI	MP. MIRANDA	CM. PARIAGUAN	ESCUELA RURAL BOLIVARIANA JOSE ANTONIO ANZOATEGUI	705	2	14	618	479	604	0	6	0	0	119	618
EDO. ANZOATEGUI	MP. MIRANDA	CM. PARIAGUAN	ESCUELA BOLIVARIANA LAS PIEDRITAS	259	1	12	230	142	218	1	2	0	1	72	230
EDO. ANZOATEGUI	MP. MIRANDA	CM. PARIAGUAN	GRUPO ESCOLAR FREITES	3601	7	73	2879	1769	2806	0	25	1	0	1011	2879
EDO. ANZOATEGUI	MP. MIRANDA	CM. PARIAGUAN	ESCUELA BASICA NACIONAL RURAL SAN MAURICIO	645	2	22	558	388	536	1	3	0	0	144	558
EDO. ANZOATEGUI	MP. MIRANDA	CM. PARIAGUAN	LICEO PINTO SALINAS	2852	5	74	2421	1230	2347	0	18	2	1	1096	2421
EDO. ANZOATEGUI	MP. MIRANDA	CM. PARIAGUAN	UNIDAD EDUCATIVA BOLIVARIANA LA SIERRA	120	1	1	105	88	104	0	0	0	0	16	105
EDO. ANZOATEGUI	MP. MIRANDA	PQ. EL PAO	GRUPO ESCOLAR CREACION EL PAO	2612	5	51	2052	1077	2001	0	11	3	0	910	2052
EDO. ANZOATEGUI	MP. MIRANDA	PQ. EL PAO	ESCUELA BOLIVARIANA INDIGENA SANTA CRUZ DE CACHIPO	225	1	3	188	171	185	0	1	0	0	13	188
EDO. ANZOATEGUI	MP. MIRANDA	PQ. ATAPIRIRE	ESCUELA CONCENTRADA ATAPIRIRE	2012	4	54	1565	706	1511	1	6	0	0	798	1565
EDO. ANZOATEGUI	MP. MIRANDA	PQ. ATAPIRIRE	ESCUELA  BOLIVARIANA MUCURA	638	2	12	440	229	428	0	2	1	0	196	440
EDO. ANZOATEGUI	MP. MIRANDA	PQ. ATAPIRIRE	ESCUELA RURAL NACIONAL AGUA CLARITA DE LIMO	293	1	12	264	171	252	0	6	0	0	75	264
EDO. ANZOATEGUI	MP. MIRANDA	PQ. ATAPIRIRE	ESCUELA BASICA SAN SIMON	208	1	2	141	80	139	0	0	0	0	59	141
EDO. ANZOATEGUI	MP. MIRANDA	PQ. ATAPIRIRE	NUCLEO ESCOLAR RURAL 321 ALTAGRACIA DEL CARI	236	1	5	213	154	208	0	3	0	0	51	213
EDO. ANZOATEGUI	MP. MIRANDA	PQ. BOCA DEL PAO	ESCUELA ESTADAL RURAL LA PIÑA	193	1	3	145	73	142	0	0	1	0	68	145
EDO. ANZOATEGUI	MP. MIRANDA	PQ. BOCA DEL PAO	ESCUELA CONCENTRADA LAS RAICES	407	1	5	262	161	257	0	0	1	0	95	262
EDO. ANZOATEGUI	MP. MIRANDA	PQ. BOCA DEL PAO	ESCUELA SEBASTIAN FRANCISCO DE MIRANDA	1601	3	18	1093	655	1075	0	1	0	0	419	1093
EDO. ANZOATEGUI	MP. BRUZUAL	PQ. GUANAPE	UNIDAD EDUCATIVA NACIONAL MANUEL EZEQUIEL BRUZUAL	478	1	7	420	212	413	0	2	1	0	198	420
EDO. ANZOATEGUI	MP. BRUZUAL	PQ. GUANAPE	ESCUELA LA CIRILERA NUCLEO ESTADAL RURAL  444	101	1	1	92	69	91	0	0	0	0	22	92
EDO. ANZOATEGUI	MP. BRUZUAL	PQ. GUANAPE	ESCUELA CREACIÓN NACIONAL	414	1	5	336	179	331	0	2	0	0	150	336
EDO. ANZOATEGUI	MP. BRUZUAL	PQ. GUANAPE	ESCUELA  MIXTA CONCENTRADA NUMERO 47 1355 2000	724	2	14	543	284	529	0	5	0	0	240	543
EDO. ANZOATEGUI	MP. BRUZUAL	PQ. GUANAPE	UNIDAD EDUCATIVA MAYARES NUMERO 2118   2184	155	1	0	144	100	144	0	0	0	0	44	144
EDO. ANZOATEGUI	MP. BRUZUAL	PQ. GUANAPE	GRUPO ESCOLAR DIEGO BAUTISTA URBANEJA	3635	7	60	2762	1406	2702	1	16	4	0	1275	2762
EDO. ANZOATEGUI	MP. BRUZUAL	PQ. SABANA DE UCHIRE	GRUPO ESCOLAR LICENCIADO URBANEJA	3130	6	55	2517	1283	2462	0	19	3	1	1156	2517
EDO. ANZOATEGUI	MP. BRUZUAL	PQ. SABANA DE UCHIRE	UNIDAD EDUCATIVA SAN ANTONIO  154 80 NUCLEO EDUCACION RURAL 504	398	1	7	291	130	284	0	1	0	0	153	291
EDO. ANZOATEGUI	MP. BRUZUAL	PQ. SABANA DE UCHIRE	ESCUELA  MIXTA CONCENTRADA SIN NUMERO	205	1	1	167	50	166	0	1	0	0	115	167
EDO. ANZOATEGUI	MP. BRUZUAL	PQ. SABANA DE UCHIRE	ESCUELA ESTADAL DE CHAVITO	428	1	5	344	164	339	0	3	1	0	171	344
EDO. ANZOATEGUI	MP. BRUZUAL	CM. CLARINES	LICEO RAFAEL PEÑALVER	1719	3	45	1440	754	1395	1	4	0	1	635	1440
EDO. ANZOATEGUI	MP. BRUZUAL	CM. CLARINES	ESCUELA ESTADAL PEDRO ANTONIO MEDINA	2054	4	48	1743	913	1695	0	10	1	0	771	1743
EDO. ANZOATEGUI	MP. BRUZUAL	CM. CLARINES	ESCUELA CONCENTRADA NUMERO 1243 288	742	2	14	607	369	593	0	0	1	0	223	607
EDO. ANZOATEGUI	MP. BRUZUAL	CM. CLARINES	GRUPO ESCOLAR MONSEÑOR ARTURO CELESTINO ÁLVAREZ	1790	4	24	1354	512	1330	3	2	0	0	813	1354
EDO. ANZOATEGUI	MP. BRUZUAL	CM. CLARINES	ESCUELA BOLIVARIANA CARUTICO	526	1	9	475	238	466	0	2	0	0	226	475
EDO. ANZOATEGUI	MP. BRUZUAL	CM. CLARINES	UNIDAD  EDUCATIVA NACIONAL DOCTOR JOSÉ DOMÍNGUEZ	3654	7	76	3098	1390	3022	0	11	1	1	1619	3098
EDO. ANZOATEGUI	MP. BRUZUAL	CM. CLARINES	JARDÍN DE INFANCIA MONSEÑOR ARTURO CELESTINO ÁLVAREZ	1215	3	23	1074	439	1051	0	6	0	0	606	1074
EDO. ANZOATEGUI	MP. BRUZUAL	CM. CLARINES	ESCUELA MIXTA NUMERO 1768 44	352	1	4	260	157	256	0	1	0	0	98	260
EDO. ANZOATEGUI	MP.S JUAN CAPISTRANO	PQ. BOCA DE CHAVEZ	ESCUELA CONCENTRADA NUMERO 2069	833	2	22	668	346	646	0	4	0	0	296	668
EDO. ANZOATEGUI	MP.S JUAN CAPISTRANO	PQ. BOCA UCHIRE	ESCUELA BÁSICA TOMAS IGNACIO POTENTINI	2949	6	52	2308	1290	2256	2	13	2	1	948	2308
EDO. ANZOATEGUI	MP.S JUAN CAPISTRANO	PQ. BOCA UCHIRE	UNIDAD EDUCATIVA NACIONAL AUGUSTO D`AUBTERRE	3092	6	56	2487	1328	2431	1	17	1	0	1084	2487
EDO. ANZOATEGUI	MP. SIMON RODRIGUEZ	CM. EL TIGRE	UNIDAD EDUCATIVA SANTELIZ PEÑA	3415	6	46	2836	1242	2790	1	21	0	0	1526	2836
EDO. ANZOATEGUI	MP. SIMON RODRIGUEZ	CM. EL TIGRE	LICEO BRICEÑO MÉNDEZ	2640	5	69	2176	1052	2107	2	12	0	1	1040	2176
EDO. ANZOATEGUI	MP. SIMON RODRIGUEZ	CM. EL TIGRE	ESCUELA UNITARIA NUMERO 197	417	1	6	258	177	252	1	3	0	1	70	258
EDO. ANZOATEGUI	MP. SIMON RODRIGUEZ	CM. EL TIGRE	ESCUELA BÁSICA  ESTADAL MENCA DE LEONI	2710	5	44	2353	1023	2309	0	25	1	2	1258	2353
EDO. ANZOATEGUI	MP. SIMON RODRIGUEZ	CM. EL TIGRE	ESCUELA ESTADAL UNITARIA NUMERO 104	564	1	6	418	314	412	0	2	0	0	96	418
EDO. ANZOATEGUI	MP. SIMON RODRIGUEZ	CM. EL TIGRE	UNIDAD EDUCATIVA HERNANDEZ PARES	4885	9	102	3765	1970	3663	3	24	1	3	1662	3765
EDO. ANZOATEGUI	MP. SIMON RODRIGUEZ	CM. EL TIGRE	ESCUELA NACIONAL JOSE ANTONIO ANZOATEGUI	3098	6	61	2467	1150	2406	2	17	1	1	1235	2467
EDO. ANZOATEGUI	MP. SIMON RODRIGUEZ	CM. EL TIGRE	UNIDAD EDUCATIVA MANUEL CARLOS PIAR	1763	3	23	1390	465	1367	1	6	1	0	894	1390
EDO. ANZOATEGUI	MP. SIMON RODRIGUEZ	CM. EL TIGRE	UNIDAD EDUCATIVA VALLE DE GUANIPA	1526	3	24	1307	688	1283	0	4	1	0	590	1307
EDO. ANZOATEGUI	MP. SIMON RODRIGUEZ	CM. EL TIGRE	ESCUELA DE MANUALIDADES MARIA ANTONIA BOLÍVAR	1625	3	25	1191	452	1166	0	6	1	0	707	1191
EDO. ANZOATEGUI	MP. SIMON RODRIGUEZ	CM. EL TIGRE	UNIDAD EDUCATIVA LA BOMBA NUMERO 1	274	1	5	234	159	229	0	1	1	0	68	234
EDO. ANZOATEGUI	MP. SIMON RODRIGUEZ	CM. EL TIGRE	INSTITUTO DE EDUCACION ESPECIAL EL TIGRE	778	2	9	616	284	607	0	2	0	0	321	616
EDO. ANZOATEGUI	MP. SIMON RODRIGUEZ	CM. EL TIGRE	JARDIN DE INFANCIA PUEBLO AJURO	1138	2	23	909	511	886	0	9	1	0	365	909
EDO. ANZOATEGUI	MP. SIMON RODRIGUEZ	CM. EL TIGRE	INSTITUTO ALBERTO CARNEVALLI	3309	6	85	2581	1041	2496	0	26	1	0	1428	2581
EDO. ANZOATEGUI	MP. SIMON RODRIGUEZ	CM. EL TIGRE	COLEGIO KALIL GIBRAN	3669	7	37	3224	917	3187	0	10	0	3	2257	3224
EDO. ANZOATEGUI	MP. SIMON RODRIGUEZ	CM. EL TIGRE	SOCIEDAD DE AMIGOS CENTRO DE RECUPERACIÓN Y EDUCATIVO	1743	3	22	1460	714	1438	0	4	0	0	720	1460
EDO. ANZOATEGUI	MP. SIMON RODRIGUEZ	CM. EL TIGRE	LICEO JOSE CELESTINO HURTADO	1693	3	38	1383	859	1345	1	9	0	0	476	1383
EDO. ANZOATEGUI	MP. SIMON RODRIGUEZ	CM. EL TIGRE	JARDÍN DE INFANCIA  ROSALÍA DE HERRERA	1498	3	32	1200	751	1168	0	9	1	0	407	1200
EDO. ANZOATEGUI	MP. SIMON RODRIGUEZ	CM. EL TIGRE	CICLO BASICO JUAN PABLO ROJAS PAUL	4222	8	72	3422	1618	3350	0	28	1	0	1703	3422
EDO. ANZOATEGUI	MP. SIMON RODRIGUEZ	CM. EL TIGRE	ESCUELA RURAL LA AVENTAZON	324	1	10	294	207	284	0	4	0	0	73	294
EDO. ANZOATEGUI	MP. SIMON RODRIGUEZ	CM. EL TIGRE	COLEGIO DIVINO MAESTRO	3719	7	39	2909	1132	2870	0	17	1	1	1719	2909
EDO. ANZOATEGUI	MP. SIMON RODRIGUEZ	CM. EL TIGRE	CENTRO DE ATENCION COMUNITARIO ANDRES BELLO	831	2	13	681	343	668	0	3	0	0	322	681
EDO. ANZOATEGUI	MP. SIMON RODRIGUEZ	CM. EL TIGRE	TALLER LIBRE DE ARTE EL TIGRE	497	1	14	455	166	441	0	3	0	1	271	455
EDO. ANZOATEGUI	MP. SIMON RODRIGUEZ	CM. EL TIGRE	GRUPO ESCOLAR DIEGO BAUTISTA URBANEJA	2500	5	45	2064	845	2019	0	19	0	0	1155	2064
EDO. ANZOATEGUI	MP. SIMON RODRIGUEZ	CM. EL TIGRE	ESCUELA NACIONAL FELIPE WALKER	3924	7	68	3114	1779	3046	1	34	3	2	1227	3114
EDO. ANZOATEGUI	MP. SIMON RODRIGUEZ	CM. EL TIGRE	PARQUE ANDRES BELLO	1519	3	24	1248	549	1224	2	6	1	0	666	1248
EDO. ANZOATEGUI	MP. SIMON RODRIGUEZ	CM. EL TIGRE	LICEO JOSE RAFAEL REVENGA	3791	7	67	3250	1086	3183	1	13	2	0	2081	3250
EDO. ANZOATEGUI	MP. SIMON RODRIGUEZ	CM. EL TIGRE	ESCUELA NACIONAL LA FLORIDA	4211	8	102	3252	2015	3150	1	23	0	0	1111	3252
EDO. ANZOATEGUI	MP. SIMON RODRIGUEZ	CM. EL TIGRE	ESCUELA MENEVEN	1535	3	41	1306	578	1265	0	8	2	0	677	1306
EDO. ANZOATEGUI	MP. SIMON RODRIGUEZ	CM. EL TIGRE	ANCIANATO LA MONTONERA	1366	3	24	1061	726	1037	0	6	0	1	304	1061
EDO. ANZOATEGUI	MP. SIMON RODRIGUEZ	CM. EL TIGRE	GRUPO ESCOLAR SIMON RODRIGUEZ	3614	7	38	2924	1040	2886	1	13	1	0	1831	2924
EDO. ANZOATEGUI	MP. SIMON RODRIGUEZ	CM. EL TIGRE	ESCUELA DE MANUALIDADES FEMENINAS DOÑA EVA DE LISCANO	1629	3	28	1277	727	1249	1	12	4	0	505	1277
EDO. ANZOATEGUI	MP. SIMON RODRIGUEZ	CM. EL TIGRE	GRUPO ESCOLAR ESTADO TRUJILLO	3138	6	49	2420	1142	2371	1	22	2	1	1203	2420
EDO. ANZOATEGUI	MP. SIMON RODRIGUEZ	CM. EL TIGRE	ESCUELA BOLIVARIANA LA ALFARERIA	237	1	6	218	169	212	0	2	0	0	41	218
EDO. ANZOATEGUI	MP. SIMON RODRIGUEZ	CM. EL TIGRE	COLEGIO SAN ANTONIO	3804	7	36	3121	938	3085	0	14	2	1	2130	3121
EDO. ANZOATEGUI	MP. SIMON RODRIGUEZ	CM. EL TIGRE	ESCUELA BÁSICA RURAL LA ESPERANZA	3013	6	65	2382	1184	2317	1	16	0	0	1116	2382
EDO. ANZOATEGUI	MP. SIMON RODRIGUEZ	CM. EL TIGRE	UNIDAD EDUCATIVA FERMIN TORO	810	2	17	718	291	701	0	4	0	0	406	718
EDO. ANZOATEGUI	MP. SIMON RODRIGUEZ	CM. EL TIGRE	GRUPO ESCOLAR DOCTOR RAFAEL  FERNÁNDEZ PADILLA	2943	6	51	2402	1103	2351	0	18	0	2	1228	2402
EDO. ANZOATEGUI	MP. SIMON RODRIGUEZ	CM. EL TIGRE	ESCUELA BASICA 12 DE MARZO	2057	4	38	1752	957	1714	0	18	1	2	736	1752
EDO. ANZOATEGUI	MP. SIMON RODRIGUEZ	CM. EL TIGRE	JARDIN DE INFANCIA LA CHARNECA	1953	4	37	1534	749	1497	0	15	0	0	733	1534
EDO. ANZOATEGUI	MP. SIMON RODRIGUEZ	CM. EL TIGRE	UNIDAD EDUCATIVA MIGUEL OTERO SILVA	1806	4	43	1581	864	1538	1	11	1	0	661	1581
EDO. ANZOATEGUI	MP. SIMON RODRIGUEZ	CM. EL TIGRE	UNIDAD EDUCATIVA NUESTRA SEÑORA DEL PILAR	650	2	17	602	221	585	0	3	1	0	360	602
EDO. ANZOATEGUI	MP. SIMON RODRIGUEZ	CM. EL TIGRE	ESTADIO DE BEISBOL ALEJANDRO CARRASQUEL	1780	4	27	1479	604	1452	1	11	0	1	835	1479
EDO. ANZOATEGUI	MP. SIMON RODRIGUEZ	CM. EL TIGRE	ESCUELA BRISAS DEL CARIS	655	2	15	557	428	542	0	5	0	0	109	557
EDO. ANZOATEGUI	MP. SIMON RODRIGUEZ	CM. EL TIGRE	UNIDAD EDUCATIVA MANUEL ANTONIO CARREÑO	1396	3	11	997	424	986	1	3	0	1	557	997
EDO. ANZOATEGUI	MP. SIMON RODRIGUEZ	CM. EL TIGRE	PARQUE LA CHARNECA	1695	3	22	1328	638	1306	0	10	2	0	656	1328
EDO. ANZOATEGUI	MP. SIMON RODRIGUEZ	CM. EL TIGRE	GRUPO ESCOLAR RIGOBERTO PARACO	3438	6	47	2967	916	2920	0	13	0	1	1990	2967
EDO. ANZOATEGUI	MP. SIMON RODRIGUEZ	CM. EL TIGRE	COLEGIO DOCTOR JOSE MARIA VARGAS	1948	4	37	1749	1047	1712	0	14	0	0	651	1749
EDO. ANZOATEGUI	MP. SIMON RODRIGUEZ	CM. EL TIGRE	UNIDAD EDUCATIVA PRIVADA LUISA CACERES DE ARISMENDI	1203	3	29	1090	365	1061	0	5	0	1	690	1090
EDO. ANZOATEGUI	MP. SIMON RODRIGUEZ	CM. EL TIGRE	UNIDAD EDUCATIVA LOS CHAGUARAMOS	2864	5	51	2442	1529	2391	1	24	0	3	834	2442
EDO. ANZOATEGUI	MP. SIMON RODRIGUEZ	CM. EL TIGRE	GRUPO ESCUELA RAÚL LEONI	3213	6	44	2768	1020	2724	0	14	0	0	1690	2768
EDO. ANZOATEGUI	MP. SIMON RODRIGUEZ	CM. EL TIGRE	CENTRO PREESCOLAR ANDRES BELLO	908	2	11	772	330	761	0	8	0	0	423	772
EDO. ANZOATEGUI	MP. SIMON RODRIGUEZ	CM. EL TIGRE	ACADEMIA VIRGEN DEL VALLE	1740	3	38	1421	549	1383	0	6	0	0	828	1421
EDO. ANZOATEGUI	MP. SIMON RODRIGUEZ	CM. EL TIGRE	UNIVERSIDAD NACIONAL ABIERTA	1836	4	40	1403	588	1363	1	4	1	0	769	1403
EDO. ANZOATEGUI	MP. LIBERTAD	CM. SAN MATEO	UNIDAD EDUCATIVA FÉLIX ARMANDO NÚÑEZ	3065	6	56	2420	1364	2364	0	16	2	0	982	2420
EDO. ANZOATEGUI	MP. LIBERTAD	CM. SAN MATEO	ESCUELA BÁSICA BALTASAR VALLENILLA	2328	4	25	1720	919	1695	0	8	0	0	768	1720
EDO. ANZOATEGUI	MP. LIBERTAD	CM. SAN MATEO	ESCUELA ESTADAL NACIONAL JOSE FELIX RIBAS	1530	3	21	1187	661	1166	0	16	0	0	489	1187
EDO. ANZOATEGUI	MP. LIBERTAD	CM. SAN MATEO	UNIDAD BASICA POTRERITO	494	1	7	428	341	421	0	1	0	0	79	428
EDO. ANZOATEGUI	MP. LIBERTAD	CM. SAN MATEO	ESCUELA CONCENTRADA MIXTA NUMERO 69 212 1203	807	2	12	605	340	593	0	2	1	0	250	605
EDO. ANZOATEGUI	MP. LIBERTAD	PQ. EL CARITO	ESCUELA  ESTADAL JOSÉ GREGORIO MONAGAS	1598	3	17	1193	614	1176	0	7	0	0	555	1193
EDO. ANZOATEGUI	MP. LIBERTAD	PQ. SANTA INES	ESCUELA MIXTA ESTADAL NUMERO. 72
EDO. ANZOATEGUI	MP. LIBERTAD	PQ. SANTA INES	ESCUELA BÁSICA MANUEL BUCK	2057	4	19	1525	921	1506	0	7	1	0	577	1525
EDO. ANZOATEGUI	MP. CAJIGAL	PQ. SAN PABLO	ESCUELAN NACIONAL  CONCENTRADA SAN LORENZO	200	1	2	168	129	166	0	0	1	1	35	168
EDO. ANZOATEGUI	MP. CAJIGAL	PQ. SAN PABLO	ESCUELA  ESTADAL CONCENTRADA NUMERO 144 55	374	1	3	323	270	320	0	0	0	0	50	323
EDO. ANZOATEGUI	MP. CAJIGAL	PQ. SAN PABLO	GRUPO ESCOLAR SAN PABLO	1520	3	23	1236	789	1213	0	2	1	0	421	1236
EDO. ANZOATEGUI	MP. CAJIGAL	CM. ONOTO	CENTRO DE CAPACITACION ARGUINDEGUIZ DE ANZOATEGUI	830	2	16	730	490	714	1	9	1	1	212	730
EDO. ANZOATEGUI	MP. CAJIGAL	CM. ONOTO	LICEO BOLIVARIANO TOMAS IGNACIO POTENTINI	519	1	9	451	311	442	0	5	0	0	126	451
EDO. ANZOATEGUI	MP. CAJIGAL	CM. ONOTO	GRUPO ESCOLAR JOSE DESIDERIO TRIAS II	1098	2	28	976	569	948	0	8	0	0	371	976
EDO. ANZOATEGUI	MP. CAJIGAL	CM. ONOTO	UNIDAD EDUCATIVA LAS VEGUITAS	346	1	6	259	181	253	0	3	1	0	68	259
EDO. ANZOATEGUI	MP. CAJIGAL	CM. ONOTO	UNIDAD EDUCATIVA NACIONAL EL COROZO	123	1	1	112	100	111	1	3	0	0	7	112
EDO. ANZOATEGUI	MP. CAJIGAL	CM. ONOTO	ESCUELA BASICA JOSE DESIDERIO TRIAS	2108	4	38	1522	745	1484	1	6	1	0	731	1522
EDO. ANZOATEGUI	MP. CAJIGAL	CM. ONOTO	ESCUELA BASICA LAS FLORES UNITARIA NUMERO  44 1768	312	1	1	211	132	210	0	4	0	0	74	211
EDO. ANZOATEGUI	MP. CAJIGAL	CM. ONOTO	UNIDAD EDUCATIVA BOLIVARIANA GUARIBE TENEPE NUMERO 1195 269 140 NUCLEO ESCOLAR RURAL 444	589	1	3	426	224	423	0	1	0	0	198	426
EDO. ANZOATEGUI	MP. CAJIGAL	CM. ONOTO	UNIDAD EDUCATIVA   GRANADILLO	580	1	0	440	361	440	0	2	0	0	77	440
EDO. ANZOATEGUI	MP. CAJIGAL	CM. ONOTO	UNIDAD EDUCATIVA LAS TRINCHERAS  NUMERO 1255 2036 159 2099 SIN NUMERO	586	1	16	387	250	371	0	3	0	0	118	387
EDO. ANZOATEGUI	MP. CAJIGAL	CM. ONOTO	ESCUELA BASICA EL CARIBE  UNITARIA NUMERO 2045	192	1	6	117	76	111	0	1	0	0	34	117
EDO. ANZOATEGUI	MP. CAJIGAL	CM. ONOTO	ESCUELA BOLIVARIANA LA ENCANTADA  NUMERO 55 1310	441	1	4	352	191	348	0	6	0	0	151	352
EDO. ANZOATEGUI	MP. SOTILLO	CM. PUERTO LA CRUZ	UNIDAD EDUCATIVA JOSEFA MATILDE SALAZAR	772	2	10	687	413	677	0	3	0	0	261	687
EDO. ANZOATEGUI	MP. SOTILLO	CM. PUERTO LA CRUZ	GRUPO ESCOLAR RAFAEL MARCANO RODRIGUEZ	4085	7	69	3369	1445	3300	2	21	2	4	1826	3369
EDO. ANZOATEGUI	MP. SOTILLO	CM. PUERTO LA CRUZ	COLEGIO SALESIANO PIO XII	4345	8	41	3314	901	3273	1	18	3	3	2347	3314
EDO. ANZOATEGUI	MP. SOTILLO	CM. PUERTO LA CRUZ	PRE ESCOLAR JOSE LUIS ARREAZA	1119	2	11	914	436	903	2	8	1	0	456	914
EDO. ANZOATEGUI	MP. SOTILLO	CM. PUERTO LA CRUZ	INSTITUTO ANGELO DE MARTA	1555	3	10	1305	297	1295	0	3	1	0	994	1305
EDO. ANZOATEGUI	MP. SOTILLO	CM. PUERTO LA CRUZ	GRUPO ESCOLAR RAFAEL MARCANO RODRIGUEZ II	685	2	10	584	261	574	0	4	2	0	307	584
EDO. ANZOATEGUI	MP. SOTILLO	CM. PUERTO LA CRUZ	LICEO TOMAS ALFARO CALATRAVA	3399	6	43	2666	1179	2623	0	13	2	1	1428	2666
EDO. ANZOATEGUI	MP. SOTILLO	CM. PUERTO LA CRUZ	ESCUELA NUESTRA SEÑORA DE LOURDES	2912	5	32	2426	569	2394	2	5	0	0	1818	2426
EDO. ANZOATEGUI	MP. SOTILLO	CM. PUERTO LA CRUZ	GRUPO ESCOLAR GUARAGUAOS	3740	7	43	3144	1186	3101	0	7	2	2	1904	3144
EDO. ANZOATEGUI	MP. SOTILLO	CM. PUERTO LA CRUZ	GRUPO ESCOLAR RODOLFO MAURERA	3157	6	59	2337	1229	2278	0	11	2	0	1036	2337
EDO. ANZOATEGUI	MP. SOTILLO	CM. PUERTO LA CRUZ	UNIDAD EDUCATIVA PLACIDO MANEIRO	1530	3	25	1161	501	1136	0	8	1	1	625	1161
EDO. ANZOATEGUI	MP. SOTILLO	CM. PUERTO LA CRUZ	GRUPO ESCOLAR CREACION PARAISO	3954	7	58	3108	1507	3050	3	17	0	2	1521	3108
EDO. ANZOATEGUI	MP. SOTILLO	CM. PUERTO LA CRUZ	CENTRO JUVENIL DON BOSCO	2208	4	21	1658	437	1637	0	7	1	0	1192	1658
EDO. ANZOATEGUI	MP. SOTILLO	CM. PUERTO LA CRUZ	LICEO ALIRIO ARREAZA ARREAZA	2268	4	40	1903	814	1863	0	8	0	0	1041	1903
EDO. ANZOATEGUI	MP. SOTILLO	CM. PUERTO LA CRUZ	PREESCOLAR EL PARAÍSO I	2387	5	33	1871	882	1838	1	6	1	1	947	1871
EDO. ANZOATEGUI	MP. SOTILLO	CM. PUERTO LA CRUZ	GRUPO ESCOLAR BELLO MONTE	2750	5	40	2192	1392	2152	1	17	1	1	740	2192
EDO. ANZOATEGUI	MP. SOTILLO	CM. PUERTO LA CRUZ	INSTITUTO UNIVERSITARIO ANTONIO JOSE DE SUCRE	1493	3	21	1164	513	1143	1	6	1	0	622	1164
EDO. ANZOATEGUI	MP. SOTILLO	CM. PUERTO LA CRUZ	ESCUELA BASICA ESTADAL MANUEL MORENO HERNANDEZ	3283	6	57	2567	1567	2510	1	18	0	0	924	2567
EDO. ANZOATEGUI	MP. SOTILLO	CM. PUERTO LA CRUZ	CENTRO DE EDUCACION INICIAL LUIGGI EMILIO CECCATO	642	2	18	587	271	569	0	5	1	0	292	587
EDO. ANZOATEGUI	MP. SOTILLO	CM. PUERTO LA CRUZ	CONJUNTO RESIDENCIAL DORAL BEACH VILLAS	612	2	5	550	144	545	0	3	0	0	398	550
EDO. ANZOATEGUI	MP. SOTILLO	CM. PUERTO LA CRUZ	GRUPO ESCOLAR DOMINGO SABIO	1484	3	15	1152	354	1137	0	10	0	0	773	1152
EDO. ANZOATEGUI	MP. SOTILLO	CM. PUERTO LA CRUZ	ESCUELA BOLIVARIANA DOCTOR SEVERIANO HERNANDEZ	3928	7	51	3240	1401	3189	1	14	0	3	1770	3240
EDO. ANZOATEGUI	MP. SOTILLO	CM. PUERTO LA CRUZ	ESCUELA GRADUADA MARIA GUZMÁN DE MARCANO	3471	7	44	2800	1348	2756	4	18	2	2	1382	2800
EDO. ANZOATEGUI	MP. SOTILLO	CM. PUERTO LA CRUZ	UNIDAD EDUCATIVA INTEGRAL COLEGIO LAURA VICUÑA	667	2	12	602	240	590	0	0	2	2	346	602
EDO. ANZOATEGUI	MP. SOTILLO	PQ. POZUELOS	CENTRO DE EDUCACION INICIAL SIMONCITO  LA FUNDACION	1923	4	15	1708	518	1693	0	7	1	1	1166	1708
EDO. ANZOATEGUI	MP. SOTILLO	PQ. POZUELOS	ESCUELA BOLIVARIANA PUTUCUAL	919	2	11	791	543	780	1	3	0	0	233	791
EDO. ANZOATEGUI	MP. SOTILLO	PQ. POZUELOS	HOGAR DE CUIDADOS DIARIOS	1088	2	9	836	451	827	0	5	0	0	371	836
EDO. ANZOATEGUI	MP. SOTILLO	PQ. POZUELOS	GUARDERIA MULTIHOGAR LA PEDRERA	1327	3	25	1071	659	1046	0	5	0	0	382	1071
EDO. ANZOATEGUI	MP. SOTILLO	PQ. POZUELOS	ESCUELA BASICA VALLE DE LAS CARMELITAS	336	1	9	288	216	279	1	0	0	0	62	288
EDO. ANZOATEGUI	MP. SOTILLO	PQ. POZUELOS	PRE ESCOLAR LUIS BELTRAN PRIETO FIGUEROA	401	1	7	356	258	349	0	2	0	0	89	356
EDO. ANZOATEGUI	MP. SOTILLO	PQ. POZUELOS	CENTRO DE EDUCACION INICIAL MARIA ZABALA	416	1	3	366	257	363	0	1	0	0	105	366
EDO. ANZOATEGUI	MP. SOTILLO	PQ. POZUELOS	UNIDAD EDUCATIVA DOCTOR RAUL LEONI	588	1	8	526	271	518	0	2	0	1	244	526
EDO. ANZOATEGUI	MP. SOTILLO	PQ. POZUELOS	ESCUELA CONCENTRADA MIXTA NUMERO 113	348	1	10	245	165	235	0	4	0	1	65	245
EDO. ANZOATEGUI	MP. SOTILLO	PQ. POZUELOS	ESCUELA GRADUADA RAFAEL FERNÁNDEZ PADILLA	3139	6	82	2485	1483	2403	1	24	2	1	892	2485
EDO. ANZOATEGUI	MP. SOTILLO	PQ. POZUELOS	CICLO BASICO FRANCISCO SALIAS	1716	3	17	1483	586	1466	0	4	2	2	872	1483
EDO. ANZOATEGUI	MP. SOTILLO	PQ. POZUELOS	NUCLEO DE ATENCION FAMILIAR	907	2	11	709	297	698	0	6	0	1	394	709
EDO. ANZOATEGUI	MP. SOTILLO	PQ. POZUELOS	GRUPO ESCOLAR ANIBAL DOMINICCI	2984	6	40	2403	1026	2363	0	7	0	2	1328	2403
EDO. ANZOATEGUI	MP. SOTILLO	PQ. POZUELOS	ESCUELA UNITARIA NUMERO 283	312	1	4	155	119	151	0	3	0	0	29	155
EDO. ANZOATEGUI	MP. SOTILLO	PQ. POZUELOS	GRUPO ESCOLAR INES MARIA DE POTENTINI	5617	10	104	4466	2082	4362	3	34	3	0	2240	4466
EDO. ANZOATEGUI	MP. SOTILLO	PQ. POZUELOS	LICEO CRISTOBAL COLON	4355	8	70	3547	1756	3477	2	17	0	2	1700	3547
EDO. ANZOATEGUI	MP. SOTILLO	PQ. POZUELOS	ESCUELA CONCENTRADA AGUAS CALIENTES	501	1	13	429	299	416	0	4	1	0	112	429
EDO. ANZOATEGUI	MP. SOTILLO	PQ. POZUELOS	ESCUELA FE Y ALEGRIA	2307	4	39	1871	864	1832	1	7	1	2	957	1871
EDO. ANZOATEGUI	MP. SOTILLO	PQ. POZUELOS	CENTRO DE EDUCACION INICIAL PROFESOR NARCISO RODRIGUEZ	509	1	10	454	303	444	0	5	0	0	136	454
EDO. ANZOATEGUI	MP. SOTILLO	PQ. POZUELOS	ESCUELA NACIONAL CAMPO ALEGRE	1223	3	21	1027	637	1006	0	6	0	1	362	1027
EDO. ANZOATEGUI	MP. SOTILLO	PQ. POZUELOS	CENTRO DE CAPACITACIÓN DE ADULTO OLIMPIA COVA DE NÚÑEZ	1325	3	16	984	593	968	1	4	1	0	369	984
EDO. ANZOATEGUI	MP. SOTILLO	PQ. POZUELOS	CENTRO DE EDUCACION INICIAL VALLE VERDE	237	1	2	187	128	185	1	0	0	0	56	187
EDO. ANZOATEGUI	MP. SOTILLO	PQ. POZUELOS	CENTRO DE EDUCACION INICIAL NACIONAL JOSEFA JOAQUINA SANCHEZ	1145	2	24	922	504	898	0	6	1	0	387	922
EDO. ANZOATEGUI	MP. SOTILLO	PQ. POZUELOS	GRUPO ESCOLAR DOMINGO GUZMAN LANDER	2771	5	38	2274	1083	2236	0	11	3	3	1136	2274
EDO. ANZOATEGUI	MP. SOTILLO	PQ. POZUELOS	PRE ESCOLAR DOCTOR GUZMAN LANDER	1338	3	15	1081	574	1066	3	4	1	1	483	1081
EDO. ANZOATEGUI	MP. SOTILLO	PQ. POZUELOS	ESCUELA  CONCENTRADA NUMERO 273	280	1	1	186	146	185	0	2	0	0	37	186
EDO. ANZOATEGUI	MP. SOTILLO	PQ. POZUELOS	ESCUELA BOLIVARIANA DOCTOR JULIAN TEMISTOCLES MAZA	1188	3	20	1029	424	1009	0	4	0	1	580	1029
EDO. ANZOATEGUI	MP. SOTILLO	PQ. POZUELOS	ESCUELA BÁSICA VISTA AL MAR	1206	3	20	1016	635	996	1	5	1	1	353	1016
EDO. ANZOATEGUI	MP. SOTILLO	PQ. POZUELOS	UNIDAD EDUCATIVA CARLOS SOUBLETTE	401	1	6	354	161	348	0	2	0	1	184	354
EDO. ANZOATEGUI	MP. SOTILLO	PQ. POZUELOS	COLEGIO SANTA TERESITA	2610	5	24	2227	761	2203	0	6	1	2	1433	2227
EDO. ANZOATEGUI	MP. SOTILLO	PQ. POZUELOS	GRUPO ESCOLAR CACIQUE PAISANA	2800	5	40	2174	1160	2134	1	12	2	1	958	2174
EDO. ANZOATEGUI	MP. SOTILLO	PQ. POZUELOS	LICEO PEDRO MARIA FREITES	1108	2	11	855	311	844	0	6	0	0	527	855
EDO. ANZOATEGUI	MP. SOTILLO	PQ. POZUELOS	ESCUELA TÉCNICA INDUSTRIAL ROBINSONIANA EUGENIO MENDOZA	1983	4	31	1621	888	1590	0	6	2	1	693	1621
EDO. ANZOATEGUI	MP. SOTILLO	PQ. POZUELOS	ESCUELA VALLE LINDO	4349	8	82	3393	2010	3311	1	19	4	0	1277	3393
EDO. ANZOATEGUI	MP. SOTILLO	PQ. POZUELOS	GRUPO ESCOLAR ANDRES ELOY BLANCO	3088	6	20	2569	984	2549	0	17	1	1	1546	2569
EDO. ANZOATEGUI	MP. SOTILLO	PQ. POZUELOS	ESCUELA OFICIAL COMBINADA NUCLEO ESCOLAR RURAL 039	659	2	10	573	417	563	2	3	0	1	140	573
EDO. ANZOATEGUI	MP. SOTILLO	PQ. POZUELOS	ESCUELA  BÁSICA CREACIÓN SAN DIEGO	3554	7	68	2721	1753	2653	2	28	1	1	868	2721
EDO. ANZOATEGUI	MP. SOTILLO	PQ. POZUELOS	ESCUELA BOLIVARIANA SABANA LARGA	277	1	1	241	133	240	0	2	1	1	103	241
EDO. ANZOATEGUI	MP. SOTILLO	PQ. POZUELOS	INSTITUTO NACIONAL DE COOPERACIÓN EDUCATIVA	2042	4	44	1578	731	1534	2	7	1	0	793	1578
EDO. ANZOATEGUI	MP. SOTILLO	PQ. POZUELOS	ESCUELA EZEQUIEL ZAMORA	1528	3	37	1252	827	1215	2	10	2	0	374	1252
EDO. ANZOATEGUI	MP. SOTILLO	PQ. POZUELOS	UNIDAD EDUCATIVA NUESTRA SEÑORA DEL VALLE	1066	2	13	797	421	784	0	2	0	1	360	797
EDO. ANZOATEGUI	MP. SOTILLO	PQ. POZUELOS	UNIDAD EDUCATIVA GENERALÍSIMO FRANCISCO DE MIRANDA	2550	5	45	2013	1185	1968	1	7	2	1	772	2013
EDO. ANZOATEGUI	MP. SOTILLO	PQ. POZUELOS	COMPLEJO EDUCATIVO JOSE ANGEL MONTERO II	219	1	3	191	85	188	0	2	0	0	101	191
EDO. ANZOATEGUI	MP. SOTILLO	PQ. POZUELOS	ESCUELA COMBINADA MIXTA BOQUERÓN	645	2	12	485	265	473	0	6	0	1	201	485
EDO. ANZOATEGUI	MP. SOTILLO	PQ. POZUELOS	ESCUELA VALLE VERDE	2631	5	48	2066	1369	2018	0	21	1	1	626	2066
EDO. ANZOATEGUI	MP. SOTILLO	PQ. POZUELOS	CENTRO DE EDUCACION INICIAL DOCTOR PASTOR OROPEZA UNIDAD II	309	1	3	274	168	271	0	1	0	0	102	274
EDO. ANZOATEGUI	MP. SOTILLO	PQ. POZUELOS	ESCUELA BASICA DOCTOR ARMANDO ARMAS MOGNA	423	1	8	359	235	351	0	1	0	0	115	359
EDO. ANZOATEGUI	MP. SOTILLO	PQ. POZUELOS	GRUPO ESCOLAR TEODORO QUIJADA WETTER	4080	8	74	3212	1912	3138	1	23	3	2	1197	3212
EDO. ANZOATEGUI	MP. SOTILLO	PQ. POZUELOS	ESCUELA BASICA LA FLORESTA	878	2	13	728	576	715	0	5	0	0	134	728
EDO. ANZOATEGUI	MP. SOTILLO	PQ. POZUELOS	ESCUELA CONCENTRADA MIXTA NUMERO 2128	256	1	7	184	91	177	0	7	0	0	79	184
EDO. ANZOATEGUI	MP. SOTILLO	PQ. POZUELOS	ESCUELA  BÁSICA BARRIO SUCRE	3594	7	53	2892	1893	2839	0	22	0	2	922	2892
EDO. ANZOATEGUI	MP. SOTILLO	PQ. POZUELOS	ESCUELA NACIONAL CREACION LAS CHARAS	4735	9	112	3736	2033	3624	3	21	2	2	1563	3736
EDO. ANZOATEGUI	MP. SOTILLO	PQ. POZUELOS	UNIDAD EDUCATIVA MIGUEL OTERO SILVA	2473	5	32	2085	971	2053	2	12	2	1	1065	2085
EDO. ANZOATEGUI	MP. SOTILLO	PQ. POZUELOS	GRUPO ESCOLAR ANTONIO JOSE SOTILLO	3474	6	32	2749	1320	2717	3	15	0	1	1378	2749
EDO. ANZOATEGUI	MP. SOTILLO	PQ. POZUELOS	ESCUELA BOLIVARIANA LUIS BELTRAN MARTINEZ	484	1	2	405	164	403	0	1	0	1	237	405
EDO. ANZOATEGUI	MP. SOTILLO	PQ. POZUELOS	GRUPO  ESCOLAR CELESTINO GONZÁLEZ ORTIZ	3223	6	57	2721	1037	2664	0	14	1	1	1611	2721
EDO. ANZOATEGUI	MP. SOTILLO	PQ. POZUELOS	UNIDAD EDUCATIVA  BATALLA DE LA VICTORIA	1367	3	24	1038	559	1014	0	5	0	0	450	1038
EDO. ANZOATEGUI	MP. SOTILLO	PQ. POZUELOS	CICLO BÁSICO PUERTO LA CRUZ	2500	5	31	2042	908	2011	0	15	0	1	1087	2042
EDO. ANZOATEGUI	MP. SOTILLO	PQ. POZUELOS	ESCUELA RURAL DE EDUCACION BASICA EL RESFRAN	840	2	21	733	550	712	0	7	0	0	155	733
EDO. ANZOATEGUI	MP. SOTILLO	PQ. POZUELOS	GRUPO ESCOLAR CUEVA DE GUANIRE	2755	5	37	2190	1303	2153	0	10	1	0	839	2190
EDO. ANZOATEGUI	MP. SOTILLO	PQ. POZUELOS	PRE ESCOLAR LUISA CACERES DE ARISMENDI	1402	3	31	1090	616	1059	0	16	2	0	425	1090
EDO. ANZOATEGUI	MP. SOTILLO	PQ. POZUELOS	ESCUELA UNITARIA NUMERO 2153	314	1	6	247	184	241	0	0	1	1	55	247
EDO. ANZOATEGUI	MP. SOTILLO	PQ. POZUELOS	ESCUELA NACIONAL UNITARIA NUMERO 2080	188	1	4	150	114	146	0	1	0	0	31	150
EDO. ANZOATEGUI	MP. SOTILLO	PQ. POZUELOS	GRUPO ESCOLAR TOMAS MOGNA	4558	8	84	3837	2041	3753	2	21	3	5	1681	3837
EDO. ANZOATEGUI	MP. SOTILLO	PQ. POZUELOS	UNIDAD EDUCATIVA ROMULO GALLEGOS	999	2	12	807	281	795	0	3	0	1	510	807
EDO. ANZOATEGUI	MP. CARVAJAL	PQ. SANTA BARBARA	ESCUELA CONCENTRADA MIXTA NUMERO 229 1256 SIN NUMERO SANTA BARBARA	992	2	15	830	478	815	0	0	0	0	337	830
EDO. ANZOATEGUI	MP. CARVAJAL	PQ. VALLE GUANAPE	ESCUELA BÁSICA NACIONAL CARVAJAL	3010	6	49	2411	1228	2362	1	8	2	0	1123	2411
EDO. ANZOATEGUI	MP. CARVAJAL	PQ. VALLE GUANAPE	LICEO BOLIVARIANO SIMON RODRIGUEZ	2325	4	33	1934	985	1901	0	12	2	1	901	1934
EDO. ANZOATEGUI	MP. CARVAJAL	PQ. VALLE GUANAPE	ESCUELA BOLIVARIANA LAS COCUIZAS NUCLEO EDUCACION RURAL 128	537	1	9	443	254	434	0	0	0	0	180	443
EDO. ANZOATEGUI	MP. CARVAJAL	PQ. VALLE GUANAPE	ESCUELA BOLIVARIANA JOSE DE JESUS CUMACHE	1949	4	30	1614	851	1584	0	9	0	0	724	1614
EDO. ANZOATEGUI	MP. CARVAJAL	PQ. VALLE GUANAPE	ESCUELA BOLIVARIANA EL RINCON	174	1	2	159	91	157	0	0	0	0	66	159
EDO. ANZOATEGUI	MP. CARVAJAL	PQ. VALLE GUANAPE	ESCUELA BOLIVARIANA LAS AGUADITAS	845	2	7	698	397	691	0	3	0	1	290	698
EDO. ANZOATEGUI	MP. SANTA ANA	PQ. SANTA ANA	UNIDAD EDUCATIVA NACIONAL SANTA ANA	1487	3	20	1218	659	1198	1	7	0	0	531	1218
EDO. ANZOATEGUI	MP. SANTA ANA	PQ. SANTA ANA	ESCUELA BÁSICA PEDRO EMILIO COLL	2897	5	39	2309	1044	2270	0	13	1	0	1212	2309
EDO. ANZOATEGUI	MP. SANTA ANA	PQ. SANTA ANA	ESCUELA OFICIAL SIN NUMERO LECHOZAL	124	1	1	115	92	114	0	0	0	0	22	115
EDO. ANZOATEGUI	MP. SANTA ANA	PQ. SANTA ANA	ESCUELA BÁSICA ESTADAL EDUARDO DELFÍN  MÉNDEZ	2369	5	35	2010	982	1975	1	21	3	0	968	2010
EDO. ANZOATEGUI	MP. SANTA ANA	PQ. PUEBLO NUEVO	ESCUELA OFICIAL NUCLEO EDUCACION RURAL 342	302	1	13	196	129	183	1	1	0	0	52	196
EDO. ANZOATEGUI	MP. SANTA ANA	PQ. PUEBLO NUEVO	ESCUELA OFICIAL UNITARIA NUCLEO EDUCACION RURAL 144	653	2	14	520	315	506	0	3	1	1	186	520
EDO. ANZOATEGUI	MP. ANACO	PQ. SAN JOAQUIN	CENTRO DE EDUCACION INICIAL URIMARE	339	1	8	308	276	300	0	1	1	0	22	308
EDO. ANZOATEGUI	MP. ANACO	PQ. SAN JOAQUIN	UNIDAD EDUCATIVA  PEDRO ANTONIO MEDINA	2869	5	51	2348	1130	2297	0	18	3	0	1146	2348
EDO. ANZOATEGUI	MP. ANACO	PQ. SAN JOAQUIN	UNIDAD EDUCATIVA LAS PARCELAS NUCLEO DE EDUCACION RURAL 595	459	1	12	336	194	324	0	4	0	0	126	336
EDO. ANZOATEGUI	MP. ANACO	PQ. SAN JOAQUIN	UNIDAD EDUCATIVA DIEGO JIMÉNEZ SALAZAR	2869	5	57	2302	1517	2245	1	19	0	0	708	2302
EDO. ANZOATEGUI	MP. ANACO	PQ. ANACO	LICEO BOLIVARIANO JOSE MANUEL MATUTE SALAZAR	980	2	21	866	453	845	0	8	0	1	383	866
EDO. ANZOATEGUI	MP. ANACO	PQ. ANACO	UNIDAD EDUCATIVA  VIENTO FRESCO	4653	9	71	3666	1941	3595	1	42	2	4	1605	3666
EDO. ANZOATEGUI	MP. ANACO	PQ. ANACO	ESCUELA BOLIVARIANA PRIMERO DE MAYO	1902	4	31	1655	1224	1624	1	13	2	1	383	1655
EDO. ANZOATEGUI	MP. ANACO	PQ. ANACO	UNIDAD EDUCATIVA ALI PRIMERA NUCLEO EDUCATIVO RURAL 144	1831	4	25	1547	1038	1522	0	11	2	1	470	1547
EDO. ANZOATEGUI	MP. ANACO	PQ. ANACO	BIBLIOTECA ANDRES BELLO. ATENEO DE ANACO	1772	4	22	1371	526	1349	0	6	2	2	813	1371
EDO. ANZOATEGUI	MP. ANACO	PQ. ANACO	JARDIN DE INFANCIA LUISA CACERES DE ARISMENDI	1181	2	23	938	487	915	0	7	0	0	421	938
EDO. ANZOATEGUI	MP. ANACO	PQ. ANACO	CENTRO DE EDUCACION INICIAL VALLE LINDO	363	1	4	322	210	318	0	2	0	2	104	322
EDO. ANZOATEGUI	MP. ANACO	PQ. ANACO	ESCUELA BOLIVARIANA ENURUU TAPIJHA	3467	6	82	2851	1805	2769	1	25	1	3	934	2851
EDO. ANZOATEGUI	MP. ANACO	PQ. ANACO	ESCUELA BASICA 19 DE ABRIL DE 1810	662	2	13	610	384	597	0	4	0	1	208	610
EDO. ANZOATEGUI	MP. ANACO	PQ. ANACO	CENTRO INTEGRAL DOCTOR EDUARDO CABRERA AMARAL	1106	2	25	887	303	862	0	9	0	0	550	887
EDO. ANZOATEGUI	MP. ANACO	PQ. ANACO	ESCUELA BÁSICA NACIONAL BICENTENARIO SIMÓN BOLÍVAR	3057	6	33	2525	982	2492	0	22	3	2	1483	2525
EDO. ANZOATEGUI	MP. ANACO	PQ. ANACO	UNIDAD EDUCATIVA ESPECIAL JULIO VICENTE APONTE BELISARIO	913	2	14	773	510	759	0	4	0	0	245	773
EDO. ANZOATEGUI	MP. ANACO	PQ. ANACO	ESCUELA BÁSICA NACIONAL FRAY NICOLÁS DE ODENA	2298	4	55	1910	864	1855	0	12	1	0	978	1910
EDO. ANZOATEGUI	MP. ANACO	PQ. ANACO	UNIDAD EDUCATIVA ANTONIO JOSÉ DE SUCRE	1663	3	35	1328	668	1293	2	11	1	0	611	1328
EDO. ANZOATEGUI	MP. ANACO	PQ. ANACO	UNIDAD EDUCATIVA JUAN PABLO SOJO	1883	4	34	1564	713	1530	0	15	0	1	801	1564
EDO. ANZOATEGUI	MP. ANACO	PQ. ANACO	UNIDAD EDUCATIVA DOCTOR CRUZ DEL VALLE RODRÍGUEZ	3090	6	48	2506	1170	2458	0	25	3	0	1260	2506
EDO. ANZOATEGUI	MP. ANACO	PQ. ANACO	ESCUELA  BÁSICA MERCEDES DE PÉREZ FREITES	3389	6	54	2731	1164	2677	1	20	0	0	1492	2731
EDO. ANZOATEGUI	MP. ANACO	PQ. ANACO	UNIDAD EDUCATIVA NARCISO FRAGACHAN	5010	9	120	3928	1980	3808	1	41	2	5	1779	3928
EDO. ANZOATEGUI	MP. ANACO	PQ. ANACO	UNIDAD EDUCATIVA ROBERTO CASTILLO CARDIER	2718	5	42	2270	878	2228	1	12	1	2	1334	2270
EDO. ANZOATEGUI	MP. ANACO	PQ. ANACO	UNIDAD EDUCATIVA MIXTA 9411 ROMULO GALLEGOS	338	1	17	296	183	279	0	3	0	0	93	296
EDO. ANZOATEGUI	MP. ANACO	PQ. ANACO	ESCUELA  BÁSICA  PEDRO  HERRERA	4235	8	87	3574	1665	3487	1	16	3	0	1802	3574
EDO. ANZOATEGUI	MP. ANACO	PQ. ANACO	UNIDAD EDUCATIVA JOSÉ ANTONIO ANZOÁTEGUI	1787	4	37	1490	775	1453	2	13	1	1	661	1490
EDO. ANZOATEGUI	MP. ANACO	PQ. ANACO	ESCUELA BASICA JOSE MARIA VARGAS	376	1	9	331	251	322	0	3	0	0	68	331
EDO. ANZOATEGUI	MP. ANACO	PQ. ANACO	ESCUELA  BÁSICA  23 DE ENERO	3646	7	75	3029	1203	2954	0	25	2	0	1724	3029
EDO. ANZOATEGUI	MP. ANACO	PQ. ANACO	INSTITUTO NACIONAL DEL MENOR	1562	3	34	1284	441	1250	0	15	0	0	794	1284
EDO. ANZOATEGUI	MP. ANACO	PQ. ANACO	ESCUELA BÁSICA ARTESANAL URBANA ANACO	3557	7	72	2945	1343	2873	1	33	1	3	1492	2945
EDO. ANZOATEGUI	MP. ANACO	PQ. ANACO	ESCUELA BASICA AGUSTIN CODAZZI	2110	4	33	1807	1132	1774	0	10	3	0	629	1807
EDO. ANZOATEGUI	MP. ANACO	PQ. ANACO	ESCUELA OFICIAL CONCENTRADA MIXTA SIN NUMERO ANAQUITO NUCLEO EDUCATIVO RURAL 144	531	1	14	461	285	447	1	5	0	0	156	461
EDO. ANZOATEGUI	MP. ANACO	PQ. ANACO	ESCUELA  RURAL B  KILÓMETRO 5	3968	7	95	3327	1777	3232	0	25	2	1	1427	3327
EDO. ANZOATEGUI	MP. ANACO	PQ. ANACO	ESCUELA BÁSICA CREACIÓN ANACO	1845	4	49	1503	638	1454	0	9	1	0	806	1503
EDO. ANZOATEGUI	MP. ANACO	PQ. ANACO	UNIDAD  EDUCATIVA  ANACO PDVSA	4123	8	55	3626	1320	3571	1	16	0	1	2233	3626
EDO. ANZOATEGUI	MP. ANACO	PQ. ANACO	ESCUELA DOCTOR RAUL LEONI	356	1	11	327	201	316	0	1	0	0	114	327
EDO. ANZOATEGUI	MP. ANACO	PQ. ANACO	UNIDAD EDUCATIVA  LIBERTADOR SIMÓN BOLÍVAR	3966	7	72	3383	1270	3311	1	27	6	0	2007	3383
EDO. ANZOATEGUI	MP. ANACO	PQ. ANACO	JARDÍN DE INFANCIA 23 DE ENERO	1722	3	40	1425	560	1385	0	16	0	1	808	1425
EDO. ANZOATEGUI	MP. ANACO	PQ. ANACO	COLEGIO PRIVADO EULALIA RAMOS SANCHEZ	1365	3	21	1086	540	1065	0	10	1	0	514	1086
EDO. ANZOATEGUI	MP. ANACO	PQ. ANACO	UNIDAD EDUCATIVA DOCTOR AGUSTÍN RAFAEL HERNÁNDEZ	2132	4	53	1704	616	1651	0	9	1	0	1025	1704
EDO. ANZOATEGUI	MP. FREITES	CM. CANTAURA	CENTRO DE EDUCACION INICIAL BOLIVARANA AGUSTÍN AVELEDO	2142	4	35	1865	855	1830	0	10	0	0	965	1865
EDO. ANZOATEGUI	MP. FREITES	CM. CANTAURA	ESCUELA BOLIVARIANA BARBONERO	416	1	3	391	349	388	0	2	2	0	35	391
EDO. ANZOATEGUI	MP. FREITES	CM. CANTAURA	ESCUELA BOLIVARIANA MARE MARE	391	1	7	367	325	360	0	0	1	0	34	367
EDO. ANZOATEGUI	MP. FREITES	CM. CANTAURA	LICEO BOLIVARIANO JOSE RAMON CAMEJO	3342	6	33	2767	1225	2734	0	19	1	1	1488	2767
EDO. ANZOATEGUI	MP. FREITES	CM. CANTAURA	ESCUELA UNITARIA LA MATA	1100	2	25	824	579	799	0	6	2	0	212	824
EDO. ANZOATEGUI	MP. FREITES	CM. CANTAURA	LICEO DOCTOR FELIPE GUEVARA ROJAS	1828	4	40	1601	679	1561	0	11	0	0	871	1601
EDO. ANZOATEGUI	MP. FREITES	CM. CANTAURA	ESCUELA NACIONAL CONCENTRADA NUMERO 1759 1763	550	1	5	438	364	433	0	5	2	0	62	438
EDO. ANZOATEGUI	MP. FREITES	CM. CANTAURA	UNIDAD EDUCATIVA TASCABAÑA I	639	2	5	543	484	538	0	3	1	0	50	543
EDO. ANZOATEGUI	MP. FREITES	CM. CANTAURA	UNIVERSIDAD GRAN MARISCAL DE AYACUCHO	269	1	5	239	142	234	0	0	0	0	92	239
EDO. ANZOATEGUI	MP. FREITES	CM. CANTAURA	ESCUELA BOLIVARIANA CHAMARIAPA	817	2	7	711	451	704	0	11	0	0	242	711
EDO. ANZOATEGUI	MP. FREITES	CM. CANTAURA	UNIDAD EDUCATIVA MERECURAL	380	1	12	285	118	273	0	0	0	0	155	285
EDO. ANZOATEGUI	MP. FREITES	CM. CANTAURA	ESCUELA CONCENTRADA MIXTA NUMERO 115 165 1747 216	1282	3	33	960	774	927	0	9	0	0	144	960
EDO. ANZOATEGUI	MP. FREITES	CM. CANTAURA	ESCUELA CAPACITACIÓN FEMENINA GREGORIA DÍAZ	1479	3	22	1249	538	1227	1	5	0	1	682	1249
EDO. ANZOATEGUI	MP. FREITES	CM. CANTAURA	ESCUELA BÁSICA  FE Y ALEGRÍA	1873	4	43	1451	895	1408	1	6	2	0	504	1451
EDO. ANZOATEGUI	MP. FREITES	CM. CANTAURA	ESCUELA  NACIONAL  CONCENTRADA 2060 213 1752	549	1	10	438	353	428	1	2	2	0	70	438
EDO. ANZOATEGUI	MP. FREITES	CM. CANTAURA	CENTRO DE EDUCACION INICIAL BOLIVARIANO LAS KARIÑITAS	1642	3	34	1336	647	1302	1	10	0	0	644	1336
EDO. ANZOATEGUI	MP. FREITES	CM. CANTAURA	ESCUELA BOLIVARIANA LAS POTOCAS	147	1	3	145	122	142	0	1	0	0	19	145
EDO. ANZOATEGUI	MP. FREITES	CM. CANTAURA	CENTRO DE EDUCACION INICIAL ANDRES BELLO 2	619	2	11	538	291	527	1	5	0	1	229	538
EDO. ANZOATEGUI	MP. FREITES	CM. CANTAURA	UNIDAD EDUCATIVA FELIPE GUEVARA ROJAS	2759	5	40	2216	978	2176	1	15	3	0	1179	2216
EDO. ANZOATEGUI	MP. FREITES	CM. CANTAURA	ESCUELA BASICA JESÚS MARIA PORRAS ALFARO	3241	6	30	2611	1285	2581	0	15	0	0	1281	2611
EDO. ANZOATEGUI	MP. FREITES	CM. CANTAURA	ESCUELA BOLIVARIANA LOS CHAGUARAMOS	324	1	1	255	159	254	0	3	0	0	92	255
EDO. ANZOATEGUI	MP. FREITES	CM. CANTAURA	ESCUELA BOLIVARIANA BAJO HONDO	458	1	15	402	361	387	0	4	0	0	22	402
EDO. ANZOATEGUI	MP. FREITES	CM. CANTAURA	UNIDAD EDUCATIVA PEDRO MARIA FREITES	3515	6	42	2721	1382	2679	0	10	0	0	1287	2721
EDO. ANZOATEGUI	MP. FREITES	CM. CANTAURA	ESCUELA BÁSICA NACIONAL GUEVARA Y LIRA	2781	5	42	2252	982	2210	1	11	1	1	1214	2252
EDO. ANZOATEGUI	MP. FREITES	CM. CANTAURA	UNIDAD EDUCATIVA GRANADILLO	405	1	8	352	265	344	0	1	1	0	77	352
EDO. ANZOATEGUI	MP. FREITES	CM. CANTAURA	ESCUELA BÁSICA ALMIRANTE LUÍS BRION	1667	3	43	1427	762	1384	0	6	1	0	615	1427
EDO. ANZOATEGUI	MP. FREITES	CM. CANTAURA	COLEGIO SAN TOME	3790	7	53	3216	2101	3163	2	24	1	2	1033	3216
EDO. ANZOATEGUI	MP. FREITES	CM. CANTAURA	COLEGIO SANTA JOAQUINA DE VEDRUNA	3310	6	34	2844	1193	2810	0	19	0	0	1598	2844
EDO. ANZOATEGUI	MP. FREITES	PQ. URICA	ESCUELA  BOLIVARIANA EL SAMAN	1120	2	3	952	628	949	0	2	0	0	319	952
EDO. ANZOATEGUI	MP. FREITES	PQ. URICA	ESCUELA NACIONAL UNITARIA NUMERO 1860	171	1	1	122	91	121	0	0	0	0	30	122
EDO. ANZOATEGUI	MP. FREITES	PQ. URICA	UNIDAD EDUCATIVA  BLAS FARIÑA	1620	3	22	1165	583	1143	1	6	2	1	550	1165
EDO. ANZOATEGUI	MP. FREITES	PQ. URICA	LICEO BOLIVARIANO FRANCISCO CARVAJAL	2052	4	31	1715	1077	1684	2	6	1	0	598	1715
EDO. ANZOATEGUI	MP. FREITES	PQ. SANTA ROSA	ESCUELA NACIONAL INDIGENA BOLIVARIANA PARAMAN	936	2	3	797	675	794	0	4	0	0	115	797
EDO. ANZOATEGUI	MP. FREITES	PQ. SANTA ROSA	ESCUELA NACIONAL INDIGENA LA ISLA	603	2	8	513	454	505	0	6	2	0	43	513
EDO. ANZOATEGUI	MP. FREITES	PQ. SANTA ROSA	ESCUELA NACIONAL BOLIVARIANA TERESA DE LA PARRA	2388	5	41	1938	919	1897	0	3	0	0	975	1938
EDO. ANZOATEGUI	MP. FREITES	PQ. SANTA ROSA	ESCUELA UNITARIA NUMERO 62	498	1	1	402	210	401	0	2	0	0	189	402
EDO. ANZOATEGUI	MP. FREITES	PQ. LIBERTADOR	ESCUELA NACIONAL UNITARIA NUMERO 1760 EL BUCARE	558	1	1	352	295	351	0	0	0	0	56	352
EDO. ANZOATEGUI	MP. FREITES	PQ. LIBERTADOR	UNIDAD EDUCATIVA NACIONAL RAFAEL CABALLERO SARMIENTO	1307	3	4	938	667	934	0	1	0	0	266	938
EDO. ANZOATEGUI	MP. GUANTA	PQ. GUANTA	CASA DE LA CULTURA	1487	3	23	1282	521	1259	0	7	1	0	730	1282
EDO. ANZOATEGUI	MP. GUANTA	PQ. GUANTA	UNIDAD EDUCATIVA CIUDAD DE GUANTA	1051	2	18	937	433	919	0	2	0	1	483	937
EDO. ANZOATEGUI	MP. GUANTA	PQ. GUANTA	GRUPO ESCOLAR SANDALIO GÓMEZ	2685	5	42	2218	1007	2176	1	16	1	0	1151	2218
EDO. ANZOATEGUI	MP. GUANTA	PQ. GUANTA	UNIDAD EDUCATIVA ESTADAL RURAL VOLCADERO	1699	3	40	1396	941	1356	1	4	0	0	410	1396
EDO. ANZOATEGUI	MP. GUANTA	PQ. GUANTA	CENTRO DE EDUCACION INICIAL BOLIVARIANO CACIQUE GUANTAR	1261	3	15	1017	464	1002	0	1	0	0	537	1017
EDO. ANZOATEGUI	MP. GUANTA	PQ. GUANTA	INFOCENTRO	1459	3	25	1192	577	1167	0	4	0	0	586	1192
EDO. ANZOATEGUI	MP. GUANTA	PQ. GUANTA	JARDIN DE INFANCIA GUANTA	927	2	36	843	513	807	0	1	0	0	293	843
EDO. ANZOATEGUI	MP. GUANTA	PQ. GUANTA	UNIDAD EDUCATIVA MANUEL REYES BRAVO	3261	6	62	2804	1150	2742	0	14	0	0	1578	2804
EDO. ANZOATEGUI	MP. GUANTA	PQ. GUANTA	UNIDAD EDUCATIVA ESTADAL LA PLAYA	737	2	24	658	476	634	0	1	0	0	157	658
EDO. ANZOATEGUI	MP. GUANTA	PQ. GUANTA	UNIDAD EDUCATIVA JUAN VICENTE GONZÁLEZ	932	2	12	800	291	788	0	5	0	0	492	800
EDO. ANZOATEGUI	MP. GUANTA	PQ. CHORRERON	ESCUELA OFICIAL COMBINADA LA LAGUNA NUCLEO ESCOLAR RURAL 310	378	1	20	348	262	328	1	0	0	0	65	348
EDO. ANZOATEGUI	MP. GUANTA	PQ. CHORRERON	UNIDAD EDUCATIVA ESTADAL 2058, VALLE SECO	315	1	0	285	214	285	0	1	0	0	70	285
EDO. ANZOATEGUI	MP. GUANTA	PQ. CHORRERON	UNIDAD EDUCATIVA NACIONAL BARRIO COLOMBIA	574	1	16	522	347	506	0	2	1	0	156	522
EDO. ANZOATEGUI	MP. GUANTA	PQ. CHORRERON	UNIDAD EDUCATIVA LUISA CACERES DE ARISMENDI	754	2	25	618	446	593	0	9	0	0	138	618
EDO. ANZOATEGUI	MP. GUANTA	PQ. CHORRERON	GRUPO ESCOLAR ANDRES BELLO	2685	5	71	2106	1144	2035	0	15	1	3	872	2106
EDO. ANZOATEGUI	MP. GUANTA	PQ. CHORRERON	ESCUELA CREACION CHORRERON	2200	4	33	1749	1058	1716	0	10	0	1	647	1749
EDO. ANZOATEGUI	MP. GUANTA	PQ. CHORRERON	ESCUELA GRADUADA ENRIQUE STOLK	340	1	4	259	120	255	0	2	0	0	133	259
EDO. ANZOATEGUI	MP. GUANTA	PQ. CHORRERON	CENTRO DE EDUCACION INICIAL COLOMBIA	357	1	3	328	192	325	0	1	0	0	132	328
EDO. ANZOATEGUI	MP. GUANTA	PQ. CHORRERON	ESCUELA CONCENTRADA NUMERO 106 267	1255	3	29	1011	573	982	0	10	0	0	399	1011
EDO. ANZOATEGUI	CE. BOLIVAR	PQ. CAIGUA	ESCUELA BOLIVARIANA PANAMAYAL	1040	2	17	871	633	854	1	4	2	0	214	871
EDO. ANZOATEGUI	CE. BOLIVAR	PQ. CAIGUA	ESCUELA BÁSICA JOSE ANTONIO MATA MEDINA	2723	5	68	2128	1245	2060	0	10	0	2	803	2128
EDO. ANZOATEGUI	CE. BOLIVAR	PQ. CAIGUA	ESCUELA UNITARIA NUMERO  1239	311	1	5	217	132	212	0	2	0	0	78	217
EDO. ANZOATEGUI	CE. BOLIVAR	PQ. EL CARMEN	ESCUELA BOLIVARIANA SANTO DOMINGO	464	1	7	395	280	388	0	1	1	0	106	395
EDO. ANZOATEGUI	CE. BOLIVAR	PQ. EL CARMEN	COMPLEJO EDUCATIVO ESTADAL ANZOATEGUI	2904	5	34	2319	1005	2285	0	19	0	2	1259	2319
EDO. ANZOATEGUI	CE. BOLIVAR	PQ. EL CARMEN	UNIDAD EDUCATIVA ALBERTO LOVERA	1498	3	21	1178	915	1157	0	2	1	0	239	1178
EDO. ANZOATEGUI	CE. BOLIVAR	PQ. EL CARMEN	CENTRO RECREATIVO EDUCATIVO GENERAL JOSÉ ANTONIO ANZOÁTEGUI	1589	3	34	1352	648	1318	1	8	2	0	659	1352
EDO. ANZOATEGUI	CE. BOLIVAR	PQ. EL CARMEN	ESCUELA NACIONAL BARRIO UNIVERSITARIO	3970	7	71	3080	1868	3009	1	18	0	2	1120	3080
EDO. ANZOATEGUI	CE. BOLIVAR	PQ. EL CARMEN	GRUPO ESCOLAR ANGEL CELESTINO BELLO	2219	4	21	1776	654	1755	0	6	0	0	1095	1776
EDO. ANZOATEGUI	CE. BOLIVAR	PQ. EL CARMEN	ESCUELA RURAL EXPERIMENTAL BASICA RAZZETTI I.	1831	4	37	1402	907	1365	0	11	2	1	444	1402
EDO. ANZOATEGUI	CE. BOLIVAR	PQ. EL CARMEN	ESCUELA ESTADAL CONSUELO NAVAS TOVAR	3013	6	50	2354	1289	2304	1	18	1	0	995	2354
EDO. ANZOATEGUI	CE. BOLIVAR	PQ. EL CARMEN	ESCUELA BOLIVARIANA PICAS DEL NEVERI	502	1	13	437	276	424	0	2	0	0	146	437
EDO. ANZOATEGUI	CE. BOLIVAR	PQ. EL CARMEN	LICEO BOLIVARIANO DOCTOR LUIS RAZETTI	1471	3	30	1265	629	1235	0	8	1	0	597	1265
EDO. ANZOATEGUI	CE. BOLIVAR	PQ. EL CARMEN	LICEO JOSE ANTONIO ANZOATEGUI	3892	7	87	3195	1376	3108	0	17	2	1	1712	3195
EDO. ANZOATEGUI	CE. BOLIVAR	PQ. EL CARMEN	SINDICATO VENEZOLANO DE MAESTROS DEL ESTADO ANZOATEGUI	1658	3	20	1381	406	1361	0	3	1	0	951	1381
EDO. ANZOATEGUI	CE. BOLIVAR	PQ. EL CARMEN	ESCUELA COMÚN EL ESFUERZO II	1907	4	42	1500	885	1458	1	7	0	0	565	1500
EDO. ANZOATEGUI	CE. BOLIVAR	PQ. EL CARMEN	UNIDAD EDUCATIVA JOSE RAMON CAMEJO	1814	4	27	1671	855	1644	0	10	0	0	779	1671
EDO. ANZOATEGUI	CE. BOLIVAR	PQ. EL CARMEN	COMPLEJO EDUCATIVO ESTADAL PROFESOR PEDRO ARNAL	1787	4	38	1373	899	1335	2	16	4	2	412	1373
EDO. ANZOATEGUI	CE. BOLIVAR	PQ. EL CARMEN	ESCUELA NACIONAL MIGUEL ANGEL PEREZ	3211	6	77	2422	1407	2345	4	34	3	1	896	2422
EDO. ANZOATEGUI	CE. BOLIVAR	PQ. EL CARMEN	ESCUELA NACIONAL PRIMARIA DOCTOR JOSÉ MARIA VARGAS	4498	8	56	3641	2120	3585	1	30	0	4	1430	3641
EDO. ANZOATEGUI	CE. BOLIVAR	PQ. EL CARMEN	ESCUELA ANTONIO JOSE DE SUCRE	4103	8	104	3300	1835	3196	1	26	3	0	1331	3300
EDO. ANZOATEGUI	CE. BOLIVAR	PQ. EL CARMEN	PRE ESCOLAR EZPELOSIN UNIDAD NUMERO 7	1118	2	28	942	503	914	0	2	3	0	406	942
EDO. ANZOATEGUI	CE. BOLIVAR	PQ. EL CARMEN	ESCUELA NACIONAL ANDRES ELOY BLANCO	2499	5	18	2101	460	2083	0	8	0	1	1614	2101
EDO. ANZOATEGUI	CE. BOLIVAR	PQ. EL CARMEN	ESCUELA BASICA NACIONAL NUMERO 77 ANGOSTURA	275	1	12	237	171	225	0	2	1	1	50	237
EDO. ANZOATEGUI	CE. BOLIVAR	PQ. EL CARMEN	UNIDAD EDUCATIVA NUESTRA SEÑORA DE LOURDES II	1870	4	20	1697	615	1677	0	3	0	0	1059	1697
EDO. ANZOATEGUI	CE. BOLIVAR	PQ. EL CARMEN	CENTRO DE CAPACITACION DE ADULTOS JUANA PETRONILA DE ANZOATEGUI	130	1	5	112	59	107	0	1	0	0	47	112
EDO. ANZOATEGUI	CE. BOLIVAR	PQ. EL CARMEN	LICEO MONSEÑOR NICOLAS EUGENIO NAVARRO	5905	11	98	4680	2248	4582	4	29	0	1	2300	4680
EDO. ANZOATEGUI	CE. BOLIVAR	PQ. EL CARMEN	CENTRO DE EDUCACION INICIAL MANUELITA SAEZ	221	1	6	186	115	180	0	2	0	0	63	186
EDO. ANZOATEGUI	CE. BOLIVAR	PQ. EL CARMEN	INSTITUTO UNIVERSITARIO DE TECNOLOGIA JUAN PABLO PEREZ ALFONZO	2033	4	24	1848	710	1824	2	11	0	2	1099	1848
EDO. ANZOATEGUI	CE. BOLIVAR	PQ. EL CARMEN	CENTRO DE EDUCACION INICIAL SIMONCITO TRONCONAL V	1718	3	30	1422	747	1392	0	8	0	0	637	1422
EDO. ANZOATEGUI	CE. BOLIVAR	PQ. EL CARMEN	CENTRO DE EDUCACION INICIAL CECILIA NUNEZ SUCRE	504	1	13	421	321	408	0	2	0	0	85	421
EDO. ANZOATEGUI	CE. BOLIVAR	PQ. EL CARMEN	GRUPO ESCOLAR BOYACA	3455	6	42	3041	892	2999	1	5	0	2	2099	3041
EDO. ANZOATEGUI	CE. BOLIVAR	PQ. EL CARMEN	UNIDAD EDUCATIVA PEDRO CENTENO VALLENILLA CRISTO DE JOSE	1679	3	10	1399	267	1389	0	5	0	2	1115	1399
EDO. ANZOATEGUI	CE. BOLIVAR	PQ. EL CARMEN	CENTRO DE ATENCION INTEGRAL A PERSONAS CON AUTISMO CAIPA	165	1	2	156	61	154	0	0	0	1	92	156
EDO. ANZOATEGUI	CE. BOLIVAR	PQ. EL CARMEN	ESCUELA  BÁSICA RÓMULO GALLEGO	3608	7	54	3062	1700	3008	2	26	1	1	1278	3062
EDO. ANZOATEGUI	CE. BOLIVAR	PQ. EL CARMEN	GRUPO ESCOLAR JOSÉ BERNARDO GOMEZ	3333	6	36	2810	1240	2774	2	10	2	2	1518	2810
EDO. ANZOATEGUI	CE. BOLIVAR	PQ. EL CARMEN	ESCUELA CONCENTRADA LA PRADERA	528	1	12	455	323	443	0	1	1	0	118	455
EDO. ANZOATEGUI	CE. BOLIVAR	PQ. EL CARMEN	LICEO BOLIVARIANO DOCTOR JESÚS MARIA BIANCO	3797	7	58	3121	1825	3063	0	18	4	1	1215	3121
EDO. ANZOATEGUI	CE. BOLIVAR	PQ. EL CARMEN	ESCUELA PRIMARIA BOLIVARIANA MADRE TERESA DE CALCUTA	818	2	12	741	364	729	0	4	0	0	361	741
EDO. ANZOATEGUI	CE. BOLIVAR	PQ. EL CARMEN	ESCUELA NACIONAL TRONCONAL II	3923	7	70	3316	1583	3246	1	20	1	2	1639	3316
EDO. ANZOATEGUI	CE. BOLIVAR	PQ. EL CARMEN	INSTITUTO NACIONAL DE CAPACITACIÓN Y EDUCACIÓN SOCIALISTA	3360	6	16	3017	650	3001	0	9	0	1	2341	3017
EDO. ANZOATEGUI	CE. BOLIVAR	PQ. EL CARMEN	UNIDAD EDUCATIVA FRANCISCO DE MIRANDA	1786	3	32	1371	776	1339	1	6	1	2	553	1371
EDO. ANZOATEGUI	CE. BOLIVAR	PQ. EL CARMEN	CENTRO DE EDUCACION INICIAL JOSÉ FÉLIX RIBAS	2453	5	42	2054	1110	2012	0	13	2	1	886	2054
EDO. ANZOATEGUI	CE. BOLIVAR	PQ. EL CARMEN	ESCUELA BOLIVARIANA EL ENEAL	363	1	6	296	146	290	0	2	0	0	142	296
EDO. ANZOATEGUI	CE. BOLIVAR	PQ. EL CARMEN	UNIDAD EDUCATIVA MANUEL FELIPE TOVAR	224	1	4	177	109	173	1	2	0	0	61	177
EDO. ANZOATEGUI	CE. BOLIVAR	PQ. EL CARMEN	CENTRO DE EDUCACIÓN BELÉN MARÍA SAN JUÁN	1096	2	16	842	348	826	2	5	1	0	470	842
EDO. ANZOATEGUI	CE. BOLIVAR	PQ. EL CARMEN	ESCUELA EDUCATIVA RAZETTI II	1137	2	33	952	585	919	0	6	0	0	328	952
EDO. ANZOATEGUI	CE. BOLIVAR	PQ. EL CARMEN	PRE ESCOLAR MENCA DE LEONI	1583	3	16	1378	585	1362	2	9	2	2	762	1378
EDO. ANZOATEGUI	CE. BOLIVAR	PQ. EL CARMEN	INSTITUTO DE EDUCACION ESPECIAL BARCELONA	2648	5	43	2261	881	2218	2	11	0	1	1323	2261
EDO. ANZOATEGUI	CE. BOLIVAR	PQ. EL CARMEN	UNIDAD EDUCATIVA PADRE SALINERO FE Y ALEGRIA	4077	8	78	3101	1703	3023	2	15	0	2	1301	3101
EDO. ANZOATEGUI	CE. BOLIVAR	PQ. EL CARMEN	CASA DE LOS NINO GENERAL  JOSE ANTONIO ANZOATEGUI	3965	7	68	3304	1775	3236	0	18	2	0	1441	3304
EDO. ANZOATEGUI	CE. BOLIVAR	PQ. EL CARMEN	ESCUELA NACIONAL CREACION BARCELONA	3372	6	67	2860	1364	2793	0	22	0	0	1407	2860
EDO. ANZOATEGUI	CE. BOLIVAR	PQ. EL CARMEN	ESCUELA NACIONAL ENRIQUE PEREZ VALENCIA	3476	6	69	2775	1430	2706	2	21	0	0	1253	2775
EDO. ANZOATEGUI	CE. BOLIVAR	PQ. EL CARMEN	UNIDAD EDUCATIVA NICOLÁS ROLANDO MONTEVERDE	1618	3	23	1391	454	1368	0	7	0	0	907	1391
EDO. ANZOATEGUI	CE. BOLIVAR	PQ. EL CARMEN	CENTRO DE EDUCACION INICIAL GIORGINA DE MATA	1043	2	24	874	589	850	1	4	1	1	254	874
EDO. ANZOATEGUI	CE. BOLIVAR	PQ. EL CARMEN	LICEO NACIONAL DOCTOR RAFAEL FERNÁNDEZ PADILLA	2849	5	41	2481	1034	2440	0	19	1	1	1385	2481
EDO. ANZOATEGUI	CE. BOLIVAR	PQ. EL CARMEN	ESCUELA BOLIVARIANA VALLES DEL NEVERI	995	2	22	792	499	770	1	6	0	0	264	792
EDO. ANZOATEGUI	CE. BOLIVAR	PQ. EL CARMEN	ESCUELA NACIONAL JESUS RAFAEL VALLADARES GIL TRONCONAL III B	2923	5	65	2366	1572	2301	1	14	4	0	710	2366
EDO. ANZOATEGUI	CE. BOLIVAR	PQ. SAN CRISTOBAL	ESCUELA BASICA LOS POTOCOS 371	1215	3	18	990	785	972	0	8	1	2	176	990
EDO. ANZOATEGUI	CE. BOLIVAR	PQ. SAN CRISTOBAL	ESCUELA BASICA ESTADAL NEGRO PRIMERO MAYORQUIN III	1228	3	38	986	727	948	1	10	1	0	209	986
EDO. ANZOATEGUI	CE. BOLIVAR	PQ. SAN CRISTOBAL	ESCUELA BASICA SIMON BOLIVAR	599	1	13	504	359	491	0	3	0	1	128	504
EDO. ANZOATEGUI	CE. BOLIVAR	PQ. SAN CRISTOBAL	LICEO NACIONAL CAMINO NUEVO	4970	9	74	4217	2316	4143	1	27	3	4	1792	4217
EDO. ANZOATEGUI	CE. BOLIVAR	PQ. SAN CRISTOBAL	ESCUELA DE CAPACITACION PARA ADULTOS QUINTINA MENESES DE MOYA	705	2	18	580	373	562	0	7	2	0	180	580
EDO. ANZOATEGUI	CE. BOLIVAR	PQ. SAN CRISTOBAL	ESCUELA BASICA LA ORQUIDEA	1772	3	48	1406	993	1358	0	12	1	0	352	1406
EDO. ANZOATEGUI	CE. BOLIVAR	PQ. SAN CRISTOBAL	ESCUELA BASICA SANTA BARBARA	185	1	13	161	129	148	0	0	0	0	19	161
EDO. ANZOATEGUI	CE. BOLIVAR	PQ. SAN CRISTOBAL	ESCUELA BASICA ANTONIO GUZMÁN BLANCO	1983	4	39	1546	923	1507	0	14	0	0	570	1546
EDO. ANZOATEGUI	CE. BOLIVAR	PQ. SAN CRISTOBAL	LICEO BOLIVARIANO MIGUEL OTERO SILVA	3932	7	83	2933	2167	2850	1	19	2	0	661	2933
EDO. ANZOATEGUI	CE. BOLIVAR	PQ. SAN CRISTOBAL	UNIDAD EDUCATIVA RURAL CECILIO ACOSTA	920	2	14	783	456	769	1	5	1	0	306	783
EDO. ANZOATEGUI	CE. BOLIVAR	PQ. SAN CRISTOBAL	COMPLEJO EDUCATIVO NACIONAL MANUEL FARIAS LUCES	2708	5	47	2136	1030	2089	0	19	2	3	1035	2136
EDO. ANZOATEGUI	CE. BOLIVAR	PQ. SAN CRISTOBAL	UNIDAD EDUCATIVA ESTADAL  HÉCTOR GARCÍA SALAS	2006	4	37	1565	1006	1528	1	19	0	0	502	1565
EDO. ANZOATEGUI	CE. BOLIVAR	PQ. SAN CRISTOBAL	CENTRO DE EDUCACION  INICIAL FELICIDAD MATA DE GOMEZ	717	2	11	578	403	567	1	2	1	0	160	578
EDO. ANZOATEGUI	CE. BOLIVAR	PQ. SAN CRISTOBAL	UNIDAD EDUCATIVA INDIGENA BOLIVARIANA SAN BERNANDINO	574	1	5	365	231	360	0	1	0	0	128	365
EDO. ANZOATEGUI	CE. BOLIVAR	PQ. SAN CRISTOBAL	UNIDAD EDUCATIVA GENERAL  JOSÉ ANTONIO PÁEZ	2791	5	106	2160	1338	2054	2	10	1	0	703	2160
EDO. ANZOATEGUI	CE. BOLIVAR	PQ. SAN CRISTOBAL	UNIDAD  EDUCATIVA FRANCISCO DE MIRANDA	906	2	7	772	243	765	0	6	0	0	516	772
EDO. ANZOATEGUI	CE. BOLIVAR	PQ. SAN CRISTOBAL	UNIDAD EDUCATIVA RIO NEVERI	1325	3	8	1259	279	1251	1	8	0	2	961	1259
EDO. ANZOATEGUI	CE. BOLIVAR	PQ. SAN CRISTOBAL	ESCUELA BOLIVARIANA MESONES	4353	8	79	3378	1862	3299	1	29	2	1	1404	3378
EDO. ANZOATEGUI	CE. BOLIVAR	PQ. SAN CRISTOBAL	ESCUELA DE CAPACITACION DE ADULTOS	1834	4	38	1486	775	1448	1	10	3	0	659	1486
EDO. ANZOATEGUI	CE. BOLIVAR	PQ. SAN CRISTOBAL	UNIDAD EDUCATIVA BOLIVARIANA PARACACUAL NUMERO 24  41	524	1	9	317	171	308	1	0	0	0	136	317
EDO. ANZOATEGUI	CE. BOLIVAR	PQ. SAN CRISTOBAL	UNIDAD EDUCATIVA NACIONAL  MERCEDES DE PÉREZ FREITES	4540	8	20	3915	715	3895	2	8	0	0	3170	3915
EDO. ANZOATEGUI	CE. BOLIVAR	PQ. SAN CRISTOBAL	GRUPO ESCOLAR JUAN MANUEL CAJIGAL	3478	6	35	2754	1331	2719	0	29	0	1	1358	2754
EDO. ANZOATEGUI	CE. BOLIVAR	PQ. SAN CRISTOBAL	ESCUELA BÁSICA NACIONAL DOCTOR JULIO CAMEJO	3398	6	67	2816	1410	2749	0	21	0	2	1316	2816
EDO. ANZOATEGUI	CE. BOLIVAR	PQ. SAN CRISTOBAL	CENTRO EDUCACIONAL INICIAL LYA IMBER DE CORONIL	506	1	7	456	259	449	0	3	0	0	187	456
EDO. ANZOATEGUI	CE. BOLIVAR	PQ. SAN CRISTOBAL	CENTRO DE EDUCACION INICIAL DIVINO NIÑO	659	2	16	607	426	591	0	8	2	0	155	607
EDO. ANZOATEGUI	CE. BOLIVAR	PQ. SAN CRISTOBAL	LICEO BOLIVARIANO CORONEL JUAN BAUTISTA BIDEAUX	4327	8	77	3618	1623	3541	0	22	2	3	1891	3618
EDO. ANZOATEGUI	CE. BOLIVAR	PQ. SAN CRISTOBAL	UNIDAD EDUCATIVA CACIQUE CAYAURIMA	415	1	10	327	238	317	0	3	1	0	75	327
EDO. ANZOATEGUI	CE. BOLIVAR	PQ. SAN CRISTOBAL	GRUPO ESCOLAR REPUBLICA DE CHILE	4009	8	60	3298	1454	3238	0	25	0	2	1757	3298
EDO. ANZOATEGUI	CE. BOLIVAR	PQ. SAN CRISTOBAL	CASA DE FORMACION INTEGRAL PROFESOR JOSÉ ANTONIO DIAZ	1291	3	28	1068	525	1040	0	8	1	0	506	1068
EDO. ANZOATEGUI	CE. BOLIVAR	PQ. SAN CRISTOBAL	ESCUELA BICENTENARIO DEL LIBERTADOR	5028	9	130	3926	2724	3796	1	36	2	0	1033	3926
EDO. ANZOATEGUI	CE. BOLIVAR	PQ. SAN CRISTOBAL	AUDITORIO JUAN MANUEL CAJIGAL	1831	4	17	1465	570	1448	0	6	1	0	871	1465
EDO. ANZOATEGUI	CE. BOLIVAR	PQ. SAN CRISTOBAL	ESCUELA DE CAPACITACION DE ADULTOS CAMINO NUEVO 1	182	1	2	145	68	143	0	1	0	0	74	145
EDO. ANZOATEGUI	CE. BOLIVAR	PQ. SAN CRISTOBAL	CENTRO DE EDUCACION INICIAL LA PONDEROSA	815	2	16	626	422	610	0	8	2	0	178	626
EDO. ANZOATEGUI	CE. BOLIVAR	PQ. SAN CRISTOBAL	UNIDAD EDUCATIVA DOCTOR LUIS BELTRAN PRIETO FIGUEROA	2053	4	38	1779	943	1741	1	23	1	0	773	1779
EDO. ANZOATEGUI	CE. BOLIVAR	PQ. SAN CRISTOBAL	CENTRO EDUCACION INICIAL PROFESOR JESUS RAFAEL VALLADARES	508	1	9	446	267	437	1	1	0	1	167	446
EDO. ANZOATEGUI	CE. BOLIVAR	PQ. SAN CRISTOBAL	UNIDAD EDUCATIVA DOCTOR JOSE GIL FORTOUL II ALA IZQUIERDA	452	1	8	361	180	353	1	2	0	0	170	361
EDO. ANZOATEGUI	CE. BOLIVAR	PQ. SAN CRISTOBAL	UNIDAD EDUCATIVA JUAN GERMAN ROCIO	1347	3	13	1071	470	1058	0	12	0	1	575	1071
EDO. ANZOATEGUI	CE. BOLIVAR	PQ. SAN CRISTOBAL	UNIDAD EDUCATIVA NUESTRA SEÑORA DE LA COROMOTO	220	1	1	191	104	190	0	3	0	0	83	191
EDO. ANZOATEGUI	CE. BOLIVAR	PQ. SAN CRISTOBAL	CENTRO DE EDUCACION INICIAL PADRE PIO	2592	5	51	2018	1120	1967	0	8	3	1	835	2018
EDO. ANZOATEGUI	CE. BOLIVAR	PQ. SAN CRISTOBAL	INTERNADO JUDICIAL BARCELONA	1838	4	27	1039	683	1012	0	8	0	1	320	1039
EDO. ANZOATEGUI	CE. BOLIVAR	PQ. SAN CRISTOBAL	UNIDAD EDUCATIVA DOCTOR EDGAR CALATRAVA GAGO	2399	5	10	2103	379	2093	0	6	0	0	1708	2103
EDO. ANZOATEGUI	CE. BOLIVAR	PQ. SAN CRISTOBAL	UNIDAD EDUCATIVA NACIONAL 29 DE MARZO	4360	8	59	3457	1594	3398	1	35	3	0	1765	3457
EDO. ANZOATEGUI	CE. BOLIVAR	PQ. SAN CRISTOBAL	UNIDAD EDUCATIVA DOCTOR JOSÉ GIL FORTOUL	4675	9	66	4003	2174	3937	0	17	3	2	1741	4003
EDO. ANZOATEGUI	CE. BOLIVAR	PQ. SAN CRISTOBAL	CENTRO DE EDUCACION INICIAL MANUELA SAENZ	979	2	11	788	563	777	0	8	2	0	204	788
EDO. ANZOATEGUI	CE. BOLIVAR	PQ. SAN CRISTOBAL	ESCUELA  PUENTE AYALA	1488	3	42	1197	760	1155	0	9	0	0	386	1197
EDO. ANZOATEGUI	CE. BOLIVAR	PQ. SAN CRISTOBAL	UNIVERSIDAD SIMÓN RODRÍGUEZ	1364	3	15	1076	442	1061	0	4	0	0	615	1076
EDO. ANZOATEGUI	CE. BOLIVAR	PQ. SAN CRISTOBAL	UNIDAD EDUCATIVA LOS ALEROS	1308	3	17	1004	620	987	0	5	0	2	360	1004
EDO. ANZOATEGUI	CE. BOLIVAR	PQ. SAN CRISTOBAL	LICEO BOLIVARIANO JUAN MANUEL CAJIGAL	921	2	11	847	284	836	0	3	0	1	548	847
EDO. ANZOATEGUI	CE. BOLIVAR	PQ. SAN CRISTOBAL	UNIDAD EDUCATIVA NACIONAL CELESTINO FARRERA	1715	3	12	1536	563	1524	0	7	1	1	952	1536
EDO. ANZOATEGUI	CE. BOLIVAR	PQ. SAN CRISTOBAL	UNIDAD EDUCATIVA BOLIVARIANA CAMPO ALEGRE NER 371	169	1	1	146	98	145	0	1	0	0	46	146
EDO. ANZOATEGUI	CE. BOLIVAR	PQ. SAN CRISTOBAL	ESCUELA ESTADAL DOMINGO MAZA VELASQUEZ	4519	8	52	3300	1732	3248	4	27	3	0	1482	3300
EDO. ANZOATEGUI	CE. BOLIVAR	PQ. SAN CRISTOBAL	UNIDAD EDUCATIVA INSTITUTO CREATIVO	976	2	9	826	205	817	0	5	2	1	604	826
EDO. ANZOATEGUI	CE. BOLIVAR	PQ. SAN CRISTOBAL	LICEO BOLIVARIANO MESONES	397	1	6	328	215	322	0	5	0	0	102	328
EDO. ANZOATEGUI	CE. BOLIVAR	PQ. SAN CRISTOBAL	UNIDAD EDUCATIVA SIMON BOLIVAR 29 DE MARZO	1475	3	43	1088	584	1045	0	14	0	0	447	1088
EDO. ANZOATEGUI	CE. BOLIVAR	PQ. SAN CRISTOBAL	ESCUELA TECNICA ROBINSONIANA COMERCIAL DOCTOR  FELIPE GUEVARA ROJAS	3069	6	48	2514	926	2466	1	18	1	0	1520	2514
EDO. ANZOATEGUI	CE. BOLIVAR	PQ. SAN CRISTOBAL	ESCUELA BOLIVARIANA LA ESPERANZA	141	1	5	124	92	119	0	0	0	0	27	124
EDO. ANZOATEGUI	CE. BOLIVAR	PQ. SAN CRISTOBAL	CENTRO DE EDUCACION INICIAL POETA EDUARDO SIFONTES	1874	4	35	1555	864	1520	0	10	0	1	645	1555
EDO. ANZOATEGUI	CE. BOLIVAR	PQ. SAN CRISTOBAL	ESCUELA RURAL  DE EDUCACION BASICA LA PONDEROSA	3566	7	71	2639	1715	2568	0	25	1	0	827	2639
EDO. ANZOATEGUI	CE. BOLIVAR	PQ. SAN CRISTOBAL	ESCUELA DOCTOR JOSÉ TADEO ARREAZA CALATRAVA	3306	6	32	2691	1129	2659	0	16	1	1	1512	2691
EDO. ANZOATEGUI	CE. BOLIVAR	PQ. SAN CRISTOBAL	UNIDAD EDUCATIVA EULALIA BUROZ	1878	4	24	1546	817	1522	0	14	3	0	688	1546
EDO. ANZOATEGUI	CE. BOLIVAR	PQ. SAN CRISTOBAL	COMPLEJO EDUCATIVO NUESTRA SEÑORA DEL VALLE	2802	5	37	2390	966	2353	1	14	1	1	1370	2390
EDO. ANZOATEGUI	CE. BOLIVAR	PQ. SAN CRISTOBAL	ESCUELA DE ARTES PLASTICAS ARMANDO REVERON	336	1	6	306	123	300	0	1	0	0	176	306
EDO. ANZOATEGUI	CE. BOLIVAR	PQ. SAN CRISTOBAL	TALLER DE EDUCACION LABORAL ANZOATEGUI	1482	3	5	1290	237	1285	0	5	1	2	1040	1290
EDO. ANZOATEGUI	CE. BOLIVAR	PQ. SAN CRISTOBAL	CENTRO DE EDUCACION INICIAL  FRANCISCO FERRER	2076	4	44	1654	737	1610	0	12	0	1	860	1654
EDO. ANZOATEGUI	CE. BOLIVAR	PQ. BERGANTIN	NUCLEO ESCOLAR RURAL 594 EL ZAMURO	90	1	1	52	43	51	0	0	0	0	8	52
EDO. ANZOATEGUI	CE. BOLIVAR	PQ. BERGANTIN	ESCUELA NACIONAL  NICOLAS LAREZ	2274	4	39	1607	940	1568	0	15	1	0	612	1607
EDO. ANZOATEGUI	CE. BOLIVAR	PQ. BERGANTIN	CICLO BASICO CREACIÓN BERGANTÍN	1176	2	10	847	586	837	0	2	3	0	246	847
EDO. ANZOATEGUI	CE. BOLIVAR	PQ. BERGANTIN	ESCUELA ESTADAL UNITARIA NUMERO 284
EDO. ANZOATEGUI	CE. BOLIVAR	PQ. NARICUAL	ESCUELA EL FRANCES	341	1	2	260	127	258	0	5	0	0	126	260
EDO. ANZOATEGUI	CE. BOLIVAR	PQ. NARICUAL	UNIDAD EDUCATIVA ARAGUITA	1272	3	61	948	577	887	0	7	0	1	302	948
EDO. ANZOATEGUI	CE. BOLIVAR	PQ. NARICUAL	ESCUELA BOLIVARIANA LAS MINAS	393	1	13	342	193	329	0	3	0	0	133	342
EDO. ANZOATEGUI	CE. BOLIVAR	PQ. NARICUAL	NUCLEO ESCOLAR RURAL 212 CARINAGUA	281	1	1	166	116	165	0	2	0	0	47	166
EDO. ANZOATEGUI	CE. BOLIVAR	PQ. NARICUAL	LICEO BOLIVARIANO NARICUAL	1699	3	40	1262	762	1222	1	12	0	0	447	1262
EDO. ANZOATEGUI	CE. BOLIVAR	PQ. NARICUAL	UNIDAD EDUCATIVA QUERECUAL II NUCLEO DE EDUCACION RURAL 311	98	1	7	88	48	81	0	1	0	0	32	88
EDO. ANZOATEGUI	CE. BOLIVAR	PQ. NARICUAL	UNIDAD EDUCATIVA JOSEFINA DE HERNANDEZ CAMEJO	867	2	23	589	229	566	0	13	0	1	323	589
EDO. ANZOATEGUI	CE. BOLIVAR	PQ. NARICUAL	ESCUELA NACIONAL BOLIVARIANA CAPIRICUAL	805	2	29	618	390	589	0	6	2	0	191	618
EDO. ANZOATEGUI	CE. BOLIVAR	PQ. NARICUAL	UNIDAD EDUCATIVA CARABOBO	125	1	2	121	48	119	0	1	0	0	70	121
EDO. ANZOATEGUI	CE. BOLIVAR	PQ. NARICUAL	UNIDAD EDUCATIVA ESTADAL NICOLAS ROLANDO	1008	2	16	805	423	789	0	4	0	0	362	805
EDO. ANZOATEGUI	CE. BOLIVAR	PQ. NARICUAL	UNIDAD EDUCATIVA JESÚS RAFAEL ALBORNOZ	2990	6	38	2325	1459	2287	1	10	1	0	816	2325
EDO. ANZOATEGUI	CE. BOLIVAR	PQ. NARICUAL	ESCUELA NACIONAL CURATAQUICHE	1001	2	13	792	416	779	0	9	1	0	353	792
EDO. ANZOATEGUI	CE. BOLIVAR	PQ. EL PILAR	ESCUELA CONCENTRADA NUMERO 2070 38	530	1	6	332	186	326	1	3	1	0	135	332
EDO. ANZOATEGUI	CE. BOLIVAR	PQ. EL PILAR	ESCUELA BOLIVARIANA DOCTOR PEDRO GARRONI NÚÑEZ	1588	3	10	1231	748	1221	0	9	1	1	462	1231
EDO. ANZOATEGUI	CE. BOLIVAR	PQ. EL PILAR	ESCUELA CONCENTRADA NUMERO 1240	219	1	4	110	65	106	0	1	0	0	40	110
EDO. ANZOATEGUI	MP. L/DIEGO BAUTISTA	PQ. EL MORRO	COLEGIO HUMBOLT	2409	5	10	1980	316	1970	0	6	0	1	1647	1980
EDO. ANZOATEGUI	MP. L/DIEGO BAUTISTA	PQ. EL MORRO	INSTITUTO UNIVERSITARIO DE TECNOLOGÍA RODOLFO LOERO ARISMENDI (I.U.T.I.R.L.A.)	2738	5	20	2288	455	2268	0	7	1	0	1805	2288
EDO. ANZOATEGUI	MP. L/DIEGO BAUTISTA	PQ. LECHERIAS	COLEGIO JUAN XXIII	5291	10	29	4357	449	4328	0	6	0	1	3872	4357
EDO. ANZOATEGUI	MP. L/DIEGO BAUTISTA	PQ. LECHERIAS	CENTRO DE PROFESIONALES DE LECHERIA	2430	5	12	2157	424	2145	0	7	0	1	1713	2157
EDO. ANZOATEGUI	MP. L/DIEGO BAUTISTA	PQ. LECHERIAS	UNIDAD EDUCATIVA MANUEL GUAL	1991	4	13	1628	257	1615	0	4	0	0	1354	1628
EDO. ANZOATEGUI	MP. L/DIEGO BAUTISTA	PQ. LECHERIAS	CENTRO DE EDUCACION INICIAL VIRGEN DEL VALLE	1367	3	20	1259	422	1239	0	4	1	0	812	1259
EDO. ANZOATEGUI	MP. L/DIEGO BAUTISTA	PQ. LECHERIAS	GRUPO ESCOLAR TOMAS ALFARO CALATRAVA	4012	8	25	3250	814	3225	1	6	0	4	2400	3250
EDO. ANZOATEGUI	MP. L/DIEGO BAUTISTA	PQ. LECHERIAS	UNIDAD EDUCATIVA MENCA DE LEONI	3193	6	20	2612	302	2592	1	2	0	1	2286	2612
EDO. ANZOATEGUI	MP. L/DIEGO BAUTISTA	PQ. LECHERIAS	COLEGIO FRANCISCO LINARES ALCANTARA	2235	4	10	1859	315	1849	0	7	0	2	1525	1859
EDO. ANZOATEGUI	MP. L/DIEGO BAUTISTA	PQ. LECHERIAS	UNIDAD EDUCATIVA LICENCIADO DIEGO BAUTISTA URBANEJA	2979	6	20	2459	507	2439	0	4	0	3	1925	2459
EDO. ANZOATEGUI	MP. L/DIEGO BAUTISTA	PQ. LECHERIAS	UNIDAD EDUCATIVA MARIA AUXILIADORA	3483	7	18	2960	444	2942	1	4	0	0	2493	2960
EDO. ANZOATEGUI	MP. PIRITU	PQ. SAN FRANCISCO	UNIDAD EDUCATIVA ESTADAL SAN FRANSISCO DE ASIS	703	2	6	572	346	566	0	2	0	0	218	572
EDO. ANZOATEGUI	MP. PIRITU	PQ. PIRITU	ESCUELA BASICA DON FERNANDO PEÑALVER	622	2	8	557	332	549	0	2	0	1	214	557
EDO. ANZOATEGUI	MP. PIRITU	PQ. PIRITU	CENTRO DE EDUCACION INICIAL PEDRO CELESTINO MUÑOZ	2155	4	42	1774	862	1732	0	3	2	2	863	1774
EDO. ANZOATEGUI	MP. PIRITU	PQ. PIRITU	UNIDAD EDUCATIVA GUAYABAL	1415	3	28	1179	560	1151	0	5	0	0	586	1179
EDO. ANZOATEGUI	MP. PIRITU	PQ. PIRITU	UNIDAD EDUCATIVA NACIONAL POZO HONDO
EDO. ANZOATEGUI	MP. PIRITU	PQ. PIRITU	ESCUELA BOLIVARIANA EL MEREY	595	1	14	479	276	465	0	6	1	0	182	479
EDO. ANZOATEGUI	MP. PIRITU	PQ. PIRITU	ESCUELA BOLIVARIANA CAPACHAL	177	1	4	169	110	165	0	0	0	0	55	169
EDO. ANZOATEGUI	MP. PIRITU	PQ. PIRITU	LICEO BOLIVARIANO ROLINGSON HERRERA	3613	7	64	3077	1792	3013	0	18	4	1	1198	3077
EDO. ANZOATEGUI	MP. PIRITU	PQ. PIRITU	UNIDAD EDUCATIVA RURAL SAN ANTONIO	1880	4	51	1569	817	1518	1	5	1	0	694	1569
EDO. ANZOATEGUI	MP. PIRITU	PQ. PIRITU	COMPLEJO EDUCACIONAL FRANCISCO FAJARDO	3703	7	56	3045	1773	2989	0	18	1	2	1195	3045
EDO. ANZOATEGUI	MP. PIRITU	PQ. PIRITU	ESCUELA BASICA PEDRO CELESTINO MUNOZ	2733	5	76	2268	1097	2192	0	12	0	0	1083	2268
EDO. ANZOATEGUI	MP. GUANIPA	CM. SAN JOSE DE GUANIPA	UNIDAD EDUCATIVA LOS OLIVOS	1134	2	17	951	709	934	0	6	0	0	219	951
EDO. ANZOATEGUI	MP. GUANIPA	CM. SAN JOSE DE GUANIPA	CENTRO DE EDUCACION INICIAL BICENTENARIO	1005	2	15	857	615	842	0	8	1	0	218	857
EDO. ANZOATEGUI	MP. GUANIPA	CM. SAN JOSE DE GUANIPA	UNIDAD EDUCATIVA PROFESOR ANDRES HERNANDEZ	1404	3	30	1119	825	1089	0	5	0	0	259	1119
EDO. ANZOATEGUI	MP. GUANIPA	CM. SAN JOSE DE GUANIPA	INSTITUTO PRIVADO JOSE GIL FORTOUL.	2244	4	18	1884	806	1866	0	12	1	0	1047	1884
EDO. ANZOATEGUI	MP. GUANIPA	CM. SAN JOSE DE GUANIPA	PRE ESCOLAR JARDIN DE INFANCIA SAN JOSE DE GUANIPA	467	1	8	427	227	419	0	4	0	0	188	427
EDO. ANZOATEGUI	MP. GUANIPA	CM. SAN JOSE DE GUANIPA	ESCUELA BÁSICA VISTA AL SOL	1960	4	32	1788	891	1756	0	14	0	0	851	1788
EDO. ANZOATEGUI	MP. GUANIPA	CM. SAN JOSE DE GUANIPA	ESCUELA RURAL BASICA EL BASQUERO	1185	2	22	1010	717	988	0	5	0	1	265	1010
EDO. ANZOATEGUI	MP. GUANIPA	CM. SAN JOSE DE GUANIPA	NUCLEO DE APOYO FAMILIAR SAN JOSE.	2277	5	27	1857	1042	1830	1	17	0	0	770	1857
EDO. ANZOATEGUI	MP. GUANIPA	CM. SAN JOSE DE GUANIPA	ESCUELA RURAL BÁSICA LA FLORESTA	1615	3	32	1356	655	1324	0	12	0	0	657	1356
EDO. ANZOATEGUI	MP. GUANIPA	CM. SAN JOSE DE GUANIPA	CENTRO DE EDUCACION INICIAL LOS SAUCES	388	1	3	347	236	344	0	3	1	1	103	347
EDO. ANZOATEGUI	MP. GUANIPA	CM. SAN JOSE DE GUANIPA	ESCUELA BASICA EZEQUIEL ZAMORA	333	1	5	296	248	291	0	4	0	0	39	296
EDO. ANZOATEGUI	MP. GUANIPA	CM. SAN JOSE DE GUANIPA	SIMONCITO COMUNITARIO PAULA CORREA	1143	2	21	935	546	914	0	5	0	0	363	935
EDO. ANZOATEGUI	MP. GUANIPA	CM. SAN JOSE DE GUANIPA	ESCUELA BÁSICA CIUDAD DE LA ASUNCIÓN	3547	7	56	2757	1597	2701	0	21	2	1	1080	2757
EDO. ANZOATEGUI	MP. GUANIPA	CM. SAN JOSE DE GUANIPA	LICEO BOLIVARIANO GUANIPA	3113	6	38	2576	1414	2538	0	21	0	0	1103	2576
EDO. ANZOATEGUI	MP. GUANIPA	CM. SAN JOSE DE GUANIPA	INSTITUTO RAFAEL RANGEL	3539	7	61	3032	1573	2971	0	23	2	1	1372	3032
EDO. ANZOATEGUI	MP. GUANIPA	CM. SAN JOSE DE GUANIPA	GRUPO ESCOLAR DOCTOR JOSÉ COVA MAZA	3813	7	61	2971	1563	2910	1	22	0	0	1324	2971
EDO. ANZOATEGUI	MP. GUANIPA	CM. SAN JOSE DE GUANIPA	GRUPO ESCOLAR RAFAEL MEDINA GARCIA	3593	7	56	2934	1366	2878	0	20	2	1	1489	2934
EDO. ANZOATEGUI	MP. GUANIPA	CM. SAN JOSE DE GUANIPA	UNIDAD EDUCATIVA LIBERTADOR	1487	3	21	1222	624	1201	0	5	0	1	571	1222
EDO. ANZOATEGUI	MP. GUANIPA	CM. SAN JOSE DE GUANIPA	GRUPO ESCOLAR CARLOS FRAGACHAN	2967	6	44	2281	1065	2237	0	11	1	0	1160	2281
EDO. ANZOATEGUI	MP. GUANIPA	CM. SAN JOSE DE GUANIPA	INSTITUTO DE EDUCACION ESPECIAL AGUAPANE	302	1	6	281	158	275	0	2	0	0	115	281
EDO. ANZOATEGUI	MP. GUANIPA	CM. SAN JOSE DE GUANIPA	LICEO PROFESOR JESUS LOPEZ CASTRO	3322	6	50	2800	1256	2750	1	23	1	1	1468	2800
EDO. ANZOATEGUI	MP. GUANIPA	CM. SAN JOSE DE GUANIPA	UNIDAD EDUCATIVA RAFAEL MARCANO RODRIGUEZ	3721	7	51	3125	1919	3074	2	21	0	3	1129	3125
EDO. ANZOATEGUI	MP. GUANIPA	CM. SAN JOSE DE GUANIPA	ESCUELA UNITARIA LA PEÑA NUCLEO DE EDUCACION RURAL 239	167	1	2	141	104	139	0	1	0	0	34	141
EDO. ANZOATEGUI	MP. GUANIPA	CM. SAN JOSE DE GUANIPA	UNIDAD EDUCATIVA MARIO BRICEÑO IRAGORRI	2030	4	32	1602	790	1570	1	7	1	1	770	1602
EDO. ANZOATEGUI	MP. GUANIPA	CM. SAN JOSE DE GUANIPA	ESCUELA BASICA EL MIRADOR	990	2	34	872	502	838	0	11	0	2	323	872
EDO. ANZOATEGUI	MP. GUANIPA	CM. SAN JOSE DE GUANIPA	ESCUELA LA FLORIDA	1237	3	21	989	635	968	0	9	0	0	324	989
EDO. ANZOATEGUI	MP. GUANIPA	CM. SAN JOSE DE GUANIPA	UNIDAD EDUCATIVA SAN JOSE	1892	4	35	1499	745	1464	0	8	2	1	708	1499
EDO. ANZOATEGUI	MP. GUANIPA	CM. SAN JOSE DE GUANIPA	ESCUELA BASICA LOS MELONES	303	1	4	267	218	263	0	1	0	0	44	267
EDO. ANZOATEGUI	MP. MONAGAS	PQ. PIAR	ESCUELA ESTADAL CONCENTRADA NUMERO 81 82 189	1056	2	15	802	477	787	0	1	0	0	309	802
EDO. ANZOATEGUI	MP. MONAGAS	PQ. PIAR	ESCUELA ESTADAL SIN NUMERO	162	1	1	122	66	121	0	0	0	0	55	122
EDO. ANZOATEGUI	MP. MONAGAS	PQ. UVERITO	GRUPO ESCOLAR ROMULO GALLEGOS	1906	4	48	1490	805	1442	0	11	0	2	624	1490
EDO. ANZOATEGUI	MP. MONAGAS	PQ. ZUATA	ESCUELA UNITARIA LA MUCHACHA	147	1	1	83	39	82	0	2	1	0	40	83
EDO. ANZOATEGUI	MP. MONAGAS	PQ. ZUATA	GRUPO ESCOLAR DOCTOR PIÓ CEBALLOS	2267	4	57	1718	1158	1661	0	6	0	0	497	1718
EDO. ANZOATEGUI	MP. MONAGAS	PQ. SANTA CLARA	ESCUELA CONCENTRADA NUMERO 88 215 4	2065	4	45	1621	1107	1576	0	9	3	0	457	1621
EDO. ANZOATEGUI	MP. MONAGAS	PQ. SANTA CLARA	ESCUELA UNITARIA NUMERO 229	362	1	6	258	172	252	0	0	1	0	79	258
EDO. ANZOATEGUI	MP. MONAGAS	CM. MAPIRE	GRUPO ESCOLAR DOCTOR RAFAEL VELÁSQUEZ MÁRQUEZ	1354	3	39	1089	553	1050	1	11	1	0	484	1089
EDO. ANZOATEGUI	MP. MONAGAS	CM. MAPIRE	ESCUELA LA CALCETA	365	1	6	271	230	265	0	2	1	0	32	271
EDO. ANZOATEGUI	MP. MONAGAS	CM. MAPIRE	UNIVERSIDAD BOLIVARIANA ROMULO GALLEGOS	804	2	21	628	350	607	0	4	1	0	252	628
EDO. ANZOATEGUI	MP. MONAGAS	PQ. SN DIEGO DE CABRUTICA	ESCUELA ESTADAL SAN MIGUEL	109	1	2	78	70	76	0	0	0	0	6	78
EDO. ANZOATEGUI	MP. MONAGAS	PQ. SN DIEGO DE CABRUTICA	ESCUELA ESTADAL UNITARIA NUMERO 246	664	2	14	482	369	468	0	3	0	0	96	482
EDO. ANZOATEGUI	MP. MONAGAS	PQ. SN DIEGO DE CABRUTICA	ESCUELA NACIONAL CONCENTRADA NUMERO 16 190 27	2905	5	52	2217	1597	2165	2	14	1	0	551	2217
EDO. ANZOATEGUI	MP. MONAGAS	PQ. SN DIEGO DE CABRUTICA	UNIDAD EDUCATIVA COGOLLAL NUCLEO DE EDUCACION RURAL 445	413	1	7	359	248	352	0	0	0	0	104	359
EDO. LARA	MP. ANDRES E BLANCO	PQ. PIO TAMAYO	ESCUELA ESTADAL CONCENTRADA EL PLACER	71	1	2	59	31	57	0	1	0	0	25	59
EDO. LARA	MP. ANDRES E BLANCO	PQ. PIO TAMAYO	ESCUELA ESTADAL FILA RICA DE LONDRES	83	1	0	69	40	69	0	1	0	0	28	69
EDO. LARA	MP. ANDRES E BLANCO	PQ. PIO TAMAYO	ESCUELA NACIONAL CONCENTRADA BOLIVARIANA VILLORIN	354	1	2	293	254	291	0	3	0	0	34	293
EDO. LARA	MP. ANDRES E BLANCO	PQ. PIO TAMAYO	ESCUELA BASICA PALO VERDE	1511	3	27	1280	606	1253	0	7	0	0	640	1280
EDO. LARA	MP. ANDRES E BLANCO	PQ. PIO TAMAYO	ESCUELA BOLIVARIANA ANDRES ELOY BLANCO	1091	2	23	942	553	919	0	2	2	0	362	942
EDO. LARA	MP. ANDRES E BLANCO	PQ. PIO TAMAYO	ESCUELA CAMPESINA FE Y ALEGRIA EL PORTACHUELO	236	1	0	211	193	211	0	0	0	0	18	211
EDO. LARA	MP. ANDRES E BLANCO	PQ. PIO TAMAYO	ESCUELA ESTADAL LAS QUEBRADITAS 1	484	1	8	408	285	400	2	5	0	0	108	408
EDO. LARA	MP. ANDRES E BLANCO	PQ. PIO TAMAYO	ESCUELA UNITARIA DE SABANA REDONDA ABAJO	577	1	6	471	398	465	0	0	0	0	67	471
EDO. LARA	MP. ANDRES E BLANCO	PQ. PIO TAMAYO	ESCUELA BOLIVARIANA EL JARILLAL	377	1	3	316	150	313	0	1	0	0	162	316
EDO. LARA	MP. ANDRES E BLANCO	PQ. PIO TAMAYO	ESCUELA ESTADAL BOLIVARIANA HATO DE GUAPA	276	1	2	243	204	241	1	1	0	2	33	243
EDO. LARA	MP. ANDRES E BLANCO	PQ. PIO TAMAYO	ESCUELA BOLIVARIANA CASPO	455	1	4	378	336	374	0	1	0	0	37	378
EDO. LARA	MP. ANDRES E BLANCO	PQ. PIO TAMAYO	ESCUELA BOLIVARIANA BOJO	454	1	3	398	360	395	0	0	0	0	35	398
EDO. LARA	MP. ANDRES E BLANCO	PQ. PIO TAMAYO	UNIDAD EDUCATIVA NACIONAL SABANA GRANDE	1462	3	10	1194	656	1184	0	7	0	0	521	1194
EDO. LARA	MP. ANDRES E BLANCO	PQ. PIO TAMAYO	ESCUELA UNITARIA NUMERO 4113 MIRACUY	296	1	4	202	158	198	1	2	0	0	37	202
EDO. LARA	MP. ANDRES E BLANCO	PQ. PIO TAMAYO	ESCUELA BOLIVARIANA JORNADA COMPLETA ALTAMIRA	272	1	3	243	215	240	0	0	0	0	25	243
EDO. LARA	MP. ANDRES E BLANCO	PQ. PIO TAMAYO	CENTRO DE EDUCACION INICIAL SIMONCITO EL VOLCANCITO	260	1	2	237	114	235	0	5	0	0	116	237
EDO. LARA	MP. ANDRES E BLANCO	PQ. PIO TAMAYO	CASA DE LA CULTURA JOSE NEMESIO GODOY	1747	3	35	1425	569	1390	1	7	0	1	812	1425
EDO. LARA	MP. ANDRES E BLANCO	PQ. PIO TAMAYO	ESCUELA BOLIVARIANA TINTINAL	1049	2	14	803	617	789	1	3	1	1	166	803
EDO. LARA	MP. ANDRES E BLANCO	PQ. PIO TAMAYO	ESCUELA BASICA EL VOLCANCITO	1618	3	27	1401	571	1374	0	11	2	0	790	1401
EDO. LARA	MP. ANDRES E BLANCO	PQ. PIO TAMAYO	ESCUELA BOLIVARIANA MONTE CARMELO	570	1	10	489	421	479	0	0	0	0	58	489
EDO. LARA	MP. ANDRES E BLANCO	PQ. PIO TAMAYO	ESCUELA NACIONAL BOLIVARIANA JORNADA COMPLETA PORTUGUESITA ARRIBA	59	1	1	54	46	53	0	2	0	0	5	54
EDO. LARA	MP. ANDRES E BLANCO	PQ. PIO TAMAYO	OFICINA MUNICIPAL DE EDUCACION DE ANDRES ELOY BLANCO	373	1	9	338	209	329	0	0	0	1	119	338
EDO. LARA	MP. ANDRES E BLANCO	PQ. PIO TAMAYO	ESCUELA NACIONAL BOLIVARIANA YAY	293	1	6	188	141	182	0	0	0	0	41	188
EDO. LARA	MP. ANDRES E BLANCO	PQ. PIO TAMAYO	ESCUELA BOLIVARIANA MANUEL ANTONIO CARREÑO	2994	6	51	2464	999	2413	0	18	0	2	1394	2464
EDO. LARA	MP. ANDRES E BLANCO	PQ. PIO TAMAYO	ESCUELA BOLIVARIANA MEDIA JORNADA LA GUAPA	222	1	3	198	159	195	0	1	0	0	35	198
EDO. LARA	MP. ANDRES E BLANCO	PQ. PIO TAMAYO	UNIDAD EDUCATIVA MATEO SEGUNDO VIERA	1275	3	17	1122	617	1105	1	7	1	0	479	1122
EDO. LARA	MP. ANDRES E BLANCO	PQ. PIO TAMAYO	ESCUELA ESTADAL CONCENTRADA YACAMBU	752	2	7	555	423	548	1	5	1	0	118	555
EDO. LARA	MP. ANDRES E BLANCO	PQ. PIO TAMAYO	UNIDAD EDUCATIVA NACIONAL SANARE	1691	3	33	1414	580	1381	0	10	0	1	790	1414
EDO. LARA	MP. ANDRES E BLANCO	PQ. YACAMBU	ESCUELA BOLIVARIANA JORNADA COMPLETA LAS DAMAS	434	1	4	296	215	292	0	1	1	0	75	296
EDO. LARA	MP. ANDRES E BLANCO	PQ. YACAMBU	UNIDAD EDUCATIVA BRISAS DEL GUAICAL	136	1	2	126	112	124	0	1	1	0	10	126
EDO. LARA	MP. ANDRES E BLANCO	PQ. YACAMBU	ESCUELA ESTADAL UNITARIA CERRO DE SILLA	180	1	4	141	100	137	1	0	0	0	36	141
EDO. LARA	MP. ANDRES E BLANCO	PQ. YACAMBU	ESCUELA NUEZAL DE ESCALERA	232	1	4	151	113	147	0	0	0	0	34	151
EDO. LARA	MP. ANDRES E BLANCO	PQ. YACAMBU	ESCUELA BOLIVARIANA JORNADA COMPLETA EL HELECHAL	174	1	1	144	124	143	0	2	0	0	17	144
EDO. LARA	MP. ANDRES E BLANCO	PQ. YACAMBU	ESCUELA CONCENTRADA EL CERRON DE TAMBORAL	97	1	1	78	60	77	0	1	1	0	15	78
EDO. LARA	MP. ANDRES E BLANCO	PQ. YACAMBU	ESCUELA BOLIVARIANA JORNADA COMPLETA LAS VIRTUDES	425	1	7	315	207	308	0	0	0	0	101	315
EDO. LARA	MP. ANDRES E BLANCO	PQ. YACAMBU	ESCUELA CONCENTRADA ESTADAL CERRO BLANCO	313	1	7	238	161	231	0	1	0	1	68	238
EDO. LARA	MP. ANDRES E BLANCO	PQ. YACAMBU	ESCUELA NACIONAL CONCENTRADA EL NARANJAL	94	1	0	77	68	77	0	0	0	0	9	77
EDO. LARA	MP. ANDRES E BLANCO	PQ. YACAMBU	ESCUELA ESTADAL LUCIA INDIANA	288	1	5	194	79	189	1	2	1	0	106	194
EDO. LARA	MP. ANDRES E BLANCO	PQ. YACAMBU	ESCUELA UNITARIA EL GUAICAL	608	2	6	415	336	409	0	4	1	0	68	415
EDO. LARA	MP. ANDRES E BLANCO	PQ. YACAMBU	ESCUELA BOLIVARIANA LA GRAN PARADA	151	1	6	109	60	103	0	0	1	0	42	109
EDO. LARA	MP. ANDRES E BLANCO	PQ. YACAMBU	ESCUELA UNITARIA EL TAMBORAL NO 295	471	1	2	279	239	277	0	1	0	0	37	279
EDO. LARA	MP. ANDRES E BLANCO	PQ. YACAMBU	ESCUELA ESTADAL BOLIVARIANA MEDIA JORNADA EL LLORON	68	1	0	55	45	55	1	1	0	0	8	55
EDO. LARA	MP. ANDRES E BLANCO	PQ. YACAMBU	ESCUELA BOLIVARIANA JORNADA COMPLETA EL BARRANCON DEL DEGREDO	543	1	15	383	251	368	0	3	1	0	113	383
EDO. LARA	MP. ANDRES E BLANCO	PQ. YACAMBU	ESCUELA ESTADAL CONCENTRADA EL SILENCIO NUMERO 517	219	1	1	178	161	177	0	1	0	0	15	178
EDO. LARA	MP. ANDRES E BLANCO	PQ. YACAMBU	ESCUELA JORNADA COMPLETA EL PROGRESO	183	1	3	172	100	169	0	0	0	0	69	172
EDO. LARA	MP. ANDRES E BLANCO	PQ. YACAMBU	ESCUELA ESTADAL QUEBRADA HONDA DE LA ESCALERA	253	1	1	180	137	179	0	0	0	1	41	180
EDO. LARA	MP. ANDRES E BLANCO	PQ. YACAMBU	ESCUELA ESTADAL MIRAFLORES DEL DEGREDO	80	1	6	68	37	62	0	0	0	0	25	68
EDO. LARA	MP. ANDRES E BLANCO	PQ. YACAMBU	ESCUELA CONCENTRADA ESCALERA	561	1	5	409	300	404	0	5	0	0	99	409
EDO. LARA	MP. ANDRES E BLANCO	PQ. YACAMBU	UNIDAD EDUCATIVA BOLIVARIANA NACIONAL PALMAR DEL DEGREDO (NUCLEO ESCOLAR 377)	306	1	8	244	184	236	1	0	0	0	51	244
EDO. LARA	MP. ANDRES E BLANCO	PQ. QBDA. HONDA DE GUACHE	ESCUELA BOLIVARIANA JORNADA COMPLETA QUEBRADA HONDA DE GUACHE	809	2	2	632	507	630	0	1	1	1	120	632
EDO. LARA	MP. ANDRES E BLANCO	PQ. QBDA. HONDA DE GUACHE	ESCUELA NACIONAL BOLIVARIANA MEDIA JORNADA NUEZALITO DE GUACHE	227	1	2	118	104	116	0	0	0	0	12	118
EDO. LARA	MP. ANDRES E BLANCO	PQ. QBDA. HONDA DE GUACHE	ESCUELA CONCENTRADA NACIONAL LOMA SANARE	436	1	1	287	280	286	0	1	1	0	4	287
EDO. LARA	MP. ANDRES E BLANCO	PQ. QBDA. HONDA DE GUACHE	ESCUELA BOLIVARIANA MEDIA JORNADA ESCUELA NUEZAL TRISTE	225	1	0	209	208	209	0	0	0	0	1	209
EDO. LARA	MP. ANDRES E BLANCO	PQ. QBDA. HONDA DE GUACHE	ESCUELA ESTADAL RURAL MIRAFLORES 1 DE GUACHE	308	1	4	249	184	245	0	2	0	1	58	249
EDO. LARA	MP. ANDRES E BLANCO	PQ. QBDA. HONDA DE GUACHE	ESCUELA ESTADAL BOLIVARIANA SABANA DEL PADRE NUCLEO ESCOLAR RURAL 456	415	1	5	358	351	353	0	0	1	0	1	358
EDO. LARA	MP. ANDRES E BLANCO	PQ. QBDA. HONDA DE GUACHE	ESCUELA BOLIVARIANA MEDIA JORNADA EL HONDO	64	1	1	63	62	62	0	0	0	0	0	63
EDO. LARA	MP. ANDRES E BLANCO	PQ. QBDA. HONDA DE GUACHE	ESCUELA ESTADAL PLAN DE SAN ANTONIO DE GUACHE	398	1	2	276	236	274	0	1	0	0	37	276
EDO. LARA	MP. ANDRES E BLANCO	PQ. QBDA. HONDA DE GUACHE	ESCUELA EDUCATIVA ESTADAL PLATANAL	323	1	3	230	211	227	2	2	1	0	11	230
EDO. LARA	MP. ANDRES E BLANCO	PQ. QBDA. HONDA DE GUACHE	ESCUELA BASICA ESTADAL CONCENTRADA PLAZA DE SAN ANTONIO DE GUACHE	136	1	0	108	89	108	0	0	0	0	19	108
EDO. LARA	MP. ANDRES E BLANCO	PQ. QBDA. HONDA DE GUACHE	ECUELA BOLIVARIANA LAS BUCARITAS	509	1	1	415	382	414	0	0	0	0	32	415
EDO. LARA	MP. ANDRES E BLANCO	PQ. QBDA. HONDA DE GUACHE	ESCUELA ESTADAL CONCENTRADA FILA RICA	315	1	3	263	257	260	0	0	0	0	3	263
EDO. LARA	MP. MORAN	PQ. HILARIO LUNA Y LUNA	ESCUELA BOLIVARIANA  EL CAURO	1079	2	18	709	596	691	0	4	4	0	87	709
EDO. LARA	MP. MORAN	PQ. HILARIO LUNA Y LUNA	ESCUELA CONCENTRADA POTRERITO DEL MANZANO	208	1	2	180	160	178	1	0	0	0	17	180
EDO. LARA	MP. MORAN	PQ. HILARIO LUNA Y LUNA	ESCUELA BOLIVARIANA LOS PLANES	78	1	2	63	48	61	0	0	0	0	13	63
EDO. LARA	MP. MORAN	PQ. HILARIO LUNA Y LUNA	ESCUELA RURAL ESTADAL AGUA AMARILLA	48	1	0	35	33	35	0	0	0	0	2	35
EDO. LARA	MP. MORAN	PQ. HILARIO LUNA Y LUNA	UNIDAD EDUCATIVA  ESTADAL MIRASOL	337	1	2	244	236	242	1	1	0	0	4	244
EDO. LARA	MP. MORAN	PQ. HILARIO LUNA Y LUNA	ESCUELA RURAL ESTADAL SABANETA	161	1	2	146	138	144	0	1	0	0	5	146
EDO. LARA	MP. MORAN	PQ. HILARIO LUNA Y LUNA	ESCUELA NACIONAL BOLIVARIANA CACAHUAL DE SAN JOSE	157	1	4	131	95	127	1	3	0	0	28	131
EDO. LARA	MP. MORAN	PQ. HILARIO LUNA Y LUNA	UNIDAD EDUCATIVA NACIONAL  ISABEL TERESA PEREIRA DE VALERA	2172	4	46	1486	1134	1440	3	14	1	0	288	1486
EDO. LARA	MP. MORAN	PQ. HILARIO LUNA Y LUNA	ESCUELA BOLIVARIANA LOS  HIGUERONES ARRIBA	173	1	1	130	120	129	0	0	1	0	8	130
EDO. LARA	MP. MORAN	PQ. HILARIO LUNA Y LUNA	ESCUELA BOLIVARIANA QUEBRADA ARRIBA	295	1	5	231	183	226	1	2	1	0	39	231
EDO. LARA	MP. MORAN	PQ. HILARIO LUNA Y LUNA	ESCUELA ESTADAL CONCENTRADA SANTA LUCIA	189	1	1	162	123	161	1	4	1	0	32	162
EDO. LARA	MP. MORAN	PQ. HILARIO LUNA Y LUNA	UNIDAD EDUCATIVA  NACIONAL MARILONZA	315	1	3	220	207	217	0	2	1	0	7	220
EDO. LARA	MP. MORAN	PQ. HILARIO LUNA Y LUNA	ESCUELA BOLIVARIANA   LA FLORIDA	462	1	4	346	318	342	0	2	1	0	21	346
EDO. LARA	MP. MORAN	PQ. HILARIO LUNA Y LUNA	ESCUELA BOLIVARIANA LAS CRUCES	278	1	1	212	161	211	0	1	0	0	49	212
EDO. LARA	MP. MORAN	PQ. HILARIO LUNA Y LUNA	ESCUELA BOLIVARIANA SANTA ROSA	254	1	5	225	211	220	1	0	0	0	8	225
EDO. LARA	MP. MORAN	PQ. HILARIO LUNA Y LUNA	ESCUELA BOLIVARIANA LAGUNETA	562	1	3	388	330	385	0	2	0	1	52	388
EDO. LARA	MP. MORAN	PQ. HILARIO LUNA Y LUNA	ESCUELA ESTATAL CONCENTRADA EL COGOLLAL NUMERO 506	115	1	0	109	107	109	0	0	0	0	2	109
EDO. LARA	MP. MORAN	PQ. HUMOCARO BAJO	ESCUELA BOLIVARIANA EL PARCHAL	563	1	10	419	190	409	1	4	0	0	214	419
EDO. LARA	MP. MORAN	PQ. HUMOCARO BAJO	ESCUELA ESTADAL CONCENTRADA MIXTA POTRERO DE SAN JUAN	574	1	3	419	294	416	0	6	3	0	113	419
EDO. LARA	MP. MORAN	PQ. HUMOCARO BAJO	ESCUELA CONCENTRADA SAN JOSE	126	1	4	109	73	105	0	2	0	0	30	109
EDO. LARA	MP. MORAN	PQ. HUMOCARO BAJO	UNIDAD EDUCATIVA MANUEL RAMON YEPEZ	2759	5	66	2137	964	2071	1	8	8	0	1090	2137
EDO. LARA	MP. MORAN	PQ. HUMOCARO BAJO	JARDIN DE INFANCIA MANUEL RAMON YEPEZ	403	1	4	295	134	291	0	0	1	0	156	295
EDO. LARA	MP. MORAN	PQ. HUMOCARO BAJO	ESCUELA ESTADAL CONCENTRADA LAS PALMITAS	241	1	2	199	144	197	1	2	0	0	50	199
EDO. LARA	MP. MORAN	PQ. HUMOCARO BAJO	ESCUELA CONCENTRADA EL ESPINAL	164	1	2	158	110	156	0	1	0	0	45	158
EDO. LARA	MP. MORAN	PQ. HUMOCARO BAJO	ESCUELA BOLIVARIANA  LAS HUERTAS	195	1	5	169	154	164	0	0	0	0	10	169
EDO. LARA	MP. MORAN	PQ. HUMOCARO BAJO	ESCUELA BOLIVARIANA CONCENTRADA LAS VEGAS	214	1	5	194	158	189	0	0	0	0	31	194
EDO. LARA	MP. MORAN	PQ. HUMOCARO BAJO	ESCUELA CONCENTRADA LA LAGUNA DE HUMOCARO BAJO	237	1	3	182	153	179	0	0	1	0	25	182
EDO. LARA	MP. MORAN	PQ. HUMOCARO BAJO	UNIDAD EDUCATIVA  ESTADAL LOS NARANJOS	198	1	2	145	97	143	0	2	1	0	43	145
EDO. LARA	MP. MORAN	PQ. HUMOCARO BAJO	ESCUELA BOLIVARIANA EL MOLINO	261	1	4	236	194	232	0	3	0	0	35	236
EDO. LARA	MP. MORAN	PQ. HUMOCARO BAJO	LICEO BOLIVARIANO  PABLO GIL GARCIA	1710	3	43	1320	845	1277	2	2	1	1	426	1320
EDO. LARA	MP. MORAN	PQ. HUMOCARO BAJO	UNIDAD EDUCATIVA EL HATO	256	1	3	205	186	202	0	1	1	0	14	205
EDO. LARA	MP. MORAN	PQ. HUMOCARO BAJO	UNIDAD EDUCATIVA ESTADAL LA ESTANCIA	153	1	7	119	105	112	0	0	0	0	7	119
EDO. LARA	MP. MORAN	PQ. HUMOCARO BAJO	ESCUELA CONCENTRADA LA MESA DE LA CUATRO	112	1	3	103	92	100	0	0	0	0	8	103
EDO. LARA	MP. MORAN	PQ. HUMOCARO ALTO	ESCUELA BOLIVARIANA EL JABON	480	1	16	344	280	328	1	1	0	0	46	344
EDO. LARA	MP. MORAN	PQ. HUMOCARO ALTO	ESCUELA ESTADAL CONCENTRADA LA PEÑA	438	1	9	384	371	375	0	0	1	0	3	384
EDO. LARA	MP. MORAN	PQ. HUMOCARO ALTO	ESCUELA BOLIVARIANA MEDIA JORNADA LA COSTA	179	1	4	164	154	160	0	0	0	0	6	164
EDO. LARA	MP. MORAN	PQ. HUMOCARO ALTO	UNIDAD EDUCATIVA GUAYAUTA	2377	4	31	1804	1247	1773	0	10	1	0	515	1804
EDO. LARA	MP. MORAN	PQ. HUMOCARO ALTO	ESCUELA BOLIVARIANA PUERTO RICO	264	1	2	235	229	233	0	0	0	0	4	235
EDO. LARA	MP. MORAN	PQ. HUMOCARO ALTO	UNIDAD EDUCATIVA  LA PALOMERA	557	1	12	456	330	444	0	5	2	0	107	456
EDO. LARA	MP. MORAN	PQ. HUMOCARO ALTO	ESCULA RURAL ESTADAL CONCENTRADA ARENALES	367	1	3	322	265	319	0	0	0	1	53	322
EDO. LARA	MP. MORAN	PQ. HUMOCARO ALTO	UNIDAD EDUCATIVA  LOS LLANITOS	488	1	13	374	321	361	0	3	1	0	36	374
EDO. LARA	MP. MORAN	PQ. HUMOCARO ALTO	ESCUELA NACIONAL LA MESA	1029	2	10	770	613	760	1	10	3	0	133	770
EDO. LARA	MP. MORAN	PQ. HUMOCARO ALTO	ESCUELA BOLIVARIANA EL POTRERO	213	1	2	191	174	189	0	2	1	0	12	191
EDO. LARA	MP. MORAN	PQ. MORAN	UNIDAD EDUCATIVA  JOSE TRINIDAD MORAN	1157	2	42	894	457	852	0	10	1	0	384	894
EDO. LARA	MP. MORAN	PQ. MORAN	ESCUELA LA LAGUNA DE HATO ARRIBA	353	1	4	217	185	213	0	1	1	0	26	217
EDO. LARA	MP. MORAN	PQ. MORAN	ESCUELA GRANJA HATO ARRIBA	233	1	0	206	184	206	0	0	0	0	22	206
EDO. LARA	MP. MORAN	PQ. MORAN	ESCUELA CONCENTRADA HATO VIEJO	389	1	10	278	253	268	0	2	0	0	13	278
EDO. LARA	MP. MORAN	PQ. MORAN	ESCUELA CONCENTRADA POTRERITO.	104	1	1	69	62	68	0	0	1	0	5	69
EDO. LARA	MP. MORAN	PQ. MORAN	ESCUELA BOLIVARIANA MEDIA JORNADA EL CUJIZAL NER 332	158	1	1	147	139	146	0	0	0	0	7	147
EDO. LARA	MP. MORAN	PQ. MORAN	ESCUELA RURAL ESTADAL LA YERBABUENA	449	1	4	340	259	336	0	0	2	2	73	340
EDO. LARA	MP. MORAN	PQ. ANZOATEGUI	ESCUELA BOLIVARIANA CASCAJAL	159	1	0	124	101	124	0	0	0	0	23	124
EDO. LARA	MP. MORAN	PQ. ANZOATEGUI	ESCUELA BOLIVARIANA EL ALMORZADERO	281	1	4	218	176	214	1	0	0	0	37	218
EDO. LARA	MP. MORAN	PQ. ANZOATEGUI	ESCUELA BOLIVARIANA LA TRINIDAD	161	1	2	139	125	137	0	1	0	0	11	139
EDO. LARA	MP. MORAN	PQ. ANZOATEGUI	ESCUELA NACIONAL CONCENTRADA BOLIVARIANA HUMBERTO PARRA MONTESINOS	742	2	16	563	431	547	1	2	0	0	113	563
EDO. LARA	MP. MORAN	PQ. ANZOATEGUI	ESCUELA BOLIVARIANA LOS MEMBRILLOS	286	1	4	215	176	211	0	0	0	0	35	215
EDO. LARA	MP. MORAN	PQ. ANZOATEGUI	ESCUELA BOLIVARIANA AGUAS TURBIAS	167	1	2	95	50	93	0	0	1	0	42	95
EDO. LARA	MP. MORAN	PQ. ANZOATEGUI	ESCUELA BOLIVARIANA POTRERO DE LA VIRGEN	184	1	2	153	127	151	0	2	0	0	22	153
EDO. LARA	MP. MORAN	PQ. ANZOATEGUI	ESCUELA BOLIVARIANA LA BOCA	412	1	3	304	244	301	0	1	0	0	56	304
EDO. LARA	MP. MORAN	PQ. ANZOATEGUI	ESCUELA BOLIVARIANA EL RODEO	281	1	7	220	162	213	0	3	2	0	46	220
EDO. LARA	MP. MORAN	PQ. ANZOATEGUI	UNIDAD EDUCATIVA  BOLIVARIANA ZAZARABICOA	1289	3	28	988	553	960	1	5	0	0	401	988
EDO. LARA	MP. MORAN	PQ. GUARICO	ESCUELA BOLIVARIANA SAN LUIS	86	1	4	68	59	64	1	0	0	0	4	68
EDO. LARA	MP. MORAN	PQ. GUARICO	ESCUELA CAMPESINA FE Y ALEGRIA SANTO DOMINGO	136	1	1	125	119	124	0	0	1	1	3	125
EDO. LARA	MP. MORAN	PQ. GUARICO	CENTRO EDUCACION INICIAL SANTA ELENA	307	1	2	274	137	272	0	4	0	0	131	274
EDO. LARA	MP. MORAN	PQ. GUARICO	ESCUELA RURAL ESTADAL CAMPO LINDO	104	1	3	94	85	91	0	1	0	0	5	94
EDO. LARA	MP. MORAN	PQ. GUARICO	ESCUELA CAMPESINA FE Y ALEGRIA BUCARAL	246	1	2	210	195	208	0	2	4	1	6	210
EDO. LARA	MP. MORAN	PQ. GUARICO	ESCUELA BOLIVARIANA EL VISO	286	1	2	258	219	256	0	2	0	0	35	258
EDO. LARA	MP. MORAN	PQ. GUARICO	ESCUELA BOLIVARIANA LA PRIMAVERA	752	2	12	633	480	621	0	8	0	0	133	633
EDO. LARA	MP. MORAN	PQ. GUARICO	ESCUELA RURAL ESTADAL RIO BRAVO	110	1	4	104	93	100	0	2	1	0	4	104
EDO. LARA	MP. MORAN	PQ. GUARICO	UNIDAD EDUCATIVA NACIONAL  GUARICO	2021	4	34	1548	1023	1514	3	18	4	0	466	1548
EDO. LARA	MP. MORAN	PQ. GUARICO	ESCUELA CAMPESINA FE Y ALEGRIA RIO ARRIBA	191	1	3	170	152	167	1	2	1	0	11	170
EDO. LARA	MP. MORAN	PQ. GUARICO	UNIDAD EDUCATIVA NACIONAL  SIMON CASTEJON	2296	4	34	1739	1043	1705	0	12	1	0	649	1739
EDO. LARA	MP. MORAN	PQ. GUARICO	ESCUELA BOLIVARIANA FILA DE TIGRE	532	1	10	336	224	326	3	0	1	0	98	336
EDO. LARA	MP. MORAN	PQ. GUARICO	ESCUELA BOLIVARIANA OJO DE AGUA	502	1	7	370	322	363	0	1	0	0	40	370
EDO. LARA	MP. MORAN	PQ. GUARICO	ESCUELA BOLIVARIANA LOS HATICOS	237	1	5	223	182	218	0	3	0	0	33	223
EDO. LARA	MP. MORAN	PQ. GUARICO	ESCUELA BOLIVARIANA EL CIELITO	912	2	10	646	590	636	2	3	1	1	39	646
EDO. LARA	MP. MORAN	PQ. GUARICO	ESCUELA BOLIVARIANA EL PEÑON	482	1	5	363	243	358	0	1	0	0	114	363
EDO. LARA	MP. MORAN	PQ. GUARICO	BIBLIOTECA LEONARDO RUIZ PINEDA	670	2	13	551	362	538	1	2	1	0	172	551
EDO. LARA	MP. MORAN	PQ. GUARICO	ESCUELA UNITARIA GUARIQUITO	457	1	10	339	184	329	0	3	1	0	141	339
EDO. LARA	MP. MORAN	PQ. GUARICO	JARDIN DE INFANCIA SAN JOSE	515	1	4	400	256	396	0	6	0	0	134	400
EDO. LARA	MP. MORAN	PQ. GUARICO	ESCUELA UNITARIA  BOLIVARIANA MIJINO	121	1	3	111	66	108	0	1	1	0	40	111
EDO. LARA	MP. MORAN	PQ. BOLIVAR	UNIDAD EDUCATIVA NACIONAL CONCENTRADA OSPINAL	402	1	3	380	347	377	0	1	0	0	29	380
EDO. LARA	MP. MORAN	PQ. BOLIVAR	UNIDAD EDUCATIVA MERCEDES GONZALEZ DE MUJICA	661	2	10	613	461	603	0	3	1	0	138	613
EDO. LARA	MP. MORAN	PQ. BOLIVAR	JARDIN DE INFANCIA EMILIA ROSA RODRIGUEZ	845	2	11	750	321	739	0	6	0	0	412	750
EDO. LARA	MP. MORAN	PQ. BOLIVAR	ESCUELA UNITARIA GUACARA	303	1	0	115	76	115	0	0	1	0	38	115
EDO. LARA	MP. MORAN	PQ. BOLIVAR	UNIDAD EDUCATIVA NACIONAL UNITARIA MAMONAL	332	1	2	262	195	260	0	4	0	0	61	262
EDO. LARA	MP. MORAN	PQ. BOLIVAR	UNIDAD EDUCATIVA NACIONAL JUAN CEFERINO CASTILLO	1805	4	38	1474	593	1436	0	11	1	1	830	1474
EDO. LARA	MP. MORAN	PQ. BOLIVAR	ESCUELA BOLIVARIANA FALCON	893	2	23	666	532	643	0	3	0	0	108	666
EDO. LARA	MP. MORAN	PQ. BOLIVAR	ESCUELA RURAL ESTADAL LA PEÑA	91	1	2	86	78	84	0	0	0	0	6	86
EDO. LARA	MP. MORAN	PQ. BOLIVAR	UNIDAD EDUCATIVA REPUBLICA DOMINICANA	3008	6	30	2377	1010	2347	0	14	1	2	1320	2377
EDO. LARA	MP. MORAN	PQ. BOLIVAR	ESCUELA RURAL ESTADAL CERRITO ABAJO	146	1	2	117	86	115	0	0	0	0	29	117
EDO. LARA	MP. MORAN	PQ. BOLIVAR	UNIDAD EDUCATIVA NACIONAL  CONCENTRADA QUEBRADA NEGRA	293	1	2	223	184	221	0	0	1	0	36	223
EDO. LARA	MP. MORAN	PQ. BOLIVAR	UNIDAD EDUCATIVA  BUENA VISTA	821	2	12	639	528	627	1	2	1	1	94	639
EDO. LARA	MP. MORAN	PQ. BOLIVAR	ESCUELA BOLIVARIANA NACIONAL JORNADA COMPLETA  EL LIMONCITO	340	1	5	297	225	292	0	2	0	0	65	297
EDO. LARA	MP. MORAN	PQ. BOLIVAR	UNIDAD EDUCATIVA BASICA BORO CUJIZAL NER 055	330	1	3	273	237	270	0	3	0	0	30	273
EDO. LARA	MP. MORAN	PQ. BOLIVAR	ESCUELA ESTADAL UNITARIA EL HATILLO	265	1	1	197	176	196	0	0	0	0	20	197
EDO. LARA	MP. MORAN	PQ. BOLIVAR	ESCUELA BOLIVARIANA MARACA	443	1	11	356	301	345	0	1	0	0	43	356
EDO. LARA	MP. MORAN	PQ. BOLIVAR	UNIDAD EDUCATIVA BASICA  CIMARRONA NER 055	455	1	9	343	249	334	0	2	1	1	81	343
EDO. LARA	MP. MORAN	PQ. BOLIVAR	UNIDAD EDUCATIVA JOSE NICOLAS SILVA CASTILLO	2722	5	54	2146	1408	2092	1	14	3	0	666	2146
EDO. LARA	MP. MORAN	PQ. BOLIVAR	ESCUELA BOLIVARIANA SABANA DE CURUMATO	639	2	26	452	288	426	1	2	0	0	135	452
EDO. LARA	MP. MORAN	PQ. BOLIVAR	CENTRO DE ATENCION COMUNITARIA FUNDACION DEL NIÑO	1168	2	18	929	445	911	0	10	1	0	455	929
EDO. LARA	MP. MORAN	PQ. BOLIVAR	UNIDAD EDUCATIVA ARTESANAL FRANCISCO OLIVO	1777	3	50	1487	653	1437	0	14	0	0	770	1487
EDO. LARA	MP. MORAN	PQ. BOLIVAR	I.N.C.E.	1486	3	19	1271	591	1252	0	3	2	4	652	1271
EDO. LARA	MP. MORAN	PQ. BOLIVAR	LICEO BOLIVARIANO EDUARDO BLANCO	1776	3	34	1583	659	1549	0	8	0	0	882	1583
EDO. LARA	MP. MORAN	PQ. BOLIVAR	LICEO BOLIVARIANO DOCTOR FERNANDO GARMENDIA YEPEZ	546	1	12	489	260	477	0	2	0	0	215	489
EDO. LARA	MP. MORAN	PQ. BOLIVAR	UNIDAD EDUCATIVA NACIONAL  AMERICA FERNANDEZ DE LEONI	2574	5	55	2140	1098	2085	0	14	1	0	972	2140
EDO. LARA	MP. MORAN	PQ. BOLIVAR	UNIDAD EDUCATIVA NACIONAL CONCENTRADA SAN JOSE DE POTRERITO	269	1	8	229	139	221	0	5	1	1	75	229
EDO. LARA	MP. MORAN	PQ. BOLIVAR	JARDIN DE INFANCIA EL TOCUYO	1212	3	19	1079	439	1060	0	7	0	0	614	1079
EDO. LARA	MP. MORAN	PQ. BOLIVAR	ESCUELA BOLIVARIANA EL PALMAR	1551	3	45	1281	845	1236	0	2	0	0	389	1281
EDO. LARA	MP. MORAN	PQ. BOLIVAR	UNIDAD EDUCATIVA NACIONAL JOSE PIO TAMAYO	1244	3	13	1055	673	1042	0	6	2	1	360	1055
EDO. LARA	MP. MORAN	PQ. BOLIVAR	ESCUELA BOLIVARIANA YOGORE	593	1	8	487	371	479	0	3	0	0	105	487
EDO. LARA	MP. MORAN	PQ. BOLIVAR	UNIDAD EDUCATIVA PADRE PEREZ LIMARDO	3274	6	41	2535	1120	2494	2	18	6	0	1348	2535
EDO. LARA	MP. MORAN	PQ. BOLIVAR	ESCUELA BOLIVARIANA JORNEDA COMPLETA LOS PATIOS	164	1	2	149	112	147	0	1	0	1	33	149
EDO. LARA	MP. MORAN	PQ. BOLIVAR	UNIDAD EDUCATIVA NACIONAL. JESUS ARFILIO MOGOLLON OVALLES	1098	2	23	898	782	875	0	4	0	0	89	898
EDO. LARA	MP. MORAN	PQ. BOLIVAR	UNIDAD EDUCATIVA NACIONAL  MARIA CONSUELO TORCATES DE MONACO	1702	3	56	1354	776	1298	0	11	0	2	509	1354
EDO. LARA	MP. MORAN	PQ. BOLIVAR	ESCUELA BOLIVARIANA LAS ADJUNTAS	1256	3	12	977	781	965	1	5	0	0	178	977
EDO. LARA	MP. MORAN	PQ. BOLIVAR	ESCUELA CONCENTRADA SANTA RITA	1249	3	28	1097	715	1069	0	7	1	3	343	1097
EDO. LARA	MP. MORAN	PQ. BOLIVAR	UNIDAD EDUCATIVA NACIONAL CONCENTRADA EL OLIVO	847	2	11	642	488	631	0	3	1	0	139	642
EDO. LARA	MP. MORAN	PQ. BOLIVAR	ESCUELA BOLIVARIANA PEDRO MANUEL GUEDEZ	490	1	2	440	400	438	0	1	0	0	37	440
EDO. LARA	MP. MORAN	PQ. BOLIVAR	GRUPO ESCOLAR ROBERTO MONTESINOS	3575	7	82	2952	1217	2870	1	19	1	1	1631	2952
EDO. LARA	MP. MORAN	PQ. BOLIVAR	FUNDASABUM	733	2	26	553	249	527	1	6	1	0	270	553
EDO. LARA	MP. MORAN	PQ. BOLIVAR	CENTRO DE EDUCACION INICIAL EL BOSQUE	1173	2	12	989	532	977	1	7	0	0	437	989
EDO. LARA	MP. MORAN	PQ. BOLIVAR	ESCUELA ESTADAL UNITARIA  CURARIGUITA	56	1	1	55	41	54	1	1	1	0	10	55
EDO. LARA	MP. MORAN	PQ. BOLIVAR	BIBLIOTECA PUBLICA ALCIDES LOZADA	675	2	6	539	243	533	2	3	0	0	285	539
EDO. LARA	MP. MORAN	PQ. BOLIVAR	ESCUELA CONCENTRADA EL HATICO	1088	2	20	847	649	827	0	6	0	0	172	847
EDO. LARA	MP. MORAN	PQ. LA CANDELARIA	ESCUELA BOLIVARIANA TIERRA DE LOZA	302	1	6	201	184	195	0	0	1	0	10	201
EDO. LARA	MP. MORAN	PQ. LA CANDELARIA	ESCUELA ESTADAL UNITARIA LA MESA DE GUAITO	181	1	1	125	115	124	0	0	0	0	9	125
EDO. LARA	MP. MORAN	PQ. LA CANDELARIA	ESCUELA BOLIVARIANA  PALMA RICA	474	1	13	356	307	343	0	1	0	1	34	356
EDO. LARA	MP. MORAN	PQ. LA CANDELARIA	ESCUELA BOLIVARIANA JACINTO LARA	548	1	8	372	320	364	0	0	0	0	44	372
EDO. LARA	MP. JIMENEZ	PQ. CRNEL. MARIANO PERAZA	ESCUELA BASICA ESTADAL EL CAMBURAL NER 475	333	1	10	262	192	252	1	1	0	1	57	262
EDO. LARA	MP. JIMENEZ	PQ. CRNEL. MARIANO PERAZA	UNIDAD EDUCATIVA BOLIVARIANA EL PARAPARO NUCLEO ESCOLAR	195	1	4	173	140	169	0	1	1	0	27	173
EDO. LARA	MP. JIMENEZ	PQ. CRNEL. MARIANO PERAZA	UNIDAD EDUCATIVA BOLIVARIANA LA GUAROA	798	2	23	705	448	682	0	6	0	1	227	705
EDO. LARA	MP. JIMENEZ	PQ. CRNEL. MARIANO PERAZA	CENTRO DE EDUCACION INICIAL ROSA ISABEL ANGULO	2345	5	44	2005	1024	1961	1	17	1	4	914	2005
EDO. LARA	MP. JIMENEZ	PQ. CRNEL. MARIANO PERAZA	UNIDAD EDUCATIVA BOLIVARIANA LAS FLORES NUCLEO ESCOLAR	592	1	11	529	357	518	0	6	2	1	152	529
EDO. LARA	MP. JIMENEZ	PQ. CRNEL. MARIANO PERAZA	UNIDAD EDUCATIVA NACIONAL BOLIVARIANA LOS JEBES	347	1	9	281	204	272	0	1	1	0	66	281
EDO. LARA	MP. JIMENEZ	PQ. CRNEL. MARIANO PERAZA	UNIDAD EDUCATIVA ESTADAL EDILBERTO SANCHEZ CACERES	3199	6	53	2619	1417	2566	1	23	2	0	1123	2619
EDO. LARA	MP. JIMENEZ	PQ. CRNEL. MARIANO PERAZA	CENTRO DE EDUCACION INICIAL SIMONCITO BOLIVARIANO FRANCISCO DE MIRANDA	662	2	9	597	378	588	0	5	0	3	202	597
EDO. LARA	MP. JIMENEZ	PQ. CRNEL. MARIANO PERAZA	CASA COMUNAL ARENALES I	616	2	25	541	372	516	2	2	2	0	138	541
EDO. LARA	MP. JIMENEZ	PQ. JUAN B RODRIGUEZ	CENTRO DE EDUCACION INICIAL CARMEN ELENA ARGUELLES DE LARA	1039	2	21	939	394	918	0	7	0	0	517	939
EDO. LARA	MP. JIMENEZ	PQ. JUAN B RODRIGUEZ	ESCUELA BASICA NACIONAL MATEO LISCANO TORRES	3232	6	38	2646	1229	2608	1	15	0	1	1362	2646
EDO. LARA	MP. JIMENEZ	PQ. JUAN B RODRIGUEZ	CENTRO DE EDUCACION INICIAL BOLIVARIANO SIMONCITO CONCEPCION CORTEZ DE LARA	418	1	13	373	231	360	0	1	0	1	127	373
EDO. LARA	MP. JIMENEZ	PQ. JUAN B RODRIGUEZ	SIMONCITO COMUNITARIO MIS SUEÑOS	375	1	5	347	279	342	0	2	0	0	61	347
EDO. LARA	MP. JIMENEZ	PQ. JUAN B RODRIGUEZ	ESCUELA BASICA OJO DE AGUA ARRIBA NUCLEO ESCOLAR RURAL	205	1	3	186	146	183	0	1	0	0	36	186
EDO. LARA	MP. JIMENEZ	PQ. JUAN B RODRIGUEZ	UNIDAD EDUCATIVA NACIONAL PROFESOR PASTOR CORTEZ VASQUEZ	2105	4	33	1747	747	1714	0	7	0	3	957	1747
EDO. LARA	MP. JIMENEZ	PQ. JUAN B RODRIGUEZ	UNIDAD EDUCATIVA BOLIVARIANA EL PUEBLITO	487	1	8	451	382	443	0	2	0	0	59	451
EDO. LARA	MP. JIMENEZ	PQ. JUAN B RODRIGUEZ	UNIDAD EDUCATIVA  BOLIVARIANA NUESTRA SEÑORA DE GUADALUPE	1725	3	31	1201	937	1170	1	8	2	1	221	1201
EDO. LARA	MP. JIMENEZ	PQ. JUAN B RODRIGUEZ	UNIDAD EDUCATIVA NACIONAL PLAYA BONITA	820	2	15	709	444	694	1	4	1	0	244	709
EDO. LARA	MP. JIMENEZ	PQ. JUAN B RODRIGUEZ	CASA COMUNAL LA ISLA ALTAGRACIA	242	1	4	207	143	203	1	2	1	0	56	207
EDO. LARA	MP. JIMENEZ	PQ. JUAN B RODRIGUEZ	UNIDAD EDUCATIVA NACIONAL RICARDO ARCADIO YEPEZ	3445	6	68	2850	1755	2782	1	22	1	1	1002	2850
EDO. LARA	MP. JIMENEZ	PQ. JUAN B RODRIGUEZ	UNIDAD EDUCATIVA NACIONAL TOMAS LISCANO	2813	5	23	2456	1092	2433	0	15	1	2	1323	2456
EDO. LARA	MP. JIMENEZ	PQ. JUAN B RODRIGUEZ	ALDEA UNIVERSITARIA MANUELA SAENZ   MISION SUCRE	443	1	7	373	323	366	0	1	2	0	40	373
EDO. LARA	MP. JIMENEZ	PQ. JUAN B RODRIGUEZ	CENTRO DE EDUCACION INICIAL ANA GRANADO (FUNDACION DEL NIÑO)	827	2	14	729	512	715	1	5	0	0	197	729
EDO. LARA	MP. JIMENEZ	PQ. JUAN B RODRIGUEZ	UNIDAD EDUCATIVA NACIONAL MAESTRO ORLANDO RAMON JIMENEZ	5322	10	74	4229	2371	4155	3	39	4	4	1734	4229
EDO. LARA	MP. JIMENEZ	PQ. JUAN B RODRIGUEZ	CASA COMUNAL BARRIO LIBERTADOR	343	1	2	317	278	315	0	1	1	0	35	317
EDO. LARA	MP. JIMENEZ	PQ. JUAN B RODRIGUEZ	UNIDAD EDUCATIVA ESTADAL  GENERAL FLORENCIO JIMENEZ	2998	6	52	2340	1737	2288	1	20	0	1	529	2340
EDO. LARA	MP. JIMENEZ	PQ. TINTORERO	ESCUELA BOLIVARIANA LAS CAMPANAS	610	2	13	495	364	482	2	4	2	0	110	495
EDO. LARA	MP. JIMENEZ	PQ. TINTORERO	UNIDAD EDUCATIVA NACIONAL MARIA CELESTINA GARCIA	1602	3	29	1398	1008	1369	0	9	1	0	351	1398
EDO. LARA	MP. JIMENEZ	PQ. TINTORERO	ESCUELA BOLIVARIANA EL POZON	273	1	2	255	178	253	0	0	0	1	74	255
EDO. LARA	MP. JIMENEZ	PQ. TINTORERO	UNIDAD EDUCATIVA ESTATAL HISPOPAL	428	1	7	354	304	347	0	2	0	0	41	354
EDO. LARA	MP. JIMENEZ	PQ. TINTORERO	UNIDAD EDUCATIVA NACIONAL CAMPO LINDO	1731	3	30	1369	831	1339	1	10	3	2	492	1369
EDO. LARA	MP. JIMENEZ	PQ. TINTORERO	ESCUELA PRIMARIA BOLIVARIANA EL AUYAMAL	439	1	7	408	246	401	0	4	1	0	150	408
EDO. LARA	MP. JIMENEZ	PQ. TINTORERO	ESCUELA BOLIVARIANA JORNADA COMPLETA EL VIGIADERO	521	1	11	410	330	399	0	2	0	1	66	410
EDO. LARA	MP. JIMENEZ	PQ. TINTORERO	UNIDAD EDUCATIVA JUAN BAUTISTA OVIEDO BRACHO	742	2	29	588	304	559	0	0	0	0	255	588
EDO. LARA	MP. JIMENEZ	PQ. TINTORERO	ESCUELA UNITARIA EL RODEO	1176	2	19	969	645	950	0	7	0	2	296	969
EDO. LARA	MP. JIMENEZ	PQ. TINTORERO	UNIDAD EDUCATIVA NACIONAL BOLIVARIANA EL PATRIOTA	481	1	10	414	244	404	0	3	1	1	155	414
EDO. LARA	MP. JIMENEZ	PQ. SAN MIGUEL	ESCUELA NACIONAL BOLIVARIANA CANTARRANA	418	1	2	343	313	341	0	0	0	0	28	343
EDO. LARA	MP. JIMENEZ	PQ. SAN MIGUEL	ESCUELA NACIONAL EL VOLCANCITO	267	1	0	232	207	232	0	4	0	0	21	232
EDO. LARA	MP. JIMENEZ	PQ. SAN MIGUEL	ESCUELA UNITARIA LAS TABLAS	136	1	1	111	100	110	1	1	1	0	7	111
EDO. LARA	MP. JIMENEZ	PQ. SAN MIGUEL	ESCUELA BOLIVARIANA JORNADA COMPLETA EL TURBIO	1661	3	13	1262	881	1249	0	14	1	0	353	1262
EDO. LARA	MP. JIMENEZ	PQ. SAN MIGUEL	UNIDAD EDUCATIVA ESTADAL PASO DEL RIO	279	1	6	230	195	224	0	2	0	0	27	230
EDO. LARA	MP. JIMENEZ	PQ. PARAISO DE SAN JOSE	ESCUELA PRIMARIA BOLIVARIANA MEDIA JORNADA EL ZANCUDO	238	1	2	180	156	178	1	0	0	0	21	180
EDO. LARA	MP. JIMENEZ	PQ. PARAISO DE SAN JOSE	ESCUELA BOLIVARIANA RAFAEL RAMÓN SUÁREZ	867	2	13	707	603	694	0	1	1	0	89	707
EDO. LARA	MP. JIMENEZ	PQ. CUARA	ESCUELA BASICA QUEBRADA SECA	229	1	5	209	141	204	0	2	0	0	61	209
EDO. LARA	MP. JIMENEZ	PQ. CUARA	ESCUELA BOLIVARIANA MAESTRO FELICIANO RODRIGUEZ	1407	3	24	1114	847	1090	0	9	2	0	232	1114
EDO. LARA	MP. JIMENEZ	PQ. CUARA	UNIDAD EDUCATIVA NACIONAL MOCUNDO	169	1	3	157	86	154	0	3	0	0	65	157
EDO. LARA	MP. JIMENEZ	PQ. CUARA	ESCUELA GRANJA BOLIVARIANA CUARA	1511	3	16	1255	736	1239	1	9	1	0	492	1255
EDO. LARA	MP. JIMENEZ	PQ. DIEGO DE LOZADA	UNIDAD EDUCATIVA BOLIVARIANA LA RELUCIENTE NUCLEO ESCOLAR RURAL 304	341	1	6	313	265	307	0	0	0	0	42	313
EDO. LARA	MP. JIMENEZ	PQ. DIEGO DE LOZADA	ESCUELA PRIMARIA BOLIVARIANA MEDIA JORNADA QUEBRADA ARRIBA	583	1	13	416	338	403	0	3	1	0	61	416
EDO. LARA	MP. JIMENEZ	PQ. DIEGO DE LOZADA	ESCUELA UNITARIA PARAMO ABAJO	522	1	6	410	325	404	0	7	1	0	71	410
EDO. LARA	MP. JIMENEZ	PQ. DIEGO DE LOZADA	UNIDAD EDUCATIVA BOLIVARIANA PIEDRA DE OJO	614	2	9	522	412	513	0	5	0	0	96	522
EDO. LARA	MP. JIMENEZ	PQ. DIEGO DE LOZADA	LICEO NACIONAL BOLIVARIANO PEPE COLOMA	2429	5	61	2013	973	1952	0	9	3	0	967	2013
EDO. LARA	MP. JIMENEZ	PQ. DIEGO DE LOZADA	UNIDAD EDUCATIVA NACIONAL  PROFESOR ALEXANDER CORTEZ	894	2	19	719	479	700	0	12	0	0	209	719
EDO. LARA	MP. JIMENEZ	PQ. JOSE BERNARDO DORANTE	UNIDAD BOLIVARIANA CERRO MORON	482	1	9	368	286	359	0	4	0	0	69	368
EDO. LARA	MP. JIMENEZ	PQ. JOSE BERNARDO DORANTE	ESCUEL BOLIVARIANA NACIONAL EMPERATRIZ DE AGÜERO (LA VIGIA)	988	2	23	831	503	808	0	6	1	0	298	831
EDO. LARA	MP. JIMENEZ	PQ. JOSE BERNARDO DORANTE	UNIDAD EDUCATIVA CHAIMARE ARRIBA NUCLEO ESCOLAR RURAL	322	1	5	294	220	289	0	5	1	0	63	294
EDO. LARA	MP. JIMENEZ	PQ. JOSE BERNARDO DORANTE	ESCUELA NACIONAL CONCENTRADA CERRITO DE SAN JOSE	1009	2	36	859	484	823	0	10	2	0	327	859
EDO. LARA	MP. JIMENEZ	PQ. JOSE BERNARDO DORANTE	UNIDAD EDUCATIVA MEDIA JORNADA CERRO PELON	384	1	8	367	323	359	0	1	0	0	35	367
EDO. LARA	MP. JIMENEZ	PQ. JOSE BERNARDO DORANTE	UNIDAD EDUCATIVA BOLIVARIANA EL HATO	1525	3	22	1188	664	1166	0	5	0	0	497	1188
EDO. LARA	MP. JIMENEZ	PQ. JOSE BERNARDO DORANTE	UNIDAD EDUCATIVA LOS EJIDOS NUCLEO ESCOLAR RURAL 221	323	1	6	304	261	298	0	2	0	1	34	304
EDO. LARA	MP. JIMENEZ	PQ. JOSE BERNARDO DORANTE	UNIDAD EDUCATIVA LA FLORENCIA NUCLEO ESCOLAR RURAL 221	327	1	9	307	227	298	0	1	1	1	68	307
EDO. LARA	MP. JIMENEZ	PQ. JOSE BERNARDO DORANTE	UNIDAD EDUCATIVA NACIONAL ANTONIO JOSE DE SUCRE	1116	2	16	890	605	874	2	7	1	0	259	890
EDO. LARA	MP. JIMENEZ	PQ. JOSE BERNARDO DORANTE	UNIDAD EDUCATIVA NACIONAL SAN JOSE DE QUIBOR	1403	3	29	1133	806	1104	0	5	1	1	291	1133
EDO. LARA	MP. TORRES	PQ. EL BLANCO	ESCUELA BASICA TRINIDAD SAMUEL	2306	4	24	1789	929	1765	1	8	0	0	827	1789
EDO. LARA	MP. TORRES	PQ. EL BLANCO	ESCUELA NACIONAL UNITARIA NÚMERO 1581	285	1	2	189	152	187	0	1	1	0	33	189
EDO. LARA	MP. TORRES	PQ. EL BLANCO	ESCUELA YARABANA	203	1	2	162	90	160	1	1	1	0	67	162
EDO. LARA	MP. TORRES	PQ. EL BLANCO	ESCUELA BASICA EL PALMICHAL	206	1	3	162	141	159	0	1	0	0	17	162
EDO. LARA	MP. TORRES	PQ. EL BLANCO	ESCUELA ESTADAL LA LUCIA	155	1	7	82	14	75	0	3	0	0	58	82
EDO. LARA	MP. TORRES	PQ. EL BLANCO	ESCUELA UNITARIA NUMERO 13	243	1	0	121	29	121	1	1	0	0	90	121
EDO. LARA	MP. TORRES	PQ. EL BLANCO	ESCUELA BASICA EL CERRON	323	1	4	217	133	213	0	1	0	0	79	217
EDO. LARA	MP. TORRES	PQ. EL BLANCO	ESCUELA UNITARIA LAS FLORES	84	1	0	57	20	57	1	0	0	0	36	57
EDO. LARA	MP. TORRES	PQ. EL BLANCO	UNIDAD EDUCATIVA NACIONAL  TRINIDAD SAMUEL	2045	4	25	1618	911	1593	0	6	1	0	675	1618
EDO. LARA	MP. TORRES	PQ. EL BLANCO	ESCUELA BASICA UNITARIA EL JORDAN	241	1	2	106	79	104	0	2	0	0	23	106
EDO. LARA	MP. TORRES	PQ. EL BLANCO	ESCUELA BASICA NACIONAL UNITARIA EL GUARABAL	67	1	0	18	9	18	0	0	0	0	9	18
EDO. LARA	MP. TORRES	PQ. MANUEL MORILLO	UNIDAD EDUCATIVA NACIONAL SIMON CASTEJON	1189	2	16	961	758	945	0	2	0	1	184	961
EDO. LARA	MP. TORRES	PQ. MANUEL MORILLO	ESCUELA EL PICUDO	106	1	4	76	57	72	0	1	0	0	14	76
EDO. LARA	MP. TORRES	PQ. MANUEL MORILLO	ESCUELA BASICA ELMA SILVEIRA	1041	2	22	774	402	752	0	4	0	0	346	774
EDO. LARA	MP. TORRES	PQ. LAS MERCEDES	ESCUELA UNITARIA NACIONAL NO 1690	828	2	10	668	521	658	0	2	0	0	135	668
EDO. LARA	MP. TORRES	PQ. LAS MERCEDES	ESCUELA CONCENTRADA LAS PLAYITAS	966	2	31	781	411	750	1	5	1	1	331	781
EDO. LARA	MP. TORRES	PQ. LAS MERCEDES	ESCUELA BASICA NACIONAL  BOLIVARIANA EL ESCOBAL	300	1	7	228	114	221	1	1	0	0	105	228
EDO. LARA	MP. TORRES	PQ. LAS MERCEDES	ESCUELA ESTADAL BOLIVARIANA LOS QUEDICHES	396	1	8	312	227	304	1	1	1	0	74	312
EDO. LARA	MP. TORRES	PQ. LAS MERCEDES	ESCUELA UNITARIA NUMERO 245	112	1	1	58	37	57	0	0	0	0	20	58
EDO. LARA	MP. TORRES	PQ. LAS MERCEDES	ESCUELA BOLIVARIANA SIRUMITA	249	1	5	216	139	211	0	3	0	0	69	216
EDO. LARA	MP. TORRES	PQ. LAS MERCEDES	ESCUELA BOLIVARIANA NUMERO 4330	606	2	13	449	172	436	1	0	0	0	263	449
EDO. LARA	MP. TORRES	PQ. LAS MERCEDES	UNIDAD EDUCATIVA NACIONAL JUAN JOSE BRACHO	2262	4	33	1793	1148	1760	0	8	1	0	603	1793
EDO. LARA	MP. TORRES	PQ. TORRES	GRUPO ESCOLAR FRANCISCO SUAREZ	1113	2	14	744	463	730	0	4	2	0	261	744
EDO. LARA	MP. TORRES	PQ. ANTONIO DIAZ	ESCUELA BOLIVARIANA NACIONAL TUNALITO	298	1	11	229	181	218	0	4	0	0	33	229
EDO. LARA	MP. TORRES	PQ. ANTONIO DIAZ	ESCUELA BOLIVARIANA LUIS HERIZE PONTE	2272	4	26	1664	934	1638	0	5	1	1	697	1664
EDO. LARA	MP. TORRES	PQ. ANTONIO DIAZ	ESCUELA BOLIVARIANA MONSEÑOR DE JOSE DE JESUS SILVA	270	1	0	185	131	185	0	0	0	0	54	185
EDO. LARA	MP. TORRES	PQ. ANTONIO DIAZ	ESCUELA BASICA NO 127	219	1	0	146	119	146	0	1	1	0	25	146
EDO. LARA	MP. TORRES	PQ. ANTONIO DIAZ	ESCUELA BASICA ESTATAL NO 121	220	1	5	173	136	168	0	0	0	0	32	173
EDO. LARA	MP. TORRES	PQ. ANTONIO DIAZ	ESCUELA UNITARIA LA RINCONADA	347	1	6	279	146	273	0	2	0	0	125	279
EDO. LARA	MP. TORRES	PQ. CECILIO ZUBILLAGA	ESCUELA BASICA NACIONAL MONTAÑA VERDES	924	2	7	748	614	741	0	2	1	0	124	748
EDO. LARA	MP. TORRES	PQ. CECILIO ZUBILLAGA	ESCUELA BASICA MONSEÑOR SALVADOR MONTES DE OCA	2352	5	48	1907	1395	1859	0	9	1	1	453	1907
EDO. LARA	MP. TORRES	PQ. CECILIO ZUBILLAGA	UNIDAD EDUCATIVA NACIONAL  CREACION V	1319	3	19	1094	768	1075	0	5	1	0	301	1094
EDO. LARA	MP. TORRES	PQ. TRINIDAD SAMUEL	CASA COMUNAL INTEGRAL BARRIO NUEVO	651	2	19	586	410	567	0	3	0	0	154	586
EDO. LARA	MP. TORRES	PQ. TRINIDAD SAMUEL	ESCUELA UNITARIA  SAN VICENTE	829	2	22	736	499	714	0	5	1	0	209	736
EDO. LARA	MP. TORRES	PQ. TRINIDAD SAMUEL	ESCUELA BASICA NACIONAL  PEDRO LEON TORRES	2442	5	16	2092	557	2076	0	5	1	1	1512	2092
EDO. LARA	MP. TORRES	PQ. TRINIDAD SAMUEL	UNIDAD EDUCATIVA NACIONAL  RAMON POMPILIO OROPEZA	2522	5	32	2045	755	2013	0	11	0	0	1247	2045
EDO. LARA	MP. TORRES	PQ. TRINIDAD SAMUEL	LICEO SECUNDARIO BOLIVARIANO ANDRES BELLO	822	2	11	738	417	727	0	3	0	1	306	738
EDO. LARA	MP. TORRES	PQ. TRINIDAD SAMUEL	GRUPO ESCUELA PRISCILO VELIZ	2077	4	44	1696	794	1652	1	8	0	0	849	1696
EDO. LARA	MP. TORRES	PQ. TRINIDAD SAMUEL	CENTRO DE EDUCACION INICIAL SIMON RODRIGUEZ	1113	2	19	967	463	948	1	4	1	0	479	967
EDO. LARA	MP. TORRES	PQ. TRINIDAD SAMUEL	SALON DE LA ALCALDIA DEL MUNICIPIO TORRES	889	2	10	735	276	725	0	1	0	0	448	735
EDO. LARA	MP. TORRES	PQ. TRINIDAD SAMUEL	PRE ESCOLAR JOSEITO RIERA	669	2	15	553	349	538	0	7	0	0	182	553
EDO. LARA	MP. TORRES	PQ. TRINIDAD SAMUEL	PRE ESCOLAR DON PIO ALVARADO	1470	3	49	1262	659	1213	0	6	0	0	548	1262
EDO. LARA	MP. TORRES	PQ. TRINIDAD SAMUEL	ESCUELA BASICA CARORA	2741	5	36	2220	1088	2184	0	10	0	1	1085	2220
EDO. LARA	MP. TORRES	PQ. TRINIDAD SAMUEL	COLEGIO NUESTRA SEÑORA DEL ROSARIO	1442	3	19	1294	421	1275	0	2	0	1	851	1294
EDO. LARA	MP. TORRES	PQ. TRINIDAD SAMUEL	JARDIN DE INFANCIA MARIA PERERA	991	2	8	833	281	825	0	4	0	0	540	833
EDO. LARA	MP. TORRES	PQ. TRINIDAD SAMUEL	UNIDAD EDUCATIVA NACIONAL  JUAN BAUTISTA FRANCO	3979	7	53	3218	1575	3165	1	8	2	1	1578	3218
EDO. LARA	MP. TORRES	PQ. TRINIDAD SAMUEL	ESCUELA BASICA EL TERMINAL	869	2	38	742	474	704	2	8	2	0	218	742
EDO. LARA	MP. TORRES	PQ. TRINIDAD SAMUEL	ESCUELA ESTADAL CONCENTRADA CERRO PELON CELESTINO CARRASCO	211	1	5	189	149	184	0	2	0	0	33	189
EDO. LARA	MP. TORRES	PQ. TRINIDAD SAMUEL	UNIDAD EDUCATIVA ESTADAL RAIMUNDO PERNALETE	4346	8	64	3501	1774	3437	1	23	1	5	1633	3501
EDO. LARA	MP. TORRES	PQ. TRINIDAD SAMUEL	ESCUELA BASICA CREACION CALICANTO	4378	8	67	3653	1853	3586	2	25	2	0	1704	3653
EDO. LARA	MP. TORRES	PQ. TRINIDAD SAMUEL	UNIDAD EDUCATIVA NACIONAL  MADRE EMILIA	790	2	12	703	412	691	0	6	1	0	272	703
EDO. LARA	MP. TORRES	PQ. TRINIDAD SAMUEL	UNIDAD EDUCATIVA ESTADAL  PROFESOR MIGUEL ANGEL PINTO	1906	4	52	1640	1120	1588	0	14	3	0	451	1640
EDO. LARA	MP. TORRES	PQ. TRINIDAD SAMUEL	UNIDAD EDUCATIVA QUEBRADA GRANDE	479	1	11	425	274	414	0	3	1	0	136	425
EDO. LARA	MP. TORRES	PQ. TRINIDAD SAMUEL	ESCUELA UNITARIA NUMERO 91	286	1	6	180	123	174	2	2	0	1	46	180
EDO. LARA	MP. TORRES	PQ. TRINIDAD SAMUEL	UNIDAD EDUCATIVA NACIONAL  DR JULIO SEGUNDO ALVAREZ	3062	6	59	2595	1097	2536	2	12	2	2	1421	2595
EDO. LARA	MP. TORRES	PQ. TRINIDAD SAMUEL	INCE	1466	3	32	1200	509	1168	0	8	0	1	650	1200
EDO. LARA	MP. TORRES	PQ. TRINIDAD SAMUEL	ESCUELA BOLIVARIANA MAESTRO JORGE RODRIGUEZ	530	1	8	389	272	381	1	2	0	0	106	389
EDO. LARA	MP. TORRES	PQ. TRINIDAD SAMUEL	CENTRO SOCIAL DEPORTIVO PUEBLO APARTE	1262	3	26	1025	506	999	1	8	0	0	484	1025
EDO. LARA	MP. TORRES	PQ. TRINIDAD SAMUEL	PARQUE EXPOSICION TEODORO HERRERA	939	2	10	761	368	751	1	5	0	1	376	761
EDO. LARA	MP. TORRES	PQ. TRINIDAD SAMUEL	CENTRO DE EDUCACION INICIAL JARDIN INICIAL PRISCILO VELIZ	1090	2	13	890	453	877	0	2	1	0	421	890
EDO. LARA	MP. TORRES	PQ. TRINIDAD SAMUEL	ESCUELA NACIONAL MOREDE	3329	6	53	2746	1173	2693	0	16	2	2	1500	2746
EDO. LARA	MP. TORRES	PQ. TRINIDAD SAMUEL	ESCUELA BOLIVARIANA EDUCADORA LUZ DE CARRASCO	126	1	1	118	82	117	0	5	0	0	30	118
EDO. LARA	MP. TORRES	PQ. TRINIDAD SAMUEL	ESCUELA CONCENTRADA LOS ARANGUES	1112	2	6	848	733	842	0	6	0	0	103	848
EDO. LARA	MP. TORRES	PQ. TRINIDAD SAMUEL	AEROPUERTO LA GREDA	207	1	3	136	76	133	0	1	0	0	56	136
EDO. LARA	MP. TORRES	PQ. TRINIDAD SAMUEL	GIMNASIO CUBIERTO EL PENTAGONO	439	1	8	359	191	351	1	2	0	0	157	359
EDO. LARA	MP. TORRES	PQ. TRINIDAD SAMUEL	ESCUELA BOLIVARIANA SABANA GRANDE	513	1	6	465	419	459	0	3	0	0	37	465
EDO. LARA	MP. TORRES	PQ. TRINIDAD SAMUEL	ESCUELA BASICA ARGENIS GRATEROL	4256	8	96	3644	1781	3548	2	16	3	5	1741	3644
EDO. LARA	MP. TORRES	PQ. TRINIDAD SAMUEL	ESCUELA BOLIVARIANA CARLOS SAMPAYO	823	2	15	741	443	726	0	5	0	0	278	741
EDO. LARA	MP. TORRES	PQ. TRINIDAD SAMUEL	INSTITUTO UNIVERSITARIO DE TECNOLOGIA MARIO BRICEÑO IRAGORRY	553	1	8	506	204	498	0	2	2	0	290	506
EDO. LARA	MP. TORRES	PQ. TRINIDAD SAMUEL	COLEGIO MONSEÑOR PEDRO FELIPE MONTES DE OCA	1134	2	15	978	471	963	0	4	0	0	488	978
EDO. LARA	MP. TORRES	PQ. TRINIDAD SAMUEL	UNIDAD EDUCATIVA ESPECIAL CARORA	371	1	3	319	143	316	0	2	0	0	171	319
EDO. LARA	MP. TORRES	PQ. TRINIDAD SAMUEL	LICEO BOLIVARIANO EJIDIO MONTESINOS	1520	3	21	1343	500	1322	0	1	0	0	821	1343
EDO. LARA	MP. TORRES	PQ. TRINIDAD SAMUEL	UNIVERSIDAD CENTROOCIDENTAL LISANDRO ALVARADO NUCLEO TORRES	944	2	10	777	284	767	0	2	0	0	481	777
EDO. LARA	MP. TORRES	PQ. TRINIDAD SAMUEL	ESCUELA BASICA BOLIVARIANA CARORA I	2497	5	35	2059	1240	2024	0	8	0	0	776	2059
EDO. LARA	MP. TORRES	PQ. TRINIDAD SAMUEL	CENTRO DE EDUCACION INICIAL CALICANTO	757	2	22	658	313	636	0	1	0	0	322	658
EDO. LARA	MP. TORRES	PQ. TRINIDAD SAMUEL	ESCUELA CONCENTRADA SICARIGUA	579	1	9	473	417	464	1	3	0	0	43	473
EDO. LARA	MP. TORRES	PQ. TRINIDAD SAMUEL	ESCUELA ESTADAL JOSE ANTONIO ROJAS	395	1	5	267	174	262	0	2	0	0	86	267
EDO. LARA	MP. TORRES	PQ. TRINIDAD SAMUEL	ESCUELA UNITARIA GUAIGUAYURE	760	2	9	652	379	643	0	0	0	0	264	652
EDO. LARA	MP. TORRES	PQ. TRINIDAD SAMUEL	GRUPO ESCOLAR JOSE HERRERA OROPEZA	5086	9	73	4246	2022	4173	5	17	4	1	2124	4246
EDO. LARA	MP. TORRES	PQ. TRINIDAD SAMUEL	UNIDAD EDUCATIVA  COLEGIO CRISTO REY	3054	6	63	2577	941	2514	1	14	0	1	1557	2577
EDO. LARA	MP. TORRES	PQ. LARA	ESCUELA BOLIVARIANA ROSENDO PERDOMO	1027	2	13	829	491	816	0	4	1	1	319	829
EDO. LARA	MP. TORRES	PQ. LARA	ESCUELA SABANETA	106	1	1	80	63	79	0	0	0	0	16	80
EDO. LARA	MP. TORRES	PQ. CHIQUINQUIRA	ESCUELA UNITARIA EL CUJI	384	1	5	272	154	267	0	1	1	0	111	272
EDO. LARA	MP. TORRES	PQ. CHIQUINQUIRA	ESCUELA NACIONAL UNITARIA SAN CRISTOBAL	213	1	1	156	60	155	0	1	0	0	94	156
EDO. LARA	MP. TORRES	PQ. CHIQUINQUIRA	ESCUELA CONCENTRADA ESTADAL PALO DE OLOR	382	1	5	324	185	319	0	1	0	0	133	324
EDO. LARA	MP. TORRES	PQ. CHIQUINQUIRA	ESCUELA UNITARIA CIENEGA DE COLLAE	78	1	0	67	32	67	0	0	1	0	34	67
EDO. LARA	MP. TORRES	PQ. CHIQUINQUIRA	UNIDAD EDUCATIVA LARGIO JIMENEZ	2710	5	34	2169	1296	2135	0	7	0	1	831	2169
EDO. LARA	MP. TORRES	PQ. MONTA A VERDE	ESCUELA CONCENTRADA SAN PEDRO DEL PARAMO	284	1	8	238	189	230	1	2	0	0	38	238
EDO. LARA	MP. TORRES	PQ. MONTA A VERDE	ESCUELA NACIONAL SICARE	580	1	7	479	407	472	0	3	1	1	60	479
EDO. LARA	MP. TORRES	PQ. MONTA A VERDE	ESCUELA UNITARIA NÚMERO 174	310	1	1	180	105	179	0	1	2	0	71	180
EDO. LARA	MP. TORRES	PQ. MONTA A VERDE	ESCUELA NACIONAL AGUA LINDA	124	1	2	108	77	106	0	0	0	0	29	108
EDO. LARA	MP. TORRES	PQ. MONTA A VERDE	UNIDAD EDUCATIVA NACIONAL PALMARITO	2457	5	33	1800	1100	1767	1	16	7	2	641	1800
EDO. LARA	MP. TORRES	PQ. MONTA A VERDE	ESCUELA PRIMARIA BOLIVARIANA AGUAS CALIENTES	212	1	0	182	143	182	0	0	1	0	38	182
EDO. LARA	MP. TORRES	PQ. MONTA A VERDE	ESCUELA BOLIVARIANA MATAGEY	459	1	3	337	204	334	0	0	0	0	130	337
EDO. LARA	MP. TORRES	PQ. MONTA A VERDE	ESCUELA BOLIVARIANA EL MORROCO	1160	2	18	825	458	807	0	10	1	0	338	825
EDO. LARA	MP. TORRES	PQ. MONTA A VERDE	ESCUELA BOLIVARIANA LA SABANA	361	1	4	321	257	317	0	0	1	1	58	321
EDO. LARA	MP. TORRES	PQ. MONTA A VERDE	ESCUELA BOLIVARIANA LA ESPERANZA	281	1	1	234	194	233	0	3	0	0	36	234
EDO. LARA	MP. TORRES	PQ. MONTA A VERDE	ESCUELA UNITARIA CERRO VERDE	322	1	4	240	198	236	0	3	0	0	35	240
EDO. LARA	MP. TORRES	PQ. MONTA A VERDE	ESCUELA ESTADAL RIO CHIQUITO	221	1	4	121	88	117	0	2	0	0	27	121
EDO. LARA	MP. TORRES	PQ. MONTA A VERDE	ESCUELA BOLIVARIANA LAS COCUIZAS	314	1	4	299	249	295	0	0	0	0	46	299
EDO. LARA	MP. TORRES	PQ. MONTA A VERDE	ESCUELA ESTADAL PUERTO RICO	305	1	8	202	112	194	0	6	1	0	75	202
EDO. LARA	MP. TORRES	PQ. ESPINOZA LOS MONTEROS	ESCUELA UNITARIA LAS NIEVES	142	1	1	135	128	134	0	1	0	0	5	135
EDO. LARA	MP. TORRES	PQ. ESPINOZA LOS MONTEROS	ESCUELA CONCENTRADA PUENTE TORRES	1091	2	15	853	541	838	0	5	1	1	290	853
EDO. LARA	MP. TORRES	PQ. ESPINOZA LOS MONTEROS	ESCUELA CONCENTRADA MIXTA NÚMERO 1773 CASCAJALES	215	1	1	203	181	202	0	0	0	1	20	203
EDO. LARA	MP. TORRES	PQ. ESPINOZA LOS MONTEROS	ESCUELA SAN JOSE DE LOS RANCHOS	407	1	7	307	199	300	0	2	1	1	97	307
EDO. LARA	MP. TORRES	PQ. ESPINOZA LOS MONTEROS	ESCUELA BASICA BOLIVARIANA ANANIAS COTTE	2308	4	58	1863	1074	1805	1	8	0	0	722	1863
EDO. LARA	MP. TORRES	PQ. HERIBERTO ARROYO	ESCUELA UNITARIA LOMA SECA	293	1	2	217	154	215	2	0	0	0	59	217
EDO. LARA	MP. TORRES	PQ. CASTA#EDA	ESCUELA BOLIVARIANA PAULA EDILIA TORRES	73	1	1	63	61	62	0	0	0	0	1	63
EDO. LARA	MP. TORRES	PQ. CASTA#EDA	UNIDAD EDUCATIVA NACIONAL DON GIL ARTURO ZAMBRANO	1526	3	24	1205	631	1181	2	9	0	2	537	1205
EDO. LARA	MP. TORRES	PQ. CASTA#EDA	ESCUELA SAN PABLO
EDO. LARA	MP. TORRES	PQ. CASTA#EDA	ESCUELA JUAN JACINTO LARA	546	1	7	430	289	423	0	6	0	0	128	430
EDO. LARA	MP. TORRES	PQ. CASTA#EDA	ESCUELA NACIONAL CONCENTRADA EL YABITO	366	1	1	245	224	244	0	2	1	5	12	245
EDO. LARA	MP. TORRES	PQ. MONTES DE OCA	ESCUELA BOLIVARIANA SIMON PLANAS	1663	3	20	1193	635	1173	0	9	1	1	527	1193
EDO. LARA	MP. TORRES	PQ. MONTES DE OCA	ESCUELA BASICA ESTADAL LA MAMITA	728	2	17	576	375	559	0	0	0	0	184	576
EDO. LARA	MP. TORRES	PQ. MONTES DE OCA	ESCUELA BASICA TEOFILO CARRASCO	279	1	7	204	100	197	0	0	2	0	95	204
EDO. LARA	MP. TORRES	PQ. MONTES DE OCA	ESCUELA CASERIO LA CUESTA	147	1	4	84	38	80	0	0	0	0	42	84
EDO. LARA	MP. TORRES	PQ. MONTES DE OCA	ESCUELA NACIONAL BOLIVARIANA MEDIA JORNADA SAN PEDRO	134	1	2	129	114	127	0	0	0	0	13	129
EDO. LARA	MP. TORRES	PQ. CAMACARO	CENTRO DE EDUCACION INICIAL LAS FLORES	449	1	4	417	361	413	0	1	0	0	51	417
EDO. LARA	MP. TORRES	PQ. CAMACARO	ESCUELA BOLIVARIANA MEDIA JORNADA UVEDALES	213	1	3	186	147	183	0	1	1	0	34	186
EDO. LARA	MP. TORRES	PQ. CAMACARO	GRUPO ESCOLAR RAFAEL TOBIAS MARQUIZ	2851	5	39	2333	1499	2294	1	1	4	0	789	2333
EDO. LARA	MP. TORRES	PQ. CAMACARO	ESCUELA CURARI	473	1	4	331	212	327	0	1	1	0	113	331
EDO. LARA	MP. TORRES	PQ. CAMACARO	UNIDAD EDUCATIVA NACIONAL JUAN A OROPEZA	1471	3	21	1246	821	1225	0	4	1	0	399	1246
EDO. LARA	MP. TORRES	PQ. CAMACARO	ESCUELA NACIONAL GUAIDI	776	2	7	538	356	531	0	4	1	0	170	538
EDO. LARA	MP. TORRES	PQ. CAMACARO	ESCUELA NACIONAL CONCENTRADA 3956 HOLLICAN	413	1	7	395	344	388	0	0	0	0	44	395
EDO. LARA	MP. TORRES	PQ. CAMACARO	ESCUELA CONCENTRADA ANDRES ELOY BLANCO	286	1	3	168	108	165	0	3	1	0	53	168
EDO. LARA	MP. TORRES	PQ. ALTAGRACIA	ESCUELA BASICA NACIONAL PEDERNALES	120	1	2	82	18	80	0	0	0	0	62	82
EDO. LARA	MP. TORRES	PQ. ALTAGRACIA	ESCUELA BOLIVARIANA ALTAGRACIA	967	2	7	793	351	786	0	3	0	2	430	793
EDO. LARA	MP. TORRES	PQ. ALTAGRACIA	ESCUELA BOLIVARIANA MEDIA JORNADA LAS PLAYITAS	131	1	1	99	79	98	0	0	0	0	19	99
EDO. LARA	MP. TORRES	PQ. ALTAGRACIA	ESCUELA NACIONAL BOLIVARIANA EL LORO	92	1	1	72	35	71	0	1	0	0	35	72
EDO. LARA	MP. TORRES	PQ. ALTAGRACIA	ESCUELA UNITARIA 4210 LAS MATAS	116	1	6	105	62	99	0	0	0	0	37	105
EDO. LARA	MP. TORRES	PQ. REYES VARGAS	ESCUELA BOLIVARIANA PARAPARA	1147	2	20	857	606	837	1	3	2	0	225	857
EDO. LARA	MP. TORRES	PQ. REYES VARGAS	ESCUELA NACIONAL BOLIVARIANA MALDONADO	378	1	3	347	250	344	0	1	2	0	91	347
EDO. LARA	MP. TORRES	PQ. REYES VARGAS	ESCUELA BOLIVARIANA LA FUNDACION	429	1	6	376	340	370	0	2	0	0	28	376
EDO. LARA	MP. TORRES	PQ. REYES VARGAS	ESCUELA UNITARIA DE CAMBURAL	277	1	3	150	53	147	0	1	0	0	93	150
EDO. LARA	MP. SIMON PLANAS	PQ. SARARE	ESCUELA BOLIVARIANA GAMELOTAL	397	1	8	370	290	362	0	1	1	0	70	370
EDO. LARA	MP. SIMON PLANAS	PQ. SARARE	ESCUELA BASICA ESTADAL SABANETA	525	1	19	430	334	411	2	2	0	0	73	430
EDO. LARA	MP. SIMON PLANAS	PQ. SARARE	COMEDOR ESCOLAR TERESA BORGES	906	2	14	717	519	703	0	0	0	0	184	717
EDO. LARA	MP. SIMON PLANAS	PQ. SARARE	ESCUELA BOLIVARIANA MEDIA JORNADA ALCIDES LOZADA	3255	6	55	2605	1729	2550	2	16	4	2	797	2605
EDO. LARA	MP. SIMON PLANAS	PQ. SARARE	ESCUELA ESTADAL MIXTA CAMORUCO	645	2	20	512	358	492	0	3	0	0	131	512
EDO. LARA	MP. SIMON PLANAS	PQ. SARARE	CENTRO EXPERIMENTAL EL GOAJIRO	1193	2	22	992	749	970	0	6	0	1	214	992
EDO. LARA	MP. SIMON PLANAS	PQ. SARARE	CASA COMUNAL EL MILAGRO 2	498	1	5	431	363	426	0	2	1	0	60	431
EDO. LARA	MP. SIMON PLANAS	PQ. SARARE	UNIDAD EDUCATIVA MONSEÑOR SALVADOR MONTES DE OCA	1738	3	24	1403	946	1379	2	8	1	2	420	1403
EDO. LARA	MP. SIMON PLANAS	PQ. SARARE	ESCUELA BOLIVARIANA MEDIA JORNADA NINO SIMON BOLIVAR	918	2	17	770	634	753	1	1	1	0	116	770
EDO. LARA	MP. SIMON PLANAS	PQ. SARARE	CONCEJO MUNICIPAL SIMON PLANAS	820	2	8	636	423	628	0	0	0	1	204	636
EDO. LARA	MP. SIMON PLANAS	PQ. SARARE	ESCUELABOLIVARIANA JOSE ANTONIO PAEZ	650	2	6	526	411	520	0	4	2	0	103	526
EDO. LARA	MP. SIMON PLANAS	PQ. GUSTAVO VEGAS LEON	COMEDOR ESCOLAR ATURES	1030	2	22	847	542	825	0	10	0	0	273	847
EDO. LARA	MP. SIMON PLANAS	PQ. GUSTAVO VEGAS LEON	ESCUELA BOLIVARIANA JORNADA COMPLETA MAESTRO JOSE GARCIA ( EL CERRITO)	780	2	9	628	533	619	0	2	0	0	84	628
EDO. LARA	MP. SIMON PLANAS	PQ. GUSTAVO VEGAS LEON	GRUPO ESCOLAR ATURES	3511	6	58	2860	1818	2802	2	20	0	0	962	2860
EDO. LARA	MP. SIMON PLANAS	PQ. GUSTAVO VEGAS LEON	ESCUELA BOLIVARIANA CABALLITO	341	1	0	299	291	299	0	1	2	0	5	299
EDO. LARA	MP. SIMON PLANAS	PQ. GUSTAVO VEGAS LEON	UNIDAD EDUCATIVA SABANA ALTA	1575	3	24	1321	1115	1297	1	7	1	1	172	1321
EDO. LARA	MP. SIMON PLANAS	PQ. GUSTAVO VEGAS LEON	CANCHA TECHADA  DE CAJA DE AGUA	614	2	12	543	449	531	1	2	0	0	79	543
EDO. LARA	MP. SIMON PLANAS	PQ. GUSTAVO VEGAS LEON	ESCUELA BOLIVARIANA CORONEL GENARO VASQUEZ	95	1	3	86	71	83	1	1	0	0	10	86
EDO. LARA	MP. SIMON PLANAS	PQ. BURIA	ESCUELA EL CHARAY	319	1	7	227	191	220	1	1	0	2	25	227
EDO. LARA	MP. SIMON PLANAS	PQ. BURIA	ESCUELA NACIONAL BOLIVARIANA PROFESOR OTILIO GALLARDO( MANZANITA)	2322	4	46	1809	1323	1763	1	7	1	0	431	1809
EDO. LARA	MP. SIMON PLANAS	PQ. BURIA	ESCUELA  NUARITO	224	1	4	162	112	158	0	0	0	0	46	162
EDO. LARA	MP. SIMON PLANAS	PQ. BURIA	ESCUELA BOLIVARIANA FRANCISCO DE MIRANDA	1275	3	32	1022	665	990	0	9	3	0	313	1022
EDO. LARA	MP. SIMON PLANAS	PQ. BURIA	ESCUELA BOLIVARIANA JUAN DE VILLEGAS II	1213	3	23	998	768	975	0	10	1	0	196	998
EDO. LARA	MP. CRESPO	PQ. JOSE MARIA BLANCO	UNIDAD EDUCATIVA BOLIVARIANA LAS VERAS	555	1	17	453	235	436	0	1	0	1	199	453
EDO. LARA	MP. CRESPO	PQ. JOSE MARIA BLANCO	UNIDAD EDUCATIVA NACIONAL PERARAPA	721	2	16	637	455	621	0	3	3	0	160	637
EDO. LARA	MP. CRESPO	PQ. JOSE MARIA BLANCO	UNIDAD EDUCATIVA NACIONAL EL ENEAL	3303	6	86	2749	1333	2663	0	21	5	1	1303	2749
EDO. LARA	MP. CRESPO	PQ. JOSE MARIA BLANCO	UNIDAD EDUCATIVA LOS POCITOS	496	1	8	392	180	384	0	1	0	1	202	392
EDO. LARA	MP. CRESPO	PQ. JOSE MARIA BLANCO	UNIDAD EDUCATIVA NACIONAL TACARIGUITA	1323	3	26	1070	621	1044	0	15	3	0	405	1070
EDO. LARA	MP. CRESPO	PQ. JOSE MARIA BLANCO	ESCUELA BOLIVARIANA  AGUA SALADA	1008	2	28	745	435	717	1	1	4	0	276	745
EDO. LARA	MP. CRESPO	PQ. JOSE MARIA BLANCO	ESCUELA BOLIVARIANA JORNADA COMPLETA LA RINCONADA	488	1	12	455	339	443	0	0	0	0	104	455
EDO. LARA	MP. CRESPO	PQ. JOSE MARIA BLANCO	ESCUELA BOLIVARIANA JORNADA COMPLETA EL TORO	458	1	5	432	262	427	0	2	0	0	163	432
EDO. LARA	MP. CRESPO	PQ. JOSE MARIA BLANCO	UNIDAD EDUCATIVA PASO DE TACARIGUA	1671	3	51	1431	903	1380	0	8	3	1	465	1431
EDO. LARA	MP. CRESPO	PQ. JOSE MARIA BLANCO	UNIDAD EDUCATIVA LUZ DE TACARIGUITA	492	1	9	359	164	350	0	4	0	0	182	359
EDO. LARA	MP. CRESPO	PQ. JOSE MARIA BLANCO	ESCUELA BOLIVARIANA TUCURAGUA	841	2	14	691	363	677	0	5	0	0	309	691
EDO. LARA	MP. CRESPO	PQ. FREITEZ	ESCUELA BOLIVARIANA CAÑO RICO	232	1	8	192	96	184	1	1	1	0	85	192
EDO. LARA	MP. CRESPO	PQ. FREITEZ	ESCUELA BOLIVARIANA NUMERO 3544	394	1	7	276	118	269	0	1	1	0	149	276
EDO. LARA	MP. CRESPO	PQ. FREITEZ	UNIDAD EDUCATIVA PADRE ORENI	1589	3	35	1272	697	1237	0	8	1	3	528	1272
EDO. LARA	MP. CRESPO	PQ. FREITEZ	ESCUELA NACIONAL CONCENTRADA EL LIMONCITO
EDO. LARA	MP. CRESPO	PQ. FREITEZ	ESCUELA NACIONAL 1183 CUCUTA	410	1	5	302	220	297	0	0	1	0	76	302
EDO. LARA	MP. CRESPO	PQ. FREITEZ	UNIDAD EDUCATIVA HERMANAS FALCON	2989	6	73	2525	1239	2452	2	20	4	0	1187	2525
EDO. LARA	MP. CRESPO	PQ. FREITEZ	UNIDAD EDUCATIVA HERMANAS JIMENEZ	3060	6	53	2488	1105	2435	2	17	0	1	1310	2488
EDO. LARA	MP. CRESPO	PQ. FREITEZ	ESCUELA BOLIVARIANA GUAYABITO	550	1	13	385	226	372	0	1	0	1	144	385
EDO. LARA	MP. CRESPO	PQ. FREITEZ	ESCUELA UNITARIA LAS COCUISAS	135	1	0	115	69	115	0	0	0	0	46	115
EDO. LARA	MP. CRESPO	PQ. FREITEZ	UNIDAD EDUCATIVA NUMERO 465	237	1	6	213	129	207	0	0	1	0	77	213
EDO. LARA	MP. CRESPO	PQ. FREITEZ	TEATRO MUNICIPAL ROSINA GRIMALDI	803	2	12	627	271	615	0	3	0	1	340	627
EDO. LARA	MP. CRESPO	PQ. FREITEZ	ESCUELA BOLIVARIANA MEDIA JORNADA NUMERO 444 LOS VOLCANES	124	1	3	115	96	112	0	0	0	0	16	115
EDO. LARA	MP. CRESPO	PQ. FREITEZ	UNIDAD EDUCATIVA  EFREN COLMENARES GIMENEZ	3202	6	68	2692	1311	2624	1	14	1	4	1293	2692
EDO. LARA	MP. CRESPO	PQ. FREITEZ	UNIDAD EDUCATIVA ESTADAL SAN MIGUEL	230	1	2	171	78	169	0	0	0	0	91	171
EDO. LARA	MP. CRESPO	PQ. FREITEZ	UNIDAD EDUCATIVA JUAN MANUEL ALAMO	3792	7	62	3049	1263	2987	2	17	5	2	1698	3049
EDO. LARA	MP. CRESPO	PQ. FREITEZ	ESCUELA BASICA LICUA	951	2	14	752	548	738	1	5	0	0	184	752
EDO. LARA	MP. CRESPO	PQ. FREITEZ	UNIDAD EDUCATIVA LAS CASITAS	383	1	6	243	116	237	0	0	0	0	121	243
EDO. LARA	MP. CRESPO	PQ. FREITEZ	ESCUELA UNITARIA ESTADAL NUMERO 445	254	1	2	132	76	130	0	1	0	0	53	132
EDO. LARA	MP. CRESPO	PQ. FREITEZ	ESCUELA BOLIVARIANA QUEBRADA DE ORO	445	1	4	370	174	366	0	0	0	0	192	370
EDO. LARA	MP. CRESPO	PQ. FREITEZ	CENTRO DE EDUCACION BASICA DE ADULTO LUCIO DELGADO	1200	3	24	1072	427	1048	0	3	0	2	616	1072
EDO. LARA	MP. CRESPO	PQ. FREITEZ	ESCUELA NACIONAL LA TRAVESIA	500	1	8	353	204	345	0	2	1	0	138	353
EDO. LARA	MP. CRESPO	PQ. FREITEZ	ESCUELA ESTADAL UNITARIA NO 235 LA PANCHERA	404	1	9	320	212	311	0	5	1	0	93	320
EDO. LARA	MP. PALAVECINO	PQ. CABUDARE	COMPLEJO CULTURAL ANDRES ELOY BLANCO CASA DE LA CULTURA	764	2	6	678	232	672	0	1	0	0	439	678
EDO. LARA	MP. PALAVECINO	PQ. CABUDARE	LICEO BOLIVARIANO CREACION PALAVECINO	788	2	11	663	301	652	0	7	0	0	344	663
EDO. LARA	MP. PALAVECINO	PQ. CABUDARE	ATENEO DE CABUDARE	1733	3	15	1515	343	1500	2	1	1	0	1153	1515
EDO. LARA	MP. PALAVECINO	PQ. CABUDARE	UNIDAD EDUCATIVA NACIONAL FRANCISCO JOSE ROJAS	1876	4	16	1633	675	1617	0	9	3	2	928	1633
EDO. LARA	MP. PALAVECINO	PQ. CABUDARE	ESCUELA BASICA  LUIS BELTRAN PRIETO FIGUEROA	2631	5	42	2260	1161	2218	0	28	0	0	1029	2260
EDO. LARA	MP. PALAVECINO	PQ. CABUDARE	INSTITUTO DE EDUCACION ESPECIAL ALICIA PIETRI DE CALDERA	1027	2	12	917	521	905	0	0	1	0	383	917
EDO. LARA	MP. PALAVECINO	PQ. CABUDARE	PREESCOLAR DOÑA BARBARA	344	1	6	307	209	301	0	2	0	0	90	307
EDO. LARA	MP. PALAVECINO	PQ. CABUDARE	ESCUELA BOLIVARIANA JOSE APARICIO SALCEDO	699	2	20	566	307	546	0	4	0	1	234	566
EDO. LARA	MP. PALAVECINO	PQ. CABUDARE	UNIDAD EDUCATIVA LOMAS DE TABURE	226	1	2	205	135	203	0	2	0	0	66	205
EDO. LARA	MP. PALAVECINO	PQ. CABUDARE	GRUPO ESCOLAR GLADYS BRICEÑO MENDEZ	3280	6	29	2724	908	2695	0	15	2	6	1764	2724
EDO. LARA	MP. PALAVECINO	PQ. CABUDARE	ESCUELA NACIONAL BOLIVARIANA OMAIRA MENDOZA DE ESCOBAR	169	1	2	157	140	155	0	0	0	0	15	157
EDO. LARA	MP. PALAVECINO	PQ. CABUDARE	UNIDAD EDUCATIVA  ARTESANAL VALMORE RODRIGUEZ	1444	3	22	1303	400	1281	0	6	0	0	875	1303
EDO. LARA	MP. PALAVECINO	PQ. CABUDARE	ESCUELA BOLIVARIANA GENERAL NICOLAS PATIÑO SOSA	3617	7	48	2895	1148	2847	0	21	1	2	1675	2895
EDO. LARA	MP. PALAVECINO	PQ. CABUDARE	CENTRO DE EDUCACION INICIAL ASENTAMIENTO CAMPESINO LA MATA	389	1	16	349	192	333	0	3	1	0	137	349
EDO. LARA	MP. PALAVECINO	PQ. CABUDARE	UNIDAD EDUCATIVA ESTADAL ROMULO BETANCOURT II	2191	4	27	1875	785	1848	0	14	1	1	1047	1875
EDO. LARA	MP. PALAVECINO	PQ. CABUDARE	ESCUELA BOLIVARIANA URBANO YEPEZ	759	2	21	625	425	604	1	6	2	1	169	625
EDO. LARA	MP. PALAVECINO	PQ. CABUDARE	CASA COMUNAL URBANIZACION DANIEL CARIAS	681	2	9	633	273	624	0	4	0	1	346	633
EDO. LARA	MP. PALAVECINO	PQ. CABUDARE	CENTRO DE ESPECIALIZACION LUISA CACERES DE ARISMENDI	2604	5	22	2265	571	2243	0	12	1	1	1658	2265
EDO. LARA	MP. PALAVECINO	PQ. CABUDARE	UNIDAD EDUCATIVA ESTADAL. LAS ACACIAS	3409	6	62	2941	1106	2879	0	22	3	0	1748	2941
EDO. LARA	MP. PALAVECINO	PQ. CABUDARE	UNIDAD EDUCATIVA ESTADAL JOSE FELIX RIVAS	1911	4	20	1537	728	1517	0	13	0	2	774	1537
EDO. LARA	MP. PALAVECINO	PQ. CABUDARE	UNIDAD EDUCATIVA COLEGIO MADRE CARMEN RENDILES	2338	4	20	2019	662	1999	0	7	2	0	1328	2019
EDO. LARA	MP. PALAVECINO	PQ. CABUDARE	ESCUELA GRANJA HECTOR ROJAS MEZA	1447	3	13	1239	489	1226	0	13	1	0	723	1239
EDO. LARA	MP. PALAVECINO	PQ. CABUDARE	CASA COMUNAL BRISAS DE TEREPAIMA	133	1	4	122	47	118	0	1	0	0	70	122
EDO. LARA	MP. PALAVECINO	PQ. CABUDARE	UNIDAD EDUCATIVA ANDRES BELLO	1965	4	39	1707	991	1668	1	14	1	0	661	1707
EDO. LARA	MP. PALAVECINO	PQ. CABUDARE	GRUPO ESCOLAR EZEQUIEL BUJANDA	1805	4	24	1495	440	1471	1	10	1	1	1018	1495
EDO. LARA	MP. PALAVECINO	PQ. CABUDARE	UNIDAD EDUCATIVA NACIONAL  JACINTO LARA	3309	6	37	2856	1070	2819	2	23	1	0	1723	2856
EDO. LARA	MP. PALAVECINO	PQ. AGUA VIVA	CASA COMUNAL DE VALLECITO	567	1	8	501	325	493	0	0	0	0	168	501
EDO. LARA	MP. PALAVECINO	PQ. AGUA VIVA	UNIDAD EDUCATIVA BOLIVARIANA PROFESOR JOSE EVELIO APONTE	1861	4	32	1596	849	1564	0	13	1	1	700	1596
EDO. LARA	MP. PALAVECINO	PQ. AGUA VIVA	ESCUELA BOLIVARIANA JOSE MARIA VARGAS	1165	2	25	1013	544	988	1	5	2	1	435	1013
EDO. LARA	MP. PALAVECINO	PQ. AGUA VIVA	SEDE JUNTA PARROQUIAL SECTOR AGUA VIVA	1431	3	25	1252	506	1227	0	3	2	0	716	1252
EDO. LARA	MP. PALAVECINO	PQ. AGUA VIVA	UNIDAD EDUCATIVA AGUA VIVA	4657	8	98	3919	1831	3821	1	25	7	2	1955	3919
EDO. LARA	MP. PALAVECINO	PQ. JOSE G. BASTIDAS	ESCUELA BOLIVARIANA ZANJON COLORADO	2073	4	34	1904	945	1870	0	7	1	1	916	1904
EDO. LARA	MP. PALAVECINO	PQ. JOSE G. BASTIDAS	GRUPO ESCOLAR CABUDARE	4349	8	30	3698	1182	3668	1	12	2	0	2471	3698
EDO. LARA	MP. PALAVECINO	PQ. JOSE G. BASTIDAS	ESCUELA BOLIVARIANA FRANCISCO DE PAULA BRICEÑO	2711	5	39	2266	898	2227	2	9	0	0	1318	2266
EDO. LARA	MP. PALAVECINO	PQ. JOSE G. BASTIDAS	PRE ESCOLAR CREACION LAS MERCEDES	3287	6	23	2961	712	2938	0	9	2	1	2214	2961
EDO. LARA	MP. PALAVECINO	PQ. JOSE G. BASTIDAS	UNIDAD EDUCATIVA NACIONAL  CARMEN GONZALEZ DE MUSSET	1408	3	29	1099	683	1070	0	19	0	3	365	1099
EDO. LARA	MP. PALAVECINO	PQ. JOSE G. BASTIDAS	ESCUELA BOLIVARIANA EUSTAQUIO YEPEZ	383	1	4	353	195	349	0	1	0	0	153	353
EDO. LARA	MP. PALAVECINO	PQ. JOSE G. BASTIDAS	UNIDAD EDUCATIVA ESTADAL PEDRO GUAL	2422	5	37	2133	1063	2096	0	8	0	1	1024	2133
EDO. LARA	MP. PALAVECINO	PQ. JOSE G. BASTIDAS	ESCUELA BOLIVARIANA DON SIMON RODRIGUEZ	3879	7	30	3481	1053	3451	0	13	3	2	2380	3481
EDO. LARA	MP. PALAVECINO	PQ. JOSE G. BASTIDAS	ESCUELA BOLIVARIANA DON VICENTE AMENGUAL VILLALONGA	257	1	3	239	156	236	0	3	0	0	77	239
EDO. LARA	MP. PALAVECINO	PQ. JOSE G. BASTIDAS	UNIDAD EDUCATIVA  BASICA PIEDRA AZUL	3722	7	41	3371	883	3330	1	11	3	1	2431	3371
EDO. LARA	MP. PALAVECINO	PQ. JOSE G. BASTIDAS	UNIDAD EDUCATIVA OMAIRA SEQUERA SALAS	4103	8	37	3647	738	3610	1	8	3	1	2859	3647
EDO. LARA	MP. PALAVECINO	PQ. JOSE G. BASTIDAS	COLEGIO MARIA SANTISIMA	4488	8	36	4151	666	4115	0	7	2	0	3440	4151
EDO. LARA	MP. PALAVECINO	PQ. JOSE G. BASTIDAS	UNIDAD EDUCATIVA  MIGUEL OTERO SILVA	955	2	26	813	625	787	0	1	3	0	158	813
EDO. LARA	MP. PALAVECINO	PQ. JOSE G. BASTIDAS	UNIVERSIDAD YACAMBU	2324	4	25	2082	396	2057	0	7	1	1	1652	2082
EDO. LARA	MP. PALAVECINO	PQ. JOSE G. BASTIDAS	ESCUELA ESTADAL CONCENTRADA HERMANN GARMENDIA	808	2	16	681	390	665	0	3	0	0	272	681
EDO. LARA	MP. PALAVECINO	PQ. JOSE G. BASTIDAS	UNIDAD EDUCATIVA NACIONAL  LA PIEDAD	2889	5	31	2462	983	2431	0	5	0	1	1442	2462
EDO. LARA	MP. PALAVECINO	PQ. JOSE G. BASTIDAS	CASA COMUNAL LA HACIENDA	1393	3	2	1235	210	1233	0	1	3	0	1019	1235
EDO. LARA	MP. PALAVECINO	PQ. JOSE G. BASTIDAS	ESCUELA BOLIVARIANA DOCTOR JUAN DE DIOS PONTE	1982	4	38	1639	847	1601	1	7	1	1	744	1639
EDO. LARA	MP. PALAVECINO	PQ. JOSE G. BASTIDAS	UNIDAD EDUCATIVA  GENERAL AQUILINO JUAREZ	2433	5	62	2095	1144	2033	1	17	0	0	871	2095
EDO. LARA	MP. PALAVECINO	PQ. JOSE G. BASTIDAS	BIBLIOTECA PUBLICA LAS MERCEDES OTTO CIVIDANES LIRA	1992	4	19	1870	434	1851	0	4	0	2	1411	1870
EDO. LARA	MP. PALAVECINO	PQ. JOSE G. BASTIDAS	ESCUELA ESTADAL LA MORITA	457	1	7	333	243	326	0	1	1	0	81	333
EDO. LARA	MP. PALAVECINO	PQ. JOSE G. BASTIDAS	ESCUELA BOLIVARIANA MIGUEL RENOM	646	2	10	532	333	522	0	6	2	0	181	532
EDO. LARA	MP. PALAVECINO	PQ. JOSE G. BASTIDAS	ESCUELA BASICA NACIONAL LOS RASTROJOS	2116	4	22	1945	489	1923	0	5	0	2	1427	1945
EDO. LARA	CE. IRIBARREN	PQ. TAMACA	UNIDAD EDUCATIVA NACIONAL TAMACA	4268	8	84	3341	1594	3257	1	25	9	1	1627	3341
EDO. LARA	CE. IRIBARREN	PQ. TAMACA	UNIDAD EDUCATIVA ESTADAL RETEN ABAJO	1756	3	27	1409	776	1382	0	14	3	0	589	1409
EDO. LARA	CE. IRIBARREN	PQ. TAMACA	UNIDAD EDUCATIVA COLEGIO MANUEL CARLOS PIAR	1122	2	18	1010	455	992	1	6	2	0	528	1010
EDO. LARA	CE. IRIBARREN	PQ. TAMACA	ESCUELA UNITARIA EL PAUJI	253	1	4	201	118	197	0	7	0	0	72	201
EDO. LARA	CE. IRIBARREN	PQ. TAMACA	UNIDAD EDUCATIVA DON ROMULO GALLEGOS	1093	2	22	943	584	921	1	5	1	0	330	943
EDO. LARA	CE. IRIBARREN	PQ. TAMACA	UNIDAD EDUCATIVA BOLIVARIANA RETEN ARRIBA	473	1	5	410	248	405	0	2	0	3	152	410
EDO. LARA	CE. IRIBARREN	PQ. TAMACA	UNIDAD EDUCATIVA ESTADAL PROFESOR CAMACHO LAGUNA	517	1	10	468	321	458	0	3	0	0	134	468
EDO. LARA	CE. IRIBARREN	PQ. TAMACA	ESCUELA ESTADAL SORAGE	337	1	8	218	103	210	0	4	0	0	103	218
EDO. LARA	CE. IRIBARREN	PQ. TAMACA	ESCUELA ESTADAL LAS PLAZUELAS	361	1	8	303	182	295	0	1	1	0	111	303
EDO. LARA	CE. IRIBARREN	PQ. TAMACA	UNIDAD EDUCATIVA ESTADAL ANTONIO JOSE PACHECO	2941	6	50	2401	1360	2351	1	28	3	2	957	2401
EDO. LARA	CE. IRIBARREN	PQ. TAMACA	UNIDAD EDUCATIVA SANTA CRUZ	162	1	4	153	81	149	0	1	0	0	67	153
EDO. LARA	CE. IRIBARREN	PQ. TAMACA	ESCUELA CONCENTRADA VALLE HONDO	1172	2	18	939	510	921	1	10	1	0	399	939
EDO. LARA	CE. IRIBARREN	PQ. TAMACA	CENTRO PENITENCIARIO DE LA REGION CENTRO OCCIDENTAL	366	1	5	215	161	210	0	2	0	0	47	215
EDO. LARA	CE. IRIBARREN	PQ. TAMACA	CANCHA DEPORTIVA YUCATAN	567	1	10	517	314	507	0	2	0	0	191	517
EDO. LARA	CE. IRIBARREN	PQ. TAMACA	ESCUELA CONCENTRADA TOROY	560	1	5	421	245	416	3	6	0	0	162	421
EDO. LARA	CE. IRIBARREN	PQ. TAMACA	ESCUELA ESTADAL LA ESCALERA	307	1	6	205	128	199	0	2	0	0	69	205
EDO. LARA	CE. IRIBARREN	PQ. TAMACA	ESCUELA BASICA ARTURO USLAR PIETRI	2528	5	52	1988	1234	1936	0	16	0	0	686	1988
EDO. LARA	CE. IRIBARREN	PQ. TAMACA	UNIDAD EDUCATIVA ESTADAL EL PAMPERO	1579	3	41	1288	777	1247	0	8	2	1	459	1288
EDO. LARA	CE. IRIBARREN	PQ. TAMACA	ESCUELA NACIONAL RASTROJITOS	1807	4	32	1430	825	1398	0	13	6	1	553	1430
EDO. LARA	CE. IRIBARREN	PQ. TAMACA	LICEO BOLIVARIANO PROFESOR JESUS PERAZA	1302	3	11	1099	725	1088	0	6	2	0	355	1099
EDO. LARA	CE. IRIBARREN	PQ. TAMACA	CENTRO DE EDUCACION INICIAL VALLES DE URIBANA	716	2	15	588	428	573	0	3	0	0	142	588
EDO. LARA	CE. IRIBARREN	PQ. TAMACA	UNIDAD EDUCATIVA JUAN BAUTISTA RODRIGUEZ	4171	8	93	3309	1573	3216	0	26	5	1	1611	3309
EDO. LARA	CE. IRIBARREN	PQ. TAMACA	UNIDAD EDUCATIVA ESTADAL 19 DE ABRIL	611	2	8	560	444	552	1	5	0	0	102	560
EDO. LARA	CE. IRIBARREN	PQ. TAMACA	ESCUELA BOLIVARIANA LA PALMITA	834	2	13	680	456	667	0	8	1	0	202	680
EDO. LARA	CE. IRIBARREN	PQ. TAMACA	ESCUELA BOLIVARIANA LAS TUNITAS	355	1	4	331	224	327	0	3	0	1	99	331
EDO. LARA	CE. IRIBARREN	PQ. TAMACA	UNIDAD EDUCATIVA ESTADAL FRANCISCO DE MIRANDA	1679	3	30	1249	718	1219	1	12	0	1	487	1249
EDO. LARA	CE. IRIBARREN	PQ. TAMACA	ESCUELA BASICA ALI PRIMERA	2291	4	28	2043	1014	2015	0	21	1	1	978	2043
EDO. LARA	CE. IRIBARREN	PQ. TAMACA	ESCUELA BASICA MEDIA JORNADAROMERAL III	739	2	14	665	489	651	1	9	1	0	151	665
EDO. LARA	CE. IRIBARREN	PQ. TAMACA	ESCUELA BOLIVARIANA MEDIA JORNADA TAMAQUITA NER 140	406	1	4	379	311	375	0	4	0	0	60	379
EDO. LARA	CE. IRIBARREN	PQ. TAMACA	UNIDAD EDUCATIVA SAN ANTONIO DE PADUA (LAS DELICIAS)	1244	3	34	1103	663	1069	0	16	0	0	390	1103
EDO. LARA	CE. IRIBARREN	PQ. TAMACA	UNIDAD EDUCATIVA LAS PLAYITAS	495	1	7	445	263	438	0	8	1	0	166	445
EDO. LARA	CE. IRIBARREN	PQ. SANTA ROSA	COLEGIO PRIVADO LAS FUENTES	5468	10	18	4869	686	4851	0	8	1	2	4154	4869
EDO. LARA	CE. IRIBARREN	PQ. SANTA ROSA	ESCUELA BOLIVARIANA SANTA ISABEL	2939	5	71	2431	1329	2360	1	24	5	3	998	2431
EDO. LARA	CE. IRIBARREN	PQ. SANTA ROSA	TALLER BOLIVARIANO DE EDUCACION ESPECIAL NUEVA SEGOVIA	621	2	11	536	330	525	1	8	1	2	183	536
EDO. LARA	CE. IRIBARREN	PQ. SANTA ROSA	ESCUELA BOLIVARIANA YACURAL	1386	3	38	1191	456	1153	1	9	0	2	685	1191
EDO. LARA	CE. IRIBARREN	PQ. SANTA ROSA	UNIDAD EDUCATIVA COLEGIO SAN VICENTE DE PAUL	2084	4	24	1881	237	1857	1	8	1	0	1610	1881
EDO. LARA	CE. IRIBARREN	PQ. SANTA ROSA	ESCUELA NACIONAL GRADUADA VERAGACHA	1602	3	36	1340	615	1304	0	7	0	2	680	1340
EDO. LARA	CE. IRIBARREN	PQ. SANTA ROSA	UNIDAD EDUCATIVA ESTADAL MONSEÑOR CRISPULO BENITEZ FONTURVEL	1116	2	10	980	498	970	1	5	0	0	466	980
EDO. LARA	CE. IRIBARREN	PQ. SANTA ROSA	COLEGIO PABLO VI	4364	8	20	3682	357	3662	0	7	0	0	3298	3682
EDO. LARA	CE. IRIBARREN	PQ. SANTA ROSA	ESCUELA TECNICA COMERCIAL DOCTOR AMBROSIO PERERA	6032	11	28	5219	657	5191	1	11	1	2	4519	5219
EDO. LARA	CE. IRIBARREN	PQ. SANTA ROSA	CANCHA TECHADA EL UJANO	333	1	3	297	174	294	0	2	0	0	118	297
EDO. LARA	CE. IRIBARREN	PQ. SANTA ROSA	UNIDAD EDUCATIVA NACIONAL EL UJANO	3893	7	71	3299	1554	3228	0	25	5	0	1644	3299
EDO. LARA	CE. IRIBARREN	PQ. SANTA ROSA	ESCUELA BOLIVARIANA CHOROBOBO	999	2	21	739	513	718	0	3	0	2	200	739
EDO. LARA	CE. IRIBARREN	PQ. SANTA ROSA	CENTRO DE EDUCACION INICIAL DRA CLEMENTE BUSTAMANTE	764	2	14	653	309	639	0	4	2	0	324	653
EDO. LARA	CE. IRIBARREN	PQ. SANTA ROSA	CENTRO DE EDUCACION INICIAL JOSE GREGORIO BASTIDAS	786	2	16	717	444	701	0	7	1	0	249	717
EDO. LARA	CE. IRIBARREN	PQ. SANTA ROSA	UNIDAD EDUCATIVA ESPECIAL BOLIVARIANA DE AUDICION Y LENGUAJE ICOAL (INSTITUTO CENTRO OCCIDENTAL DE AUDICION Y LENGUAJE)	1353	3	8	1265	214	1257	0	1	0	0	1042	1265
EDO. LARA	CE. IRIBARREN	PQ. SANTA ROSA	COMEDOR ESCOLAR ANTONIO RAMIREZ	2299	4	32	1920	487	1888	2	11	0	0	1388	1920
EDO. LARA	CE. IRIBARREN	PQ. SANTA ROSA	UNIDAD EDUCATIVA ESTADAL CHIRGUA	2768	5	44	2255	1435	2211	1	15	2	4	754	2255
EDO. LARA	CE. IRIBARREN	PQ. SANTA ROSA	GRUPO ESCOLAR NACIONAL JUAREZ	2710	5	54	2270	621	2216	3	12	2	1	1577	2270
EDO. LARA	CE. IRIBARREN	PQ. SANTA ROSA	UNIDAD EDUCATIVA MARIA LEDEZMA	4249	8	74	3556	1783	3482	1	19	1	3	1675	3556
EDO. LARA	CE. IRIBARREN	PQ. SANTA ROSA	CENTRO EDUCACION INICIAL DOÑA MENCA DE LEONI	1558	3	29	1276	602	1247	1	12	0	0	632	1276
EDO. LARA	CE. IRIBARREN	PQ. SANTA ROSA	UNIDAD EDUCATIVA LUIS SANABRIA SANCHEZ	1595	3	44	1417	922	1373	0	4	3	0	444	1417
EDO. LARA	CE. IRIBARREN	PQ. SANTA ROSA	UNIDAD EDUCATIVA COLEGIO RIO CLARO	1102	2	10	999	259	989	0	2	0	0	728	999
EDO. LARA	CE. IRIBARREN	PQ. SANTA ROSA	UNIDAD EDUCATIVA COLEGIO ANDRES BELLO	5167	9	18	4359	451	4341	0	11	1	3	3875	4359
EDO. LARA	CE. IRIBARREN	PQ. SANTA ROSA	CENTRO DE EDUCACION INICIAL LOMAS VERDES	574	1	7	488	269	481	0	0	1	1	210	488
EDO. LARA	CE. IRIBARREN	PQ. SANTA ROSA	FUNDACION CONSERVATORIO VICENTE EMILIO SOJO	1056	2	7	958	179	951	0	1	0	1	770	958
EDO. LARA	CE. IRIBARREN	PQ. SANTA ROSA	COMPLEJO COMUNITARIO CHIRGUA 4	453	1	9	395	290	386	0	1	0	1	94	395
EDO. LARA	CE. IRIBARREN	PQ. CATEDRAL	CENTRO DE EDUCACION INICIAL SAN JUAN DE LA CRUZ	1385	3	16	1206	480	1190	2	3	1	0	704	1206
EDO. LARA	CE. IRIBARREN	PQ. CATEDRAL	ESCUELA TECNICA COMERCIAL ELIODORO PINEDA	934	2	11	824	318	813	0	3	0	0	492	824
EDO. LARA	CE. IRIBARREN	PQ. CATEDRAL	HOGAR CACHORRITOS 11 Y 12 EL JEBE	1272	3	35	1065	644	1030	0	6	1	1	378	1065
EDO. LARA	CE. IRIBARREN	PQ. CATEDRAL	UNIDAD EDUCATIVA MANUELA MERCEDES DUIN	3454	6	33	2945	660	2912	0	12	0	0	2240	2945
EDO. LARA	CE. IRIBARREN	PQ. CATEDRAL	ESCUELA DE ARTES PLASTICAS MARTIN TOVAR Y TOVAR	1537	3	16	1242	332	1226	0	4	1	0	889	1242
EDO. LARA	CE. IRIBARREN	PQ. CATEDRAL	JARDIN DE INFANCIA PABLO ACOSTA ORTIZ	962	2	13	879	185	866	0	1	0	0	680	879
EDO. LARA	CE. IRIBARREN	PQ. CATEDRAL	ESCUELA CONCENTRADA EL VALLE	452	1	6	354	241	348	0	4	1	0	102	354
EDO. LARA	CE. IRIBARREN	PQ. CATEDRAL	CENTRO DE EDUCACION INICIAL MARIA PEREIRA DE DAZA	774	2	4	644	137	640	0	2	0	0	501	644
EDO. LARA	CE. IRIBARREN	PQ. CATEDRAL	CENTRO DE EDUCACION INICIAL CREACION EL MUCHACHITO	225	1	2	189	74	187	0	2	0	0	111	189
EDO. LARA	CE. IRIBARREN	PQ. CATEDRAL	ESCUELA BOLIVARIANA NACIONAL DON ARTURO MICHELENA	1235	3	40	1050	608	1010	0	12	2	0	388	1050
EDO. LARA	CE. IRIBARREN	PQ. CATEDRAL	UNIDAD EDUCATIVA DOCTOR JOSE MANUEL SISO MARTINEZ	1724	3	22	1463	673	1441	0	7	0	0	761	1463
EDO. LARA	CE. IRIBARREN	PQ. CATEDRAL	JARDIN DE INFANCIA PASTOR OROPEZA	623	2	21	575	242	554	0	2	0	0	310	575
EDO. LARA	CE. IRIBARREN	PQ. CATEDRAL	ESCUELA BOLIVARIANA NACIONAL TEREPAIMA	1491	3	26	1191	484	1165	2	9	2	0	668	1191
EDO. LARA	CE. IRIBARREN	PQ. CATEDRAL	UNIDAD EDUCATIVA LUCRECIA GARCIA	2730	5	24	2258	555	2234	1	12	0	2	1664	2258
EDO. LARA	CE. IRIBARREN	PQ. CATEDRAL	LICEO BOLIVARIANO MARIO BRICEÑO IRAGORRY	3527	7	25	2955	804	2930	0	7	0	0	2119	2955
EDO. LARA	CE. IRIBARREN	PQ. CATEDRAL	CASA COMUNAL URBANIZACION NUEVA SEGOVIA	2044	4	15	1769	338	1754	0	3	2	1	1410	1769
EDO. LARA	CE. IRIBARREN	PQ. CATEDRAL	JARDIN DE INFANCIA ANDRES BELLO	1370	3	8	1125	105	1117	0	1	1	2	1008	1125
EDO. LARA	CE. IRIBARREN	PQ. CATEDRAL	UNIDAD EDUCATIVA ESPECIAL BOLIVARIANA LUIS BRAILE	1274	3	19	1175	300	1156	0	3	1	0	852	1175
EDO. LARA	CE. IRIBARREN	PQ. CATEDRAL	UNIDAD EDUCATIVA MILITARIZADA CORONEL JOSE MARIA CAMACARO	721	2	10	659	203	649	0	5	0	0	441	659
EDO. LARA	CE. IRIBARREN	PQ. CATEDRAL	ALCALDIA CATEDRAL	1414	3	10	1173	374	1163	0	6	1	0	782	1173
EDO. LARA	CE. IRIBARREN	PQ. CATEDRAL	UNIDAD EDUCATIVA BOLIVARIANA DR. RAMON E. GUALDRON	2692	5	17	2326	524	2309	0	9	1	2	1773	2326
EDO. LARA	CE. IRIBARREN	PQ. CATEDRAL	CICLO BASICO FELIX GONZALEZ LAMEDA	3936	7	49	3194	1095	3145	0	20	3	2	2025	3194
EDO. LARA	CE. IRIBARREN	PQ. CATEDRAL	GRUPO ESCOLAR BOLIVIA TOVAR	2925	5	61	2477	1108	2416	0	13	2	0	1293	2477
EDO. LARA	CE. IRIBARREN	PQ. CATEDRAL	UNIDAD EDUCATIVA ALIRIO UGARTE PELAYO	1467	3	17	1270	213	1253	0	2	1	0	1037	1270
EDO. LARA	CE. IRIBARREN	PQ. CATEDRAL	CANCHA TECHADA LA LAGUNITA	314	1	12	274	172	262	1	1	2	0	86	274
EDO. LARA	CE. IRIBARREN	PQ. CATEDRAL	AMBULATORIO ASISTENCIAL PASTOR OROPEZA (CLARET)	884	2	9	702	99	693	0	3	0	0	591	702
EDO. LARA	CE. IRIBARREN	PQ. CATEDRAL	FUNDACION SOCIAL AMIGOS DE BARQUISIMETO	830	2	12	647	174	635	0	6	0	1	454	647
EDO. LARA	CE. IRIBARREN	PQ. CATEDRAL	UNIDAD EDUCATIVA NACIONAL MIGUEL JOSE SANZ	1239	3	15	1039	211	1024	0	3	0	0	810	1039
EDO. LARA	CE. IRIBARREN	PQ. CATEDRAL	CENTRO DE DESARROLLO DESTREZAS COGNITIVAS TIERNO AMANECER	1842	4	17	1612	368	1595	0	11	1	0	1215	1612
EDO. LARA	CE. IRIBARREN	PQ. CATEDRAL	UNIDAD EDUCATIVA ESTADAL CARMEN FERNANDEZ DE LEONI	3388	6	50	2988	1189	2938	1	21	3	2	1722	2988
EDO. LARA	CE. IRIBARREN	PQ. CATEDRAL	INSTITUTO NACIONAL DE CAPACITACION Y EDUCACION SOCIALISTA	1560	3	24	1216	326	1192	1	12	1	1	851	1216
EDO. LARA	CE. IRIBARREN	PQ. CATEDRAL	UNIDAD EDUCATIVA CERRO MACUTO	1398	3	26	1108	520	1082	1	7	1	0	553	1108
EDO. LARA	CE. IRIBARREN	PQ. CATEDRAL	ESCUELA DE ADMINISTRACION UNIVERSIDAD CENTROOCCIDENTAL LISANDRO ALVARADO	4137	8	28	3575	669	3547	0	10	0	3	2865	3575
EDO. LARA	CE. IRIBARREN	PQ. CATEDRAL	ESCUELA NACIONAL BOLIVARIANA BARARIDA	2436	5	20	2048	411	2028	1	3	1	0	1612	2048
EDO. LARA	CE. IRIBARREN	PQ. CATEDRAL	UNIDAD EDUCATIVA NUESTRA SEÑORA DEL COROMOTO	2511	5	55	2039	1184	1984	0	25	2	1	772	2039
EDO. LARA	CE. IRIBARREN	PQ. CATEDRAL	CICLO BASICO FEDERICO CARMONA	2916	5	24	2441	250	2417	0	2	1	2	2162	2441
EDO. LARA	CE. IRIBARREN	PQ. CATEDRAL	UNIDAD EDUCATIVA BOLIVARIANA. MARIA PEREIRA DE DAZA	2991	6	22	2617	564	2595	0	9	1	1	2020	2617
EDO. LARA	CE. IRIBARREN	PQ. CATEDRAL	ESCUELA TECNICA COMERCIAL CARLOS GIL YEPEZ	2793	5	45	2420	1109	2375	0	22	3	3	1238	2420
EDO. LARA	CE. IRIBARREN	PQ. CATEDRAL	UNIDAD EDUCATIVA ESTADAL SIMON BOLIVAR	4309	8	129	3384	2045	3255	1	39	2	1	1167	3384
EDO. LARA	CE. IRIBARREN	PQ. CATEDRAL	UNIDAD EDUCATIVA VICENTE SALIAS	1986	4	17	1655	232	1638	1	5	0	1	1399	1655
EDO. LARA	CE. IRIBARREN	PQ. CATEDRAL	CANCHA TECHADA VALLE LINDO	216	1	2	196	152	194	1	1	0	0	40	196
EDO. LARA	CE. IRIBARREN	PQ. CATEDRAL	UNIDAD EDUCATIVA NACIONAL BOLIVARIANA ALI RAFAEL BRAVO	3042	6	43	2507	986	2464	0	16	2	2	1458	2507
EDO. LARA	CE. IRIBARREN	PQ. CATEDRAL	UNIDAD EDUCATIVA PABLO ACOSTA ORTIZ	3139	6	30	2582	586	2552	1	7	2	1	1955	2582
EDO. LARA	CE. IRIBARREN	PQ. CATEDRAL	UNIDAD EDUCATIVA TOMAS RAFAEL GIMENEZ	2890	5	20	2473	442	2453	0	9	0	3	1999	2473
EDO. LARA	CE. IRIBARREN	PQ. CATEDRAL	UNIDAD EDUCATIVA NACIONAL BOLIVARIANA EGIDIO MONTESINOS	2421	5	28	1888	497	1860	0	5	0	2	1356	1888
EDO. LARA	CE. IRIBARREN	PQ. CATEDRAL	UNIDAD EDUCATIVA BRISAS DE BARRIO LINDO	403	1	9	355	256	346	0	1	1	0	88	355
EDO. LARA	CE. IRIBARREN	PQ. CATEDRAL	UNIDAD EDUCATIVA LA ARBOLEDA	894	2	18	764	446	746	0	7	1	0	292	764
EDO. LARA	CE. IRIBARREN	PQ. CATEDRAL	GRUPO ESCOLAR JUAN TAMAYO RODRIGUEZ	4096	8	92	3393	1701	3301	1	25	3	0	1571	3393
EDO. LARA	CE. IRIBARREN	PQ. CATEDRAL	UNIDAD EDUCATIVA JOSE MACARIO YEPEZ	3231	6	30	2591	677	2561	0	13	2	1	1868	2591
EDO. LARA	CE. IRIBARREN	PQ. CATEDRAL	CICLO COMBINADO COTO PAUL	1259	3	13	1109	258	1096	0	2	1	1	834	1109
EDO. LARA	CE. IRIBARREN	PQ. CATEDRAL	BIBLIOTECA MAHATMA GANDHI	1244	3	18	1016	544	998	0	8	2	1	443	1016
EDO. LARA	CE. IRIBARREN	PQ. AGUEDO F. ALVARADO	UNIDAD EDUCATIVA NACIONAL AGUEDO FELIPE ALVARADO	2276	4	39	1790	1010	1751	1	14	2	0	724	1790
EDO. LARA	CE. IRIBARREN	PQ. AGUEDO F. ALVARADO	ESCUELA ESTADAL USERA NUMERO 24	1099	2	18	889	632	871	0	5	1	0	233	889
EDO. LARA	CE. IRIBARREN	PQ. AGUEDO F. ALVARADO	UNIDAD EDUCATIVA NACIONAL BOLIVARIANA LOS QUEMADOS	726	2	10	594	255	584	0	6	3	0	320	594
EDO. LARA	CE. IRIBARREN	PQ. AGUEDO F. ALVARADO	ESCUELA BOLIVARIANA POTRERO DE BUCARE	641	2	15	570	390	555	0	7	0	0	158	570
EDO. LARA	CE. IRIBARREN	PQ. AGUEDO F. ALVARADO	ESCUELA BASICA UNITARIA LA FUNDACION	476	1	6	366	311	360	1	2	1	0	45	366
EDO. LARA	CE. IRIBARREN	PQ. AGUEDO F. ALVARADO	ESCUELA ESTADAL MATATERE	816	2	6	519	315	513	0	2	2	1	193	519
EDO. LARA	CE. IRIBARREN	PQ. AGUEDO F. ALVARADO	CENTRO DE EDUCACION INICIAL SIMONCITO PROFESORA CARMEN ALVIZU DE BRICENO	279	1	5	250	152	245	0	1	0	0	92	250
EDO. LARA	CE. IRIBARREN	PQ. AGUEDO F. ALVARADO	UNIDAD EDUCATIVA MAESTRO SERGIO PARRA	232	1	4	223	202	219	0	0	1	0	16	223
EDO. LARA	CE. IRIBARREN	PQ. AGUEDO F. ALVARADO	ESCUELA BASICA PIEDRA COLORADA	444	1	6	381	227	375	0	4	0	0	144	381
EDO. LARA	CE. IRIBARREN	PQ. AGUEDO F. ALVARADO	ESCUELA ESTADAL LAS MULAS NUMERO 471	816	2	6	644	387	638	0	5	0	0	246	644
EDO. LARA	CE. IRIBARREN	PQ. AGUEDO F. ALVARADO	UNIDAD EDUCATIVA PUERTA DE BOBARE	364	1	17	337	241	320	0	3	0	1	75	337
EDO. LARA	CE. IRIBARREN	PQ. AGUEDO F. ALVARADO	CASA DE LA CULTURA ROMULO GALLEGOS	613	2	11	514	296	503	0	2	0	0	205	514
EDO. LARA	CE. IRIBARREN	PQ. AGUEDO F. ALVARADO	UNIDAD EDUCATIVA BOLIVARIANA MEDIA JORNADA VEGA FRESCA	261	1	1	234	158	233	0	2	0	0	73	234
EDO. LARA	CE. IRIBARREN	PQ. AGUEDO F. ALVARADO	ESCUELA BOLIVARIANA ANA MUJICA DE BARRIOS	392	1	8	355	154	347	1	1	0	0	191	355
EDO. LARA	CE. IRIBARREN	PQ. AGUEDO F. ALVARADO	ESCUELA NACIONAL CUESTA GRANDE	524	1	4	423	325	419	0	2	1	0	91	423
EDO. LARA	CE. IRIBARREN	PQ. AGUEDO F. ALVARADO	ESCUELA NACIONAL LAS BRUJITAS	851	2	13	667	324	654	0	3	2	0	325	667
EDO. LARA	CE. IRIBARREN	PQ. AGUEDO F. ALVARADO	UNIDAD EDUCATIVA NACIONAL EL TACAL	215	1	6	197	171	191	0	0	0	0	20	197
EDO. LARA	CE. IRIBARREN	PQ. AGUEDO F. ALVARADO	ESCUELA BASICA ALTOS DE MUCURAGUA	111	1	3	94	77	91	1	2	0	0	11	94
EDO. LARA	CE. IRIBARREN	PQ. AGUEDO F. ALVARADO	ESCUELA BASICA NACIONAL FRANCISCO DE MIRANDA	2923	6	41	2212	1141	2171	1	16	5	0	1008	2212
EDO. LARA	CE. IRIBARREN	PQ. EL CUJI	ESCUELA BASICA ESTADAL LA ROSA	368	1	5	344	214	339	0	1	1	1	122	344
EDO. LARA	CE. IRIBARREN	PQ. EL CUJI	UNIDAD EDUCATIVA EL JAYO	456	1	11	409	248	398	0	3	0	0	147	409
EDO. LARA	CE. IRIBARREN	PQ. EL CUJI	ESCUELA NACIONAL EL CARDENAL	719	2	9	667	467	658	1	4	1	3	182	667
EDO. LARA	CE. IRIBARREN	PQ. EL CUJI	CICLO BASICO CARORITA ABAJO	3477	6	46	2703	1440	2657	0	24	4	1	1188	2703
EDO. LARA	CE. IRIBARREN	PQ. EL CUJI	UNIDAD EDUCATIVA ESTADAL GRAN MARISCAL DE AYACUCHO	1198	2	14	1072	597	1058	0	11	4	1	445	1072
EDO. LARA	CE. IRIBARREN	PQ. EL CUJI	ESCUELA EL CALLAO	186	1	8	174	101	166	0	6	1	1	57	174
EDO. LARA	CE. IRIBARREN	PQ. EL CUJI	CENTRO DE EDUCACION INICIAL EL CUJI	1215	3	24	1033	478	1009	1	6	0	2	522	1033
EDO. LARA	CE. IRIBARREN	PQ. EL CUJI	CIRA MARIA NOGUERA DE LORENA	387	1	1	361	267	360	1	1	0	0	91	361
EDO. LARA	CE. IRIBARREN	PQ. EL CUJI	ESCUELA BASICA BOLIVARIANA MEDIA JORNADA LOS ROBLES	433	1	9	387	250	378	0	2	0	0	126	387
EDO. LARA	CE. IRIBARREN	PQ. EL CUJI	UNIDAD EDUCATIVA ANDRES BELLO	3737	7	52	3222	1603	3170	0	29	3	2	1533	3222
EDO. LARA	CE. IRIBARREN	PQ. EL CUJI	UNIDAD EDUCATIVA DOCTOR ARGIMIRO BRACAMONTE II	2296	4	33	1952	853	1919	0	20	0	4	1042	1952
EDO. LARA	CE. IRIBARREN	PQ. EL CUJI	UNIDAD EDUCATIVA LAS VEGAS	328	1	2	186	147	184	0	1	0	1	35	186
EDO. LARA	CE. IRIBARREN	PQ. EL CUJI	UNIDAD EDUCATIVA BOLIVARIANA LA PLAYA	1059	2	23	932	492	909	0	6	1	0	410	932
EDO. LARA	CE. IRIBARREN	PQ. EL CUJI	UNIDAD EDUCATIVA EL TURAL	159	1	0	133	103	133	0	1	0	0	29	133
EDO. LARA	CE. IRIBARREN	PQ. EL CUJI	UNIDAD EDUCATIVA PRADOS DEL NORTE II	1355	3	26	1214	553	1188	0	12	1	0	622	1214
EDO. LARA	CE. IRIBARREN	PQ. EL CUJI	UNIDAD EDUCATIVA ESTADAL  DOMINGO HURTADO	519	1	12	463	325	451	0	2	1	0	123	463
EDO. LARA	CE. IRIBARREN	PQ. EL CUJI	UNIDAD EDUCATIVA ESTADAL JUAN DE VILLEGAS	1319	3	30	1134	665	1104	3	8	0	1	427	1134
EDO. LARA	CE. IRIBARREN	PQ. EL CUJI	UNIDAD EDUCATIVA NACIONAL EL CUJI	3926	7	72	3110	1509	3038	0	22	2	3	1502	3110
EDO. LARA	CE. IRIBARREN	PQ. EL CUJI	UNIDAD EDUCATIVA NACIONAL FEDERMAN NER 140	65	1	2	60	39	58	0	0	0	0	19	60
EDO. LARA	CE. IRIBARREN	PQ. EL CUJI	ESCUELA ESTADAL JOSE A GIRARDOT	4220	8	52	3437	1522	3385	0	26	5	1	1831	3437
EDO. LARA	CE. IRIBARREN	PQ. UNION	PROFESOR TULIO FEBRES CORDERO	1252	3	35	1115	731	1080	1	7	0	1	340	1115
EDO. LARA	CE. IRIBARREN	PQ. UNION	CENTRO COMUNITARIO DE PROTECCION Y DESARROLLO ESTUDIANTIL	1181	3	30	960	496	930	0	10	1	1	422	960
EDO. LARA	CE. IRIBARREN	PQ. UNION	UNIDAD EDUCATIVA COLINAS SAN LORENZO II	490	1	13	413	235	400	0	3	0	0	162	413
EDO. LARA	CE. IRIBARREN	PQ. UNION	GIMNASIO DE BOXEO SAN JACINTO II	314	1	14	283	175	269	0	1	0	0	93	283
EDO. LARA	CE. IRIBARREN	PQ. UNION	CENTRO DE EDUCACIÓN INCIAL MOISES Y LUISA ZISMAN	1076	2	12	874	394	862	1	5	0	0	462	874
EDO. LARA	CE. IRIBARREN	PQ. UNION	UNIDAD EDUCATIVA ANTONIO ARRAIZ	2718	5	46	2307	1177	2261	0	22	2	1	1059	2307
EDO. LARA	CE. IRIBARREN	PQ. UNION	UNIDAD EDUCATIVA COLEGIO FE Y ALEGRIA MONSEÑOR OSCAR ARNURLFO ROMERO	1155	2	36	993	627	957	0	2	1	0	327	993
EDO. LARA	CE. IRIBARREN	PQ. UNION	ESCUELA GRADUADA GABRIELA MISTRAL	2526	5	62	2087	1304	2025	0	23	1	1	696	2087
EDO. LARA	CE. IRIBARREN	PQ. UNION	CASA COMUNAL LA CAÑADA SECTOR NICASIO	207	1	2	192	165	190	0	1	0	0	24	192
EDO. LARA	CE. IRIBARREN	PQ. UNION	SIMONCITO COMUNITARIO MIS PAYASITOS	264	1	3	230	142	227	0	2	0	0	83	230
EDO. LARA	CE. IRIBARREN	PQ. UNION	UNIDAD EDUCATIVA NACIONAL LOS CREPUSCULOS	3537	7	45	3106	1193	3061	0	22	0	2	1844	3106
EDO. LARA	CE. IRIBARREN	PQ. UNION	ESCUELA ALGARI	1100	2	23	896	715	873	1	1	0	1	155	896
EDO. LARA	CE. IRIBARREN	PQ. UNION	ESCUELA BASICA GRAN MARISCAL DE AYACUCHO	4190	8	79	3521	1651	3442	0	27	2	4	1758	3521
EDO. LARA	CE. IRIBARREN	PQ. UNION	CENTRO DE EDUCACION INICIAL MICAELA ESCALONA	1325	3	25	1106	571	1081	0	10	1	2	497	1106
EDO. LARA	CE. IRIBARREN	PQ. UNION	CASA COMUNAL CRUZ BAJA	287	1	4	262	204	258	0	0	0	0	54	262
EDO. LARA	CE. IRIBARREN	PQ. UNION	ESCUELA BASICA EZEQUIEL ZAMORA	3713	7	44	3063	1611	3019	2	26	1	2	1377	3063
EDO. LARA	CE. IRIBARREN	PQ. UNION	ESCUELA BASICA EL CARMEN	3509	6	67	2819	1836	2752	1	28	4	3	880	2819
EDO. LARA	CE. IRIBARREN	PQ. UNION	CASA COMUNAL MANUEL PRADO	447	1	7	394	223	387	0	0	0	0	164	394
EDO. LARA	CE. IRIBARREN	PQ. UNION	UNIDAD EDUCATIVA NACIONAL ELADIO DEL CASTILLO	2095	4	25	1713	963	1688	0	8	0	0	717	1713
EDO. LARA	CE. IRIBARREN	PQ. UNION	UNIDAD EDUCATIVA DOCTOR CECILIO ACOSTA	2841	5	38	2393	1299	2355	1	16	2	1	1036	2393
EDO. LARA	CE. IRIBARREN	PQ. UNION	UNIDAD EDUCATIVA DOCTOR ALBERTO CARNEVALI	3046	6	77	2546	1648	2469	1	10	0	2	808	2546
EDO. LARA	CE. IRIBARREN	PQ. UNION	CENTRO DE EDUCACION INICIAL LOS CREPUSCULOS	1577	3	34	1398	513	1364	0	5	0	0	846	1398
EDO. LARA	CE. IRIBARREN	PQ. UNION	CENTRO DE EDUCACION INICIAL SAN JOSE	706	2	4	555	290	551	1	9	0	0	251	555
EDO. LARA	CE. IRIBARREN	PQ. UNION	ESC NAC JUAN GUILLERMO IRIBARREN	3219	6	73	2552	1355	2479	1	28	4	1	1090	2552
EDO. LARA	CE. IRIBARREN	PQ. UNION	ESCUELA BASICA PEDRO RAFAEL CHACON	2262	4	65	1793	940	1728	2	7	0	1	778	1793
EDO. LARA	CE. IRIBARREN	PQ. UNION	CENTRO DE EDUCACION INICIAL CORAZON DE JESUS	234	1	6	208	170	202	0	1	0	0	31	208
EDO. LARA	CE. IRIBARREN	PQ. UNION	ESCUELA BASICA NACIONAL NUEVO BARRIO	1499	3	26	1291	891	1265	2	7	1	0	364	1291
EDO. LARA	CE. IRIBARREN	PQ. UNION	UNIDAD EDUCATIVA CARORITA ARRIBA	635	2	15	484	291	469	0	4	0	2	172	484
EDO. LARA	CE. IRIBARREN	PQ. UNION	UNIDAD EDUCATIVA DOMINGO HURTADO	1933	4	32	1630	840	1598	0	10	1	1	746	1630
EDO. LARA	CE. IRIBARREN	PQ. UNION	CENTRO DE FORMACION INDUSTRIAL (INCE)	2236	4	32	1824	957	1792	0	16	0	1	818	1824
EDO. LARA	CE. IRIBARREN	PQ. UNION	GRUPO ESCOLAR CECILIO ZUBILLAGA PERERA	2962	6	41	2494	1063	2453	1	15	0	2	1372	2494
EDO. LARA	CE. IRIBARREN	PQ. UNION	CENTRO DE EDUCACION INICIAL MARIA TERESA DEL TORO	509	1	7	447	345	440	0	2	0	0	93	447
EDO. LARA	CE. IRIBARREN	PQ. UNION	BIBLIOTECA GERARDO PEREZ	310	1	4	284	163	280	0	2	0	0	115	284
EDO. LARA	CE. IRIBARREN	PQ. UNION	ESUELA BOLIVARIANA CIUDAD DE MATURIN	5654	10	90	4710	2637	4620	3	21	1	2	1956	4710
EDO. LARA	CE. IRIBARREN	PQ. UNION	UNIDAD EDUCATIVADEPARTAMENTO LIBERTADOR	4001	7	62	3233	1734	3171	0	21	4	3	1409	3233
EDO. LARA	CE. IRIBARREN	PQ. UNION	CENTRO DE EDUCACION INICIAL DON GERMAN PRADO GOMEZ	579	1	7	426	236	419	0	2	0	0	181	426
EDO. LARA	CE. IRIBARREN	PQ. UNION	CENTRO DE EDUCACION INICIAL BOLIVARIANO JACINTO LARA I	777	2	23	675	282	652	0	5	1	1	363	675
EDO. LARA	CE. IRIBARREN	PQ. UNION	UNIDAD EDUCATIVA CORONEL GENARO VASQUEZ	5140	9	107	4194	2246	4087	3	32	1	1	1804	4194
EDO. LARA	CE. IRIBARREN	PQ. UNION	ESCUELA NACIONAL BOLIVARIANA MIGUEL ANGEL DELGADO	1273	3	16	1038	538	1022	1	7	0	0	476	1038
EDO. LARA	CE. IRIBARREN	PQ. UNION	UNIDAD EDUCATIVA ANDRES ELOY BLANCO	2573	5	39	2039	1298	2000	0	13	2	0	687	2039
EDO. LARA	CE. IRIBARREN	PQ. UNION	UNIDAD EDUCATIVA JOSE LEONARDO CHIRINOS	3197	6	70	2605	1506	2535	0	18	1	2	1008	2605
EDO. LARA	CE. IRIBARREN	PQ. UNION	UNIDAD EDUCATIVA CIUDAD DE VALENCIA	3171	6	41	2537	1280	2496	1	14	2	2	1197	2537
EDO. LARA	CE. IRIBARREN	PQ. UNION	ESCUELA BOLIVARIANA PROFESOR RAFAEL CORONADO	163	1	1	134	108	133	0	3	0	0	22	134
EDO. LARA	CE. IRIBARREN	PQ. UNION	CASA COMUNAL BARRIO LINDO	261	1	9	239	142	230	0	1	0	0	87	239
EDO. LARA	CE. IRIBARREN	PQ. UNION	UNIDAD EDUCATIVA CRISTOBAL MENDOZA	861	2	16	753	601	737	0	5	0	0	131	753
EDO. LARA	CE. IRIBARREN	PQ. UNION	ESCUELA BOLIVARIANA LAS VERITAS	800	2	27	677	396	650	0	10	1	1	242	677
EDO. LARA	CE. IRIBARREN	PQ. UNION	UNIDAD EDUCATIVA LOLA ALAMO	2814	5	48	2207	1180	2159	3	19	0	2	955	2207
EDO. LARA	CE. IRIBARREN	PQ. UNION	CASA COMUNAL LA ANTENA	1396	3	20	1153	710	1133	0	13	0	1	409	1153
EDO. LARA	CE. IRIBARREN	PQ. UNION	UNIDAD EDUCATIVA COLEGIO FE Y ALEGRIA JUAN XXIII	4544	8	79	3717	2217	3638	2	30	2	2	1385	3717
EDO. LARA	CE. IRIBARREN	PQ. UNION	UNIDAD EDUCATIVA DR FORTUNATO ORELLANA	2067	4	49	1715	1203	1666	0	12	1	3	447	1715
EDO. LARA	CE. IRIBARREN	PQ. UNION	CANCHA DEPORTIVA BARRIO UNION	394	1	4	346	240	342	0	1	1	0	100	346
EDO. LARA	CE. IRIBARREN	PQ. UNION	CENTRO DE EDUCACION INICIAL JOSE FELIX RIBAS	608	2	15	565	255	550	0	3	0	1	291	565
EDO. LARA	CE. IRIBARREN	PQ. UNION	INSTITUTO POPULAR MARIA MAZZARELLO	2806	5	39	2507	1154	2468	0	12	1	2	1299	2507
EDO. LARA	CE. IRIBARREN	PQ. LA CONCEPCION	CENTRO DE EDUCACION INICIAL MANUELITA SAENZ	814	2	11	655	215	644	0	4	1	0	424	655
EDO. LARA	CE. IRIBARREN	PQ. LA CONCEPCION	LICEO LISANDRO ALVARADO	2524	5	45	2152	649	2107	0	9	0	2	1447	2152
EDO. LARA	CE. IRIBARREN	PQ. LA CONCEPCION	COLEGIO DE INGENIEROS DEL ESTADO LARA	3148	6	25	2705	683	2680	0	13	2	4	1978	2705
EDO. LARA	CE. IRIBARREN	PQ. LA CONCEPCION	CENTRO DE EDUCACION INICIAL HAIDEE RAMIREZ	458	1	13	424	222	411	0	2	0	0	187	424
EDO. LARA	CE. IRIBARREN	PQ. LA CONCEPCION	CENTRO PREESCOLAR MADRE TERESA DE CALCUTA	1188	2	12	994	237	982	0	5	0	0	740	994
EDO. LARA	CE. IRIBARREN	PQ. LA CONCEPCION	UNIDAD EDUCATIVA COLEGIO SAN PEDRO	3542	7	31	3101	386	3070	0	7	0	0	2677	3101
EDO. LARA	CE. IRIBARREN	PQ. LA CONCEPCION	CASA SINDICAL	1603	3	21	1330	477	1309	0	8	1	0	823	1330
EDO. LARA	CE. IRIBARREN	PQ. LA CONCEPCION	FUNDACION MUNICIPAL DEL NIÑO	999	2	12	816	246	804	0	4	0	1	553	816
EDO. LARA	CE. IRIBARREN	PQ. LA CONCEPCION	CENTRO DE EDUCACION INICIAL SANTUARIO DE AIRE	222	1	4	202	57	198	0	0	0	0	141	202
EDO. LARA	CE. IRIBARREN	PQ. LA CONCEPCION	U.E.COLEGIO MARIA AUXILIADORA	2555	5	19	2185	593	2166	1	11	0	1	1560	2185
EDO. LARA	CE. IRIBARREN	PQ. LA CONCEPCION	HOSPITAL DR.JUAN DAZA PEREYRA	854	2	15	739	274	724	0	2	1	0	447	739
EDO. LARA	CE. IRIBARREN	PQ. LA CONCEPCION	UNIDAD EDUCATIVA VENEZUELA	3464	6	62	2823	1167	2761	1	10	0	2	1581	2823
EDO. LARA	CE. IRIBARREN	PQ. LA CONCEPCION	ESCUELA BOLIVARIANA SAN VICENTE	385	1	14	350	216	336	0	1	0	0	119	350
EDO. LARA	CE. IRIBARREN	PQ. LA CONCEPCION	FUNDACION MUSEO DE BARQUISIMETO	1316	3	12	944	262	932	0	5	1	1	663	944
EDO. LARA	CE. IRIBARREN	PQ. LA CONCEPCION	U.E.I. LA SALLE	2596	5	35	2098	608	2063	0	5	2	0	1448	2098
EDO. LARA	CE. IRIBARREN	PQ. LA CONCEPCION	COLEGIO MADRE MARIA	2122	4	32	1724	644	1692	1	9	0	1	1037	1724
EDO. LARA	CE. IRIBARREN	PQ. LA CONCEPCION	ESCUELA BASICA JUAN BAUTISTA RODRIGUEZ	2315	4	23	2000	715	1977	0	10	1	1	1250	2000
EDO. LARA	CE. IRIBARREN	PQ. LA CONCEPCION	UNIDAD EDUCATIVA LAS BRISAS	1429	3	26	1220	551	1194	0	7	2	1	633	1220
EDO. LARA	CE. IRIBARREN	PQ. LA CONCEPCION	CASA DE ABRIGO DOCTOR FORTUNATO ORELLANA	1038	2	10	887	250	877	0	4	0	0	623	887
EDO. LARA	CE. IRIBARREN	PQ. LA CONCEPCION	UNIDAD EDUCATIVA PABLO MANZANO VELOZ	2434	5	29	2099	593	2070	0	12	1	0	1464	2099
EDO. LARA	CE. IRIBARREN	PQ. LA CONCEPCION	UNIDAD EDUCATIVA NACIONAL SAN IGNACIO DE LOYOLA	249	1	5	228	69	223	0	1	0	1	152	228
EDO. LARA	CE. IRIBARREN	PQ. LA CONCEPCION	GRUPO ESCOLAR JOSE GREGORIO HERNANDEZ	2808	5	34	2356	683	2322	0	17	1	5	1616	2356
EDO. LARA	CE. IRIBARREN	PQ. LA CONCEPCION	GRUPO ESCOLAR CIUDAD BOLIVAR	3419	6	43	2766	1191	2723	1	15	1	1	1514	2766
EDO. LARA	CE. IRIBARREN	PQ. LA CONCEPCION	ESCUELA NACIONAL INES LUCIA YEPEZ	2260	4	29	1834	571	1805	0	4	2	0	1228	1834
EDO. LARA	CE. IRIBARREN	PQ. LA CONCEPCION	U.E.N. JOSE GIL FORTOUL	3947	7	47	3378	1022	3331	1	14	1	3	2290	3378
EDO. LARA	CE. IRIBARREN	PQ. LA CONCEPCION	COLEGIO ENMANUEL. BARQUISIMETO	1493	3	22	1181	489	1159	1	7	0	0	662	1181
EDO. LARA	CE. IRIBARREN	PQ. LA CONCEPCION	CENTRO EDUCATIVO INICIAL ANTONIO JOSE DE SUCRE	897	2	12	765	244	753	0	3	0	1	505	765
EDO. LARA	CE. IRIBARREN	PQ. LA CONCEPCION	CENTRO DE EDUCACION INICIAL TEODORO MENDEZ	1617	3	30	1391	423	1361	0	7	0	2	929	1391
EDO. LARA	CE. IRIBARREN	PQ. LA CONCEPCION	CASA DEL ABUELO	1302	3	17	1091	408	1074	0	7	2	0	657	1091
EDO. LARA	CE. IRIBARREN	PQ. LA CONCEPCION	GRUPO ESCOLAR NACIONAL AYACUCHO	3235	6	44	2693	765	2649	0	15	0	2	1867	2693
EDO. LARA	CE. IRIBARREN	PQ. LA CONCEPCION	INTERNADO JUDICIAL DE BARQUISIMETO	745	2	10	592	294	582	0	3	0	0	285	592
EDO. LARA	CE. IRIBARREN	PQ. LA CONCEPCION	CICLO BASICO EZEQUIEL BUJANDA	3177	6	50	2607	976	2557	1	13	2	8	1557	2607
EDO. LARA	CE. IRIBARREN	PQ. LA CONCEPCION	CENTRO DE EDUCACION INICIAL EL LIBERTADOR	413	1	10	382	114	372	0	3	0	0	255	382
EDO. LARA	CE. IRIBARREN	PQ. LA CONCEPCION	UNIVERSIDAD YACAMBU	276	1	6	251	73	245	0	0	0	0	172	251
EDO. LARA	CE. IRIBARREN	PQ. LA CONCEPCION	U.E.N. HECTOR CASTILLO REYES	3183	6	32	2644	938	2612	0	12	2	2	1658	2644
EDO. LARA	CE. IRIBARREN	PQ. LA CONCEPCION	U.E.N. LIBERTADOR	1101	2	28	925	451	897	1	4	1	2	438	925
EDO. LARA	CE. IRIBARREN	PQ. LA CONCEPCION	UNIDAD EDUCATIVA NACIONAL PASTOR OROPEZA	1355	3	23	1213	626	1190	1	9	0	0	554	1213
EDO. LARA	CE. IRIBARREN	PQ. LA CONCEPCION	COLEGIO NACIONAL DE PERIODISTAS	1081	2	7	950	256	943	1	4	0	0	682	950
EDO. LARA	CE. IRIBARREN	PQ. LA CONCEPCION	ESCUELA NACIONAL PABLO JOSE ALVAREZ	1427	3	10	1181	376	1171	0	3	0	0	792	1181
EDO. LARA	CE. IRIBARREN	PQ. LA CONCEPCION	U.E. COLEGIO EL SANTISIMO	2459	5	25	2177	585	2152	0	15	1	2	1549	2177
EDO. LARA	CE. IRIBARREN	PQ. LA CONCEPCION	ESCUELA BASICA NACIONAL CREACION VII	1414	3	16	1205	385	1189	2	4	0	0	798	1205
EDO. LARA	CE. IRIBARREN	PQ. LA CONCEPCION	UNIDAD EDUCATIVA ESTADAL LAS VEGAS	1115	2	19	1013	446	994	0	7	0	1	540	1013
EDO. LARA	CE. IRIBARREN	PQ. LA CONCEPCION	UNIDAD EDUCATIVA ESTADAL  ARTE INFANTIL JULIO TEODOORO ARZE	987	2	16	890	226	874	1	2	1	0	644	890
EDO. LARA	CE. IRIBARREN	PQ. LA CONCEPCION	CICLO BASICO CONCENTRADO RAFAEL MONASTERIOS	2013	4	38	1717	548	1679	1	5	1	0	1124	1717
EDO. LARA	CE. IRIBARREN	PQ. LA CONCEPCION	UNIDAD EDUCATIVA LARA	1624	3	15	1384	408	1369	2	5	0	1	953	1384
EDO. LARA	CE. IRIBARREN	PQ. LA CONCEPCION	ESCUELA CONCENTRADA SANTO DOMINGO	1605	3	29	1300	730	1271	0	9	2	0	530	1300
EDO. LARA	CE. IRIBARREN	PQ. LA CONCEPCION	ESCUELA ESTADAL GRADUADA SIMON RODRIGUEZ	2674	5	33	2290	1019	2257	0	7	3	1	1227	2290
EDO. LARA	CE. IRIBARREN	PQ. LA CONCEPCION	UNIDAD EDUCATIVA COLEGIO GENERAL JOSE TRINIDAD MORAN	2092	4	66	1820	823	1754	0	26	2	2	901	1820
EDO. LARA	CE. IRIBARREN	PQ. LA CONCEPCION	UNIDAD EDUCATIVA NACIONAL VICENTE LECUNA	308	1	3	268	86	265	0	0	0	0	179	268
EDO. LARA	CE. IRIBARREN	PQ. LA CONCEPCION	UNIDAD EDUCATIVA NACIONAL OBELISCO 2	377	1	2	353	96	351	0	2	1	0	252	353
EDO. LARA	CE. IRIBARREN	PQ. LA CONCEPCION	ESCUELA BASICA EL OBELISCO	3349	6	29	2965	664	2936	1	10	0	0	2261	2965
EDO. LARA	CE. IRIBARREN	PQ. LA CONCEPCION	U.E.N. HERNAN VALERA SAAVEDRA	1526	3	14	1190	545	1176	0	4	0	1	626	1190
EDO. LARA	CE. IRIBARREN	PQ. LA CONCEPCION	GRUPO ESCOLAR REPUBLICA DE COSTA RICA	2965	6	23	2348	659	2325	0	6	2	2	1656	2348
EDO. LARA	CE. IRIBARREN	PQ. LA CONCEPCION	UNIDAD EDUCATIVA COLEGIO SAN MARCOS DE LEON	1008	2	14	841	308	827	0	6	1	0	512	841
EDO. LARA	CE. IRIBARREN	PQ. LA CONCEPCION	CENTRO DE EDUCACION INICIAL MI PAPAGAYO VOLADOR	261	1	3	232	110	229	0	0	1	0	118	232
EDO. LARA	CE. IRIBARREN	PQ. LA CONCEPCION	ESCUELA NACIONAL SAN ANTONIO	1177	2	19	926	454	907	0	6	0	1	446	926
EDO. LARA	CE. IRIBARREN	PQ. LA CONCEPCION	FETRAMAGISTERIO	753	2	8	609	181	601	0	5	0	2	413	609
EDO. LARA	CE. IRIBARREN	PQ. LA CONCEPCION	LICEO BOLIVARIANO RAFAEL VILLAVICENCIO	2486	5	18	2237	699	2219	0	7	1	0	1512	2237
EDO. LARA	CE. IRIBARREN	PQ. LA CONCEPCION	ESCUELA STELLA CECHINI	3573	7	58	3131	1005	3073	1	13	0	6	2048	3131
EDO. LARA	CE. IRIBARREN	PQ. LA CONCEPCION	UNIDAD EDUCATIVA VIRGINIA DE ANDRADE	4351	8	47	3747	1318	3700	1	14	4	0	2363	3747
EDO. LARA	CE. IRIBARREN	PQ. LA CONCEPCION	UNIDAD EDUCATIVA ESTADAL ANTONIO JOSE DE SUCRE	1287	3	14	1053	312	1039	0	2	1	1	723	1053
EDO. LARA	CE. IRIBARREN	PQ. LA CONCEPCION	CICLO BASICO INDUSTRIAL LARA	3795	7	38	3323	990	3285	1	24	0	2	2268	3323
EDO. LARA	CE. IRIBARREN	PQ. LA CONCEPCION	UNIDAD  NACIONAL SAN FRANCISCO JAVIER	2130	4	24	1882	379	1858	1	3	0	3	1472	1882
EDO. LARA	CE. IRIBARREN	PQ. LA CONCEPCION	UNIDAD EDUCATIVA JOSE MARIA DOMINGUEZ	2259	4	23	2044	489	2021	0	6	1	2	1523	2044
EDO. LARA	CE. IRIBARREN	PQ. LA CONCEPCION	CENTRO DE EDUCACION INICIAL MIRANDA PRECURSOR	792	2	8	637	234	629	0	3	2	0	390	637
EDO. LARA	CE. IRIBARREN	PQ. LA CONCEPCION	UNIDAD EDUCATIVA COLEGIO MIGUEL DE CERVANTES	304	1	2	279	73	277	0	2	0	0	202	279
EDO. LARA	CE. IRIBARREN	PQ. LA CONCEPCION	COLEGIO PRESBISTERIANO EL DIVINO SALVADOR	404	1	3	376	166	373	0	2	0	0	205	376
EDO. LARA	CE. IRIBARREN	PQ. JUAREZ	ESCUELA BOLIVARIANA MEDIA JORNADA AGUA BLANCA	183	1	4	147	122	143	0	0	0	1	20	147
EDO. LARA	CE. IRIBARREN	PQ. JUAREZ	CASA DE LA CULTURA	503	1	14	418	237	404	0	2	1	0	164	418
EDO. LARA	CE. IRIBARREN	PQ. JUAREZ	UNIDAD EDUCATIVA ESTADAL ANTONIO RICAURTE	970	2	15	767	541	752	0	5	4	1	201	767
EDO. LARA	CE. IRIBARREN	PQ. JUAREZ	ESCUELA BASICA UNITARIA EL GUAMITO	184	1	2	154	137	152	1	2	1	0	11	154
EDO. LARA	CE. IRIBARREN	PQ. JUAREZ	UNIDAD EDUCATIVA ESTADAL LIBERTADOR SIMON BOLIVAR	225	1	6	195	112	189	0	1	0	0	76	195
EDO. LARA	CE. IRIBARREN	PQ. JUAREZ	ESCUELA UNITARIA LA GOTERA	290	1	4	218	198	214	1	1	0	0	14	218
EDO. LARA	CE. IRIBARREN	PQ. JUAREZ	UNIDAD EDUCATIVA ANTONIO ALAMO	3478	6	58	2801	1644	2743	0	19	2	1	1077	2801
EDO. LARA	CE. IRIBARREN	PQ. JUAREZ	ESCUELA UNITARIA RIECITO	249	1	2	120	82	118	0	3	0	0	33	120
EDO. LARA	CE. IRIBARREN	PQ. JUAREZ	UNIDAD EDUCATIVA BOYAURE	2771	5	82	2174	1139	2092	0	14	3	4	932	2174
EDO. LARA	CE. IRIBARREN	PQ. JUAREZ	UNIDAD EDUCATIVA CONCENTRADA 544	557	1	11	465	303	454	0	2	0	0	149	465
EDO. LARA	CE. IRIBARREN	PQ. JUAREZ	ESCUELA BOLIVARIANA MEDIA JORNADA CERRO NEGRO
EDO. LARA	CE. IRIBARREN	PQ. JUAREZ	ESCUELA UNITARIA  LAS DELICIAS	530	1	3	340	280	337	0	2	0	0	55	340
EDO. LARA	CE. IRIBARREN	PQ. JUAN DE VILLEGAS	CENTRO DE EDUCACION INICIAL BOLIVARIANO SIMONCITO JEAN PIAGET	894	2	10	737	452	727	0	11	1	0	263	737
EDO. LARA	CE. IRIBARREN	PQ. JUAN DE VILLEGAS	AMBULATORIO PUEBLO NUEVO	902	2	12	750	333	738	1	6	1	0	397	750
EDO. LARA	CE. IRIBARREN	PQ. JUAN DE VILLEGAS	UNIDAD BASICA LA CARUCIEÑA	3174	6	89	2582	1450	2493	2	18	6	2	1015	2582
EDO. LARA	CE. IRIBARREN	PQ. JUAN DE VILLEGAS	ESCUELA BASICA SANTA ROSALIA	4174	8	65	3313	2024	3248	0	29	0	2	1193	3313
EDO. LARA	CE. IRIBARREN	PQ. JUAN DE VILLEGAS	CASA COMUNAL CARIBE II SECTOR II	953	2	11	775	507	764	0	6	1	1	249	775
EDO. LARA	CE. IRIBARREN	PQ. JUAN DE VILLEGAS	ESCUELA BASICA RAFAEL MONASTERIOS	3553	7	48	3024	1099	2976	1	18	0	1	1857	3024
EDO. LARA	CE. IRIBARREN	PQ. JUAN DE VILLEGAS	CENTRO DE EDUCACION INICIALJOSE FELIX RIBAS	1591	3	29	1368	679	1339	0	10	2	0	648	1368
EDO. LARA	CE. IRIBARREN	PQ. JUAN DE VILLEGAS	PREESCOLAR MUNDO DE SONRISAS	718	2	16	637	478	621	0	3	0	1	139	637
EDO. LARA	CE. IRIBARREN	PQ. JUAN DE VILLEGAS	UNIDAD EDUCATIVA JUAN JACINTO LARA	2308	4	37	1950	1194	1913	1	16	3	1	698	1950
EDO. LARA	CE. IRIBARREN	PQ. JUAN DE VILLEGAS	UNIDAD EDUCATIVA ESTADAL LUIS BELTRAN PRIETO FIGUEROA	477	1	15	430	304	415	0	5	0	0	106	430
EDO. LARA	CE. IRIBARREN	PQ. JUAN DE VILLEGAS	GIMNASIO CUBIERTO LOS HORCONES	1763	3	46	1485	811	1439	1	9	1	0	617	1485
EDO. LARA	CE. IRIBARREN	PQ. JUAN DE VILLEGAS	ESCUELA NACIONAL LA CONCORDIA 2	1472	3	25	1261	1017	1236	0	5	1	1	212	1261
EDO. LARA	CE. IRIBARREN	PQ. JUAN DE VILLEGAS	INSTITUTO DE EDUCACION ESPECIAL BARQUISIMETO	277	1	8	262	184	254	0	3	0	1	66	262
EDO. LARA	CE. IRIBARREN	PQ. JUAN DE VILLEGAS	ESCUELA BASICA LIBERTADOR	5155	9	104	4115	2642	4011	1	28	2	1	1337	4115
EDO. LARA	CE. IRIBARREN	PQ. JUAN DE VILLEGAS	UNIDAD EDUCATIVA NACIONAL ANTONIO CARRILLO	4460	8	44	3742	1662	3698	1	26	2	3	2004	3742
EDO. LARA	CE. IRIBARREN	PQ. JUAN DE VILLEGAS	ESCUELA BASICA JUAN JOSE GUERRERO	2807	5	67	2273	1354	2206	0	19	2	0	831	2273
EDO. LARA	CE. IRIBARREN	PQ. JUAN DE VILLEGAS	UNIDAD EDUCATIVA ESTADAL ROMULO BETANCOURT I	909	2	15	777	503	762	0	8	2	0	249	777
EDO. LARA	CE. IRIBARREN	PQ. JUAN DE VILLEGAS	ESCUELA BASICA TENIENTE PEDRO CAMEJO	5781	11	123	4895	1972	4772	1	29	4	4	2762	4895
EDO. LARA	CE. IRIBARREN	PQ. JUAN DE VILLEGAS	CENTRO DE EDUCACION INICIAL ROMULO GALLEGOS	264	1	3	226	135	223	0	5	1	0	82	226
EDO. LARA	CE. IRIBARREN	PQ. JUAN DE VILLEGAS	ESCUELA ESTADAL GRADUADA GENERAL JOSE TRINIDAD MORAN	4029	7	43	3343	1399	3300	1	23	3	1	1873	3343
EDO. LARA	CE. IRIBARREN	PQ. JUAN DE VILLEGAS	ESCUELA ESTADAL LA ORQUIDEA	504	1	14	432	289	418	0	3	0	0	126	432
EDO. LARA	CE. IRIBARREN	PQ. JUAN DE VILLEGAS	MODULO DE SERVICIO CERRITOS BLANCOS	1174	3	25	927	605	902	0	12	0	0	285	927
EDO. LARA	CE. IRIBARREN	PQ. JUAN DE VILLEGAS	ESCUELA RUIZ PINEDA I	4219	8	51	3481	1995	3430	1	26	6	5	1397	3481
EDO. LARA	CE. IRIBARREN	PQ. JUAN DE VILLEGAS	CENTRO DE EDUCACION INICIAL BOLIVARIANA BICENTENARIA NATALICIO DEL LIBERTADOR	414	1	5	367	210	362	0	4	1	0	147	367
EDO. LARA	CE. IRIBARREN	PQ. JUAN DE VILLEGAS	CANCHA TECHADA HAPPY BOY	338	1	6	311	190	305	0	7	0	0	108	311
EDO. LARA	CE. IRIBARREN	PQ. JUAN DE VILLEGAS	ESCUELA BASICA SIMON BOLIVAR	6767	13	141	5719	2907	5578	3	50	6	5	2607	5719
EDO. LARA	CE. IRIBARREN	PQ. JUAN DE VILLEGAS	UNIDAD EDUCATIVA  PABLO CANELA	2023	4	51	1699	1180	1648	1	9	0	1	457	1699
EDO. LARA	CE. IRIBARREN	PQ. JUAN DE VILLEGAS	CENTRO DE EDUCACION INICIAL DONA INES MANCEBO DE MIJARES	315	1	3	299	213	296	0	2	1	0	80	299
EDO. LARA	CE. IRIBARREN	PQ. JUAN DE VILLEGAS	CANCHA TECHADA CERRITOS BLANCO	387	1	6	320	226	314	0	0	0	0	88	320
EDO. LARA	CE. IRIBARREN	PQ. JUAN DE VILLEGAS	CICLO BASICO PADRE DE LAS CASAS	2346	4	19	1993	696	1974	0	10	5	1	1262	1993
EDO. LARA	CE. IRIBARREN	PQ. JUAN DE VILLEGAS	ESCUELA BOLIVARIANA DE MEDIA JORNADA DILCIA MORENO DE BOSSA	2612	5	29	2043	1188	2014	0	15	4	0	807	2043
EDO. LARA	CE. IRIBARREN	PQ. JUAN DE VILLEGAS	ESCUELA BASICA CERRITOS BLANCOS II	4667	9	62	3697	2356	3635	2	26	3	3	1245	3697
EDO. LARA	CE. IRIBARREN	PQ. JUAN DE VILLEGAS	CENTRO DE EDUCACION INICIAL ESTADAL DOCTOR AGUSTIN ZUBILLAGA	704	2	15	588	332	573	0	6	1	0	234	588
EDO. LARA	CE. IRIBARREN	PQ. JUAN DE VILLEGAS	UNIDAD EDUCATIVA BOLIVARIANA BELEN MARIA SAN JUAN	777	2	11	693	439	682	0	10	4	1	228	693
EDO. LARA	CE. IRIBARREN	PQ. JUAN DE VILLEGAS	CANCHA TECHADA EL PLAYON	401	1	10	364	251	354	0	4	0	1	98	364
EDO. LARA	CE. IRIBARREN	PQ. JUAN DE VILLEGAS	UNIDAD EDUCATIVA LAS TINAJITAS	3240	6	62	2694	1816	2632	0	29	1	1	785	2694
EDO. LARA	CE. IRIBARREN	PQ. JUAN DE VILLEGAS	ESCUELA BASICA TAPA DE PIEDRA	628	2	14	539	346	525	0	4	0	0	175	539
EDO. LARA	CE. IRIBARREN	PQ. JUAN DE VILLEGAS	UNIDAD EDUCATIVA NACIONAL JESUS DE NAZARETH	1230	3	22	1075	805	1053	0	11	2	0	235	1075
EDO. LARA	CE. IRIBARREN	PQ. JUAN DE VILLEGAS	ESCUELA NINOS LIBERTADORES	456	1	6	419	336	413	0	2	0	0	75	419
EDO. LARA	CE. IRIBARREN	PQ. JUAN DE VILLEGAS	ESCUELA JOSE DE JESUS RODRIGUEZ	371	1	21	348	205	327	0	1	1	0	120	348
EDO. LARA	CE. IRIBARREN	PQ. JUAN DE VILLEGAS	ESCUELA BASICA BOLIVARIANA PADRE DIEGO	984	2	7	826	589	819	0	6	0	0	224	826
EDO. LARA	CE. IRIBARREN	PQ. JUAN DE VILLEGAS	UNIDAD EDUCATIVA TERESA CARREÑO	1831	4	24	1530	1014	1506	0	11	1	2	478	1530
EDO. LARA	CE. IRIBARREN	PQ. JUAN DE VILLEGAS	CENTRO DE PARTICIPACION COMUNITARIA CENTRO PARTICIPACION COMUNITARIA	1933	4	28	1533	908	1505	0	9	1	0	587	1533
EDO. LARA	CE. IRIBARREN	PQ. JUAN DE VILLEGAS	JEFATURA CIVIL JUAN DE VILLEGAS	1397	3	16	1155	505	1139	1	10	0	1	622	1155
EDO. LARA	CE. IRIBARREN	PQ. JUAN DE VILLEGAS	PRE ESCOLAR ASOCIACION EL PRADO (ASOPRADO)	728	2	11	620	450	609	0	8	0	0	151	620
EDO. LARA	CE. IRIBARREN	PQ. JUAN DE VILLEGAS	ESCUELA BASICA NACIONAL EL CORIANO	1669	3	27	1398	1029	1371	1	9	5	0	327	1398
EDO. LARA	CE. IRIBARREN	PQ. JUAN DE VILLEGAS	UNIDAD EDUCATIVA COLEGIO FE Y ALEGRIA ANA SOTO	2041	4	39	1648	1097	1609	1	11	3	1	496	1648
EDO. LARA	CE. IRIBARREN	PQ. JUAN DE VILLEGAS	CANCHA TECHADA JOSE LEONARDO RUIZ PINEDA	365	1	7	328	187	321	0	3	0	0	131	328
EDO. LARA	CE. IRIBARREN	PQ. JUAN DE VILLEGAS	CENTRO PRE ESCOLAR SIMON BOLIVAR	3240	6	39	2686	1708	2647	0	10	3	3	923	2686
EDO. LARA	CE. IRIBARREN	PQ. JUAN DE VILLEGAS	UNIDAD EDUCATIVA CASTA J RIERA	2632	5	35	2326	1011	2291	1	11	2	0	1266	2326
EDO. LARA	CE. IRIBARREN	PQ. JUAN DE VILLEGAS	UNIVERSIDAD POLITECNICA TERRITORIAL DEL ESTADO LARA ANDRES ELOY BLANCO	2298	4	43	1944	930	1901	1	14	1	3	952	1944
EDO. LARA	CE. IRIBARREN	PQ. JUAN DE VILLEGAS	UNIDAD EDUCATIVA ROMULO BETANCOURT 3	706	2	26	648	451	622	1	3	2	1	164	648
EDO. LARA	CE. IRIBARREN	PQ. JUAN DE VILLEGAS	UNIDAD EDUCATIVA ESTADAL 24 DE JULIO	972	2	37	813	513	776	0	3	1	1	258	813
EDO. LARA	CE. IRIBARREN	PQ. JUAN DE VILLEGAS	UNIDAD EDUCATIVA EL PANDITO NUCLEO ESCOLAR RURAL 219	337	1	3	300	261	297	0	4	0	0	32	300
EDO. LARA	CE. IRIBARREN	PQ. JUAN DE VILLEGAS	UNIDAD EDUCATIVA ESTADAL LOS VENEZOLANOS PRIMEROS	685	2	10	572	342	562	0	4	1	0	215	572
EDO. LARA	CE. IRIBARREN	PQ. JUAN DE VILLEGAS	AMBULATORIO URBANIZACION EL CORIANO	780	2	23	569	338	546	0	5	0	0	203	569
EDO. LARA	CE. IRIBARREN	PQ. JUAN DE VILLEGAS	CENTRO DE EDUCACION INICIAL DR ANDRES ELOY BLANCO	683	2	4	564	217	560	0	2	0	3	338	564
EDO. LARA	CE. IRIBARREN	PQ. JUAN DE VILLEGAS	UNIDAD EDUCATIVA ESTADAL JUAN JOSE LANDAETA	1275	3	21	1179	586	1158	1	6	1	0	564	1179
EDO. LARA	CE. IRIBARREN	PQ. JUAN DE VILLEGAS	UNIDAD ESCUELA NACIONAL CREACION BARRIOS DEL OESTE	6249	12	92	5021	3217	4929	1	37	4	3	1667	5021
EDO. LARA	CE. IRIBARREN	PQ. JUAN DE VILLEGAS	UNIDAD EDUCATIVA NUESTRA SEÑORA DEL CARMEN COLEGIO CATOLICO	256	1	5	245	145	240	0	3	0	0	92	245
EDO. LARA	CE. IRIBARREN	PQ. JUAN DE VILLEGAS	ESCUELA BASICA MARIA ANGELICA LUSINCHI	3472	6	73	2864	1698	2791	2	20	0	2	1069	2864
EDO. LARA	CE. IRIBARREN	PQ. JUAN DE VILLEGAS	ESCUELA BASICA TITICARE	583	1	4	264	165	260	0	1	0	0	94	264
EDO. LARA	CE. IRIBARREN	PQ. JUAN DE VILLEGAS	CASA COMUNAL LA NUEVA PAZ	404	1	7	370	138	363	0	5	0	1	219	370
EDO. LARA	CE. IRIBARREN	PQ. JUAN DE VILLEGAS	ESUELA NACIONAL JUAN DE VILLEGAS	4514	8	59	3513	2360	3454	4	24	1	2	1063	3513
EDO. LARA	CE. IRIBARREN	PQ. JUAN DE VILLEGAS	ESCUELA BASICA DANIEL CANONICO	4298	8	64	3616	2013	3552	1	31	6	0	1501	3616
EDO. LARA	CE. IRIBARREN	PQ. JUAN DE VILLEGAS	UNIDAD EDUCATIVA PINTO SALINAS	2896	5	39	2351	1362	2312	1	22	5	0	922	2351
EDO. LARA	CE. IRIBARREN	PQ. JUAN DE VILLEGAS	CASA COMUNAL (AMBIENTE ROBINSON)	1323	3	15	1141	487	1126	0	13	2	0	624	1141
EDO. LARA	CE. IRIBARREN	PQ. JUAN DE VILLEGAS	CENTRO DE EDUCACION INICIAL LOS ANGELES	478	1	28	418	259	390	0	1	1	0	129	418
EDO. LARA	CE. IRIBARREN	PQ. JUAN DE VILLEGAS	UNIDAD EDUCATVA BERNABE PLANAS	5619	11	100	4583	2276	4483	2	28	6	6	2165	4583
EDO. LARA	CE. IRIBARREN	PQ. JUAN DE VILLEGAS	AMBULATORIO RURAL I SANTA ISABEL	1067	2	11	862	379	851	3	11	0	2	456	862
EDO. LARA	CE. IRIBARREN	PQ. JUAN DE VILLEGAS	UNIDAD EDUCATIVA FE Y ALEGIA CARDENAL MARCELO SPÌNOLA	434	1	17	379	235	362	0	3	1	0	123	379
EDO. LARA	CE. IRIBARREN	PQ. JUAN DE VILLEGAS	ESCUELA BASICA NACIONAL RAQUEL MONASTERIOS	2309	4	21	1982	707	1961	2	11	1	1	1239	1982
EDO. LARA	CE. IRIBARREN	PQ. JUAN DE VILLEGAS	UNIDAD EDUCATIVA ESTADAL 12 DE OCTUBRE	1003	2	18	879	561	861	2	3	0	1	294	879
EDO. LARA	CE. IRIBARREN	PQ. JUAN DE VILLEGAS	UNIDAD EDUCATIVA SAN FRANCISCO	2404	5	32	1947	1049	1915	2	17	3	1	843	1947
EDO. LARA	CE. IRIBARREN	PQ. JUAN DE VILLEGAS	CENTRO DE EDUCACION INICIAL ALI PRIMERA	1073	2	19	957	613	938	1	8	1	1	314	957
EDO. LARA	CE. IRIBARREN	PQ. JUAN DE VILLEGAS	UNIDAD EDUCATIVA POPULAR FE Y ALEGRIA SAN FRANCISCO	3794	7	67	3223	1604	3156	0	19	0	4	1529	3223
EDO. LARA	CE. IRIBARREN	PQ. JUAN DE VILLEGAS	CENTRO PRE ESCOLAR BOLIVARIANO SIMON RODRIGUEZ	2201	4	44	1945	1022	1901	0	15	0	3	861	1945
EDO. LARA	CE. IRIBARREN	PQ. JUAN DE VILLEGAS	ESCUELA CONCENTRADA SAN JOSE OBRERO	2497	5	76	1968	1332	1892	0	13	2	0	545	1968
EDO. LARA	CE. IRIBARREN	PQ. JUAN DE VILLEGAS	CANCHA TECHADA EL ESCARABAJO II	285	1	4	251	173	247	0	2	1	1	70	251
EDO. LARA	CE. IRIBARREN	PQ. JUAN DE VILLEGAS	ESCUELA BASICA NACIONAL  ANDRES ELOY BLANCO	3785	7	57	3257	1414	3200	1	26	5	3	1751	3257
EDO. LARA	CE. IRIBARREN	PQ. JUAN DE VILLEGAS	CENTRO DE EDUCACION INICIAL LA LAGUNITA	335	1	12	301	146	289	0	3	0	0	140	301
EDO. LARA	CE. IRIBARREN	PQ. JUAN DE VILLEGAS	JUNTA PARROQUIAL JUAN VILLEGAS	1091	2	30	866	522	836	1	7	0	0	306	866
EDO. LARA	CE. IRIBARREN	PQ. JUAN DE VILLEGAS	LICEO BOLIVARIANO BATALLA DE LOS HORCONES	1181	2	14	958	616	944	0	8	1	1	318	958
EDO. LARA	CE. IRIBARREN	PQ. JUAN DE VILLEGAS	MULTIHOGAR LOS CACHORRITOS NUMERO 15	1142	2	9	916	554	907	0	9	1	0	343	916
EDO. LARA	CE. IRIBARREN	PQ. JUAN DE VILLEGAS	CENTRO DIAGNOSTICO INTEGRAL LOS OLIVOS	911	2	21	768	408	747	2	11	1	1	324	768
EDO. LARA	CE. IRIBARREN	PQ. JUAN DE VILLEGAS	UNIDAD EDUCATIVA COLEGIO SAN PABLO APOSTOL	928	2	26	786	287	760	2	2	3	0	466	786
EDO. LARA	CE. IRIBARREN	PQ. JUAN DE VILLEGAS	UNIDAD EDUCATIVA ESTADAL LA MILAGROSA	1220	3	25	1076	764	1051	0	8	0	0	279	1076
EDO. LARA	CE. IRIBARREN	PQ. JUAN DE VILLEGAS	UNIDAD EDUCATIVA ESTATAL LUIS HURTADO HIGUERA	1895	4	32	1621	583	1589	0	12	0	1	993	1621
EDO. LARA	CE. IRIBARREN	PQ. JUAN DE VILLEGAS	CENTRO DE EDUCACION INICIAL CARIBE 2	280	1	7	251	153	244	0	2	0	1	88	251
EDO. LARA	CE. IRIBARREN	PQ. JUAN DE VILLEGAS	UNIDAD EDUCATIVA BERTHA CORDERO	602	2	17	525	340	508	0	7	0	0	161	525
EDO. LARA	CE. IRIBARREN	PQ. JUAN DE VILLEGAS	UNIDAD EDUCATIVA ESTATAL MIGUEL ROMERO ANTONI	3417	6	51	3068	1149	3017	0	10	2	2	1854	3068
EDO. LARA	CE. IRIBARREN	PQ. JUAN DE VILLEGAS	UNIDAD EDUCATIVA ESTADAL MARIA LEDEZMA	575	1	4	506	220	502	0	3	0	1	278	506
EDO. LARA	CE. IRIBARREN	PQ. JUAN DE VILLEGAS	ESCUELA BASICA ESTADAL JOSE VARGAS	978	2	34	830	567	796	0	4	1	2	222	830
EDO. LARA	CE. IRIBARREN	PQ. JUAN DE VILLEGAS	ESCUELA NACIONAL DIMAS ACOSTA ALVAREZ	3318	6	72	2822	993	2750	1	11	0	3	1742	2822
EDO. LARA	CE. IRIBARREN	PQ. JUAN DE VILLEGAS	CENTRO PREESCOLAR.LOS CHIQUILINES	1077	2	10	895	470	885	2	4	1	0	408	895
EDO. LARA	CE. IRIBARREN	PQ. JUAN DE VILLEGAS	CASA COMUNAL  JOSE FELIX RIBAS	433	1	8	372	229	364	0	5	1	0	129	372
EDO. LARA	CE. IRIBARREN	PQ. JUAN DE VILLEGAS	UNIDAD EDUCATIVA NACIONAL CIUDAD DE BARQUISIMETO	345	1	3	294	214	291	0	1	1	0	75	294
EDO. LARA	CE. IRIBARREN	PQ. JUAN DE VILLEGAS	CENTRO DE EDUCACION INICIAL NEGRA HIPOLITA	431	1	7	367	184	360	0	8	0	0	168	367
EDO. LARA	CE. IRIBARREN	PQ. JUAN DE VILLEGAS	UNIDAD EDUCATIVA ESTADAL LEONARDO RUIZ PINEDA II	2517	5	43	2110	1068	2067	0	24	1	0	974	2110
EDO. LARA	CE. IRIBARREN	PQ. JUAN DE VILLEGAS	LICEO BOLIVARIANO CERRITOS BLANCOS	449	1	2	361	236	359	0	1	0	0	122	361
EDO. LARA	CE. IRIBARREN	PQ. JUAN DE VILLEGAS	CENTRO EDUCATIVO RECREACION JACINTO LARA	2569	5	52	2006	1313	1954	1	14	2	2	622	2006
EDO. LARA	CE. IRIBARREN	PQ. JUAN DE VILLEGAS	CENTRO DE EDUCACION BOLIVARIANO SIMONCITO PETRALCIRA DE ECHEGARAY	243	1	6	230	125	224	0	2	0	0	97	230
EDO. LARA	CE. IRIBARREN	PQ. JUAN DE VILLEGAS	UNIDAD EDUCATIVA ESTADAL LOS OLIVOS	604	2	16	530	271	514	0	6	2	2	233	530
EDO. LARA	CE. IRIBARREN	PQ. JUAN DE VILLEGAS	ESCUELA CONCENTRADA VILLA ROSA	1256	3	20	1003	563	983	1	1	1	1	416	1003
EDO. LARA	CE. IRIBARREN	PQ. JUAN DE VILLEGAS	ESCUELA CONCENTRADA EL TOSTAO	4759	9	150	3563	2018	3413	0	33	1	3	1358	3563
EDO. LARA	CE. IRIBARREN	PQ. JUAN DE VILLEGAS	UNIDAD EDUCATIVA ESTADAL DR. FORTUNATO ORELLANA	470	1	8	427	248	419	0	2	0	0	169	427
EDO. LARA	CE. IRIBARREN	PQ. JUAN DE VILLEGAS	UNIDAD EDUCATIVA EXPEDITO CORTES	1327	3	37	1124	855	1087	0	5	0	1	226	1124
EDO. LARA	CE. IRIBARREN	PQ. JUAN DE VILLEGAS	ESCUELA BASICA JOSE MIGUEL CONTRERAS	4478	8	80	3704	2147	3624	3	26	2	1	1445	3704
EDO. LARA	CE. IRIBARREN	PQ. JUAN DE VILLEGAS	UNIDAD EDUCATIVA MARIA CONCEPCION PALACIOS	3630	7	69	2900	1685	2831	4	18	2	1	1121	2900
EDO. LARA	CE. IRIBARREN	PQ. JUAN DE VILLEGAS	CANCHA TECHADA JOSE GREGORIO HERNANDEZ II	344	1	4	308	217	304	0	2	0	0	85	308
EDO. LARA	CE. IRIBARREN	PQ. JUAN DE VILLEGAS	UNIDAD EDUCATIVA LA MILAGROSA	1283	3	21	1113	846	1092	1	6	1	0	238	1113
EDO. LARA	CE. IRIBARREN	PQ. JUAN DE VILLEGAS	UNIDAD EDUCATIVA LOS CAMAGOS NUCLEO ESCOLAR RURAL 503	206	1	3	193	159	190	0	2	0	0	29	193
EDO. LARA	CE. IRIBARREN	PQ. JUAN DE VILLEGAS	UNIDAD EDUCATIVA COLEGIO FE Y ALEGRIA VARIQUISIMETO	1000	2	15	875	596	860	0	7	0	1	256	875
EDO. LARA	CE. IRIBARREN	PQ. JUAN DE VILLEGAS	CENTRO PREESCOLAR DON SIMON RODRIGUEZ	842	2	10	685	205	675	0	2	0	0	468	685
EDO. LARA	CE. IRIBARREN	PQ. JUAN DE VILLEGAS	CENTRO DE EDUCACION INICIAL ARCO IRIS	690	2	11	564	454	553	0	5	1	0	93	564
EDO. LARA	CE. IRIBARREN	PQ. JUAN DE VILLEGAS	CICLO BASICO INDUSTRIAL AUGUSTO MALAVE VILLALBA	1635	3	29	1394	768	1365	0	15	2	1	579	1394
EDO. LARA	CE. IRIBARREN	PQ. JUAN DE VILLEGAS	UNIDAD EDUCATIVA PILAR MONTESUMA	1983	4	52	1669	1010	1617	0	14	0	0	593	1669
EDO. LARA	CE. IRIBARREN	PQ. JUAN DE VILLEGAS	UNIDAD EDUCATIVA CORONEL JUAN MANUEL ALDAO	2583	5	38	2048	1072	2010	0	13	2	1	922	2048
EDO. LARA	CE. IRIBARREN	PQ. JUAN DE VILLEGAS	UNIDAD EDUCATIVA ESTADAL DOCTOR RAUL LEONI	887	2	17	756	496	739	0	6	1	1	235	756
EDO. LARA	CE. IRIBARREN	PQ. BUENA VISTA	ESCUELA EL PALENQUE ABAJO	979	2	10	731	620	721	0	0	1	0	100	731
EDO. LARA	CE. IRIBARREN	PQ. BUENA VISTA	ESCUELA UNITARIA LOS GAVILANES	173	1	4	136	54	132	0	1	1	0	76	136
EDO. LARA	CE. IRIBARREN	PQ. BUENA VISTA	ESCUELA UNITARIA ESTADAL EL CASTAÑO	502	1	3	331	307	328	0	1	1	1	18	331
EDO. LARA	CE. IRIBARREN	PQ. BUENA VISTA	ESCUELA BOLIVARIANA PALENQUE ARRIBA	212	1	1	199	189	198	0	0	0	0	9	199
EDO. LARA	CE. IRIBARREN	PQ. BUENA VISTA	ESCUELA UNITARIA EL PLACER	320	1	1	209	183	208	0	1	0	0	24	209
EDO. LARA	CE. IRIBARREN	PQ. BUENA VISTA	GRUPO ESCOLAR CARUAO	1971	4	31	1514	978	1483	2	9	1	0	493	1514
EDO. LARA	CE. IRIBARREN	PQ. BUENA VISTA	ESCUELA UNITARIA LA CAPILLA	765	2	4	493	398	489	2	3	2	1	83	493
EDO. LARA	CE. IRIBARREN	PQ. BUENA VISTA	ESCUELA BOLIVARIANA MEDIA JORNADA BUENOS AIRES	207	1	3	188	170	185	1	2	0	0	12	188
EDO. LARA	CE. IRIBARREN	PQ. BUENA VISTA	ESCUELA BOLIVARIANA MEDIA JORNADA PICA ALTA	141	1	1	123	87	122	0	0	0	0	35	123
EDO. LARA	MP. URDANETA	PQ. MOROTURO	ESCUELA BOLIVARIANA JORNADA INTEGRAL COCUYAL	163	1	4	144	102	140	0	1	0	0	37	144
EDO. LARA	MP. URDANETA	PQ. MOROTURO	ESCUELA BOLIVARIANA PALMAR DE CUCHARITO	610	2	20	483	386	463	0	2	0	0	75	483
EDO. LARA	MP. URDANETA	PQ. MOROTURO	UNIDAD EDUCATIVA ESTADAL DR JOSE FLORENCIO MENDEZ	730	2	9	578	423	569	2	3	6	1	134	578
EDO. LARA	MP. URDANETA	PQ. MOROTURO	UNIDAD EDUCATIVA ESTADAL EL ROSARIO	367	1	2	262	218	260	0	1	0	0	41	262
EDO. LARA	MP. URDANETA	PQ. MOROTURO	UNIDAD EDUCATIVA PALMAR DE CAMIRE	946	2	11	731	505	720	0	2	1	0	212	731
EDO. LARA	MP. URDANETA	PQ. MOROTURO	ESCUELA BOLIVARIANA MEDIA JORNADA CERRO MOROTURO	122	1	0	109	107	109	1	0	0	0	1	109
EDO. LARA	MP. URDANETA	PQ. MOROTURO	ESCUELA BOLIVARIANA JORNADA INTEGRAL EL CANO	232	1	1	197	153	196	0	2	0	0	41	197
EDO. LARA	MP. URDANETA	PQ. MOROTURO	ESCUELA BOLIVARIANA MEDIA JORNADA LOTE 5	178	1	2	163	153	161	0	0	0	0	8	163
EDO. LARA	MP. URDANETA	PQ. MOROTURO	ESCUELA BASICA NAC IOMNALMOROTURO	2514	5	30	1897	1221	1867	0	13	4	1	628	1897
EDO. LARA	MP. URDANETA	PQ. MOROTURO	ESCUELA NACIONAL CONCENTRADA LOMA LARGA	334	1	0	268	258	268	0	0	0	0	10	268
EDO. LARA	MP. URDANETA	PQ. MOROTURO	ESCUELA ESTADAL LAS MERCEDES	40	1	1	29	19	28	0	0	0	0	9	29
EDO. LARA	MP. URDANETA	PQ. MOROTURO	UNIDAD EDUCATIVA DR FRANCISCO ANTONIO CARREÑO	2962	6	53	2317	1450	2264	1	22	1	0	790	2317
EDO. LARA	MP. URDANETA	PQ. MOROTURO	ESCUELA BOLIVARIANA EL TESORO	259	1	0	213	192	213	0	1	0	0	20	213
EDO. LARA	MP. URDANETA	PQ. MOROTURO	ESCUELA CONCENTRADA DE SAN RAFAEL DE ARENILLAS	1084	2	18	860	619	842	0	4	0	0	219	860
EDO. LARA	MP. URDANETA	PQ. MOROTURO	UNIDAD EDUCATIVA SANTA ROSALIA	545	1	5	483	407	478	0	2	0	0	69	483
EDO. LARA	MP. URDANETA	PQ. MOROTURO	UNIDAD EDUCATIVA PAMPANITO	964	2	12	782	490	770	1	3	2	1	273	782
EDO. LARA	MP. URDANETA	PQ. MOROTURO	ESCUELA BOLIVARIANA FRANCISCO DE MIRANDA	657	2	6	514	433	508	0	5	0	0	70	514
EDO. LARA	MP. URDANETA	PQ. MOROTURO	ESCUELA PRIMARIA BOLIVARIANA JORNADA COMPLETA LOTE 10	211	1	2	195	176	193	0	2	0	0	15	195
EDO. LARA	MP. URDANETA	PQ. MOROTURO	ESCUELA BOLIVARIANA ARTURO USLAR PIETRI	450	1	6	333	275	327	0	3	3	0	46	333
EDO. LARA	MP. URDANETA	PQ. MOROTURO	JARDIN DE INFANCIA DOCTOR FRANCISCO CARREÑO	873	2	9	733	491	724	1	5	0	0	227	733
EDO. LARA	MP. URDANETA	PQ. MOROTURO	ESCUELA BOLIVARIANA JORNADA INTEGRAL EL BONITO	156	1	5	138	120	133	0	1	0	0	12	138
EDO. LARA	MP. URDANETA	PQ. XAGUAS	ESCUELA SICUA	194	1	1	149	55	148	0	0	0	0	93	149
EDO. LARA	MP. URDANETA	PQ. XAGUAS	ESCUELA UNITARIA EL RALO NUMERO 424	164	1	3	111	71	108	0	0	0	0	37	111
EDO. LARA	MP. URDANETA	PQ. XAGUAS	ESCUELA ESTADAL PIEDRA DE CAL	172	1	3	155	108	152	0	3	1	0	40	155
EDO. LARA	MP. URDANETA	PQ. XAGUAS	ESCUELA UNITARIA NUMERO 425	187	1	2	135	67	133	0	1	0	0	65	135
EDO. LARA	MP. URDANETA	PQ. XAGUAS	ESCUELA NACIONAL UNITARIA OJO DE AGUA	125	1	1	107	38	106	0	0	0	0	68	107
EDO. LARA	MP. URDANETA	PQ. XAGUAS	ESCUELA CONCENTRADA MIXTA EL PASO DE BARAGUA	337	1	2	211	148	209	0	0	0	0	61	211
EDO. LARA	MP. URDANETA	PQ. XAGUAS	ESCUELA ESTADAL LA MAMITA	128	1	1	101	43	100	0	0	0	0	57	101
EDO. LARA	MP. URDANETA	PQ. XAGUAS	ESCUELA BASICA NACIONAL ESTADAL SIN NUMERO MAICA NUCLEO ESCOLAR RURAL 286	48	1	0	33	21	33	0	0	1	0	11	33
EDO. LARA	MP. URDANETA	PQ. XAGUAS	GRUPO ESCOLAR JUAN SANTAELLA	1450	3	20	1156	459	1136	0	6	1	0	670	1156
EDO. LARA	MP. URDANETA	PQ. SAN MIGUEL	UNIDAD EDUCATIVA NACIONAL EL GUAY	676	2	5	529	339	524	1	4	1	0	179	529
EDO. LARA	MP. URDANETA	PQ. SAN MIGUEL	ESCUELA BOLIVARIANA MEDIA JORNADA OCTAVIO  LOZADA TORRES	237	1	2	210	189	208	0	0	3	0	16	210
EDO. LARA	MP. URDANETA	PQ. SAN MIGUEL	ESCUELA BOLIVARIANA SAN MIGUEL	355	1	7	268	166	261	0	5	0	1	89	268
EDO. LARA	MP. URDANETA	PQ. SAN MIGUEL	UNIDAD EDUCATIVA NACIONAL JUAN A RODRIGUEZ DOMINGUEZ	766	2	9	610	333	601	0	3	0	0	265	610
EDO. LARA	MP. URDANETA	PQ. SAN MIGUEL	ESCUELA BOLIVARIANA LOS MANGOS	739	2	6	549	404	543	1	3	2	0	133	549
EDO. LARA	MP. URDANETA	PQ. SAN MIGUEL	ESCUELA BASICA SANTA MARIA	107	1	5	59	24	54	0	2	0	0	28	59
EDO. LARA	MP. URDANETA	PQ. SAN MIGUEL	ESCUELA BOLIVARIANA MEDIA JORNADA LAS DELICIAS	148	1	2	131	111	129	0	1	0	0	17	131
EDO. LARA	MP. URDANETA	PQ. SAN MIGUEL	UNIDAD EDUCATIVA ESTADAL EL PORVENIR	208	1	3	183	139	180	0	2	0	0	39	183
EDO. LARA	MP. URDANETA	PQ. SAN MIGUEL	UNIDAD EDUCATIVA SAN PEDRO DE MONSERRAT	260	1	2	190	119	188	0	2	0	0	67	190
EDO. LARA	MP. URDANETA	PQ. SAN MIGUEL	ESCUELA BOLIVARIANA JORNADA INTEGRAL	197	1	0	175	156	175	0	2	0	0	17	175
EDO. LARA	MP. URDANETA	PQ. SAN MIGUEL	ESCUELA ESTADAL LAS CAMELIAS	152	1	0	120	88	120	0	0	0	0	32	120
EDO. LARA	MP. URDANETA	PQ. SAN MIGUEL	UNIDAD EDUCATIVA BASICA DANIEL ANTONIO GUTIERREZ	267	1	4	241	207	237	0	1	0	0	29	241
EDO. LARA	MP. URDANETA	PQ. SAN MIGUEL	ESCUELA ESTADAL EL MACHO	123	1	1	116	87	115	0	0	0	0	28	116
EDO. LARA	MP. URDANETA	PQ. SAN MIGUEL	UNIDAD EDUCATIVA BASICA LA UNION	804	2	6	629	391	623	0	3	0	0	229	629
EDO. LARA	MP. URDANETA	PQ. SAN MIGUEL	GRUPO ESCOLAR PIO TAMAYO	2258	4	28	1811	907	1783	0	9	4	0	863	1811
EDO. LARA	MP. URDANETA	PQ. SAN MIGUEL	ESCUELA BOLIVARIANA DON SERVANDO CORDERO	275	1	2	213	160	211	0	0	0	1	50	213
EDO. LARA	MP. URDANETA	PQ. SAN MIGUEL	ESCUELA BOLIVARIANA LAS TRES CRUCES	118	1	2	116	92	114	0	0	0	0	22	116
EDO. LARA	MP. URDANETA	PQ. SAN MIGUEL	UNIDAD EDUCATIVA NACIONAL EL PAUJI	580	1	2	490	422	488	0	4	1	0	61	490
EDO. LARA	MP. URDANETA	PQ. SAN MIGUEL	ESCUELA BASICA EL GUAY DE SANTA ROSA	124	1	3	84	60	81	0	3	0	0	18	84
EDO. LARA	MP. URDANETA	PQ. SAN MIGUEL	ESCUELA BOLIVARIANA MEDIA JORNADA LAS PLAYITAS	257	1	1	219	152	218	0	0	0	0	66	219
EDO. LARA	MP. URDANETA	PQ. SAN MIGUEL	ESCUELA BASICA SAN PEDRO DE CUERILLE	146	1	0	121	99	121	0	0	0	0	22	121
EDO. LARA	MP. URDANETA	PQ. SAN MIGUEL	ESCUELA BASICA LA LOMA	189	1	0	157	149	157	0	0	0	0	8	157
EDO. LARA	MP. URDANETA	PQ. SIQUISIQUE	ESCUELA UNITARIA NACIONAL NUMERO 4265	195	1	2	132	101	130	0	0	0	0	29	132
EDO. LARA	MP. URDANETA	PQ. SIQUISIQUE	U.E.N. JOSE ANGEL RODRIGUEZ LOPEZ	2206	4	33	1824	989	1791	0	10	3	0	789	1824
EDO. LARA	MP. URDANETA	PQ. SIQUISIQUE	ESCUELA CONCENTRADA AGUA BUENA	721	2	6	580	351	574	0	2	0	0	221	580
EDO. LARA	MP. URDANETA	PQ. SIQUISIQUE	ESCUELA BASICA ESTADAL TAMURAYE	114	1	1	94	73	93	0	0	0	0	20	94
EDO. LARA	MP. URDANETA	PQ. SIQUISIQUE	ESCUELA UNITARIA ESTADAL CHORRERON	89	1	0	71	57	71	0	0	0	0	14	71
EDO. LARA	MP. URDANETA	PQ. SIQUISIQUE	ESCUELA NACIONAL SIQUISIQUE	797	2	15	631	352	616	0	2	0	0	262	631
EDO. LARA	MP. URDANETA	PQ. SIQUISIQUE	UNIDAD EDUCATIVA ESTADAL GRADUADA EL DESECHO	617	2	10	527	349	517	0	1	1	0	166	527
EDO. LARA	MP. URDANETA	PQ. SIQUISIQUE	ESCUELA ESTADAL LA FLORENCIA	53	1	0	47	41	47	0	1	0	0	5	47
EDO. LARA	MP. URDANETA	PQ. SIQUISIQUE	ESCUELA EDUCATIVA ESTADAL COPIPE	235	1	5	209	177	204	0	0	0	1	26	209
EDO. LARA	MP. URDANETA	PQ. SIQUISIQUE	ESCUELA ESTADAL CONCENTRADA OLIVERA	303	1	9	272	182	263	1	2	0	0	78	272
EDO. LARA	MP. URDANETA	PQ. SIQUISIQUE	UNIDAD EDUCATIVA NACIONAL LA COCORA	461	1	5	328	198	323	1	1	0	0	123	328
EDO. LARA	MP. URDANETA	PQ. SIQUISIQUE	ESCUELA BOLIVARIANA JORNADA COMPLETA SAN RAFAEL	185	1	1	177	131	176	0	0	0	0	45	177
EDO. LARA	MP. URDANETA	PQ. SIQUISIQUE	ESCUELA CONCENTRADA NACIONAL RIO ABAJO	726	2	7	605	439	598	0	2	2	0	155	605
EDO. LARA	MP. URDANETA	PQ. SIQUISIQUE	ESCUELA COROBORE ARRIBA	270	1	4	202	152	198	0	0	0	0	46	202
EDO. LARA	MP. URDANETA	PQ. SIQUISIQUE	ESCUELA LA ESPERANZA	542	1	8	435	282	427	0	1	1	0	143	435
EDO. LARA	MP. URDANETA	PQ. SIQUISIQUE	UNIDAD EDUCATIVA MIRANDA	355	1	0	293	237	293	0	0	0	0	56	293
EDO. LARA	MP. URDANETA	PQ. SIQUISIQUE	ESCUELA BOLIVARIANA MOMAYE	214	1	6	167	137	161	0	1	0	0	23	167
EDO. LARA	MP. URDANETA	PQ. SIQUISIQUE	ANEXO LICEO BOLIVARIANO JOSE ANGEL RODRIGUEZ LOPEZ	387	1	1	346	205	345	0	0	0	0	140	346
EDO. LARA	MP. URDANETA	PQ. SIQUISIQUE	ESCUELA BASICA NACIONAL EL JOBO	161	1	2	91	67	89	0	1	0	0	21	91
EDO. LARA	MP. URDANETA	PQ. SIQUISIQUE	ESCUELA ESTADAL GUANARITO	88	1	0	86	78	86	0	0	0	0	8	86
EDO. LARA	MP. URDANETA	PQ. SIQUISIQUE	ESCUELA BOLIVARIANA RICARDO OVIDIO LIMARDO	3137	6	50	2591	1338	2541	0	22	5	0	1176	2591
EDO. LARA	MP. URDANETA	PQ. SIQUISIQUE	UNIDAD EDUCATIVA URICHE	430	1	6	334	209	328	0	0	0	1	118	334
EDO. LARA	MP. URDANETA	PQ. SIQUISIQUE	ESCUELA NUMERO 4121 LOS CAÑITOS	277	1	4	185	129	181	1	0	0	0	51	185
EDO. LARA	MP. URDANETA	PQ. SIQUISIQUE	UNIDAD EDUCATIVA ESTADAL BOLIVARIANA MEDIA JORNADA CRUZ DE MAYO	386	1	7	350	251	343	0	2	1	0	89	350
EDO. LARA	MP. URDANETA	PQ. SIQUISIQUE	ESCUELA BASICA ALFREDO PAREDES	370	1	6	271	173	265	0	1	1	0	90	271
EDO. LARA	MP. URDANETA	PQ. SIQUISIQUE	ESCUELA UNITARIA NUMERO 394	145	1	1	108	105	107	0	0	0	0	2	108
EDO. LARA	MP. URDANETA	PQ. SIQUISIQUE	ESCUELA BOLIVARIANA MEDIA JORNADA LOS TANQUES	158	1	4	146	111	142	0	0	1	0	30	146
EDO. LARA	MP. URDANETA	PQ. SIQUISIQUE	ESCUELA UNITARIA SAHOA	113	1	1	51	39	50	0	2	0	0	9	51
EDO. LARA	MP. URDANETA	PQ. SIQUISIQUE	ESCUELA ESTADAL LA ENCRUCIJADA	164	1	3	120	80	117	1	0	1	0	35	120
EDO. LARA	MP. URDANETA	PQ. SIQUISIQUE	ESCUELA UNITARIA GUAMUY	439	1	3	350	275	347	0	6	0	0	66	350
EDO. LARA	MP. URDANETA	PQ. SIQUISIQUE	ESCUELA NACIONAL NO 3055	303	1	1	205	143	204	0	1	0	0	60	205
EDO. LARA	MP. URDANETA	PQ. SIQUISIQUE	SIMONCITO SIQUISIQUE	224	1	3	206	142	203	0	2	0	0	59	206
EDO. LARA	MP. URDANETA	PQ. SIQUISIQUE	ESCUELA UNITARIA EL ESPEJO	194	1	0	144	100	144	1	1	0	0	42	144
EDO. LARA	MP. URDANETA	PQ. SIQUISIQUE	ESCUELA BOLIVARIANA JUAN BAUTISTA MENDEZ ALVAREZ	792	2	13	642	471	629	0	5	2	0	151	642
EDO. ARAGUA	MP.OCUMARE D L COSTA	PQ. OCUMARE DE LA COSTA	CONCENTRACION ESCOLAR NUMERO 54	731	2	17	542	428	525	0	1	0	0	96	542
EDO. ARAGUA	MP.OCUMARE D L COSTA	PQ. OCUMARE DE LA COSTA	ESCUELA CUYAGUA	513	1	5	419	307	414	0	1	0	0	106	419
EDO. ARAGUA	MP.OCUMARE D L COSTA	PQ. OCUMARE DE LA COSTA	ESCUELA BASICA ESTADAL JESUS IGNACIO ITURZAETA	2233	4	36	1691	840	1655	0	7	0	1	807	1691
EDO. ARAGUA	MP.OCUMARE D L COSTA	PQ. OCUMARE DE LA COSTA	UNIDAD EDUCATIVA ESTADAL CONCENTRADA LAS MONJAS	215	1	2	184	132	182	0	1	0	0	49	184
EDO. ARAGUA	MP.OCUMARE D L COSTA	PQ. OCUMARE DE LA COSTA	UNIDAD EDUCATIVA NACIONAL BOLIVARIANA CATA	809	2	11	633	500	622	1	1	0	0	120	633
EDO. ARAGUA	MP.OCUMARE D L COSTA	PQ. OCUMARE DE LA COSTA	ESCUELA BASICA DELUYAR	2692	5	45	2053	1052	2008	0	10	2	1	943	2053
EDO. ARAGUA	MP.OCUMARE D L COSTA	PQ. OCUMARE DE LA COSTA	ESCUELA ESTADAL UNITARIA Nº 40	389	1	5	300	216	295	0	0	0	0	79	300
EDO. ARAGUA	MP.OCUMARE D L COSTA	PQ. OCUMARE DE LA COSTA	INCES OCUMARE DE LA COSTA DE ORO	1003	2	19	839	582	820	1	5	0	0	232	839
EDO. ARAGUA	MP. SANTOS MICHELENA	PQ. TIARA	ESCUELA BASICA ESTADAL TIARA	1330	3	28	1071	872	1043	0	5	0	0	166	1071
EDO. ARAGUA	MP. SANTOS MICHELENA	PQ. TIARA	UNIDAD EDUCATIVA ESTADAL RURAL CAGUA DE LAS MERCEDES	239	1	7	217	185	210	0	0	0	0	25	217
EDO. ARAGUA	MP. SANTOS MICHELENA	PQ. TIARA	UNIDAD EDUCATIVA ESTADAL CONCENTRADA LA ESPERANZA	1199	3	65	922	627	857	0	3	1	1	225	922
EDO. ARAGUA	MP. SANTOS MICHELENA	PQ. TIARA	UNIDAD EDUCATIVA ESTADAL CONCENTRADA LAS DOLORES DE ARAGUA	225	1	2	154	116	152	0	1	0	0	35	154
EDO. ARAGUA	MP. SANTOS MICHELENA	CM. LAS TEJERIAS	ESCUELA BASICA MADRE MARIA DE SAN JOSE	2870	5	55	2401	1922	2346	2	3	1	0	418	2401
EDO. ARAGUA	MP. SANTOS MICHELENA	CM. LAS TEJERIAS	ESCUELA BASICA ESTADAL TINAPUEY	1386	3	20	1219	1085	1199	0	4	1	0	109	1219
EDO. ARAGUA	MP. SANTOS MICHELENA	CM. LAS TEJERIAS	UNIDAD EDUCATIVA ESTADAL RAMON GARCIA DE SENA	2411	5	44	1893	1600	1849	1	4	0	0	244	1893
EDO. ARAGUA	MP. SANTOS MICHELENA	CM. LAS TEJERIAS	UNIDAD EDUCATIVA ESCOLAR CONCENTRADA EL JABILLAR NER 004 B	1945	4	55	1578	1210	1523	0	7	1	0	305	1578
EDO. ARAGUA	MP. SANTOS MICHELENA	CM. LAS TEJERIAS	ESCUELA GRADUADA JULIO PAEZ	2506	5	43	1982	1470	1939	3	6	3	0	457	1982
EDO. ARAGUA	MP. SANTOS MICHELENA	CM. LAS TEJERIAS	ESCUELA BASICA ENCARNACION DE NIEVES	2445	5	73	1899	1408	1826	0	5	2	0	411	1899
EDO. ARAGUA	MP. SANTOS MICHELENA	CM. LAS TEJERIAS	UNIDAD EDUCATIVA SERGIO MEDINA	2177	4	29	1714	1075	1685	1	4	0	3	602	1714
EDO. ARAGUA	MP. SANTOS MICHELENA	CM. LAS TEJERIAS	ESCUELA BASICA NACIONAL LEONARDO RUIZ PINEDA	434	1	7	413	348	406	0	1	0	0	57	413
EDO. ARAGUA	MP. SANTOS MICHELENA	CM. LAS TEJERIAS	ESCUELA BASICA JACOB PEREZ CARBALLO	3015	6	51	2422	1548	2371	0	13	0	1	809	2422
EDO. ARAGUA	MP. SANTOS MICHELENA	CM. LAS TEJERIAS	FUNDACION PARA EL DESARROLLO DE LAS ARTES Y LA CULTURA	947	2	23	847	624	824	0	2	1	0	197	847
EDO. ARAGUA	MP. SANTOS MICHELENA	CM. LAS TEJERIAS	UNIDAD EDUCATIVA CONCRENTRADA RURAL ARAIZA	204	1	3	173	153	170	1	0	0	0	16	173
EDO. ARAGUA	MP. SANTOS MICHELENA	CM. LAS TEJERIAS	UNIDAD EDUCATIVA ESTADAL NUESTRA SEÑORA DE BELEN	949	2	31	827	698	796	0	2	0	0	96	827
EDO. ARAGUA	MP. ZAMORA	PQ. VALLES DE TUCUTUNEMO	ESCUELA CONCENTRADA SIMONA ACACIO	3043	6	61	2418	2025	2357	4	16	3	0	309	2418
EDO. ARAGUA	MP. ZAMORA	PQ. VALLES DE TUCUTUNEMO	ESCUELA ESTADAL TEOTISTE DE GALLEGOS	2450	5	83	2002	1522	1919	1	15	3	3	375	2002
EDO. ARAGUA	MP. ZAMORA	PQ. VALLES DE TUCUTUNEMO	UNIDAD EDUCATIVA ESTADAL RURAL LOS CHORROS	498	1	12	464	408	452	0	1	0	0	43	464
EDO. ARAGUA	MP. ZAMORA	PQ. PQ AUGUSTO MIJARES	UNIDAD EDUCATIVA NACIONAL JOSE NUNEZ TENORIO	289	1	6	251	216	245	0	0	0	0	29	251
EDO. ARAGUA	MP. ZAMORA	PQ. PQ AUGUSTO MIJARES	PREESCOLAR NACIONAL CANDIDO ROSENDO PRADO	516	1	10	453	329	443	0	1	0	0	113	453
EDO. ARAGUA	MP. ZAMORA	PQ. PQ AUGUSTO MIJARES	ESCUELA BASICA JUAN BAUTISTA PLAZA	2770	5	65	2199	1575	2134	0	18	0	0	541	2199
EDO. ARAGUA	MP. ZAMORA	PQ. PQ AUGUSTO MIJARES	CARCEL PUBLICA TOCORON	436	1	7	227	168	220	0	3	1	1	47	227
EDO. ARAGUA	MP. ZAMORA	PQ. PQ AUGUSTO MIJARES	UNIDAD EDUCATIVA NACIONAL BOLIVARIANA MARIA LUISA PARISCA	682	2	25	588	509	563	0	0	0	0	54	588
EDO. ARAGUA	MP. ZAMORA	PQ. SAN FRANCISCO DE ASIS	UNIDAD EDUCATIVA NACIONAL VIRGEN DE FATIMA	327	1	5	290	250	285	0	2	0	0	33	290
EDO. ARAGUA	MP. ZAMORA	PQ. SAN FRANCISCO DE ASIS	UNIDAD EDUACATIVA NACIONAL BOLIVARIANA PEDRO RAFAEL COBOS	1339	3	35	1176	823	1141	1	7	1	0	309	1176
EDO. ARAGUA	MP. ZAMORA	PQ. SAN FRANCISCO DE ASIS	ESCUELA VICENTE VELASQUEZ	645	2	5	593	446	588	0	8	0	0	134	593
EDO. ARAGUA	MP. ZAMORA	PQ. SAN FRANCISCO DE ASIS	LICEO AIME BONPLAND	3249	6	64	2688	1622	2624	0	7	1	2	992	2688
EDO. ARAGUA	MP. ZAMORA	PQ. SAN FRANCISCO DE ASIS	UNIDAD EDUCATIVA NACIONAL TACASURUMA	3857	7	83	3099	1840	3016	2	18	2	2	1152	3099
EDO. ARAGUA	MP. ZAMORA	PQ. SAN FRANCISCO DE ASIS	UNIDAD EDUCATIVA MARIA TERESA GARCIA	3144	6	58	2555	1551	2497	0	12	1	2	931	2555
EDO. ARAGUA	MP. ZAMORA	PQ. SAN FRANCISCO DE ASIS	ESCUELA BASICA NACIONAL NUEVA VENEZUELA.	942	2	21	814	682	793	0	5	0	0	106	814
EDO. ARAGUA	MP. ZAMORA	PQ. SAN FRANCISCO DE ASIS	UNIDAD EDUCATIVA NACIONAL VIRGEN DEL VALLE	221	1	9	202	174	193	0	1	0	0	18	202
EDO. ARAGUA	MP. ZAMORA	PQ. MAGDALENO	UNIDAD EDUCATIVA PRIVADA FE Y ALEGRIA EUGENIO MENDOZA GOITICOA	2494	5	46	2009	1368	1963	0	8	1	1	585	2009
EDO. ARAGUA	MP. ZAMORA	PQ. MAGDALENO	ESCUELA BASICAMAGDALENO	1954	4	39	1534	1065	1495	0	11	1	0	418	1534
EDO. ARAGUA	MP. ZAMORA	PQ. MAGDALENO	CASA DE LOS NIÑOS JUAN DE DIOS AGRAZ	662	2	20	570	475	550	0	4	0	0	71	570
EDO. ARAGUA	MP. ZAMORA	PQ. MAGDALENO	ESCUELA BASICA NACIONAL PANAQUIRE	4150	8	90	3283	2251	3193	2	18	4	1	917	3283
EDO. ARAGUA	MP. ZAMORA	PQ. MAGDALENO	UNIDAD EDUCATIVA NACIONAL LA ESPERANZA(BIBLIOTECA VIRTUAL MAGDALENO)	1112	2	31	927	722	896	0	2	0	0	172	927
EDO. ARAGUA	MP. ZAMORA	PQ. MAGDALENO	PREESCOLAR ESTADAL ZORAIDA JOSEFINA CAMPOS	672	2	14	603	488	589	0	2	1	0	98	603
EDO. ARAGUA	MP. ZAMORA	PQ. MAGDALENO	ESCUELA BASICA GUACAMAYA	1030	2	22	753	465	731	1	9	3	1	252	753
EDO. ARAGUA	MP. ZAMORA	PQ. MAGDALENO	CASA DE MISIONES (ANTIGUA SEDE DE U.E.N. LA ESPERANZA)	783	2	32	627	446	595	0	5	0	0	144	627
EDO. ARAGUA	MP. ZAMORA	CM. VILLA DE CURA	UNIDAD EDUCATIVA ESTADAL  VINICIO ADAMES	732	2	14	655	439	641	0	1	0	1	200	655
EDO. ARAGUA	MP. ZAMORA	CM. VILLA DE CURA	UNIDAD EDUCATIVA ESTADAL PRISCO PEREZ MONASTERIOS	784	2	22	707	584	685	2	3	5	0	91	707
EDO. ARAGUA	MP. ZAMORA	CM. VILLA DE CURA	UNIDAD EDUCATIVA CARIDAD VILLASANA	3170	6	38	2565	1842	2527	0	17	4	1	663	2565
EDO. ARAGUA	MP. ZAMORA	CM. VILLA DE CURA	PREESCOLAR NACIONAL BOLIVARIANO TERESA CARREÑO.	575	1	20	486	328	466	0	3	0	1	134	486
EDO. ARAGUA	MP. ZAMORA	CM. VILLA DE CURA	CEICO MAESTRO SIMON RODRIGUEZ	159	1	5	135	111	130	0	0	0	0	19	135
EDO. ARAGUA	MP. ZAMORA	CM. VILLA DE CURA	INSTITUTO EDUCACIONAL ESPECIAL VILLA DE CURA	1549	3	45	1349	795	1304	2	3	2	1	501	1349
EDO. ARAGUA	MP. ZAMORA	CM. VILLA DE CURA	UNIDAD EDUCATIVA AMANDA FLORES	1649	3	37	1389	851	1352	0	13	2	0	486	1389
EDO. ARAGUA	MP. ZAMORA	CM. VILLA DE CURA	UNIDAD EDUCATIVA LEONCIO MARTINEZ	1791	4	23	1470	780	1447	0	3	0	2	662	1470
EDO. ARAGUA	MP. ZAMORA	CM. VILLA DE CURA	RESIDENCIAS MEDICAS	306	1	4	269	187	265	0	1	0	0	77	269
EDO. ARAGUA	MP. ZAMORA	CM. VILLA DE CURA	ESCUELA BASICA MELICIA NIEVES DE TEJADA	3552	7	35	2864	2058	2829	1	20	1	0	749	2864
EDO. ARAGUA	MP. ZAMORA	CM. VILLA DE CURA	ESCUELA BASICA INOCENCIO UTRERA	3135	6	63	2634	2103	2571	0	14	5	1	448	2634
EDO. ARAGUA	MP. ZAMORA	CM. VILLA DE CURA	INCES CENTRO DE FORMACION SOCIALISTA DE VILLA DE CURA	2631	5	31	2193	1429	2162	2	14	2	1	714	2193
EDO. ARAGUA	MP. ZAMORA	CM. VILLA DE CURA	ESCUELA BASICA ESTADAL RURAL CREACION GAMARA	573	1	17	502	451	485	0	1	0	0	33	502
EDO. ARAGUA	MP. ZAMORA	CM. VILLA DE CURA	UNIDAD EDUCATIVA NACIONAL ALBERTO SMITH	3351	6	53	2705	1465	2652	1	15	3	2	1166	2705
EDO. ARAGUA	MP. ZAMORA	CM. VILLA DE CURA	ESCUELA PROVISIONAL PARROQUIAL SAN LUIS DE CURA	1673	3	34	1365	783	1331	1	5	2	1	539	1365
EDO. ARAGUA	MP. ZAMORA	CM. VILLA DE CURA	PREESCOLAR NACIONAL BOLIVARIANO EZEQUIEL ZAMORA	492	1	4	442	340	438	0	2	0	0	96	442
EDO. ARAGUA	MP. ZAMORA	CM. VILLA DE CURA	ESCUELA ESTADAL CONCENTRADA Nº 70 Y 320	464	1	9	372	196	363	0	1	0	0	166	372
EDO. ARAGUA	MP. ZAMORA	CM. VILLA DE CURA	CENTRO DE EDUCACION INICIAL BOLIVARIANO FRANCISCO DE MIRANDA	1145	2	28	1025	747	997	0	5	0	0	245	1025
EDO. ARAGUA	MP. ZAMORA	CM. VILLA DE CURA	PREESCOLAR NACIONAL BOLIVARIANO LA REPRESA	443	1	12	384	261	372	0	2	1	0	108	384
EDO. ARAGUA	MP. ZAMORA	CM. VILLA DE CURA	UNIDAD EDUCATIVA ESTADAL CONCENTRADA NER 426 EL CHINO	186	1	2	98	79	96	0	2	0	0	15	98
EDO. ARAGUA	MP. ZAMORA	CM. VILLA DE CURA	GRUPO ESCOLAR LEOPOLDO TOSTA	2878	5	35	2330	1414	2295	2	19	1	5	854	2330
EDO. ARAGUA	MP. ZAMORA	CM. VILLA DE CURA	UNIDAD EDUCATIVA ESTADAL DOCTOR JOSE CASANOVA GODOY	3218	6	59	2640	2068	2581	0	10	5	1	497	2640
EDO. ARAGUA	MP. ZAMORA	CM. VILLA DE CURA	ESCUELA BASICA ESTADAL JULIETA HERNANDEZ PARRA	1717	3	16	1388	1111	1372	0	8	0	0	253	1388
EDO. ARAGUA	MP. ZAMORA	CM. VILLA DE CURA	ESCUELA BASICA SALOMON MORALES	3856	7	81	3127	2375	3046	0	17	4	2	648	3127
EDO. ARAGUA	MP. ZAMORA	CM. VILLA DE CURA	JARDIN DE INFANCIA ARISTIDES ROJAS	887	2	14	794	428	780	0	5	1	1	345	794
EDO. ARAGUA	MP. ZAMORA	CM. VILLA DE CURA	UNIDAD EDUCATIVA ESTADAL SIMON RODRIGUEZ	852	2	5	760	497	755	1	2	0	0	255	760
EDO. ARAGUA	MP. ZAMORA	CM. VILLA DE CURA	PREESCOLAR NACIONAL LAS MERCEDES	352	1	10	308	217	298	0	2	0	0	79	308
EDO. ARAGUA	MP. ZAMORA	CM. VILLA DE CURA	UNIDAD EDUCATIVA ESTADAL CONCENTRADA PIRITU	1070	2	17	857	653	840	1	1	0	0	185	857
EDO. ARAGUA	MP. ZAMORA	CM. VILLA DE CURA	GRUPO ESCOLAR ESCUELA VICTOR PADILLA	2563	5	50	2187	1339	2137	0	14	2	2	780	2187
EDO. ARAGUA	MP. ZAMORA	CM. VILLA DE CURA	BIBLIOTECA VIRTUAL	298	1	2	262	164	260	1	1	0	0	94	262
EDO. ARAGUA	MP. ZAMORA	CM. VILLA DE CURA	UNIDAD EDUCATIVA ESTADAL RURAL   CHAGUARAMA	323	1	3	286	248	283	0	1	0	0	34	286
EDO. ARAGUA	MP. ZAMORA	CM. VILLA DE CURA	PREESCOLAR NACIONAL CUYAGUA	548	1	6	473	358	467	0	1	2	0	106	473
EDO. ARAGUA	MP. ZAMORA	CM. VILLA DE CURA	ESCUELA BASICA MANUEL MORALES CARABAÑO	1148	2	19	1043	554	1024	0	3	0	0	467	1043
EDO. ARAGUA	MP. ZAMORA	CM. VILLA DE CURA	UNIDAD EDUCATIVA ESTADAL JUAN ANTONIO PEREZ BONALDE	489	1	2	447	277	445	0	5	0	1	162	447
EDO. ARAGUA	MP. ZAMORA	CM. VILLA DE CURA	ESCUELA BASICA ARISTIDES ROJAS	4567	8	56	3758	1611	3702	2	18	1	2	2068	3758
EDO. ARAGUA	MP. ZAMORA	CM. VILLA DE CURA	ESCUELA BASICA TERESA CARREÑO	2855	5	50	2344	1549	2294	1	18	4	0	722	2344
EDO. ARAGUA	MP. JOSE ANGEL LAMAS	CM. SANTA CRUZ	UNIDAD EDUCATIVA NACIONAL CARLOS RAMON APONTE	648	2	13	596	361	583	0	2	0	0	220	596
EDO. ARAGUA	MP. JOSE ANGEL LAMAS	CM. SANTA CRUZ	DON FRANCISCO CASTILLO	1543	3	23	1396	962	1373	0	3	1	1	406	1396
EDO. ARAGUA	MP. JOSE ANGEL LAMAS	CM. SANTA CRUZ	UNIDAD EDUCATIVA NACIONAL LA CANDELARIA	758	2	11	698	552	687	0	2	1	0	132	698
EDO. ARAGUA	MP. JOSE ANGEL LAMAS	CM. SANTA CRUZ	ESCUELA BASICA SANTOS ANIBAL DOMINICE	854	2	7	806	391	799	0	4	0	2	402	806
EDO. ARAGUA	MP. JOSE ANGEL LAMAS	CM. SANTA CRUZ	ESCUELA BASICA NACIONAL BOLIVARIANA SANTA CRUZ	2910	6	34	2363	1262	2329	0	7	2	0	1058	2363
EDO. ARAGUA	MP. JOSE ANGEL LAMAS	CM. SANTA CRUZ	CENTRO DE PARALISIS CEREBRAL JOSE ANGEL LAMAS	616	2	7	573	435	566	0	0	2	0	129	573
EDO. ARAGUA	MP. JOSE ANGEL LAMAS	CM. SANTA CRUZ	PREESCOLAR LOS MANGOS	725	2	10	684	460	674	0	7	0	0	207	684
EDO. ARAGUA	MP. JOSE ANGEL LAMAS	CM. SANTA CRUZ	UNIDAD EDUCATIVA NACIONAL RESIDENCIAS SANTA CRUZ	2036	4	30	1758	870	1728	0	12	2	1	843	1758
EDO. ARAGUA	MP. JOSE ANGEL LAMAS	CM. SANTA CRUZ	ESCUELA BASICA RAFAEL BRICEO ORTEGA	4004	7	33	3325	1719	3292	2	21	2	3	1545	3325
EDO. ARAGUA	MP. JOSE ANGEL LAMAS	CM. SANTA CRUZ	CENTRO DE EDUCACION INICIAL JOSE ANGEL LAMAS	621	2	7	573	442	566	0	2	0	0	122	573
EDO. ARAGUA	MP. JOSE ANGEL LAMAS	CM. SANTA CRUZ	ESCUELA BASICA ANDRES ELOY BLANCO	3658	7	60	2936	1859	2876	0	18	0	0	999	2936
EDO. ARAGUA	MP. JOSE ANGEL LAMAS	CM. SANTA CRUZ	ESCUELA BASICA DOCTOR PATROCINIO P RUIZ	3149	6	47	2596	1613	2549	2	10	1	1	922	2596
EDO. ARAGUA	MP. JOSE ANGEL LAMAS	CM. SANTA CRUZ	CASA DE LA CULTURA CLAUDIO CASTILLO	1199	3	20	1050	559	1030	0	6	4	1	460	1050
EDO. ARAGUA	MP. CAMATAGUA	CM. CAMATAGUA	CICLO BASICO FRANCISCO LINARES ALCANTARA	1936	4	37	1504	987	1467	0	9	0	1	470	1504
EDO. ARAGUA	MP. CAMATAGUA	CM. CAMATAGUA	ESCUELA BASICA ESTADAL CAMATAGUA	3258	6	47	2521	1548	2474	0	18	1	0	907	2521
EDO. ARAGUA	MP. CAMATAGUA	CM. CAMATAGUA	SIMONCITO ATENCION EDUCATIVA NO CONVENCIONAL JOSE GREGORIO HERNANDEZ	212	1	2	192	166	190	1	0	0	0	23	192
EDO. ARAGUA	MP. CAMATAGUA	CM. CAMATAGUA	PRE ESCOLAR CARIDAD DE ESPAÑA	247	1	2	224	185	222	0	1	0	0	36	224
EDO. ARAGUA	MP. CAMATAGUA	CM. CAMATAGUA	CASA COMUNAL BRISAS DE LA CALIFORNIA	138	1	2	125	118	123	0	0	2	0	3	125
EDO. ARAGUA	MP. CAMATAGUA	CM. CAMATAGUA	ESCUELA BASICA PASTOR RODRIGUEZ MANZO	2150	4	38	1710	1187	1672	0	16	0	0	469	1710
EDO. ARAGUA	MP. CAMATAGUA	CM. CAMATAGUA	ESCUELA BASICA ESTADAL LA CANDELARIA	690	2	3	584	506	581	0	3	0	0	72	584
EDO. ARAGUA	MP. CAMATAGUA	PQ. CARMEN DE CURA	ESCUELA UNITARIA  MARIA DE NAZARET	314	1	9	272	175	263	0	1	0	0	87	272
EDO. ARAGUA	MP. CAMATAGUA	PQ. CARMEN DE CURA	UNIDAD EDUCATIVA ESTADAL CARUTICO NUCLEO EDUCATIVO RURAL Nº 184 A	310	1	1	254	210	253	0	0	0	0	43	254
EDO. ARAGUA	MP. CAMATAGUA	PQ. CARMEN DE CURA	ESCUELA BASICA ESTADAL 15 DE ENERO	2571	5	67	1928	1071	1861	0	13	1	0	776	1928
EDO. ARAGUA	MP.FRANCISCO LINARES	PQ. FRANCISCO DE MIRANDA	ESCUELA BASICA ARTURO SARCO VILLENA	2110	4	28	1745	931	1717	0	5	1	1	779	1745
EDO. ARAGUA	MP.FRANCISCO LINARES	PQ. FRANCISCO DE MIRANDA	CENTRO DE ATENCION VECINAL MARIA GARCIA	332	1	11	266	190	255	0	1	0	0	64	266
EDO. ARAGUA	MP.FRANCISCO LINARES	PQ. FRANCISCO DE MIRANDA	ESCUELA BASICAJORGE SEMIDEY	2478	5	53	2039	1357	1986	3	13	1	0	612	2039
EDO. ARAGUA	MP.FRANCISCO LINARES	PQ. FRANCISCO DE MIRANDA	CENTRO DE CAPACITACION LABORAL VIRGEN DEL ROSARIO VENANCIO AZPIROZ	480	1	6	426	285	420	0	0	0	2	133	426
EDO. ARAGUA	MP.FRANCISCO LINARES	PQ. FRANCISCO DE MIRANDA	CENTRO DE ABSTECIMIENTO FAMILIAR	1617	3	32	1309	848	1277	0	8	0	2	419	1309
EDO. ARAGUA	MP.FRANCISCO LINARES	PQ. FRANCISCO DE MIRANDA	ESCUELA BASICA FRANCISCO DE MIRANDA	3851	7	57	3197	1961	3140	2	21	2	3	1151	3197
EDO. ARAGUA	MP.FRANCISCO LINARES	PQ. FRANCISCO DE MIRANDA	UE PRIVADA NUEVA REPUBLICA	2118	4	42	1735	1092	1693	0	7	0	2	592	1735
EDO. ARAGUA	MP.FRANCISCO LINARES	PQ. FRANCISCO DE MIRANDA	ESCUELA BASICA 18 DE MAYO	3480	6	80	2744	1881	2664	1	10	2	2	768	2744
EDO. ARAGUA	MP.FRANCISCO LINARES	PQ. FRANCISCO DE MIRANDA	UNIDAD EDUCATIVA NACIONAL CREACION VENEZUELA	730	2	14	628	406	614	0	0	0	0	208	628
EDO. ARAGUA	MP.FRANCISCO LINARES	PQ. FRANCISCO DE MIRANDA	CENTRO COMUNITARIO DE USOS MULTIPLES SIMON RODRIGUEZ	508	1	9	444	340	435	0	2	1	0	92	444
EDO. ARAGUA	MP.FRANCISCO LINARES	CM. SANTA RITA	ESCUELA BASICA LOS PROCERES	756	2	20	663	461	643	0	2	0	2	178	663
EDO. ARAGUA	MP.FRANCISCO LINARES	CM. SANTA RITA	UNIDAD EDUCATIVA ESTADAL SANTIAGO MARI O	2224	4	37	1829	1305	1792	0	12	4	0	471	1829
EDO. ARAGUA	MP.FRANCISCO LINARES	CM. SANTA RITA	TALLER DE EDUCACION ESPECIAL TELSUR	1060	2	34	907	709	873	0	2	1	0	161	907
EDO. ARAGUA	MP.FRANCISCO LINARES	CM. SANTA RITA	SIMONCITO COMUNITARIO ALBERTO SOLANO	529	1	8	462	394	454	0	4	0	0	56	462
EDO. ARAGUA	MP.FRANCISCO LINARES	CM. SANTA RITA	UNIDAD EDUCATIVA PRIVADA MIS SAGRADOS PRINCIPIOS	474	1	6	424	317	418	0	3	0	0	98	424
EDO. ARAGUA	MP.FRANCISCO LINARES	CM. SANTA RITA	INSTITUTO DE EDUCACION ESPECIAL BOLIVARIANO MANUELITA SAEZ	617	2	8	569	414	561	0	2	1	0	144	569
EDO. ARAGUA	MP.FRANCISCO LINARES	CM. SANTA RITA	CENTRO DE PARALISIS CEREBRAL LINARES ALCANTARA	1032	2	11	905	669	894	0	3	1	0	221	905
EDO. ARAGUA	MP.FRANCISCO LINARES	CM. SANTA RITA	ESPACIO EDUCATIVO COMUNITARIO EZEQUIEL ZAMORA	426	1	4	351	299	347	0	1	0	1	46	351
EDO. ARAGUA	MP.FRANCISCO LINARES	CM. SANTA RITA	UNIDAD EDUCATIVA INTEGRAL AYACUCHO	368	1	17	321	221	304	0	1	2	0	80	321
EDO. ARAGUA	MP.FRANCISCO LINARES	CM. SANTA RITA	ESCUELA BASICA NACIONAL COROPO	3542	7	65	2873	2172	2808	1	17	3	2	613	2873
EDO. ARAGUA	MP.FRANCISCO LINARES	CM. SANTA RITA	PREESCOLA ALVARO MARTINEZ PAIVA	776	2	15	681	517	666	0	6	0	0	143	681
EDO. ARAGUA	MP.FRANCISCO LINARES	CM. SANTA RITA	UNIDAD EDUCATIVA PRIVADA MANUEL FELIPE DE TOVAR	455	1	9	395	216	386	0	0	0	0	170	395
EDO. ARAGUA	MP.FRANCISCO LINARES	CM. SANTA RITA	ESCUELA BASICA ESTADAL JULIAN LANDAETA ROBLES	2022	4	40	1751	1261	1711	0	9	1	1	439	1751
EDO. ARAGUA	MP.FRANCISCO LINARES	CM. SANTA RITA	GALPON DE SANTA INES	966	2	25	809	583	784	2	4	0	0	195	809
EDO. ARAGUA	MP.FRANCISCO LINARES	CM. SANTA RITA	ESCUELA BASICA PARMANACAY	4427	8	58	3587	2481	3529	0	16	3	3	1026	3587
EDO. ARAGUA	MP.FRANCISCO LINARES	CM. SANTA RITA	UNIDAD EDUCATIVA PRIVADA REPUBLICA DE VENEZUELA	1014	2	16	848	615	832	0	1	0	0	216	848
EDO. ARAGUA	MP.FRANCISCO LINARES	CM. SANTA RITA	U E LEONARDO RUIZ PINEDA	4893	9	82	4085	2783	4003	0	32	1	2	1185	4085
EDO. ARAGUA	MP.FRANCISCO LINARES	CM. SANTA RITA	ESCUELA BASICA PRIVADA SIMON RODRIGUEZ	2206	4	44	1808	1078	1764	0	8	0	4	674	1808
EDO. ARAGUA	MP.FRANCISCO LINARES	CM. SANTA RITA	ESCUELA BASICA 24 DE OCTUBRE	2985	6	70	2424	1656	2354	1	11	4	4	678	2424
EDO. ARAGUA	MP.FRANCISCO LINARES	CM. SANTA RITA	UNIVERSIDAD DE CARABOBO MORITA II	7920	15	154	6501	3753	6347	1	35	5	4	2549	6501
EDO. ARAGUA	MP.FRANCISCO LINARES	CM. SANTA RITA	UNIDAD EDUCATIVA PRIVADA ANTONIO JOSE DE SUCRE	348	1	8	315	167	307	0	0	0	0	140	315
EDO. ARAGUA	MP.FRANCISCO LINARES	CM. SANTA RITA	INSTITUTO DE EDUCACION ESPECIAL LINARES ALCANTARA	563	1	8	475	294	467	1	4	2	0	166	475
EDO. ARAGUA	MP.FRANCISCO LINARES	CM. SANTA RITA	UNIDAD EDUCATIVA NACIONAL SAN FRANCISCO DE PAULA	1107	2	16	917	647	901	0	5	0	0	249	917
EDO. ARAGUA	MP.FRANCISCO LINARES	CM. SANTA RITA	UNIDAD EDUCATIVA PRIVADA GRANDES LIBERTADORES	851	2	22	758	547	736	0	5	0	1	183	758
EDO. ARAGUA	MP.FRANCISCO LINARES	CM. SANTA RITA	ESCUELA BASICA NAC SANTA RITA	2821	5	58	2261	1494	2203	0	15	2	3	689	2261
EDO. ARAGUA	MP.FRANCISCO LINARES	CM. SANTA RITA	PREESCOLAR NACIONAL  SANTA BARBARA	689	2	7	581	458	574	0	0	0	1	115	581
EDO. ARAGUA	MP.FRANCISCO LINARES	CM. SANTA RITA	UNIDAD EDUCATIVA NACIONAL COROPO III	555	1	14	443	356	429	0	2	0	0	71	443
EDO. ARAGUA	MP.FRANCISCO LINARES	CM. SANTA RITA	UNIDAD EDUCATIVA ESTADAL ANDRES BELLO	902	2	16	764	596	748	0	3	2	0	147	764
EDO. ARAGUA	MP.FRANCISCO LINARES	CM. SANTA RITA	UESCUELA BASICA 24 DE JUNIO	1518	3	29	1242	840	1213	0	6	0	0	367	1242
EDO. ARAGUA	MP.FRANCISCO LINARES	CM. SANTA RITA	UNIDAD EDUCATIVA PRIVADA VIRGEN DEL ROSARIO FE Y ALEGRIA	720	2	14	635	358	621	0	3	2	0	258	635
EDO. ARAGUA	MP.FRANCISCO LINARES	CM. SANTA RITA	ESCUELA BASICA COSTA DE RIO	3288	6	48	2723	1932	2675	0	10	4	1	728	2723
EDO. ARAGUA	MP.FRANCISCO LINARES	CM. SANTA RITA	UNIDAD EDUCATIVA PRIVADA NUESTRA SEÑORA DE COROMOTO	1057	2	29	922	674	893	0	7	1	1	210	922
EDO. ARAGUA	MP.FRANCISCO LINARES	CM. SANTA RITA	SIMONCITO COMUNITARIO MIS NINOS Y NINAS	467	1	5	420	320	415	0	1	0	0	94	420
EDO. ARAGUA	MP.FRANCISCO LINARES	PQ. MONS FELICIANO G	ESCUELA BASICA REYNA DE VAZQUEZ	4545	8	51	3708	2752	3657	0	22	0	1	882	3708
EDO. ARAGUA	MP.FRANCISCO LINARES	PQ. MONS FELICIANO G	ESCUELA BASICA  PARAPARAL II	3795	7	64	3070	2313	3006	0	14	3	3	673	3070
EDO. ARAGUA	MP.FRANCISCO LINARES	PQ. MONS FELICIANO G	CIELO ABIERTO SIMON BOLIVAR II	545	1	6	466	368	460	0	5	0	1	86	466
EDO. ARAGUA	MP.FRANCISCO LINARES	PQ. MONS FELICIANO G	UNIDAD EDUCATIVA ESTADAL VICENTE TOVAR	786	2	9	642	504	633	0	1	0	0	128	642
EDO. ARAGUA	MP.FRANCISCO LINARES	PQ. MONS FELICIANO G	PREESCOLAR NACIONAL MARACAY I.	772	2	8	672	519	664	0	2	0	0	143	672
EDO. ARAGUA	MP.FRANCISCO LINARES	PQ. MONS FELICIANO G	PREESCOLAR LUIS BELTRAN PRIETO FIGUEROA	564	1	4	481	419	477	0	3	0	0	55	481
EDO. ARAGUA	MP. JOSE R REVENGA	CM. EL CONSEJO	UNIDAD EDUCATIVA ESTADAL RURAL MOROCOPO ALTO	692	2	20	511	341	491	0	2	1	0	147	511
EDO. ARAGUA	MP. JOSE R REVENGA	CM. EL CONSEJO	ESCUELA BASICA ESTADAL RURAL LA GRUTA NER004A	322	1	6	311	282	305	0	2	0	0	21	311
EDO. ARAGUA	MP. JOSE R REVENGA	CM. EL CONSEJO	UNIDAD EDUCATIVA NACIONAL  BOLIVARIANA SANTA ROSALIA	453	1	2	425	370	423	1	5	0	0	47	425
EDO. ARAGUA	MP. JOSE R REVENGA	CM. EL CONSEJO	ESCUELA BASICA JOSE LEONARDO CHIRINOS	2224	4	61	1818	1520	1757	1	5	5	0	226	1818
EDO. ARAGUA	MP. JOSE R REVENGA	CM. EL CONSEJO	UNIDAD EDUCATIVA NACIONAL TASAJERA	481	1	12	390	200	378	0	1	0	1	176	390
EDO. ARAGUA	MP. JOSE R REVENGA	CM. EL CONSEJO	PREESCOLAR NACIONAL BOLIVARIANO SABANETA EL CONSEJO	532	1	9	482	412	473	0	2	0	0	59	482
EDO. ARAGUA	MP. JOSE R REVENGA	CM. EL CONSEJO	UNIDAD EDUCATIVA NACIONAL MANUEL CIPRIANO PEREZ	2830	5	70	2385	1665	2315	0	7	2	0	641	2385
EDO. ARAGUA	MP. JOSE R REVENGA	CM. EL CONSEJO	CASA DE LA CULTURA POETA PEDRO BUZNEGO	2299	4	47	1972	1210	1925	0	12	0	1	702	1972
EDO. ARAGUA	MP. JOSE R REVENGA	CM. EL CONSEJO	ESCUELA BASICA ESTADAL RURAL QUEBRADA SECA	1056	2	9	903	770	894	0	6	1	0	117	903
EDO. ARAGUA	MP. JOSE R REVENGA	CM. EL CONSEJO	PREESCOLAR LA CASONA ESPACIO ALTERNATIVO	313	1	3	298	256	295	0	3	0	0	36	298
EDO. ARAGUA	MP. JOSE R REVENGA	CM. EL CONSEJO	ESCUELA BASICA FRANCISCO JARAMILLO	638	2	10	593	499	583	1	0	1	0	82	593
EDO. ARAGUA	MP. JOSE R REVENGA	CM. EL CONSEJO	UNIDAD EDUCATIVA ESTADAL RURAL EL CONDE	756	2	10	651	500	641	1	0	0	2	138	651
EDO. ARAGUA	MP. JOSE R REVENGA	CM. EL CONSEJO	ALDEA UNIVERSITARIA JOSE RAFAEL REVENGA	1003	2	15	927	471	912	0	3	1	0	437	927
EDO. ARAGUA	MP. JOSE R REVENGA	CM. EL CONSEJO	ESCUELA BASICA NACIONAL ALIDA PEREZ MATOS	1056	2	5	884	762	879	1	5	1	0	110	884
EDO. ARAGUA	MP. JOSE R REVENGA	CM. EL CONSEJO	ESCUELA BASICA CREACION CALLE PAEZ	2110	4	31	1832	1454	1801	0	9	2	0	336	1832
EDO. ARAGUA	MP. JOSE R REVENGA	CM. EL CONSEJO	SIMONCITO COMUNITARIO CAMINO REAL	204	1	8	198	172	190	0	1	1	0	16	198
EDO. ARAGUA	MP. JOSE R REVENGA	CM. EL CONSEJO	UNIDAD EDUCATIVA NACIONAL MANUELA PERDOMO DE ALMEIDA	31	1	0	24	19	24	0	0	0	0	5	24
EDO. ARAGUA	MP. JOSE R REVENGA	CM. EL CONSEJO	CASA DE LA CULTURA JOSEFA PIPA RAMIREZ.	555	1	3	479	405	476	0	2	0	0	69	479
EDO. ARAGUA	MP. JOSE R REVENGA	CM. EL CONSEJO	ESCUELA BASICA LUISA CACERES DE ARISMENDI	1954	4	35	1659	1315	1624	1	6	0	0	302	1659
EDO. ARAGUA	MP. JOSE R REVENGA	CM. EL CONSEJO	ESCUELA BASICA JUAN USLAR	3655	7	38	2939	1912	2901	3	9	1	2	974	2939
EDO. ARAGUA	MP. JOSE R REVENGA	CM. EL CONSEJO	UNIDAD EDUCATIVA ESTADAL ELENA TORRES	2219	4	41	1876	1063	1835	2	7	2	3	758	1876
EDO. ARAGUA	MP. JOSE R REVENGA	CM. EL CONSEJO	ESCUELA BASICA ESTADAL SOCORRO ACOSTA DE SANCHEZ	4841	9	80	3852	2918	3772	1	17	4	3	829	3852
EDO. ARAGUA	MP. JOSE R REVENGA	CM. EL CONSEJO	PREESCOLAR NACIONAL BARRIO EL CONSEJO	448	1	7	403	265	396	0	0	0	0	131	403
EDO. ARAGUA	MP. JOSE R REVENGA	CM. EL CONSEJO	UNIDAD EDUCATIVA NACIONAL DON SIMON RODRIGUEZ.	284	1	6	257	241	251	0	0	0	0	10	257
EDO. ARAGUA	MP. SUCRE	CM. CAGUA	ESCUELA BASICA AMELIA MIRANDA	4211	8	79	3462	2425	3383	0	18	0	0	940	3462
EDO. ARAGUA	MP. SUCRE	CM. CAGUA	ESCUELA BASICA LUIS ALEJANDRO ALVARADO	3296	6	44	2665	1418	2621	3	19	0	0	1181	2665
EDO. ARAGUA	MP. SUCRE	CM. CAGUA	ESCUELA BASICA MEREGOTO	3084	6	58	2525	1060	2467	0	14	2	2	1389	2525
EDO. ARAGUA	MP. SUCRE	CM. CAGUA	ESCUELA BASICA MANUELITA SAENZ	3121	6	50	2631	1982	2581	1	15	0	2	581	2631
EDO. ARAGUA	MP. SUCRE	CM. CAGUA	ESCUELA BASICA  LUCIO ANTONIO FIGUERA	3322	6	53	2784	1893	2731	1	16	0	3	818	2784
EDO. ARAGUA	MP. SUCRE	CM. CAGUA	UNIDAD EDUCATIVA COLEGIO ARAGUA ESTUDIANTIL	3708	7	78	3426	1314	3348	0	20	0	5	2009	3426
EDO. ARAGUA	MP. SUCRE	CM. CAGUA	ESCUELA BASICA NACIONAL FELIPE LARRAZABAL	1761	3	26	1625	540	1599	0	3	1	1	1054	1625
EDO. ARAGUA	MP. SUCRE	CM. CAGUA	ESCUELA BASICA ALIDA PEREZ MATOS	3490	7	53	2784	1850	2731	2	15	1	2	861	2784
EDO. ARAGUA	MP. SUCRE	CM. CAGUA	UNIDAD EDUCATIVA AMPARO MONROY POWER	1233	3	21	1033	613	1012	0	2	1	0	396	1033
EDO. ARAGUA	MP. SUCRE	CM. CAGUA	UNIDAD EDUCATIVA NACIONAL RAFAEL BOLIVAR	874	2	32	784	546	752	0	2	0	0	204	784
EDO. ARAGUA	MP. SUCRE	CM. CAGUA	CICLO DIVERSIFICADO MARIANO FERNANDEZ FORTIQUE	3950	7	57	3277	1448	3220	1	14	1	3	1753	3277
EDO. ARAGUA	MP. SUCRE	CM. CAGUA	UNIDAD EDUCATIVA ESTADAL PADRE FRANCISCO AMIGO	1339	3	32	1173	984	1141	0	9	0	0	148	1173
EDO. ARAGUA	MP. SUCRE	CM. CAGUA	ESCUELA BASICA TAGUANES	3056	6	39	2481	1684	2442	1	16	1	4	736	2481
EDO. ARAGUA	MP. SUCRE	CM. CAGUA	ESCUELA BASICA ANDRES BELLO	2756	5	58	2245	1271	2187	0	9	5	0	902	2245
EDO. ARAGUA	MP. SUCRE	CM. CAGUA	UNIDAD EDUCATIVA NACIONAL MANUEL MANZO GORESTEGUI	1551	3	38	1377	940	1339	0	3	0	1	395	1377
EDO. ARAGUA	MP. SUCRE	CM. CAGUA	UNIDAD EDUCATIVA JOSE HELIMENAS BARRIOS	1298	3	18	1167	500	1149	1	8	0	1	639	1167
EDO. ARAGUA	MP. SUCRE	CM. CAGUA	UNIDAD EDUCATIVA PRIVADA CECILIO ACOSTA	2557	5	53	2119	1117	2066	0	17	0	1	931	2119
EDO. ARAGUA	MP. SUCRE	CM. CAGUA	UNIDAD EDUCATIVA NACIONAL SUCRE	813	2	22	684	493	662	0	1	0	0	168	684
EDO. ARAGUA	MP. SUCRE	CM. CAGUA	INSTITUTO TECNOLÓGICO PASCAL	3611	7	60	2789	982	2729	1	12	1	1	1732	2789
EDO. ARAGUA	MP. SUCRE	CM. CAGUA	CICLO DIVERSIFICADO RAFAEL HERNANDEZ LEON	4222	8	53	3418	2038	3365	2	24	1	2	1298	3418
EDO. ARAGUA	MP. SUCRE	CM. CAGUA	UNIDAD EDUCATIVA NACIONAL SOTERO ARTEAGA MIGUELENA	2804	5	76	2340	1542	2264	0	10	0	2	710	2340
EDO. ARAGUA	MP. SUCRE	CM. CAGUA	ESCUELA BASICA CESAR ZUMETA	3823	7	66	3095	1146	3029	1	16	1	0	1865	3095
EDO. ARAGUA	MP. SUCRE	CM. CAGUA	PREESCOLAR NACIONAL BOLIVARIANO ANTONIO JOSE DE SUCRE	795	2	9	703	491	694	0	5	0	1	197	703
EDO. ARAGUA	MP. SUCRE	CM. CAGUA	PREESCOLAR LUIS ALEJANDRO ALVARADO	2149	4	39	1916	915	1877	1	8	3	1	949	1916
EDO. ARAGUA	MP. SUCRE	CM. CAGUA	COLEGIO EL CARMELO	3975	7	31	3408	956	3377	1	15	0	2	2403	3408
EDO. ARAGUA	MP. SUCRE	CM. CAGUA	UNIDAD EDUCATIVA SANTISIMO SALVADOR	4844	9	41	4356	1181	4315	0	5	2	7	3120	4356
EDO. ARAGUA	MP. SUCRE	CM. CAGUA	CENTRO MOVIL CANCHA RAFAEL URDANETA	1077	2	20	950	648	930	1	7	0	1	273	950
EDO. ARAGUA	MP. SUCRE	PQ. BELLA VISTA	UNIDAD EDUCATIVA NACIONAL  CREACION BELLA VISTA	2109	4	46	1666	1155	1620	1	7	1	1	455	1666
EDO. ARAGUA	MP. SUCRE	PQ. BELLA VISTA	PREESCOLAR NACIONAL BOLIVARIANO BELLA VISTA II	600	1	12	529	384	517	0	1	0	0	132	529
EDO. ARAGUA	MP. SUCRE	PQ. BELLA VISTA	ESCUELA BASICA CIRO MALDONADO ZERPA	2944	6	55	2343	1708	2288	1	8	3	2	566	2343
EDO. ARAGUA	MP. SUCRE	PQ. BELLA VISTA	NUESTRA SENORA DEL VALLE	799	2	32	673	508	641	0	1	2	0	130	673
EDO. ARAGUA	MP. LIBERTADOR	CM. PALO NEGRO	PREESCOLAR NUESTRA SENORA DEL CARMEN	762	2	20	671	426	651	0	5	0	0	220	671
EDO. ARAGUA	MP. LIBERTADOR	CM. PALO NEGRO	ESCUELA BASICA NAC CACIQUE CHARAIMA	2550	5	40	1955	1169	1915	0	11	1	1	733	1955
EDO. ARAGUA	MP. LIBERTADOR	CM. PALO NEGRO	ESCUELA FUERZAS AEREAS VENEZOLANA N° 1 DE NUESTR SEÑORA LORETO	2231	4	31	1816	1512	1785	0	4	2	0	267	1816
EDO. ARAGUA	MP. LIBERTADOR	CM. PALO NEGRO	LICEO NACIONAL BOLIVARIANO  LUIS BELTRAN PRIETO FIGUEROA	530	1	3	469	316	466	0	3	0	1	146	469
EDO. ARAGUA	MP. LIBERTADOR	CM. PALO NEGRO	LICEO BOLIVARIANO NACIONAL TRINOCELIS RIOS	2088	4	37	1697	1034	1660	0	6	0	0	620	1697
EDO. ARAGUA	MP. LIBERTADOR	CM. PALO NEGRO	CTRO DE CAPACITACION CHARAIMA	1517	3	12	1222	697	1210	0	2	0	2	509	1222
EDO. ARAGUA	MP. LIBERTADOR	CM. PALO NEGRO	UNIDAD EDUCACIONAL INSTITUTO ANDRES BELLO	1621	3	25	1358	714	1333	0	5	1	1	612	1358
EDO. ARAGUA	MP. LIBERTADOR	CM. PALO NEGRO	UNIDAD EDUCATIVA PRIVADA  INSTITUTO PROCERES DE AMERICA	762	2	15	699	392	684	0	1	0	0	291	699
EDO. ARAGUA	MP. LIBERTADOR	CM. PALO NEGRO	ESCUELA BASICA ESTADO GUARICO	3548	6	42	2843	1531	2801	1	16	2	2	1249	2843
EDO. ARAGUA	MP. LIBERTADOR	CM. PALO NEGRO	PREESCOLAR NACIONAL BOLIVARIANO CACIQUE CHARAIMA SEDE SAN ANTONIO	468	1	7	429	317	422	0	2	0	1	102	429
EDO. ARAGUA	MP. LIBERTADOR	CM. PALO NEGRO	CASA DE LOS ABUELOS MUNICIPIO LIBERTADOR	595	1	20	542	415	522	0	2	0	0	105	542
EDO. ARAGUA	MP. LIBERTADOR	CM. PALO NEGRO	ESCUELA BASICA ESTADAL EL LIBERTADOR	3864	7	62	3161	1972	3099	2	19	0	6	1100	3161
EDO. ARAGUA	MP. LIBERTADOR	CM. PALO NEGRO	UNIDAD EDUCATIVA NACIONAL BOLIVARIANA ISIDRO RAMON MORENO	1461	3	19	1326	986	1307	0	9	1	1	310	1326
EDO. ARAGUA	MP. LIBERTADOR	CM. PALO NEGRO	ESCUELA BASICA ECARLOS GARCIA BARRERA	2063	4	40	1729	948	1689	0	11	0	3	727	1729
EDO. ARAGUA	MP. LIBERTADOR	PQ. SAN MARTIN DE PORRES	UNIDAD EDUCATIVA ESTADAL FLORINDA GALINDEZ DE ESCORCHE	1472	3	28	1363	538	1335	0	6	0	2	789	1363
EDO. ARAGUA	MP. LIBERTADOR	PQ. SAN MARTIN DE PORRES	ESCUELA BASICA ESTADAL ANDRES ELOY LEON MORATINOS	1436	3	18	1194	932	1176	1	6	0	0	237	1194
EDO. ARAGUA	MP. LIBERTADOR	PQ. SAN MARTIN DE PORRES	PREESCOLAR MADRE DE JESUS	2886	5	32	2363	1801	2331	1	19	2	1	507	2363
EDO. ARAGUA	MP. LIBERTADOR	PQ. SAN MARTIN DE PORRES	ESCUELA BASICA LA OVALLERA	4238	8	61	3606	2455	3545	0	16	4	1	1069	3606
EDO. ARAGUA	MP. LIBERTADOR	PQ. SAN MARTIN DE PORRES	UNIDAD EDUCATIVA NACIONAL REPUBLICA DE COLOMBIA	1058	2	31	909	723	878	0	4	1	0	150	909
EDO. ARAGUA	MP. LIBERTADOR	PQ. SAN MARTIN DE PORRES	ESCUELA BASICA J M SISO MARTINEZ (PRIVADA)	2527	5	31	2231	809	2200	0	4	2	1	1384	2231
EDO. ARAGUA	MP. LIBERTADOR	PQ. SAN MARTIN DE PORRES	ESCUELA BASICA SAN ISIDRO LABRADOR	4909	9	103	3915	2594	3812	1	21	8	7	1181	3915
EDO. ARAGUA	MP. LIBERTADOR	PQ. SAN MARTIN DE PORRES	ESCUELA BASICA NACIONAL BASE AEREA LIBERTADOR	1665	3	21	1389	1015	1368	0	12	0	0	341	1389
EDO. ARAGUA	MP. LIBERTADOR	PQ. SAN MARTIN DE PORRES	UNIDAD EDUCATIVA PRIVADA  ARTURO USLAR PIETRI	622	2	11	555	414	544	0	3	0	0	127	555
EDO. ARAGUA	MP. LIBERTADOR	PQ. SAN MARTIN DE PORRES	PRESCOLAR ESTADAL JULIA ELVIRA ROMERO DE MOLINA	3049	6	74	2441	1924	2367	1	11	1	4	426	2441
EDO. ARAGUA	MP. LIBERTADOR	PQ. SAN MARTIN DE PORRES	UNIDA EDUCATIVA PRIVADA MENCA DE LEONI	984	2	18	800	524	782	0	2	0	0	256	800
EDO. ARAGUA	MP. LIBERTADOR	PQ. SAN MARTIN DE PORRES	UNIDAD EDUCATIVA NACIONAL  SIMON RODRIGUEZ	809	2	6	730	510	724	1	1	0	0	212	730
EDO. ARAGUA	MP. LIBERTADOR	PQ. SAN MARTIN DE PORRES	CENTRO COMUNITARIO CIELO ABIERTO LA PICA	816	2	13	705	514	692	0	4	0	0	174	705
EDO. ARAGUA	MP. LIBERTADOR	PQ. SAN MARTIN DE PORRES	PREESCOLAR NACIONAL LOS HORNOS	724	2	14	624	513	610	0	2	1	1	93	624
EDO. ARAGUA	MP. LIBERTADOR	PQ. SAN MARTIN DE PORRES	ESCUELA BASICA JOSE ANGEL LAMAS	4895	9	89	4097	2067	4008	2	19	3	3	1914	4097
EDO. ARAGUA	MP. LIBERTADOR	PQ. SAN MARTIN DE PORRES	UNIDAD EDUCATIVA NACIONAL SIMON BOLIVAR	599	1	7	548	257	541	0	0	0	0	284	548
EDO. ARAGUA	MP. LIBERTADOR	PQ. SAN MARTIN DE PORRES	ESCUELA BASICA ESTADAL MARIA CAROLINA OLMO DE SULBARAN	617	2	12	535	408	523	0	3	2	0	110	535
EDO. ARAGUA	MP. LIBERTADOR	PQ. SAN MARTIN DE PORRES	UNIDAD EDUCATIVA ESTADAL MADRE TERESA DE CALCUTA	1065	2	23	882	735	859	0	8	0	0	116	882
EDO. ARAGUA	MP. LIBERTADOR	PQ. SAN MARTIN DE PORRES	LICEO NACIONAL BOLIVARIANO BASE AEREA EL LIBERTADOR	1389	3	28	1286	973	1258	0	4	0	1	280	1286
EDO. ARAGUA	MP. LIBERTADOR	PQ. SAN MARTIN DE PORRES	UNIDAD EDUCATIVA ADULTOS BAEL	321	1	4	284	264	280	0	0	0	0	16	284
EDO. ARAGUA	MP. TOVAR	CM. COLONIA TOVAR	UNIDAD EDUCATIVA LA LOMA	83	1	1	72	56	71	0	0	1	0	14	72
EDO. ARAGUA	MP. TOVAR	CM. COLONIA TOVAR	UNIDAD EDUCATIVA ESTADAL LAS HERNANDEZ	224	1	2	189	160	187	0	2	1	0	24	189
EDO. ARAGUA	MP. TOVAR	CM. COLONIA TOVAR	ESCUELA BASICA PEON DE GAVANTE	565	1	4	453	334	449	0	3	1	0	111	453
EDO. ARAGUA	MP. TOVAR	CM. COLONIA TOVAR	ESCUELA BASICA EL ROBLE
EDO. ARAGUA	MP. TOVAR	CM. COLONIA TOVAR	UNIDAD EDUCATICA LA CIENAGA	233	1	4	184	156	180	0	1	0	0	23	184
EDO. ARAGUA	MP. TOVAR	CM. COLONIA TOVAR	ESCUELA BASICA ROTARY CLUB	155	1	2	107	74	105	0	3	1	0	27	107
EDO. ARAGUA	MP. TOVAR	CM. COLONIA TOVAR	UNIDAD EDUCATIVA ESTADAL CUMBOTE	175	1	4	157	64	153	0	1	1	0	87	157
EDO. ARAGUA	MP. TOVAR	CM. COLONIA TOVAR	UNIDAD EDUCATIVA NACIONAL ELIZABET VONKELLER	2204	4	56	1729	490	1673	0	2	0	1	1180	1729
EDO. ARAGUA	MP. TOVAR	CM. COLONIA TOVAR	UNIDAD EDUCATIVA NACIONAL MARTIN TOVAR	432	1	8	343	184	335	0	0	0	0	151	343
EDO. ARAGUA	MP. TOVAR	CM. COLONIA TOVAR	PRESCOLAR MARTIN TOVAR Y TOVAR	2292	4	36	1738	517	1702	1	6	1	0	1177	1738
EDO. ARAGUA	MP. TOVAR	CM. COLONIA TOVAR	ESCUELA BASICA ESTADAL LAS LUISAS NUMERO 583	345	1	6	243	210	237	1	3	0	0	23	243
EDO. ARAGUA	MP. TOVAR	CM. COLONIA TOVAR	ESCUELA BASICA ESTADAL RURAL EL CEDRAL	814	2	22	593	459	571	1	5	1	1	104	593
EDO. ARAGUA	MP. TOVAR	CM. COLONIA TOVAR	UNIDAD EDUCATIVA LUIS LAPENTA	1387	3	16	1128	347	1112	0	3	0	0	762	1128
EDO. ARAGUA	MP. TOVAR	CM. COLONIA TOVAR	UNIDAD EDUCATIVA ESTADAL PUERTO DE MAYA NUMERO 583	359	1	1	285	272	284	1	1	0	0	10	285
EDO. ARAGUA	MP. TOVAR	CM. COLONIA TOVAR	ESCUELA BASICA ESTADAL DOMINGO BORGES	564	1	7	437	198	430	1	1	0	0	230	437
EDO. ARAGUA	MP. TOVAR	CM. COLONIA TOVAR	UNIDAD EDUCATIVA ESTADAL RURAL CUCURUCHO	216	1	7	189	70	182	0	1	0	0	111	189
EDO. ARAGUA	MP. TOVAR	CM. COLONIA TOVAR	ESCUELA BASICA Nº 488	605	2	20	470	378	450	0	2	0	1	69	470
EDO. ARAGUA	MP. TOVAR	CM. COLONIA TOVAR	ESCUELA LOURDES FRIGO	542	1	12	355	258	343	0	1	1	0	83	355
EDO. ARAGUA	MP. TOVAR	CM. COLONIA TOVAR	UNIDAD EDUCATIVA ESTADAL MONTE OSCURO	248	1	10	216	165	206	1	2	0	1	37	216
EDO. ARAGUA	MP. TOVAR	CM. COLONIA TOVAR	UNIDAD EDUCATIVA ESTADAL RURAL CONCENTRADA LOS ANAUCOS NUMERO 583	453	1	15	351	255	336	0	1	1	0	79	351
EDO. ARAGUA	MP. TOVAR	CM. COLONIA TOVAR	UNIDAD EDUCATIVA CURTIDOR	138	1	3	122	51	119	0	0	0	0	68	122
EDO. ARAGUA	MP. TOVAR	CM. COLONIA TOVAR	ESCUELA CONCENT Nº 3301	262	1	1	191	176	190	1	2	0	0	11	191
EDO. ARAGUA	MP. BOLIVAR	CM. SAN MATEO	COLEGIO PRIVADO LAZO MARTI	149	1	2	131	98	129	0	1	0	0	30	131
EDO. ARAGUA	MP. BOLIVAR	CM. SAN MATEO	UNIDAD EDUCATIVA ESTADAL EZEQUIEL ZAMORA	2501	5	58	1968	1423	1910	0	11	2	1	473	1968
EDO. ARAGUA	MP. BOLIVAR	CM. SAN MATEO	ESCUELA BASICA NAC RICAURTE	2342	4	39	1787	1222	1748	0	9	2	0	515	1787
EDO. ARAGUA	MP. BOLIVAR	CM. SAN MATEO	UNIDAD EDUCATIVA ESTADAL DON ROMULO GALLEGOS	818	2	30	715	587	685	0	5	0	0	93	715
EDO. ARAGUA	MP. BOLIVAR	CM. SAN MATEO	CENTRO MOVIL	1281	3	24	982	731	958	0	3	0	0	224	982
EDO. ARAGUA	MP. BOLIVAR	CM. SAN MATEO	ESCUELA BASICA FELIX MARIA PAREDES	2808	5	103	2177	1471	2074	0	8	2	1	592	2177
EDO. ARAGUA	MP. BOLIVAR	CM. SAN MATEO	ESCUELA BASICA CARMELINA BEJARANO	2311	4	59	1894	1435	1835	0	5	1	0	394	1894
EDO. ARAGUA	MP. BOLIVAR	CM. SAN MATEO	PROYECTO INICIAL BOLIVARIANO.AÑO BICENTENARIO II.	332	1	15	282	190	267	0	4	0	0	73	282
EDO. ARAGUA	MP. BOLIVAR	CM. SAN MATEO	ESCUELA BASICA SAN MATEO	1716	3	27	1350	744	1323	1	5	2	0	571	1350
EDO. ARAGUA	MP. BOLIVAR	CM. SAN MATEO	ESCUELA BASICA NACIONAL PRESIDENTE MEDINA ANGARITA	3302	6	74	2617	1709	2543	0	11	1	1	821	2617
EDO. ARAGUA	MP. BOLIVAR	CM. SAN MATEO	CENTRO DE CAPACITACION DE ADULTO ESCUELA DE ARTE Y OFICIO	872	2	21	721	543	700	0	6	0	0	151	721
EDO. ARAGUA	MP. BOLIVAR	CM. SAN MATEO	UNIDAD EDUCATIVA PRIVADA  LA SAGRADA FAMILIA	285	1	5	265	198	260	0	0	0	0	62	265
EDO. ARAGUA	MP. BOLIVAR	CM. SAN MATEO	ESCUELA ESTADAL UNITARIA Nº 753	1260	3	46	952	757	906	1	2	0	0	146	952
EDO. ARAGUA	MP. BOLIVAR	CM. SAN MATEO	SIMONCITO COMUNITARIO SAN MATEO	353	1	7	302	229	295	0	0	0	0	66	302
EDO. ARAGUA	MP. BOLIVAR	CM. SAN MATEO	MODULO DE SERVICIO ILIAN AGUILAR	388	1	5	355	308	350	1	1	1	0	39	355
EDO. ARAGUA	MP. BOLIVAR	CM. SAN MATEO	PRE ESSCOLAR MARIA ALVARADO	532	1	10	467	344	457	0	0	0	0	113	467
EDO. ARAGUA	MP. BOLIVAR	CM. SAN MATEO	UNIDAD EDUCATIVA ALBERTO CARNEVALLI	1125	2	32	895	723	863	1	5	1	1	132	895
EDO. ARAGUA	MP. BOLIVAR	CM. SAN MATEO	UNIDAD EDUCATIVA NACIONAL DANIEL MENDOZA	573	1	16	471	393	455	0	0	0	0	62	471
EDO. ARAGUA	MP. BOLIVAR	CM. SAN MATEO	COLEGIO NTRA SEÑORA DE BELEN	2241	4	65	1850	945	1785	0	4	1	0	835	1850
EDO. ARAGUA	MP. BOLIVAR	CM. SAN MATEO	ESCUELA BASICA NACIONAL 25 DE MARZO	3754	7	96	3090	2022	2994	0	21	0	2	949	3090
EDO. ARAGUA	MP. MARIO B IRAGORRY	CM. EL LIMON	ESCUELA BASICA NACIONAL 6 DE SEPTIEMBRE	1880	4	16	1560	611	1544	0	1	1	1	930	1560
EDO. ARAGUA	MP. MARIO B IRAGORRY	CM. EL LIMON	ESCUELA BASICA EL PROGRESO	3084	6	61	2571	1373	2510	0	11	2	2	1122	2571
EDO. ARAGUA	MP. MARIO B IRAGORRY	CM. EL LIMON	UNIDAD EDUCATIVA NACIONAL  EL LIMON	7185	13	97	5908	2216	5811	0	23	5	6	3561	5908
EDO. ARAGUA	MP. MARIO B IRAGORRY	CM. EL LIMON	U.E.E  HIPOLITO BONILLA	1596	3	19	1356	626	1337	0	3	1	0	707	1356
EDO. ARAGUA	MP. MARIO B IRAGORRY	CM. EL LIMON	UNIDAD EDUCATIVA NACIONAL JULIO MORALES LARA	3377	6	36	2743	972	2707	2	11	4	2	1716	2743
EDO. ARAGUA	MP. MARIO B IRAGORRY	CM. EL LIMON	COLEGIO CRISTO REY	1614	3	34	1431	687	1397	2	5	0	0	703	1431
EDO. ARAGUA	MP. MARIO B IRAGORRY	CM. EL LIMON	UNIDA EDUCATIVA ESTADAL DOCTOR JOSE FRANCISCO TORREALBA	4103	8	37	3427	1194	3390	1	12	3	2	2178	3427
EDO. ARAGUA	MP. MARIO B IRAGORRY	CM. EL LIMON	CASA DEL PODER POPULAR EL PASEO	2251	4	36	2010	1062	1974	0	5	1	4	902	2010
EDO. ARAGUA	MP. MARIO B IRAGORRY	CM. EL LIMON	COLEGIO DECROLY	4293	8	37	3699	910	3662	0	6	4	6	2736	3699
EDO. ARAGUA	MP. MARIO B IRAGORRY	PQ. CA A DE AZUCAR	UNIDAD EDUCATIVA NACIONAL BOLIVARIANA CANA DE AZUCAR	2618	5	52	2206	1166	2154	3	12	2	4	967	2206
EDO. ARAGUA	MP. MARIO B IRAGORRY	PQ. CA A DE AZUCAR	UNIDAD EDUCATIVA COLEGIO LOS ANGELES	924	2	11	828	458	817	1	3	1	0	354	828
EDO. ARAGUA	MP. MARIO B IRAGORRY	PQ. CA A DE AZUCAR	PREESCOLAR NACIONAL BOLIVARIANO ANDRES ELOY BLANCO.	463	1	4	395	247	391	0	0	0	0	144	395
EDO. ARAGUA	MP. MARIO B IRAGORRY	PQ. CA A DE AZUCAR	UNIDAD EDUCATIVA NACIONAL PEDRO JOSE MUGUERZA	3294	6	26	2861	1392	2835	0	4	2	3	1434	2861
EDO. ARAGUA	MP. MARIO B IRAGORRY	PQ. CA A DE AZUCAR	UNIDA EDUCATIVA NACIONAL  SANTOS MICHELENA	3446	6	37	2991	1432	2954	1	13	2	1	1505	2991
EDO. ARAGUA	MP. MARIO B IRAGORRY	PQ. CA A DE AZUCAR	CICLO DIVERSIFICADO OSWALDO TORRES VIÑA	768	2	10	679	405	669	1	3	0	0	260	679
EDO. ARAGUA	MP. MARIO B IRAGORRY	PQ. CA A DE AZUCAR	JARDIN DE INFANCIA INAVI	966	2	24	809	446	785	0	2	1	0	336	809
EDO. ARAGUA	MP. MARIO B IRAGORRY	PQ. CA A DE AZUCAR	ESCUELA BASICA PADRE ANTONIO LEYH	3442	6	52	2933	1570	2881	0	10	1	4	1296	2933
EDO. ARAGUA	MP. MARIO B IRAGORRY	PQ. CA A DE AZUCAR	PREESCOLAR ROMULO GALLEGOS	1337	3	29	1120	601	1091	0	7	2	0	481	1120
EDO. ARAGUA	MP. MARIO B IRAGORRY	PQ. CA A DE AZUCAR	UNIVERSIDAD SIMON RODRIGUEZ	3484	6	55	3081	1557	3026	0	8	1	6	1454	3081
EDO. ARAGUA	MP. MARIO B IRAGORRY	PQ. CA A DE AZUCAR	ESCUELA BASICA JOSE FELIX RIBAS	3746	7	38	3262	1939	3224	0	21	2	1	1261	3262
EDO. ARAGUA	MP. MARIO B IRAGORRY	PQ. CA A DE AZUCAR	UNIDAD EDUCACATIVA AUTONOMA MARIA LUISA PAREDES DE ANTONINI.	879	2	11	807	507	796	0	4	1	0	284	807
EDO. ARAGUA	MP. MARIO B IRAGORRY	PQ. CA A DE AZUCAR	INSTITUTO DE EDUCACION ESPECIAL ROMULO GALLEGOS	2624	5	31	2335	1128	2304	2	13	1	0	1160	2335
EDO. ARAGUA	MP. MARIO B IRAGORRY	PQ. CA A DE AZUCAR	CENTRO EXPERIMENTAL DE ARTES Y CIENCIAS ARAGUA PROGRAMA TALENTO	1262	3	14	1108	551	1094	0	4	0	0	539	1108
EDO. ARAGUA	MP. MARIO B IRAGORRY	PQ. CA A DE AZUCAR	TALLER DE EDUCACION LABORAL MARACAY	1327	3	16	1122	587	1106	0	7	0	0	512	1122
EDO. ARAGUA	MP. MARIO B IRAGORRY	PQ. CA A DE AZUCAR	ESCUELA BOLIVARIANA MARIA MAYOR RODRIGUEZ	2110	4	24	1786	1034	1762	0	2	0	3	723	1786
EDO. ARAGUA	MP. MARIO B IRAGORRY	PQ. CA A DE AZUCAR	CENTRO DE EDUCACION INTEGRAL ANTONIO PEREZ BONALDE	352	1	0	322	228	322	0	2	0	0	92	322
EDO. ARAGUA	MP. MARIO B IRAGORRY	PQ. CA A DE AZUCAR	INCE TEXTIL	2187	4	27	1879	957	1852	0	5	2	0	888	1879
EDO. ARAGUA	MP. MARIO B IRAGORRY	PQ. CA A DE AZUCAR	UNIDAD EDUCATIVA NACIONAL BOLIVARIANA DOCTOR ALBERTO JOSE FERNANDEZ	3842	7	47	3266	1607	3219	1	8	4	3	1596	3266
EDO. ARAGUA	MP. MARIO B IRAGORRY	PQ. CA A DE AZUCAR	ESCUELA BASICA MONSEOR FELICIANO GONZALEZ	2345	5	42	2041	1037	1999	0	12	2	0	948	2041
EDO. ARAGUA	MP. MARIO B IRAGORRY	PQ. CA A DE AZUCAR	UNIDAD EDUCATIVA  EDUARDO ASSEF RAIDI	3924	7	58	3354	1910	3296	1	15	1	5	1364	3354
EDO. ARAGUA	MP. MARIO B IRAGORRY	PQ. CA A DE AZUCAR	PREESCOLAR EXPERIMENTAL COLIBRI 1	1447	3	16	1253	660	1237	0	3	0	0	574	1253
EDO. ARAGUA	MP. MARIO B IRAGORRY	PQ. CA A DE AZUCAR	UNIDAD EDUCATIVA PRIVADA SAN VICENTE DE PAUL.	748	2	8	686	374	678	0	4	2	0	298	686
EDO. ARAGUA	MP. URDANETA	PQ. TAGUAY	ESCUELA BASICA MAESTRO LUIS JOSE BRAVO	1838	4	42	1510	955	1468	0	10	0	2	501	1510
EDO. ARAGUA	MP. URDANETA	PQ. TAGUAY	ESCUELA BASICA ESTADAL DOS MONTES	632	2	7	563	499	556	1	8	0	0	48	563
EDO. ARAGUA	MP. URDANETA	PQ. TAGUAY	UNIDAD EDUCATIVA ESTADAL NARE	329	1	3	279	214	276	0	1	0	0	61	279
EDO. ARAGUA	MP. URDANETA	PQ. TAGUAY	ESCUELA BASICA ESTADAL CONCENTRADA LA SUAREÑA	522	1	15	404	320	389	0	0	1	0	68	404
EDO. ARAGUA	MP. URDANETA	PQ. SAN FRANCISCO DE CARA	ESCUELA ESTADAL GUANAYEN	341	1	6	311	277	305	0	0	0	0	28	311
EDO. ARAGUA	MP. URDANETA	PQ. SAN FRANCISCO DE CARA	UNIDAD EDUCATIVA NACIONAL SAN FRANCISCO DE CARA	1627	3	35	1299	822	1264	0	4	0	0	438	1299
EDO. ARAGUA	MP. URDANETA	CM. BARBACOAS	UNIDAD EDUCATIVA FRANCISCO SALDIVIA LANDAETA	1725	3	50	1369	790	1319	0	11	1	1	516	1369
EDO. ARAGUA	MP. URDANETA	CM. BARBACOAS	ESCUELA UNITARIA SAMANITO	488	1	9	425	382	416	0	0	1	0	33	425
EDO. ARAGUA	MP. URDANETA	CM. BARBACOAS	ESCUELA BASICA ESTADAL JOSE RAFAEL CARBALLO	444	1	15	389	310	374	0	3	2	0	59	389
EDO. ARAGUA	MP. URDANETA	CM. BARBACOAS	ESCUELA BASICA ESTADAL CECILIO ACOSTA	871	2	18	752	511	734	0	3	0	0	220	752
EDO. ARAGUA	MP. URDANETA	CM. BARBACOAS	ESCUELA UNITARIA Nº 403	748	2	20	630	516	610	0	1	0	0	93	630
EDO. ARAGUA	MP. URDANETA	CM. BARBACOAS	ESCUELA BASICA ESTADAL UNITARIA EL COROZO	302	1	1	246	232	245	0	1	0	0	12	246
EDO. ARAGUA	MP. URDANETA	CM. BARBACOAS	ESCUELA BASICA MIGUEL ZAMORA BOLIVAR	797	2	32	658	552	626	0	3	0	0	71	658
EDO. ARAGUA	MP. URDANETA	CM. BARBACOAS	ESCUELA BASICA RAFAEL BOLIVAR CORONADO	2069	4	54	1688	930	1634	0	3	0	2	699	1688
EDO. ARAGUA	MP. URDANETA	CM. BARBACOAS	PREESCOLAR NACIONAL BOLIVARIANO BARBACOAS	1177	2	32	988	603	956	0	7	0	1	345	988
EDO. ARAGUA	MP. URDANETA	PQ. LAS PE#ITAS	ESCUELA BASICA ESTADAL CONCENTRADA EL MEDANO	316	1	11	249	181	238	0	2	0	0	55	249
EDO. ARAGUA	MP. URDANETA	PQ. LAS PE#ITAS	UNIDAD EDUCATIVA ESTADAL JUAN RAMOS	1062	2	28	860	545	832	1	2	1	1	282	860
EDO. ARAGUA	MP. URDANETA	PQ. LAS PE#ITAS	UNIDAD EDUCATIVA ESTADAL CONCENTRADA PAN DE AZUCAR	319	1	8	262	211	254	0	1	0	0	42	262
EDO. ARAGUA	MP. JOSE FELIX RIVAS	PQ. CASTOR NIEVES RIOS	UNIDAD EDUCATIVA NACIONAL VICENTE EMILIO SOJO	2515	5	30	2188	1140	2158	0	10	0	2	1006	2188
EDO. ARAGUA	MP. JOSE FELIX RIVAS	PQ. CASTOR NIEVES RIOS	ESCUELA BASICA LUIS AUGUSTO MACHADO	5176	9	91	4452	1594	4361	1	16	3	2	2745	4452
EDO. ARAGUA	MP. JOSE FELIX RIVAS	PQ. CASTOR NIEVES RIOS	ESCUELA BASICA NACIONAL LA MORA (A.I)	3458	6	42	2952	1575	2910	0	19	1	2	1313	2952
EDO. ARAGUA	MP. JOSE FELIX RIVAS	PQ. CASTOR NIEVES RIOS	UNIDAD EDUCATIVA NACIONAL  MIGUEL ALVAREZ	3712	7	60	3176	1649	3116	0	13	1	3	1450	3176
EDO. ARAGUA	MP. JOSE FELIX RIVAS	PQ. CASTOR NIEVES RIOS	ESCUELA BASICA ELBA GONZALEZ DE GIL	2522	5	39	2195	1153	2156	0	5	0	2	996	2195
EDO. ARAGUA	MP. JOSE FELIX RIVAS	PQ. CASTOR NIEVES RIOS	UNIDAD EDUCATIVA NACIONAL LA VICTORIA	2808	5	31	2398	1148	2367	0	2	1	4	1212	2398
EDO. ARAGUA	MP. JOSE FELIX RIVAS	PQ. CASTOR NIEVES RIOS	COLEGIO MARIANO MONTILLA	1325	3	12	1110	530	1098	0	5	2	0	561	1110
EDO. ARAGUA	MP. JOSE FELIX RIVAS	PQ. CASTOR NIEVES RIOS	ESCUELA BASICA NACIONAL MARIA LUISA ANTONINI DE PAREDES	2652	5	56	2300	1138	2244	0	13	1	3	1089	2300
EDO. ARAGUA	MP. JOSE FELIX RIVAS	PQ. CASTOR NIEVES RIOS	UNIDAD EDUCATIVA NACIONAL RAMON GARCIA DE SENA	4111	8	107	3588	1854	3481	0	24	2	3	1598	3588
EDO. ARAGUA	MP. JOSE FELIX RIVAS	PQ. CASTOR NIEVES RIOS	SERVICIO AUTONOMO CENTRO EUROVENEZOLANO DE DESARROLLO EMPRESARIAL	1519	3	30	1406	634	1376	0	1	0	1	740	1406
EDO. ARAGUA	MP. JOSE FELIX RIVAS	PQ. CASTOR NIEVES RIOS	CENTRO CAPACITACION ADULTOS ESTADAL CARMEN PILAR FERNANDEZ	3701	7	38	3275	1620	3237	1	10	1	1	1604	3275
EDO. ARAGUA	MP. JOSE FELIX RIVAS	PQ. ZUATA	PREESCOLAR BOLIVARIANO 12 DE FEBRERO	586	1	9	521	444	512	0	2	0	0	66	521
EDO. ARAGUA	MP. JOSE FELIX RIVAS	PQ. ZUATA	LICEO BOLIVARIANO ZUATA	2990	6	65	2344	1619	2279	1	12	2	0	645	2344
EDO. ARAGUA	MP. JOSE FELIX RIVAS	PQ. ZUATA	UNIDAD EDUCATIVA ESTADAL CONCENTRADA PUNTA DEL MONTE	162	1	4	138	120	134	0	0	0	0	14	138
EDO. ARAGUA	MP. JOSE FELIX RIVAS	PQ. ZUATA	UNIDAD EDUCATIVA ESTADAL RURAL CONCENTRADA SAN JOSE	1404	3	34	1175	905	1141	0	3	0	1	232	1175
EDO. ARAGUA	MP. JOSE FELIX RIVAS	PQ. ZUATA	UNIDAD EDUCATIVA ESTADAL NEGRA MATEA	3233	6	46	2378	1809	2332	2	15	1	0	505	2378
EDO. ARAGUA	MP. JOSE FELIX RIVAS	PQ. ZUATA	PREESCOLAR BOLIVARIANO BELLO MONTE II	761	2	20	665	511	645	0	4	0	0	130	665
EDO. ARAGUA	MP. JOSE FELIX RIVAS	PQ. ZUATA	UNIDAD EDUCATIVA PRIVADA NUESTRA SEÑORA DEL ROSARIO	765	2	11	665	532	654	0	5	3	0	114	665
EDO. ARAGUA	MP. JOSE FELIX RIVAS	PQ. ZUATA	UNIDAD EDUCATIVA ESTADAL PRIMITIVO DE JESUS	1543	3	20	1368	1166	1348	0	4	0	0	178	1368
EDO. ARAGUA	MP. JOSE FELIX RIVAS	PQ. ZUATA	UNIDAD EDUCATIVA NACIONAL CREACION JOBALITO	723	2	19	622	513	603	0	2	1	0	87	622
EDO. ARAGUA	MP. JOSE FELIX RIVAS	PQ. ZUATA	UNIDAD EDUCATIVA NACIONAL ZUATA NUEVA SEDE	3067	6	62	2483	1775	2421	0	20	0	3	623	2483
EDO. ARAGUA	MP. JOSE FELIX RIVAS	PQ. ZUATA	UNIDAD EDUCATIVA NACIONAL SIMON BOLIVAR	3020	6	40	2629	2293	2589	0	4	1	1	290	2629
EDO. ARAGUA	MP. JOSE FELIX RIVAS	PQ. ZUATA	CASA HOGAR MONSEÑOR LOPEZ AVELEDO	241	1	4	226	183	222	0	1	0	1	37	226
EDO. ARAGUA	MP. JOSE FELIX RIVAS	PQ. PAO DE ZARATE	UNIDAD EDUCATIVA ESTADAL RURAL CRUZ GUEVARA	2280	4	33	1840	1466	1807	1	6	3	2	329	1840
EDO. ARAGUA	MP. JOSE FELIX RIVAS	PQ. LAS GUACAMAYAS	CENTRO MOVIL ESTADIUM DEL POBLADO LAS GUACAMAYAS.	669	2	20	568	426	548	0	1	0	0	121	568
EDO. ARAGUA	MP. JOSE FELIX RIVAS	PQ. LAS GUACAMAYAS	ESCUELA GRADUADA RICARDO MONTILLA	3136	6	64	2462	1577	2398	2	9	1	1	808	2462
EDO. ARAGUA	MP. JOSE FELIX RIVAS	PQ. LAS GUACAMAYAS	CASA DE INTEGRACION ESCUELITA VIEJA	667	2	12	591	427	579	0	7	0	0	145	591
EDO. ARAGUA	MP. JOSE FELIX RIVAS	CM. JUAN VICENTE BOLIVAR	CENTRO LA CASONA	843	2	29	726	499	697	0	5	1	0	192	726
EDO. ARAGUA	MP. JOSE FELIX RIVAS	CM. JUAN VICENTE BOLIVAR	ESCUELA BASICA NACIONAL CECILIO ACOSTA	3423	6	78	2725	1778	2647	0	19	2	0	848	2725
EDO. ARAGUA	MP. JOSE FELIX RIVAS	CM. JUAN VICENTE BOLIVAR	ESCUELA BASICA ESTADAL JOSE MARIA ALVAREZ JARAMILLO	3207	6	36	2619	810	2583	0	12	1	0	1760	2619
EDO. ARAGUA	MP. JOSE FELIX RIVAS	CM. JUAN VICENTE BOLIVAR	UNIDAD EDUCATIVA ESTADAL RURAL PIE DE CERRO	794	2	9	609	404	600	1	3	0	1	191	609
EDO. ARAGUA	MP. JOSE FELIX RIVAS	CM. JUAN VICENTE BOLIVAR	UNIDAD EDUCATIVA ESTADAL 23 DE ENERO	2061	4	25	1713	1320	1688	0	10	1	1	356	1713
EDO. ARAGUA	MP. JOSE FELIX RIVAS	CM. JUAN VICENTE BOLIVAR	UNIDAD EDUCATIVA COLEGIO MARIA DE LA PAZ	1454	3	13	1322	336	1309	0	1	0	0	972	1322
EDO. ARAGUA	MP. JOSE FELIX RIVAS	CM. JUAN VICENTE BOLIVAR	ESCUELA TECNICA INDUSTRIAL	2882	5	38	2291	973	2253	1	5	2	2	1270	2291
EDO. ARAGUA	MP. JOSE FELIX RIVAS	CM. JUAN VICENTE BOLIVAR	UNIDAD EDUCATIVA NACIONAL FRANCISCO JAVIER USTARIZ	798	2	9	723	530	714	0	2	1	1	180	723
EDO. ARAGUA	MP. JOSE FELIX RIVAS	CM. JUAN VICENTE BOLIVAR	ESCUELA BASICA SERGIO MEDINA	3917	7	63	3179	2116	3116	1	20	4	2	973	3179
EDO. ARAGUA	MP. JOSE FELIX RIVAS	CM. JUAN VICENTE BOLIVAR	ESCUELA BASICA BRITO	3090	6	52	2640	1549	2588	2	13	2	4	1018	2640
EDO. ARAGUA	MP. JOSE FELIX RIVAS	CM. JUAN VICENTE BOLIVAR	ESCUELA BASICA ESTADAL RUDENCINDO CANELON	1297	3	32	1150	948	1118	1	2	1	1	165	1150
EDO. ARAGUA	MP. JOSE FELIX RIVAS	CM. JUAN VICENTE BOLIVAR	UNIDAD EDUCATIVA NACIONAL RUBEN DARIO	2233	4	31	1780	819	1749	1	7	0	1	921	1780
EDO. ARAGUA	MP. JOSE FELIX RIVAS	CM. JUAN VICENTE BOLIVAR	UNIDAD EDUCATIVA PRIVADA COLEGIO FRANCISCO MIGUEL JAIME OCHOA	744	2	8	669	299	661	0	3	0	1	358	669
EDO. ARAGUA	MP. JOSE FELIX RIVAS	CM. JUAN VICENTE BOLIVAR	BIBLIOTECA VIRTUAL DE LA VICTORIA	717	2	5	659	253	654	1	3	1	2	394	659
EDO. ARAGUA	MP. JOSE FELIX RIVAS	CM. JUAN VICENTE BOLIVAR	CICLO DIVERSIFICADO JOSE FELIX RIVAS	4440	8	53	3513	1084	3460	0	18	1	5	2352	3513
EDO. ARAGUA	MP. JOSE FELIX RIVAS	CM. JUAN VICENTE BOLIVAR	ESCUELA BASICA ESTADAL AMERICA FERNANDEZ DE LEONI	5220	10	132	4393	3193	4261	1	27	5	1	1034	4393
EDO. ARAGUA	MP. JOSE FELIX RIVAS	CM. JUAN VICENTE BOLIVAR	UNIDAD EDUCATIVA NACIONAL 12 DE FEBRERO	2010	4	26	1571	701	1545	3	8	0	0	833	1571
EDO. ARAGUA	MP. JOSE FELIX RIVAS	CM. JUAN VICENTE BOLIVAR	COLEGIO MADRE EMILIA	2736	5	58	2231	1290	2173	1	13	3	1	865	2231
EDO. ARAGUA	MP. JOSE FELIX RIVAS	CM. JUAN VICENTE BOLIVAR	ESCUELA BASICA NACIONAL LA QUEBRADA	994	2	34	849	728	815	0	7	2	0	78	849
EDO. ARAGUA	MP. SAN SEBASTIAN	CM. SAN SEBASTIAN	UNIDAD EDUCATIVA NACIONAL BRISAS DE MOSOCO	251	1	4	218	188	214	0	0	0	0	26	218
EDO. ARAGUA	MP. SAN SEBASTIAN	CM. SAN SEBASTIAN	ESCUELA ESTADAL UNITARIA Nº 256	307	1	10	229	172	219	1	1	1	0	44	229
EDO. ARAGUA	MP. SAN SEBASTIAN	CM. SAN SEBASTIAN	ESCUELA UNITARIA Nº 131	69	1	0	40	24	40	0	0	1	0	15	40
EDO. ARAGUA	MP. SAN SEBASTIAN	CM. SAN SEBASTIAN	CICLO BASICO ELICEO ACOSTA	2926	5	33	2383	1361	2350	2	10	2	0	975	2383
EDO. ARAGUA	MP. SAN SEBASTIAN	CM. SAN SEBASTIAN	CENTRO DE EDUCACION INICIAL PEDRO ALDAO	466	1	9	414	287	405	0	1	0	0	117	414
EDO. ARAGUA	MP. SAN SEBASTIAN	CM. SAN SEBASTIAN	UNIDAD EDUCATIVA NACIONAL WENCESLAO CASADO FONSECA	3313	6	42	2695	1443	2653	0	7	1	2	1200	2695
EDO. ARAGUA	MP. SAN SEBASTIAN	CM. SAN SEBASTIAN	ESCUELA UNITARIA Nº 95	549	1	10	414	321	404	0	1	1	0	81	414
EDO. ARAGUA	MP. SAN SEBASTIAN	CM. SAN SEBASTIAN	ESCUELA BASICA ESTADAL ANDRES RODRIGUEZ RAMIREZ	460	1	6	411	275	405	0	0	0	0	130	411
EDO. ARAGUA	MP. SAN SEBASTIAN	CM. SAN SEBASTIAN	CASA DE LOS NIÑOS MADRE MARIA DE SAN JOSE	570	1	11	511	370	500	0	0	0	0	130	511
EDO. ARAGUA	MP. SAN SEBASTIAN	CM. SAN SEBASTIAN	MODULO DE SERV CUATRICENTENARIO	1913	4	47	1591	898	1544	0	5	1	0	640	1591
EDO. ARAGUA	MP. SAN SEBASTIAN	CM. SAN SEBASTIAN	ESCUELA ESTADAL Nº 509	293	1	3	227	166	224	0	1	2	0	55	227
EDO. ARAGUA	MP. SAN SEBASTIAN	CM. SAN SEBASTIAN	ESCUELA BASICA PEDRO ALDAO	3682	7	46	2917	1829	2871	0	11	1	2	1028	2917
EDO. ARAGUA	MP. SAN SEBASTIAN	CM. SAN SEBASTIAN	ESCUELA ESPECIAL GUARATE	67	1	1	34	24	33	0	0	0	0	9	34
EDO. ARAGUA	MP. SAN SEBASTIAN	CM. SAN SEBASTIAN	ESCUELA CONCENTRADA LA GUAMA	1370	3	22	1129	704	1107	0	2	1	1	399	1129
EDO. ARAGUA	MP. SAN CASIMIRO	CM. SAN CASIMIRO	ESCUELA COMPLETA Nº 476 253	1093	2	20	886	629	866	0	3	0	0	234	886
EDO. ARAGUA	MP. SAN CASIMIRO	CM. SAN CASIMIRO	UNIDAD EDUCATIVA ESTADAL RURAL COGOLLAL	570	1	5	472	292	467	0	2	0	0	173	472
EDO. ARAGUA	MP. SAN CASIMIRO	CM. SAN CASIMIRO	ESCUELA BASICA ESTADAL AUGUSTA CARABALLO DE BLANCO	835	2	17	731	560	714	0	2	1	0	151	731
EDO. ARAGUA	MP. SAN CASIMIRO	CM. SAN CASIMIRO	UNIDAD ESTADAL GOLFO TRISTE	105	1	1	95	80	94	1	0	0	0	13	95
EDO. ARAGUA	MP. SAN CASIMIRO	CM. SAN CASIMIRO	ESCUELA EL LORO	1113	2	23	880	721	857	0	1	0	1	134	880
EDO. ARAGUA	MP. SAN CASIMIRO	CM. SAN CASIMIRO	ESCUELA ESTADAL UNITARIA Nº 572	300	1	5	238	220	233	0	0	0	0	13	238
EDO. ARAGUA	MP. SAN CASIMIRO	CM. SAN CASIMIRO	INSTITUTO DE EDUCACION ESPECIAL	465	1	2	414	316	412	0	0	0	0	96	414
EDO. ARAGUA	MP. SAN CASIMIRO	CM. SAN CASIMIRO	GRUPO ESCOLAR FRANCISCO ISNARDY	3388	6	73	2721	1603	2648	0	9	5	1	1030	2721
EDO. ARAGUA	MP. SAN CASIMIRO	CM. SAN CASIMIRO	ESCUELA BASICA ANDRES BELLO	982	2	25	811	520	786	0	4	0	0	262	811
EDO. ARAGUA	MP. SAN CASIMIRO	CM. SAN CASIMIRO	UNIDAD EDUCATIVA ESTADAL EL MAMON	669	2	10	594	467	584	0	3	0	0	114	594
EDO. ARAGUA	MP. SAN CASIMIRO	CM. SAN CASIMIRO	ESCUELA BOCA DE ZUATA 435 553	519	1	8	392	294	384	0	0	1	0	89	392
EDO. ARAGUA	MP. SAN CASIMIRO	CM. SAN CASIMIRO	UNIDAD EDUCATIVA ESTADAL SANTA ANA	1553	3	60	1273	713	1213	1	8	0	1	490	1273
EDO. ARAGUA	MP. SAN CASIMIRO	CM. SAN CASIMIRO	ESCUELA ESTADAL UNITARIA Nº 137 528	288	1	2	226	164	224	0	0	0	0	60	226
EDO. ARAGUA	MP. SAN CASIMIRO	CM. SAN CASIMIRO	UNIDAD EDUCATIVA LAS COCUIZAS	1293	3	21	1094	595	1073	1	2	0	0	475	1094
EDO. ARAGUA	MP. SAN CASIMIRO	CM. SAN CASIMIRO	CICLO BASICO SAN CASIMIRO	1636	3	52	1308	786	1256	1	8	1	1	459	1308
EDO. ARAGUA	MP. SAN CASIMIRO	PQ. VALLE MORIN	ESCUELA BASICA NACIONAL BELEN MARTINEZ	90	1	4	86	74	82	0	0	0	0	8	86
EDO. ARAGUA	MP. SAN CASIMIRO	PQ. VALLE MORIN	ESCUELA BASICA VALLE MORIN	1107	2	17	886	596	869	1	10	0	2	260	886
EDO. ARAGUA	MP. SAN CASIMIRO	PQ. OLLAS DE CARAMACATE	ESCUELA CONCENTRADA Nº 88 383 387 467 537	652	2	10	483	391	473	0	3	1	0	78	483
EDO. ARAGUA	MP. SAN CASIMIRO	PQ. OLLAS DE CARAMACATE	ESCUELA BASICA ESTADAL CONCENTRADA LOS MANIRE	82	1	2	69	52	67	0	2	0	0	13	69
EDO. ARAGUA	MP. SAN CASIMIRO	PQ. OLLAS DE CARAMACATE	ESCUELA UNITARIA Nº 109	209	1	2	157	108	155	0	1	0	0	46	157
EDO. ARAGUA	MP. SAN CASIMIRO	PQ. GUIRIPA	ESCUELA NACIONAL CONCENTRADA Nº 227 3020	1137	2	28	920	590	892	0	1	2	0	299	920
EDO. ARAGUA	MP. SAN CASIMIRO	PQ. GUIRIPA	UNIDAD EDUCATIVA RURAL CARUTICO	177	1	1	159	145	158	0	1	0	0	12	159
EDO. ARAGUA	MP. SAN CASIMIRO	PQ. GUIRIPA	ESCUELA BASICA ESTADAL GUAMBRA	165	1	3	156	134	153	0	0	0	0	19	156
EDO. ARAGUA	MP. SANTIAGO MARI#O	PQ. ALFREDO PACHECO M	UNIDAD EDUCATIVA DOCTORA PRISILA LOPEZ	2469	5	32	2026	1373	1994	0	10	1	2	608	2026
EDO. ARAGUA	MP. SANTIAGO MARI#O	PQ. ALFREDO PACHECO M	PREESCOLAR NACIONAL BOLIVARIANO EL TIERRAL.	661	2	18	572	442	554	0	1	0	0	111	572
EDO. ARAGUA	MP. SANTIAGO MARI#O	PQ. ALFREDO PACHECO M	PREESCOLAR BOLIVARIANO EL TIERRAL	502	1	2	331	243	329	0	2	0	0	84	331
EDO. ARAGUA	MP. SANTIAGO MARI#O	PQ. ALFREDO PACHECO M	UNIDAD EDUCATIVA ESTADAL LAURA PACHECO MONSERRAT	3136	6	40	2629	1785	2589	1	13	0	3	787	2629
EDO. ARAGUA	MP. SANTIAGO MARI#O	PQ. ALFREDO PACHECO M	ESCUELA BASICA FRANCISCO LINARES ALCANTARA	5035	9	88	4136	2638	4048	0	32	3	1	1374	4136
EDO. ARAGUA	MP. SANTIAGO MARI#O	PQ. ALFREDO PACHECO M	ESCUELA BASICA ROMULO BETANCOURT	2666	5	50	2273	1418	2223	2	11	1	5	786	2273
EDO. ARAGUA	MP. SANTIAGO MARI#O	PQ. CHUAO	UNIDAD EDUCATIVA ESTADAL JOSE CASANOVA GODOY	995	2	10	789	679	779	0	3	0	0	97	789
EDO. ARAGUA	MP. SANTIAGO MARI#O	PQ. CHUAO	ESCUELA BASICA CONCENTRADA CEPE	134	1	0	111	90	111	0	0	1	0	20	111
EDO. ARAGUA	MP. SANTIAGO MARI#O	PQ. AREVALO APONTE	UNIDAD EDUCATIVA ESTADAL BALBINO BLANCO SANCHEZ	2814	5	68	2203	1636	2135	0	6	1	0	492	2203
EDO. ARAGUA	MP. SANTIAGO MARI#O	PQ. AREVALO APONTE	ESCUELA GUARAUGUTA	2625	5	46	2046	1314	2000	2	8	1	2	673	2046
EDO. ARAGUA	MP. SANTIAGO MARI#O	PQ. AREVALO APONTE	ESCUELA BASICA NACIONAL PEDRO AREVALO APONTE	558	1	7	408	335	401	0	1	1	0	64	408
EDO. ARAGUA	MP. SANTIAGO MARI#O	PQ. AREVALO APONTE	ESCUELA BASICA ESTADAL CONCENTRADA ROSA BARRETO	245	1	2	130	95	128	0	0	0	1	32	130
EDO. ARAGUA	MP. SANTIAGO MARI#O	PQ. AREVALO APONTE	ESCUELA BASICA SANTIAGO MARI O	1785	4	26	1461	934	1435	0	9	0	3	489	1461
EDO. ARAGUA	MP. SANTIAGO MARI#O	PQ. AREVALO APONTE	UNIDAD EDUCATIVA ESTADAL CONCENTRADA EL PEDREGAL	494	1	15	411	241	396	0	2	0	0	153	411
EDO. ARAGUA	MP. SANTIAGO MARI#O	PQ. AREVALO APONTE	ESCUELA BASICA DOCTOR RAFAEL SEIJAS	4684	9	49	3559	2627	3510	1	20	4	0	858	3559
EDO. ARAGUA	MP. SANTIAGO MARI#O	PQ. AREVALO APONTE	UNIDAD EDUCATIVA ESTADAL ROSELIANO BLANCO SANCHEZ	1069	2	16	843	643	827	0	5	0	1	178	843
EDO. ARAGUA	MP. SANTIAGO MARI#O	PQ. AREVALO APONTE	UNIDAD EDUCATIVA ESTADAL RAFAEL TAYLHADAT	4663	9	97	3576	2721	3479	2	17	2	2	735	3576
EDO. ARAGUA	MP. SANTIAGO MARI#O	PQ. AREVALO APONTE	UNIDAD EDUCATIVA ESTADAL RURAL ALFONZO RIVAS	746	2	23	573	468	550	0	2	0	0	80	573
EDO. ARAGUA	MP. SANTIAGO MARI#O	PQ. AREVALO APONTE	INSTITUTO  ESCUELA ESPECIALROSARIO DE PAYA	875	2	17	663	488	646	0	1	0	0	157	663
EDO. ARAGUA	MP. SANTIAGO MARI#O	PQ. AREVALO APONTE	UNIDAD EDUCATIVA ESTADAL RURAL CONCENTRADA LAS MERCEDES DE PAYA	420	1	0	189	169	189	0	1	0	0	19	189
EDO. ARAGUA	MP. SANTIAGO MARI#O	PQ. AREVALO APONTE	LICEO BOLIVARIANO ROSARIO DE PAYA.	1472	3	23	1162	934	1139	0	8	0	0	197	1162
EDO. ARAGUA	MP. SANTIAGO MARI#O	PQ. AREVALO APONTE	UNIDAD EDUCATIVA RURAL FELIX MANUEL LUCES	1283	3	17	989	814	972	0	2	1	0	155	989
EDO. ARAGUA	MP. SANTIAGO MARI#O	PQ. AREVALO APONTE	ESCUELA ESTADAL UNITARIA Nº 184	225	1	1	135	129	134	0	0	0	0	5	135
EDO. ARAGUA	MP. SANTIAGO MARI#O	PQ. AREVALO APONTE	ESCUELA LA MARCELOTA	778	2	10	635	450	625	0	9	1	1	164	635
EDO. ARAGUA	MP. SANTIAGO MARI#O	PQ. SAMAN DE GUERE	ESCUELA BASICA ROSA AMELIA FLORES	5908	11	85	4874	2904	4789	0	28	1	4	1852	4874
EDO. ARAGUA	MP. SANTIAGO MARI#O	PQ. SAMAN DE GUERE	CICLO COMBINADO GONZALITO	2590	5	64	2128	1369	2064	0	9	6	1	679	2128
EDO. ARAGUA	MP. SANTIAGO MARI#O	PQ. SAMAN DE GUERE	ESCUELA PRACTICA DE AGRICULTURA LA PROVIDENCIA INCE	2737	5	42	2260	1385	2218	2	13	0	1	817	2260
EDO. ARAGUA	MP. SANTIAGO MARI#O	PQ. SAMAN DE GUERE	ESCUELA BASICA ESTADAL  ABIGAIL LOZANO	841	2	10	732	467	722	0	2	1	0	252	732
EDO. ARAGUA	MP. SANTIAGO MARI#O	PQ. SAMAN DE GUERE	ESCUELA BASICA IVON GONZALEZ MARCANO	3654	7	51	3265	1027	3214	0	11	2	1	2173	3265
EDO. ARAGUA	MP. SANTIAGO MARI#O	PQ. SAMAN DE GUERE	ESCUELA BASICA NACIONAL  CREACION SOROCAIMA	536	1	1	417	299	416	0	2	0	2	113	417
EDO. ARAGUA	MP. SANTIAGO MARI#O	PQ. SAMAN DE GUERE	CENTRO SOCIAL MARACAY SOS	1413	3	24	1041	763	1017	0	7	1	0	246	1041
EDO. ARAGUA	MP. SANTIAGO MARI#O	PQ. SAMAN DE GUERE	ESCUELA PEDRO VILLACASTIN	3165	6	81	2674	1760	2593	1	14	0	0	818	2674
EDO. ARAGUA	MP. SANTIAGO MARI#O	PQ. SAMAN DE GUERE	ESCUELA BASICA JOSEFINA BOLIVAR DE GONZALEZ	2914	5	59	2438	1459	2379	0	23	1	2	894	2438
EDO. ARAGUA	MP. SANTIAGO MARI#O	PQ. SAMAN DE GUERE	ATENCIÓN NO CONVENCIONAL NACIONAL SOROCAIMA I.	1113	2	15	910	667	895	0	4	0	0	224	910
EDO. ARAGUA	MP. SANTIAGO MARI#O	PQ. SAMAN DE GUERE	CICLO BASICO MARIÑO	5292	10	119	4411	2619	4292	0	23	2	2	1646	4411
EDO. ARAGUA	MP. SANTIAGO MARI#O	PQ. SAMAN DE GUERE	ESPACIO  ALTERNATIVO NO CONVENCIONALES LA CASONA II	1490	3	42	1308	949	1266	0	7	2	1	307	1308
EDO. ARAGUA	MP. SANTIAGO MARI#O	PQ. SAMAN DE GUERE	ESCUELA BASICA ESTADAL CRISTINA BATISTA	4679	8	69	3853	2671	3784	2	20	6	1	1084	3853
EDO. ARAGUA	MP. SANTIAGO MARI#O	PQ. SAMAN DE GUERE	ESCUELA BASICA PROFESORA ARGELIA LAYA	4686	9	154	3937	2637	3783	1	18	0	0	1127	3937
EDO. ARAGUA	MP. SANTIAGO MARI#O	PQ. SAMAN DE GUERE	UNIDAD EDUCATIVA ESTADAL  ANDRES PACHECO MIRANDA	645	2	11	540	439	529	0	3	0	0	87	540
EDO. ARAGUA	MP. SANTIAGO MARI#O	PQ. SAMAN DE GUERE	ESCUELA BASICA ESTADAL CESAR RODRIGUEZ PALENCIA	3781	7	45	3242	1675	3197	0	9	2	1	1510	3242
EDO. ARAGUA	MP. SANTIAGO MARI#O	PQ. SAMAN DE GUERE	UNIDAD EDUCATIVA NACIONAL  SAMAN DE GUERE.	4053	7	58	3218	2027	3160	2	10	1	0	1120	3218
EDO. ARAGUA	MP. SANTIAGO MARI#O	CM. TURMERO	UNIDAD EDUCATIVA NACIONAL  NUESTRA SEÑORA DE LA CARIDAD DEL COBRE	1349	3	28	1036	617	1008	0	2	0	1	388	1036
EDO. ARAGUA	MP. SANTIAGO MARI#O	CM. TURMERO	UNIDAD EDUCATIVA PRIVADA BICENTENARIO DE LA INDEPENDENCIA	5318	10	39	4710	1390	4671	1	16	3	3	3258	4710
EDO. ARAGUA	MP. SANTIAGO MARI#O	CM. TURMERO	CICLO COMBINADO RAMON BASTIDAS	2994	6	28	2388	939	2360	4	8	0	1	1408	2388
EDO. ARAGUA	MP. SANTIAGO MARI#O	CM. TURMERO	ESCUELA BASICA NACIONAL TURMERO	5878	11	88	4686	3088	4598	0	23	3	3	1481	4686
EDO. ARAGUA	MP. SANTIAGO MARI#O	CM. TURMERO	CENTRO SUPERIOR EDUCACION ESPECIAL ARTURO SARCO VILLENA	3382	6	27	2915	987	2888	0	13	2	5	1881	2915
EDO. ARAGUA	MP. SANTIAGO MARI#O	CM. TURMERO	ESCUELA BASICA LA CANDELARIA	3709	7	21	3032	1106	3011	0	10	4	0	1891	3032
EDO. ARAGUA	MP. SANTIAGO MARI#O	CM. TURMERO	ESCUELA GRADUADA MARIANO PICON SALAS	4373	8	46	3723	1911	3677	0	13	2	2	1749	3723
EDO. ARAGUA	MP. SANTIAGO MARI#O	CM. TURMERO	UNIDAD EDUCATIVA LIBERTADOR	3500	7	23	2911	1011	2888	0	2	3	4	1868	2911
EDO. ARAGUA	MP. SANTIAGO MARI#O	CM. TURMERO	ESCUELA BASICA JOSE RAFAEL REVENGA	5747	11	61	4806	1570	4745	3	19	5	4	3144	4806
EDO. ARAGUA	MP. SANTIAGO MARI#O	CM. TURMERO	ESCUELA BASICA ESTADO MIRANDA	4357	8	58	3599	1573	3541	2	20	0	3	1943	3599
EDO. ARAGUA	CE. GIRARDOT	PQ. LOS TACARIGUAS	BIBLIOTECA VIRTUAL SAN VICENTE	546	1	2	433	333	431	0	1	0	1	96	433
EDO. ARAGUA	CE. GIRARDOT	PQ. LOS TACARIGUAS	ESCUELA BASICA PRIVADA ESCUELA TALLER SAN MARCELINO CHAMPAGNAT	904	2	27	782	665	755	0	7	0	0	83	782
EDO. ARAGUA	CE. GIRARDOT	PQ. LOS TACARIGUAS	ESCUELA BASICA ANIBAL CASTILLO	3599	7	41	2938	1735	2897	2	13	3	2	1142	2938
EDO. ARAGUA	CE. GIRARDOT	PQ. LOS TACARIGUAS	FUNDACION ORQUESTA  JUVENIL E INFANTIL DE ARAGUA	325	1	6	270	213	264	0	1	0	0	50	270
EDO. ARAGUA	CE. GIRARDOT	PQ. LOS TACARIGUAS	UNIDAD EDUCATIVA GRAN MARISCAL DE AYACUCHO	3748	7	38	3257	2116	3219	0	14	1	6	1082	3257
EDO. ARAGUA	CE. GIRARDOT	PQ. LOS TACARIGUAS	TALLER DE EDUCACION LABORAL NACIONAL SAN VICENTE EDUCACION ESPECIAL	337	1	8	297	225	289	0	2	0	0	62	297
EDO. ARAGUA	CE. GIRARDOT	PQ. LOS TACARIGUAS	UNIDAD EDUCATIVA DE ADULTO ESCUELA TALLER MONSEÑOR ARIAS BLANCO	945	2	16	800	588	784	0	3	0	1	192	800
EDO. ARAGUA	CE. GIRARDOT	PQ. LOS TACARIGUAS	UNIDAD EDUCATIVA LUIS BELTRAN PRIETO FIGUEROA	991	2	16	846	526	830	0	4	0	3	297	846
EDO. ARAGUA	CE. GIRARDOT	PQ. LOS TACARIGUAS	ESCUELA BASICA ATANACIO GIRARDOT	3179	6	33	2594	1397	2561	1	12	3	0	1148	2594
EDO. ARAGUA	CE. GIRARDOT	PQ. LOS TACARIGUAS	ESCUELA BASICA CIRO MALDONADO ZERPA	1757	3	14	1480	499	1466	0	6	0	1	960	1480
EDO. ARAGUA	CE. GIRARDOT	PQ. LOS TACARIGUAS	UNIDAD EDUCATIVA NACIONAL ALFREDO EMILIO BERROTERAN	1717	3	18	1383	674	1365	2	6	0	0	683	1383
EDO. ARAGUA	CE. GIRARDOT	PQ. LOS TACARIGUAS	ESCUELA BASICA NACIONAL.BALBINA GALVIS  DE RODRIGUEZ	289	1	6	245	168	239	0	3	0	0	68	245
EDO. ARAGUA	CE. GIRARDOT	PQ. LOS TACARIGUAS	ESCUELA BASICA ESTADAL ARMANDO REVERON	3157	6	47	2474	1761	2427	1	12	3	1	649	2474
EDO. ARAGUA	CE. GIRARDOT	PQ. LOS TACARIGUAS	UNIDAD EDUCATIVA NACIONAL EL VIÑEDO	1146	2	18	927	813	909	0	2	1	2	91	927
EDO. ARAGUA	CE. GIRARDOT	PQ. LOS TACARIGUAS	ESCUELA ESTADAL 24 DE JULIO	474	1	4	342	284	338	0	0	1	0	53	342
EDO. ARAGUA	CE. GIRARDOT	PQ. LOS TACARIGUAS	CASA DE LOS NINOS MAESTRO JOSE VICENTE GONZALEZ	122	1	3	105	88	102	0	0	0	0	14	105
EDO. ARAGUA	CE. GIRARDOT	PQ. LOS TACARIGUAS	UNIDAD EDUCATIVA PRIVADA PEDRO EMILIO COLL	407	1	10	324	209	314	0	1	0	2	102	324
EDO. ARAGUA	CE. GIRARDOT	PQ. LOS TACARIGUAS	ESCUELA BASICA AGUSTIN AVELEDO	3469	6	48	2789	1674	2741	3	12	1	1	1050	2789
EDO. ARAGUA	CE. GIRARDOT	PQ. LOS TACARIGUAS	PREESCOLAR SIMON BOLIVAR	3229	6	79	2610	1916	2531	2	13	2	1	597	2610
EDO. ARAGUA	CE. GIRARDOT	PQ. LOS TACARIGUAS	CENTRO DE EDUCACIÓN INICIAL   JABILIO REYES OCHOA.	243	1	5	207	119	202	0	0	0	0	83	207
EDO. ARAGUA	CE. GIRARDOT	PQ. LOS TACARIGUAS	ESCUELA BASICA FEDERICO GARCIA ARIAS	1709	3	16	1300	962	1284	0	3	1	1	317	1300
EDO. ARAGUA	CE. GIRARDOT	PQ. LOS TACARIGUAS	ESCUELA BASICA JOSE MARIA BENITEZ	3922	7	83	3370	1650	3287	0	25	0	2	1610	3370
EDO. ARAGUA	CE. GIRARDOT	PQ. LOS TACARIGUAS	UNIDAD EDUCATIVA .ESTADAL GENERAL JOSE DE SAN MARTIN	728	2	5	644	439	639	0	0	0	0	200	644
EDO. ARAGUA	CE. GIRARDOT	PQ. LOS TACARIGUAS	UNIDAD EDUCATIVA NACIONAL  ANTONIO GARCIA ROJO	4982	9	56	4034	3222	3978	1	24	0	0	731	4034
EDO. ARAGUA	CE. GIRARDOT	PQ. LOS TACARIGUAS	ESCUELA BASICA ELIODORO BETANCOURT	4210	8	74	3455	1794	3381	1	18	0	1	1567	3455
EDO. ARAGUA	CE. GIRARDOT	PQ. LOS TACARIGUAS	ESCUELA BASICA CONCENTRADA SAN VICENTE	1881	4	27	1474	1091	1447	2	8	0	0	346	1474
EDO. ARAGUA	CE. GIRARDOT	PQ. LOS TACARIGUAS	UNIDAD EDUCATIVA PADRE JUAN JOSE ZUGARRAMUNDI (FE Y ALEGRIA)	983	2	26	791	637	765	0	5	1	0	122	791
EDO. ARAGUA	CE. GIRARDOT	PQ. LOS TACARIGUAS	ESCUELA TECNICA INDUSTRIAL JOAQUIN AVELLAN	2226	4	36	1799	747	1763	3	3	2	1	1007	1799
EDO. ARAGUA	CE. GIRARDOT	PQ. LOS TACARIGUAS	UNIDAD EDUCATIVA PRIVADA JESUS CAUTIVO.	410	1	4	381	205	377	0	3	0	1	168	381
EDO. ARAGUA	CE. GIRARDOT	PQ. LOS TACARIGUAS	UNIVERSIDAD POLITECNICA TERRITORIAL DE ARAGUA EXTENCION MARACAY	474	1	6	372	314	366	1	2	0	0	49	372
EDO. ARAGUA	CE. GIRARDOT	PQ. LOS TACARIGUAS	ESCUELA BASICA PADRE LOPEZ AVELEDO	4158	8	51	3371	2225	3320	2	15	1	0	1077	3371
EDO. ARAGUA	CE. GIRARDOT	PQ. LOS TACARIGUAS	UNIDAD EDUCATIVA PRIVADA. JUAN ANTONIO PEREZ BONALDE	301	1	4	271	186	267	0	1	0	0	80	271
EDO. ARAGUA	CE. GIRARDOT	PQ. MADRE MA DE SAN JOSE	ALDEA UNIVERSITARIA ANTONIO JOSE DE SUCRE	2267	4	30	1736	472	1706	0	6	1	1	1226	1736
EDO. ARAGUA	CE. GIRARDOT	PQ. MADRE MA DE SAN JOSE	CENTRO DE DESARROLLO INFANTIL ARAGUA	2118	4	11	1953	363	1942	2	7	1	0	1569	1953
EDO. ARAGUA	CE. GIRARDOT	PQ. MADRE MA DE SAN JOSE	CONSERVATORIO DE MUSICA	5247	10	30	4073	464	4043	0	6	0	2	3571	4073
EDO. ARAGUA	CE. GIRARDOT	PQ. MADRE MA DE SAN JOSE	CICLO BASICO  CARLOS ARRIETA	4925	9	34	4264	968	4230	3	10	2	3	3244	4264
EDO. ARAGUA	CE. GIRARDOT	PQ. MADRE MA DE SAN JOSE	ESCUELA BASICA ANTONIA ESTELLER	3585	7	51	2880	1451	2829	1	11	3	2	1361	2880
EDO. ARAGUA	CE. GIRARDOT	PQ. MADRE MA DE SAN JOSE	CICLO BASICO ARAGUA	1011	2	9	756	250	747	0	5	0	0	492	756
EDO. ARAGUA	CE. GIRARDOT	PQ. MADRE MA DE SAN JOSE	ESCUELA BASICA ESTADAL  JULIO MORALES LARA	2530	5	34	2110	940	2076	0	8	0	1	1127	2110
EDO. ARAGUA	CE. GIRARDOT	PQ. MADRE MA DE SAN JOSE	BIBLIOTECA VIRTUAL	2848	5	18	2363	388	2345	0	5	1	0	1951	2363
EDO. ARAGUA	CE. GIRARDOT	PQ. MADRE MA DE SAN JOSE	SAPANA	731	2	18	590	238	572	0	2	0	0	332	590
EDO. ARAGUA	CE. GIRARDOT	PQ. MADRE MA DE SAN JOSE	ESCUELA BASICA JUSTINA GUERRA	3417	6	51	2960	1617	2909	1	10	3	2	1276	2960
EDO. ARAGUA	CE. GIRARDOT	PQ. MADRE MA DE SAN JOSE	HOGAIN ATANACIO GIRARDOT (PARQUE DE EXPOSICION DE FERIAS)	2881	6	17	2382	501	2365	0	6	2	0	1856	2382
EDO. ARAGUA	CE. GIRARDOT	PQ. MADRE MA DE SAN JOSE	CASA DE LA CULTURA	1263	3	11	1102	327	1091	0	2	0	0	762	1102
EDO. ARAGUA	CE. GIRARDOT	PQ. MADRE MA DE SAN JOSE	SEDE DEL COLEGIO DE PROFESORES DEL ESTADO ARAGUA	677	2	3	621	81	618	0	0	1	0	536	621
EDO. ARAGUA	CE. GIRARDOT	PQ. MADRE MA DE SAN JOSE	UNIDAD EDUCATIVA NACIONAL  LUIS MARIANO RIVERA	3735	7	32	3306	1589	3274	0	13	0	1	1671	3306
EDO. ARAGUA	CE. GIRARDOT	PQ. MADRE MA DE SAN JOSE	ESCUELA DE ARTE DRAMATICO SEDE ARAGUA	835	2	9	732	310	723	0	2	1	2	408	732
EDO. ARAGUA	CE. GIRARDOT	PQ. MADRE MA DE SAN JOSE	ESCUELA BASICA GREGORIA DIAZ	2942	5	31	2401	1281	2370	0	10	1	1	1077	2401
EDO. ARAGUA	CE. GIRARDOT	PQ. MADRE MA DE SAN JOSE	COLEGIO HUMBOLT	1666	3	4	1314	215	1310	0	1	0	2	1092	1314
EDO. ARAGUA	CE. GIRARDOT	PQ. MADRE MA DE SAN JOSE	UNIDAD EDUCATIVA NACIONAL BOLIVARIANO FELIPE GUEVARA ROJAS	2086	4	32	1611	750	1579	0	4	1	2	822	1611
EDO. ARAGUA	CE. GIRARDOT	PQ. MADRE MA DE SAN JOSE	LICEO AGUSTIN CODAZZI	4703	9	39	3765	575	3726	1	11	0	4	3135	3765
EDO. ARAGUA	CE. GIRARDOT	PQ. MADRE MA DE SAN JOSE	COLEGIO PRIVADO NUESTRA SEÑORA DE LAS MERCEDES DE ARAGUA	581	1	21	510	280	489	0	1	0	0	208	510
EDO. ARAGUA	CE. GIRARDOT	PQ. MADRE MA DE SAN JOSE	PRESCOLAR NACIONAL BOLIVARIANO MARIA TERESA TORO	898	2	5	743	299	738	0	1	1	0	437	743
EDO. ARAGUA	CE. GIRARDOT	PQ. MADRE MA DE SAN JOSE	ESCUELA BASICA VICTOR MANUEL PATIO	3551	7	35	2962	1130	2927	1	13	0	2	1781	2962
EDO. ARAGUA	CE. GIRARDOT	PQ. PEDRO JOSE OVALLES	ESCUELA BASICA NACIONAL SAN PEDRO ALEJANDRINO	448	1	6	398	293	392	0	1	0	0	98	398
EDO. ARAGUA	CE. GIRARDOT	PQ. PEDRO JOSE OVALLES	CASA USOS MULTIPLES LOS SAMANES	1511	3	13	1270	466	1257	0	7	1	1	782	1270
EDO. ARAGUA	CE. GIRARDOT	PQ. PEDRO JOSE OVALLES	PRE ESCOLAR BOLIVARIANO NACIONAL EDMUNDO ARENCIBIA	522	1	8	456	333	448	0	1	1	0	113	456
EDO. ARAGUA	CE. GIRARDOT	PQ. PEDRO JOSE OVALLES	ESCUELA BASICA ESTADAL ANTONIO JOSE DE SUCRE	886	2	7	788	640	781	0	5	0	0	136	788
EDO. ARAGUA	CE. GIRARDOT	PQ. PEDRO JOSE OVALLES	ESCUELA BASICA EDMUNDO ARENCIBIA	3988	7	56	3291	2316	3235	1	6	1	2	909	3291
EDO. ARAGUA	CE. GIRARDOT	PQ. PEDRO JOSE OVALLES	CICLO BASICA ATANACIO GIRARDOT	1080	2	16	912	618	896	0	4	0	1	273	912
EDO. ARAGUA	CE. GIRARDOT	PQ. PEDRO JOSE OVALLES	UNIDAD EDUCATIVA NACIONAL  LOS SAMANES	3060	6	38	2605	985	2567	0	17	3	2	1560	2605
EDO. ARAGUA	CE. GIRARDOT	PQ. PEDRO JOSE OVALLES	ESCUELA BASICA JULIO PAEZ	3139	6	44	2581	1848	2537	1	11	4	0	673	2581
EDO. ARAGUA	CE. GIRARDOT	PQ. PEDRO JOSE OVALLES	ESCUELA BASICA LETICIA MUDARRA DE LOPEZ	3829	7	60	3101	2109	3041	2	21	2	2	905	3101
EDO. ARAGUA	CE. GIRARDOT	PQ. PEDRO JOSE OVALLES	UNIDAD EDUCATIVA NACIONAL JOSE MARTI	311	1	5	261	195	256	0	0	0	0	61	261
EDO. ARAGUA	CE. GIRARDOT	PQ. PEDRO JOSE OVALLES	ESCUELA BASICA JOSE ANTONIO PAEZ	3457	6	40	2815	1987	2775	1	22	2	2	761	2815
EDO. ARAGUA	CE. GIRARDOT	PQ. PEDRO JOSE OVALLES	ESCUELA BASICA ISABEL TERESA RANGEL	2448	5	29	1932	1426	1903	0	10	1	4	462	1932
EDO. ARAGUA	CE. GIRARDOT	PQ. PEDRO JOSE OVALLES	UNIDAD EDUCATIVA ESTADAL ENRIQUE VASQUEZ FERMIN	3785	7	45	3204	1279	3159	0	10	3	1	1866	3204
EDO. ARAGUA	CE. GIRARDOT	PQ. PEDRO JOSE OVALLES	UNIDAD EDUCATIVA PRIVADA SANTA MARTA.	830	2	14	756	229	742	0	1	1	0	511	756
EDO. ARAGUA	CE. GIRARDOT	PQ. PEDRO JOSE OVALLES	ESCUELA BASICA SAN RAFAEL	1503	3	28	1260	833	1232	0	4	1	1	393	1260
EDO. ARAGUA	CE. GIRARDOT	PQ. PEDRO JOSE OVALLES	ESCUELA BASICA NACIONAL ANA FERNANDEZ RAMIREZ	2489	5	44	1959	1381	1915	2	13	2	3	514	1959
EDO. ARAGUA	CE. GIRARDOT	PQ. PEDRO JOSE OVALLES	JARDIN DE INFANCIA RIO BLANCO I	3433	6	78	2739	1891	2661	0	13	2	2	753	2739
EDO. ARAGUA	CE. GIRARDOT	PQ. PEDRO JOSE OVALLES	ESCUELA BASICA ARNOLDO GABALDON	3321	6	49	2728	1882	2679	0	16	3	3	775	2728
EDO. ARAGUA	CE. GIRARDOT	PQ. PEDRO JOSE OVALLES	PREESCOLAR NACIONAL JOSE GREGORIO HERNANDEZ	371	1	5	316	225	311	0	1	1	0	84	316
EDO. ARAGUA	CE. GIRARDOT	PQ. PEDRO JOSE OVALLES	UNIDAD EDUCATIVA PRIVADA DOCTOR LUIS RAZETTI	670	2	17	577	374	560	0	3	0	0	183	577
EDO. ARAGUA	CE. GIRARDOT	PQ. PEDRO JOSE OVALLES	UNIDAD EDUCATIVA COOPERATIVA LAS NIEVES	2449	5	26	2131	752	2105	1	9	3	1	1339	2131
EDO. ARAGUA	CE. GIRARDOT	PQ. JOAQUIN CRESPO	GRUPO ESCOLAR JESUS PACHECO ROJAS	4667	9	61	3612	1644	3551	2	20	3	5	1877	3612
EDO. ARAGUA	CE. GIRARDOT	PQ. JOAQUIN CRESPO	CENTRO DE ATENCION INTEGRAL A NIÑOS Y NIÑAS DE LA SEGUNDA INFANCIA DE MARACAY	1524	3	14	1254	498	1240	2	5	0	2	733	1254
EDO. ARAGUA	CE. GIRARDOT	PQ. JOAQUIN CRESPO	CENTRO JUVENIL PIÑONAL	2373	5	53	1906	928	1853	0	11	1	2	911	1906
EDO. ARAGUA	CE. GIRARDOT	PQ. JOAQUIN CRESPO	CASA DE USOS MULTIPLES GUASIMAL	883	2	11	788	680	777	1	3	0	0	93	788
EDO. ARAGUA	CE. GIRARDOT	PQ. JOAQUIN CRESPO	ESCUELA BASICA VENEZUELA	963	2	19	850	280	831	1	4	0	1	545	850
EDO. ARAGUA	CE. GIRARDOT	PQ. JOAQUIN CRESPO	CENTRO DE EDUCACION DE ADULTOS CACIQUE CHARAIMA	852	2	4	783	347	779	0	2	1	2	427	783
EDO. ARAGUA	CE. GIRARDOT	PQ. JOAQUIN CRESPO	PREESCOLAR PIOÑAL	2086	4	25	1688	809	1663	0	10	0	0	844	1688
EDO. ARAGUA	CE. GIRARDOT	PQ. JOAQUIN CRESPO	GRUPO ESCOLAR JESUS HERNANDEZ PRADO	6473	12	84	5415	2775	5331	0	27	4	3	2522	5415
EDO. ARAGUA	CE. GIRARDOT	PQ. JOAQUIN CRESPO	ESCUELA GRADUADA SANTOS MICHELENA	4015	7	41	3291	1468	3250	2	11	0	1	1768	3291
EDO. ARAGUA	CE. GIRARDOT	PQ. JOAQUIN CRESPO	ESCUELA BASICA JOSEFINA BRITO	1871	4	34	1606	911	1572	0	10	0	1	650	1606
EDO. ARAGUA	CE. GIRARDOT	PQ. JOAQUIN CRESPO	ESCUELA BASICA LAS ACACIAS	753	2	6	678	263	672	0	2	1	3	403	678
EDO. ARAGUA	CE. GIRARDOT	PQ. JOAQUIN CRESPO	LICEO JOSE LUIS RAMOS	5285	10	56	4393	1387	4337	1	17	2	3	2927	4393
EDO. ARAGUA	CE. GIRARDOT	PQ. JOAQUIN CRESPO	ESCUELA BASICA NACIONAL BOLIVARIANA MARACAY	3101	6	42	2618	1264	2576	0	15	0	0	1297	2618
EDO. ARAGUA	CE. GIRARDOT	PQ. JOAQUIN CRESPO	ESCUELA BASICA ARAGUA	3544	7	48	2936	1037	2888	1	10	1	2	1837	2936
EDO. ARAGUA	CE. GIRARDOT	PQ. JOAQUIN CRESPO	GRUPO ESCOLAR MIGUEL JOSE SANZ	2887	5	35	2413	926	2378	0	10	1	1	1440	2413
EDO. ARAGUA	CE. GIRARDOT	PQ. JOAQUIN CRESPO	ESCUELA GRADUADA JACOB PEREZ CARBALLO	2996	6	26	2552	934	2526	0	9	1	2	1580	2552
EDO. ARAGUA	CE. GIRARDOT	PQ. LAS DELICIAS	UNIVERSIDAD PEDAGOGICA MARACAY	2668	5	34	2010	636	1976	0	6	2	2	1330	2010
EDO. ARAGUA	CE. GIRARDOT	PQ. LAS DELICIAS	CICLO BASICO ANDRES BELLO	4919	9	46	3818	1514	3772	1	21	3	0	2233	3818
EDO. ARAGUA	CE. GIRARDOT	PQ. LAS DELICIAS	UNIDAD EDUCATIVA PRIVADA COLEGIO DOCTOR GUSTAVO H MACHADO	1708	3	17	1310	554	1293	2	7	0	2	728	1310
EDO. ARAGUA	CE. GIRARDOT	PQ. LAS DELICIAS	ESCUELA BASICA NACIONAL BOLIVARIANA SILANIA PERAZA UDDIS	1133	2	15	1003	663	988	0	3	1	3	318	1003
EDO. ARAGUA	CE. GIRARDOT	PQ. LAS DELICIAS	COLEGIO BELLA VISTA	2520	5	31	2137	1075	2106	1	4	4	1	1021	2137
EDO. ARAGUA	CE. GIRARDOT	PQ. LAS DELICIAS	FUNDACOMUN	1459	3	26	1159	606	1133	0	5	0	0	522	1159
EDO. ARAGUA	CE. GIRARDOT	PQ. LAS DELICIAS	UNIDAD EDUCATIVA ESTADAL DOLORES MENDOZA DE OSORIO	5348	10	102	4360	1826	4258	0	17	3	4	2408	4360
EDO. ARAGUA	CE. GIRARDOT	PQ. LAS DELICIAS	ESCUELA BASICA CRISTOBAL MENDOZA	3996	8	51	3272	1666	3221	1	22	1	1	1530	3272
EDO. ARAGUA	CE. GIRARDOT	PQ. LAS DELICIAS	UNIDAD EDUCATIVA PRIVADA INTERNACIONAL	3202	6	26	2696	710	2670	0	7	1	3	1949	2696
EDO. ARAGUA	CE. GIRARDOT	PQ. LAS DELICIAS	UNIDAD EDUCATIVA NACIONAL  FRANCISCO GUEDEZ COLMENARES	2974	6	40	2400	1066	2360	1	16	2	4	1271	2400
EDO. ARAGUA	CE. GIRARDOT	PQ. LAS DELICIAS	UNIDAD EDUCATIVA ESTADAL DOCTOR EMILIO MEDINA	1234	3	23	1076	650	1053	0	7	1	1	394	1076
EDO. ARAGUA	CE. GIRARDOT	PQ. LAS DELICIAS	ESCUELA BASICA NACIONAL LAS DELICIAS	3941	7	51	3150	1505	3099	0	7	0	1	1586	3150
EDO. ARAGUA	CE. GIRARDOT	PQ. LAS DELICIAS	CORPOSALUD	1915	4	23	1505	447	1482	1	5	0	0	1029	1505
EDO. ARAGUA	CE. GIRARDOT	PQ. LAS DELICIAS	UNIDAD EDUCATIVA NACIONAL BOLIVARIANA LOS NARAJOS I.	479	1	10	425	269	415	0	0	1	0	145	425
EDO. ARAGUA	CE. GIRARDOT	PQ. LAS DELICIAS	ESCUELA BASICA ANTONIO ARRAIZ	5467	10	69	4544	1863	4475	1	19	6	4	2582	4544
EDO. ARAGUA	CE. GIRARDOT	PQ. ANDRES ELOY BLANCO	ESCUELA BASICA EUTIMIO RIVAS	4412	8	60	3600	1720	3540	0	15	0	4	1801	3600
EDO. ARAGUA	CE. GIRARDOT	PQ. ANDRES ELOY BLANCO	ESCUELA BASICA ESTADAL TRINO CELIS RIOS	2737	5	25	2270	858	2245	0	9	1	0	1377	2270
EDO. ARAGUA	CE. GIRARDOT	PQ. ANDRES ELOY BLANCO	INSTITUTO TECNOLOGICO CARLOS SOUBLETTE	1820	4	13	1465	560	1452	2	8	1	1	880	1465
EDO. ARAGUA	CE. GIRARDOT	PQ. ANDRES ELOY BLANCO	ESCUELA BASICA PILAR PELGRON	1770	3	9	1517	389	1508	0	4	0	2	1113	1517
EDO. ARAGUA	CE. GIRARDOT	PQ. ANDRES ELOY BLANCO	ESCUELA BASICA ESTADAL  JOSE RAMON GONZALEZ BAQUERO	3182	6	47	2606	1679	2559	1	11	3	0	865	2606
EDO. ARAGUA	CE. GIRARDOT	PQ. ANDRES ELOY BLANCO	UNIDAD EDUCATIVA NACIONAL BASICA VALENTIN ESPINAL	2316	4	23	1880	728	1857	0	5	1	1	1122	1880
EDO. ARAGUA	CE. GIRARDOT	PQ. ANDRES ELOY BLANCO	COLEGIO LOPE DE VEGAS	1936	4	11	1526	449	1515	0	5	0	1	1060	1526
EDO. ARAGUA	CE. GIRARDOT	PQ. ANDRES ELOY BLANCO	ESCUELA BASICA NACIONAL BOLIVARIANA JACINTO FOMBONA PACHANO	1003	2	17	869	616	852	0	3	0	1	232	869
EDO. ARAGUA	CE. GIRARDOT	PQ. ANDRES ELOY BLANCO	ESCUELA BASICA INES ALFONSO DE PEREZ	1787	4	20	1451	967	1431	1	7	3	1	452	1451
EDO. ARAGUA	CE. GIRARDOT	PQ. ANDRES ELOY BLANCO	LICEO DON ROMULO GALLEGOS	2227	4	27	1816	810	1789	0	7	1	3	968	1816
EDO. ARAGUA	CE. GIRARDOT	PQ. ANDRES ELOY BLANCO	ESCUELA BASICA ARMANDO ZULUAGA BLANCO	1187	2	12	967	275	955	0	6	0	0	674	967
EDO. ARAGUA	CE. GIRARDOT	PQ. ANDRES ELOY BLANCO	INSTITUTO UNIVERSITARIO DE TECNOLOGIA ANTONIO RICAURTE	1221	3	12	1117	287	1105	0	1	2	1	814	1117
EDO. ARAGUA	CE. GIRARDOT	PQ. ANDRES ELOY BLANCO	ESCUELA BASICA REPUBLICA DE MEJICO	3197	6	22	2478	686	2456	0	9	2	1	1758	2478
EDO. ARAGUA	CE. GIRARDOT	PQ. ANDRES ELOY BLANCO	UNIDAD EDUCATIVA NACIONAL JOSE RIBAS BALBOA	937	2	7	751	581	744	0	1	0	0	162	751
EDO. ARAGUA	CE. GIRARDOT	PQ. ANDRES ELOY BLANCO	CICLO BASICO JUAN VICENTE BOLIVAR	3108	6	19	2486	664	2467	0	12	0	1	1790	2486
EDO. ARAGUA	CE. GIRARDOT	PQ. ANDRES ELOY BLANCO	UNIDAD EDUCATIVA ESPECIAL MARACAY	406	1	1	365	145	364	0	1	0	0	218	365
EDO. ARAGUA	CE. GIRARDOT	PQ. ANDRES ELOY BLANCO	MODULO DE SERVICIO BRISAS DEL LAGO	1148	2	11	925	624	914	2	7	1	0	280	925
EDO. ARAGUA	CE. GIRARDOT	PQ. ANDRES ELOY BLANCO	ESCUELA BASICA JOSE ANTONIO MAITIN	2238	4	16	1763	904	1747	0	7	4	1	831	1763
EDO. ARAGUA	CE. GIRARDOT	PQ. ANDRES ELOY BLANCO	ESCUELA BASICA ESTADAL LA DEMOCRACIA	3204	6	33	2525	918	2492	1	7	0	1	1565	2525
EDO. ARAGUA	CE. GIRARDOT	PQ. ANDRES ELOY BLANCO	ESCUELA BASICA VIRGINIA PEREZ DE ORAMAS	4784	9	92	3945	2679	3853	4	27	0	2	1141	3945
EDO. ARAGUA	CE. GIRARDOT	PQ. ANDRES ELOY BLANCO	ESCUELA BASICA NACIONAL BRISAS DEL LAGO	1097	2	15	888	616	873	0	1	1	1	254	888
EDO. ARAGUA	CE. GIRARDOT	PQ. JOSE CASANOVA GODOY	ESCUELA BASICA RAFAEL URDANETA	3434	6	73	2778	1436	2705	0	17	0	0	1252	2778
EDO. ARAGUA	CE. GIRARDOT	PQ. JOSE CASANOVA GODOY	ESCUELA BASICA VICTOR LINO GOMEZ	4654	8	68	3776	2585	3708	0	21	2	1	1099	3776
EDO. ARAGUA	CE. GIRARDOT	PQ. JOSE CASANOVA GODOY	INSTITUTO MARISCAL DE AYACUCHO	1442	3	26	1118	501	1092	0	9	0	0	582	1118
EDO. ARAGUA	CE. GIRARDOT	PQ. JOSE CASANOVA GODOY	ESCUELA BASICA MORAL Y LUCES	2927	5	33	2342	775	2309	0	9	0	0	1525	2342
EDO. ARAGUA	CE. GIRARDOT	PQ. JOSE CASANOVA GODOY	CENTRO DE EDUCACION INICIAL AQUILES NAZOA	470	1	7	418	309	411	0	2	0	0	100	418
EDO. ARAGUA	CE. GIRARDOT	PQ. JOSE CASANOVA GODOY	ESCUELA BASICA  PRIVADA VICENTE LECUNA	1113	2	4	927	233	923	0	3	0	1	686	927
EDO. ARAGUA	CE. GIRARDOT	PQ. JOSE CASANOVA GODOY	PREESCOLAR NACIONAL CAMPO ALEGRE	1359	3	26	1133	748	1107	0	6	2	2	349	1133
EDO. ARAGUA	CE. GIRARDOT	PQ. JOSE CASANOVA GODOY	ESCUELA BASICA NACIONAL ANDRES ELOY BLANCO	744	2	22	670	434	648	0	4	0	0	210	670
EDO. ARAGUA	CE. GIRARDOT	PQ. JOSE CASANOVA GODOY	UNIDAD EDUCATIVA PRIVADA INSTITUTO EDUCATIVO EL PRECURSOR	713	2	4	644	272	640	0	0	1	0	367	644
EDO. ARAGUA	CE. GIRARDOT	PQ. JOSE CASANOVA GODOY	ESCUELA BASICA MARY DIAZ DE ESPAA	3533	7	111	2853	1796	2742	0	15	5	2	924	2853
EDO. ARAGUA	CE. GIRARDOT	PQ. JOSE CASANOVA GODOY	CICLO BASICO MANUEL ANTONIO CARREÑO	3128	6	19	2637	523	2618	0	7	1	2	2085	2637
EDO. ARAGUA	CE. GIRARDOT	PQ. JOSE CASANOVA GODOY	CASA DE LOS NIÑOS SIMON CARREÑO RODRIGUEZ	760	2	14	657	397	643	0	3	2	0	241	657
EDO. ARAGUA	CE. GIRARDOT	PQ. JOSE CASANOVA GODOY	UNIDAD EDUCATIVA ESTADAL OLINTO MORA VASQUEZ	319	1	5	274	186	269	0	2	0	0	81	274
EDO. ARAGUA	CE. GIRARDOT	PQ. JOSE CASANOVA GODOY	ESCUELA PRIVADA ACADEMUS	3827	7	20	3312	553	3292	0	7	2	0	2730	3312
EDO. ARAGUA	CE. GIRARDOT	PQ. JOSE CASANOVA GODOY	ESCUELA BASICA LUCAS GUILLERMO CASTILLO	3856	7	28	3233	1041	3205	0	8	2	1	2153	3233
EDO. ARAGUA	CE. GIRARDOT	PQ. JOSE CASANOVA GODOY	CENTRO TALLER ASOCIACION PROMOCIÓN DE LA EDUCACIÓN POPULAR NUESTRA SEÑORA DE LOURDES	1709	3	31	1465	995	1434	1	7	1	2	428	1465
EDO. ARAGUA	CE. GIRARDOT	PQ. JOSE CASANOVA GODOY	UNIDAD EDUCATIVA NACIONAL AC CREACION CAMPO ALEGRE	3862	7	65	3145	2160	3080	0	12	2	1	905	3145
EDO. ARAGUA	CE. GIRARDOT	PQ. JOSE CASANOVA GODOY	CENTRO DE FORMACION INDUSTRIAL MARACAY INCE	3571	7	64	2850	1566	2786	1	11	1	2	1205	2850
EDO. ARAGUA	CE. GIRARDOT	PQ. JOSE CASANOVA GODOY	INCE INDUSTRIAL POLIVALENTE	1872	4	43	1539	682	1496	0	12	0	0	802	1539
EDO. ARAGUA	CE. GIRARDOT	PQ. JOSE CASANOVA GODOY	UNIDAD EDUCATIVA SIMON BOLIVAR	2752	5	28	2240	1247	2212	0	7	1	3	954	2240
EDO. ARAGUA	CE. GIRARDOT	PQ. JOSE CASANOVA GODOY	ESCUELA BASICA JUAN LOVERA	3515	7	60	2950	1358	2890	1	7	2	1	1521	2950
EDO. ARAGUA	CE. GIRARDOT	PQ. CHORONI	UNIDAD EDUCATIVA CHORONI	1061	2	11	825	486	814	0	6	0	0	322	825
EDO. ARAGUA	CE. GIRARDOT	PQ. CHORONI	UNIDAD EDUCATIVA NACIONAL BOLIVARIANA CHORONI	1621	3	25	1237	821	1212	0	2	1	0	388	1237
EDO. ARAGUA	CE. GIRARDOT	PQ. CHORONI	ESCUELA BASICA OSCAR ENRIQUE ORTEGA PALMA	1052	2	15	848	673	833	1	8	0	0	151	848
EDO. MONAGAS	MP. SOTILLO	LOS BARRANCOS DE FAJARDO	ESCUELA UNITARIA 302 CAFETERA	117	1	2	104	76	102	0	0	0	0	26	104
EDO. MONAGAS	MP. SOTILLO	LOS BARRANCOS DE FAJARDO	ESCUELA UNITARIA NUMERO 301 LOS BARRANCOS DE FAJARDOS	600	1	8	459	335	451	0	2	1	0	113	459
EDO. MONAGAS	MP. SOTILLO	LOS BARRANCOS DE FAJARDO	ESCUELA UNITARIA 421 CHIGUICHIGUAL	97	1	5	89	66	84	0	2	1	0	15	89
EDO. MONAGAS	MP. SOTILLO	LOS BARRANCOS DE FAJARDO	ESCUELA 415 UVERITO	296	1	2	269	208	267	0	2	0	0	57	269
EDO. MONAGAS	MP. SOTILLO	LOS BARRANCOS DE FAJARDO	ESCUELA 417 SAN ROQUE	133	1	1	117	102	116	0	0	0	0	14	117
EDO. MONAGAS	MP. SOTILLO	LOS BARRANCOS DE FAJARDO	ESCUELA UNITARIA NUMERO 320 419 VARADERO DE LIMONES	399	1	6	284	215	278	0	5	0	0	58	284
EDO. MONAGAS	MP. SOTILLO	LOS BARRANCOS DE FAJARDO	ESCUELA BÁSICA ALARICO GÓMEZ	3118	6	48	2382	1989	2334	1	19	3	0	322	2382
EDO. MONAGAS	MP. SOTILLO	CM. BARRANCAS	JARDIN DE INFANCIA BOLIVARIANO URIAPARA	1386	3	25	995	585	970	0	7	1	0	377	995
EDO. MONAGAS	MP. SOTILLO	CM. BARRANCAS	ESCUELA BASICA CONCENTRADA NUMERO 7	149	1	0	107	55	107	0	0	0	0	52	107
EDO. MONAGAS	MP. SOTILLO	CM. BARRANCAS	ESCUELA UNITARIA NUEMRO 307 332
EDO. MONAGAS	MP. SOTILLO	CM. BARRANCAS	ESCUELA BASICA BLANCA GUEVARA DE BALAN	2509	5	37	1936	1253	1899	0	14	1	1	630	1936
EDO. MONAGAS	MP. SOTILLO	CM. BARRANCAS	ESCUELA UNITARIA 93 PUNTA DE PIEDRA	131	1	0	79	68	79	0	1	0	0	10	79
EDO. MONAGAS	MP. SOTILLO	CM. BARRANCAS	ESCUELA ESTADAL 416 BAJO HONDO	232	1	3	179	140	176	0	1	0	0	35	179
EDO. MONAGAS	MP. SOTILLO	CM. BARRANCAS	ESCUELA BASICA FLORENTINO MONTERO ARIAS	2724	5	40	1946	1222	1906	0	18	2	1	663	1946
EDO. MONAGAS	MP. SOTILLO	CM. BARRANCAS	ESCUELA BÁSICA URIAPARA	3128	6	57	2274	1340	2217	0	14	1	0	862	2274
EDO. MONAGAS	MP. PUNCERES	CM. QUIRIQUIRE	CASA DE LA CULTURA	1091	2	24	909	466	885	1	5	0	1	412	909
EDO. MONAGAS	MP. PUNCERES	CM. QUIRIQUIRE	ESCUELA BASICA EL LIMON	517	1	12	350	254	338	0	1	0	0	83	350
EDO. MONAGAS	MP. PUNCERES	CM. QUIRIQUIRE	ESCUELA BASICA 23 DE ENERO	564	1	5	444	358	439	2	6	1	0	72	444
EDO. MONAGAS	MP. PUNCERES	CM. QUIRIQUIRE	ESCUELA BASICA BOLIVARIANA EL DANTO	709	2	11	518	347	507	0	6	1	0	153	518
EDO. MONAGAS	MP. PUNCERES	CM. QUIRIQUIRE	ESCUELA BOLIVARIANA AIDA DE LEONETT	1182	2	26	900	590	874	0	4	0	0	280	900
EDO. MONAGAS	MP. PUNCERES	CM. QUIRIQUIRE	GRUPO ESCOLAR MATURIN	1581	3	20	1179	827	1159	1	11	0	0	320	1179
EDO. MONAGAS	MP. PUNCERES	CM. QUIRIQUIRE	ESCUELA BASICA NUMERO 156 LOS BAÑOS	193	1	2	171	133	169	0	1	0	0	35	171
EDO. MONAGAS	MP. PUNCERES	CM. QUIRIQUIRE	UNIDAD EDUCATIVA JUANA RAMIREZ	1362	3	28	1031	624	1003	0	9	0	1	369	1031
EDO. MONAGAS	MP. PUNCERES	CM. QUIRIQUIRE	ESCUELA BASICA ESTADAL LA CRUZ BLANCA	285	1	5	208	122	203	0	1	0	0	80	208
EDO. MONAGAS	MP. PUNCERES	CM. QUIRIQUIRE	CENTRO DE EDUCACION INICIAL QUIRIQUIRE NEGRO	167	1	7	155	115	148	0	1	0	0	32	155
EDO. MONAGAS	MP. PUNCERES	CM. QUIRIQUIRE	ESCUELA BÁSICA BOLIVARIANA  BARQUISIMETO	1572	3	22	1224	676	1202	0	13	0	1	512	1224
EDO. MONAGAS	MP. PUNCERES	CM. QUIRIQUIRE	ESCUELA PRIMARIA BOLIVARIANA NUMERO 62 LA PLACA	187	1	4	164	121	160	0	5	1	0	33	164
EDO. MONAGAS	MP. PUNCERES	CM. QUIRIQUIRE	ESCUELA 15 DE ENERO PUEBLO LIBRE	983	2	22	801	576	779	0	5	0	0	198	801
EDO. MONAGAS	MP. PUNCERES	CM. QUIRIQUIRE	JARDIN DE INFANCIA NACIONAL DOMINGO HERNANDEZ	185	1	3	175	111	172	0	2	0	0	59	175
EDO. MONAGAS	MP. PUNCERES	CM. QUIRIQUIRE	ESCUELA SABANA LARGA	740	2	14	607	383	593	0	4	0	0	206	607
EDO. MONAGAS	MP. PUNCERES	PQ. CACHIPO	ESCUELA BASICA RAFAEL URDANETA	513	1	11	373	280	362	0	1	0	0	81	373
EDO. MONAGAS	MP. PUNCERES	PQ. CACHIPO	ESCUELA BASICA BOLIVARIANA PUENTE PUNCERES	797	2	9	660	422	651	0	3	0	1	225	660
EDO. MONAGAS	MP. PUNCERES	PQ. CACHIPO	COLEGIO PRIVADO SAN MARTIN	357	1	6	293	206	287	0	3	0	1	77	293
EDO. MONAGAS	MP. PUNCERES	PQ. CACHIPO	ESCUELA BÁSICA ANDRES ELOY BLANCO	2566	5	39	1940	1320	1901	0	6	0	0	575	1940
EDO. MONAGAS	MP. PUNCERES	PQ. CACHIPO	GRUPO ESCOLAR LIBERTADOR	1386	3	13	1110	458	1097	1	7	0	2	629	1110
EDO. MONAGAS	MP. PUNCERES	PQ. CACHIPO	ESCUELA PUENTE PUNCERES NUMERO 101	411	1	3	295	201	292	0	1	0	0	90	295
EDO. MONAGAS	MP. PUNCERES	PQ. CACHIPO	LICEO NACIONAL ANTONIO JOSÉ DE SUCRE	532	1	11	433	325	422	0	2	0	0	95	433
EDO. MONAGAS	MP. PUNCERES	PQ. CACHIPO	CLUB JUAN VICENTE GONZALEZ	1193	2	20	1029	513	1009	0	6	0	0	490	1029
EDO. MONAGAS	MP. PUNCERES	PQ. CACHIPO	ESCUELA BASICA LEONARDO RUIZ PINEDA	2164	4	42	1732	1026	1690	1	13	0	0	650	1732
EDO. MONAGAS	MP. CEDE#O	PQ. SAN FELIX	ESCUELA BASICA GUARAPICHE	205	1	1	194	134	193	0	0	0	0	59	194
EDO. MONAGAS	MP. CEDE#O	PQ. SAN FELIX	ESCUELA ESTADAL QUEBRADA SECA	557	1	4	423	212	419	0	0	0	0	207	423
EDO. MONAGAS	MP. CEDE#O	PQ. SAN FELIX	ESCUELA BASICA CONSUELO NAVAS TOVAR	2219	4	13	1681	657	1668	0	7	0	0	1004	1681
EDO. MONAGAS	MP. CEDE#O	PQ. SAN FELIX	ESCUELA BASICA BOLIVARIANA GUATATA	127	1	3	120	59	117	0	0	0	0	58	120
EDO. MONAGAS	MP. CEDE#O	PQ. SAN FELIX	ESCUELA BÁSICA CONCENTRADA LOS CARDONES	340	1	9	313	200	304	0	1	0	0	103	313
EDO. MONAGAS	MP. CEDE#O	PQ. SAN FELIX	ESCUELA BASICA BOLIVARIANA LA LLANERA	102	1	3	93	38	90	0	1	0	0	51	93
EDO. MONAGAS	MP. CEDE#O	PQ. AREO	ESCUELA BASICA LOS POZOS DE AREO	387	1	11	279	200	268	0	1	1	0	66	279
EDO. MONAGAS	MP. CEDE#O	PQ. AREO	ESCUELA BASICA LOS DOS CAMINOS
EDO. MONAGAS	MP. CEDE#O	PQ. AREO	ESCUELA BASICA CONCENTRADA SAN RAMON	604	2	7	528	460	521	0	2	0	0	59	528
EDO. MONAGAS	MP. CEDE#O	PQ. AREO	ESCUELA BASICA BOLIVARIANA LA TARRAGONA	317	1	9	295	248	286	0	1	0	0	37	295
EDO. MONAGAS	MP. CEDE#O	PQ. AREO	ESCUELA BASICA LA MORITA	604	2	0	396	281	396	0	2	0	0	113	396
EDO. MONAGAS	MP. CEDE#O	PQ. AREO	ESCUELA BASICA SAN JUAN DE AREO	529	1	5	396	283	391	0	4	0	0	104	396
EDO. MONAGAS	MP. CEDE#O	PQ. AREO	ESCUELA BASICA VOLADERO	217	1	3	170	111	167	0	2	0	0	54	170
EDO. MONAGAS	MP. CEDE#O	PQ. AREO	ESCUELA BASICA EL RANGELEÑO	172	1	0	106	72	106	0	1	0	0	33	106
EDO. MONAGAS	MP. CEDE#O	PQ. AREO	ESCUELA BÁSICA LUIS FELIPE TURMERO CORVO	1134	2	22	893	573	871	0	7	0	0	291	893
EDO. MONAGAS	MP. CEDE#O	PQ. AREO	ESCUELA BASICA MANACAL	179	1	3	130	102	127	0	3	0	0	22	130
EDO. MONAGAS	MP. CEDE#O	CM. CAICARA	UNIDAD EDUCATIVA DROZ BLANCO	1391	3	24	1161	472	1137	0	3	4	0	658	1161
EDO. MONAGAS	MP. CEDE#O	CM. CAICARA	ESCUELA BASICA LUIS FELIPE TURMERO CORVO	2953	6	45	2312	709	2267	1	17	3	1	1536	2312
EDO. MONAGAS	MP. CEDE#O	CM. CAICARA	ESCUELA BASICA LAGUNA DE JUSEPIN	435	1	1	307	149	306	0	1	0	0	156	307
EDO. MONAGAS	MP. CEDE#O	CM. CAICARA	ESCUELA BASICA BEJUCALES	567	1	7	455	325	448	0	3	0	0	120	455
EDO. MONAGAS	MP. CEDE#O	CM. CAICARA	ESCUELA BASICA BAJO GRANDE	322	1	5	256	98	251	0	2	1	0	150	256
EDO. MONAGAS	MP. CEDE#O	CM. CAICARA	ESCUELA BASICA CAICARITA	507	1	4	410	264	406	0	3	0	1	138	410
EDO. MONAGAS	MP. CEDE#O	CM. CAICARA	UNIDAD EDUCATIVA JUAN FRANCISCO MILA DE LA ROCA	2419	5	25	2064	768	2039	0	11	1	0	1259	2064
EDO. MONAGAS	MP. CEDE#O	CM. CAICARA	ESCUELA BASICA POTRERITO	1124	2	12	901	603	889	0	4	3	1	278	901
EDO. MONAGAS	MP. CEDE#O	CM. CAICARA	ESCUELA BÁSICA BOLIVARIANA JOSÉ FRANCISCO BERMÚDEZ	3681	7	46	3000	970	2954	0	14	2	1	1967	3000
EDO. MONAGAS	MP. CEDE#O	PQ. VIENTO FRESCO	UNIDAD EDUCATIVA IDELFONSO NUÑEZ MARES	2622	5	50	2065	1129	2015	0	14	1	1	870	2065
EDO. MONAGAS	MP. PIAR	PQ. GUANAGUANA	ESCUELA UNITARIA NUMERO 98	202	1	2	155	108	153	0	0	1	0	44	155
EDO. MONAGAS	MP. PIAR	PQ. GUANAGUANA	UNIDAD EDUCATIVA CIRILO MARQUEZ BLANCO	944	2	24	686	492	662	0	2	0	0	168	686
EDO. MONAGAS	MP. PIAR	PQ. GUANAGUANA	ESCUELA BÁSICA BARRANCAS	1408	3	23	1089	605	1066	0	3	2	1	455	1089
EDO. MONAGAS	MP. PIAR	PQ. GUANAGUANA	ESCUELA BASICA BOLIVARIANA BOCA DE RIO CHIQUITO	760	2	20	606	316	586	0	2	1	0	267	606
EDO. MONAGAS	MP. PIAR	PQ. GUANAGUANA	ESCUELA BASICA BOLIVARIANA LA CUCHILLA NUMERO 31   181	242	1	2	191	98	189	0	0	0	0	91	191
EDO. MONAGAS	MP. PIAR	PQ. GUANAGUANA	UNIDAD EDUCATIVA BARRANCAS	314	1	8	280	197	272	0	1	0	0	74	280
EDO. MONAGAS	MP. PIAR	PQ. APARICIO	JARDIN DE INFANCIA MATIAS NUÑEZ	174	1	1	159	111	158	0	0	0	0	47	159
EDO. MONAGAS	MP. PIAR	PQ. APARICIO	ESCUELA PRIMARIA 291 LOS PEREZ	149	1	0	137	106	137	0	0	1	0	30	137
EDO. MONAGAS	MP. PIAR	PQ. APARICIO	ESCUELA BÁSICA BOLIVARIANA MATIAS NUÑEZ	957	2	21	779	366	758	0	2	1	0	389	779
EDO. MONAGAS	MP. PIAR	PQ. APARICIO	ESCUELA BASICA BOLIVARIANA LOLA BASTARDO DE GONZALEZ	715	2	12	546	341	534	0	2	0	0	191	546
EDO. MONAGAS	MP. PIAR	PQ. APARICIO	ESCUELA BASICA BOLIVARIANA JESUS EROTEIDA BARRETO DE MENDOZA	824	2	4	671	428	667	0	3	0	0	236	671
EDO. MONAGAS	MP. PIAR	PQ. LA TOSCANA	UNIDAD EDUCATIVA CAYETANO FARIAS VILLARROEL	832	2	14	691	389	677	0	3	0	0	285	691
EDO. MONAGAS	MP. PIAR	PQ. LA TOSCANA	ESCUELA TERESA CARREÑO	3694	7	43	2735	1593	2692	1	17	0	2	1079	2735
EDO. MONAGAS	MP. PIAR	PQ. LA TOSCANA	ESCUELA UNITARIA NUMERO 257	646	2	8	503	453	495	0	1	0	0	41	503
EDO. MONAGAS	MP. PIAR	PQ. LA TOSCANA	CV MOVIL LA TOSCANA	365	1	10	318	201	308	0	1	0	0	106	318
EDO. MONAGAS	MP. PIAR	PQ. LA TOSCANA	ESCUELA BASICA BOLIVARIANA VIRGEN DEL VALLE	873	2	16	712	531	696	1	4	0	0	160	712
EDO. MONAGAS	MP. PIAR	PQ. LA TOSCANA	CASA COMUNAL LA CEIBA	748	2	14	626	423	612	0	1	0	0	188	626
EDO. MONAGAS	MP. PIAR	CM. ARAGUA	ESCUELA BASICA ANICETO GUEVARA VEGA	2379	5	42	1797	1108	1755	0	9	1	0	637	1797
EDO. MONAGAS	MP. PIAR	CM. ARAGUA	ESCUELA TÉCNICA AGROPECUARIA ARAGUA DE MATURIN	487	1	5	430	353	425	0	1	2	0	69	430
EDO. MONAGAS	MP. PIAR	CM. ARAGUA	LICEO BOLIVARIANO FELIX ANTONIO CALDERON	734	2	18	609	409	591	0	2	0	0	180	609
EDO. MONAGAS	MP. PIAR	CM. ARAGUA	GRUPO ESCOLAR CACIQUE TAGUAY	2918	5	44	2358	1270	2314	0	13	1	0	1030	2358
EDO. MONAGAS	MP. PIAR	CM. ARAGUA	CENTRO DE EDUCACION INICIAL SAN ISIDRO	594	1	3	519	426	516	0	1	0	0	89	519
EDO. MONAGAS	MP. PIAR	PQ. EL PINTO	ESCUELA BASICA LA MESA DE PUNCERES	753	2	10	572	399	562	0	4	1	0	158	572
EDO. MONAGAS	MP. PIAR	PQ. EL PINTO	ESCUELA PRIMARIA BUENA VISTA DE PUNCERES	273	1	2	233	166	231	0	3	0	0	62	233
EDO. MONAGAS	MP. PIAR	PQ. EL PINTO	UNIDAD EDUCATIVA MANUEL HERNANDEZ ROCA	1276	3	15	908	686	893	3	9	1	0	194	908
EDO. MONAGAS	MP. PIAR	PQ. CHAGUARAMAL	ESCUELA BASICA CONCENTRADA LEONARDO INFANTE (LA OREJANA)	325	1	2	243	177	241	0	1	0	0	63	243
EDO. MONAGAS	MP. PIAR	PQ. CHAGUARAMAL	ESCUELA BASICA NUMERO 279 CAÑO DE LOS BECERROS	371	1	5	279	187	274	0	4	0	2	81	279
EDO. MONAGAS	MP. PIAR	PQ. CHAGUARAMAL	ESCUELA BÁSICA ELOY PALACIOS CABELLO	3115	6	45	2305	1252	2260	2	12	0	0	994	2305
EDO. MONAGAS	MP. PIAR	PQ. CHAGUARAMAL	ESCUELA BASICA CONCENTRADA 288 506 LOS POZOS	395	1	6	330	291	324	0	0	0	0	33	330
EDO. MONAGAS	MP. PIAR	PQ. CHAGUARAMAL	CENTRO DE EDUCACION NACIONAL ELOY PALACIO CABELLO	640	2	8	525	335	517	0	1	0	0	181	525
EDO. MONAGAS	MP. PIAR	PQ. CHAGUARAMAL	LICEO BOLIVARIANO JUANA RAMIREZ	339	1	8	281	160	273	0	1	0	1	111	281
EDO. MONAGAS	MP. PIAR	PQ. CHAGUARAMAL	ESCUELA BASICA CHAPARRAL	713	2	16	554	384	538	0	3	0	0	151	554
EDO. MONAGAS	MP. PIAR	PQ. TAGUAYA	ESCUELA BASICA BOLIVARIANA LA VIGIA	645	2	9	507	335	498	0	3	0	0	160	507
EDO. MONAGAS	MP. PIAR	PQ. TAGUAYA	COMPLEJO EDUCATIVO ESTADAL GUAYUTA	183	1	5	169	121	164	0	0	0	0	43	169
EDO. MONAGAS	MP. PIAR	PQ. TAGUAYA	UNIDAD EDUCATIVA OLGA BETANCOURT DE PEREZ	1548	3	12	1253	684	1241	0	5	1	0	551	1253
EDO. MONAGAS	MP. ACOSTA	PQ. SAN FRANCISCO	UNIDAD EDUCATIVA CREACION EL RINCON	2127	4	41	1560	905	1519	0	3	2	1	608	1560
EDO. MONAGAS	MP. ACOSTA	PQ. SAN FRANCISCO	ESCUELA BOLIVARIANA EL BANQUEADO	210	1	1	195	92	194	0	0	0	0	102	195
EDO. MONAGAS	MP. ACOSTA	PQ. SAN FRANCISCO	ESCUELA BASICA JULIAN PADRON	857	2	15	657	415	642	0	0	0	1	226	657
EDO. MONAGAS	MP. ACOSTA	PQ. SAN FRANCISCO	ESCUELA UNITARIA 68 438	669	2	8	466	247	458	0	0	0	0	211	466
EDO. MONAGAS	MP. ACOSTA	PQ. SAN FRANCISCO	ESCUELA BASICA CONCENTRADA NUMERO 14 393 CERRO NEGRO	463	1	13	340	232	327	0	0	0	0	95	340
EDO. MONAGAS	MP. ACOSTA	PQ. SAN FRANCISCO	ESCUELA BASICA CONCENTRADA 2 35 387	536	1	12	374	166	362	1	2	0	1	192	374
EDO. MONAGAS	MP. ACOSTA	PQ. SAN FRANCISCO	ESCUELA BASICA CONCENTRADA 361 488 LAS DELICIAS	471	1	12	334	224	322	0	1	0	0	97	334
EDO. MONAGAS	MP. ACOSTA	CM. SAN ANTONIO	ESCUELA BASICA TERESA HEREDIA	1400	3	31	1096	527	1065	0	2	1	1	534	1096
EDO. MONAGAS	MP. ACOSTA	CM. SAN ANTONIO	ESCUELA UNITARIA NUMERO 1661	225	1	8	147	114	139	0	1	0	0	24	147
EDO. MONAGAS	MP. ACOSTA	CM. SAN ANTONIO	PROGRAMA DE EDUCACION RURAL UPEL	1473	3	23	1222	600	1199	0	8	0	0	591	1222
EDO. MONAGAS	MP. ACOSTA	CM. SAN ANTONIO	UNIDAD EDUCATIVA BELLA VISTA	203	1	3	143	99	140	0	0	0	0	41	143
EDO. MONAGAS	MP. ACOSTA	CM. SAN ANTONIO	ESCUELA BASICA FRANCISCO JAVIER GOMEZ	1475	3	18	1203	565	1185	0	3	0	1	616	1203
EDO. MONAGAS	MP. ACOSTA	CM. SAN ANTONIO	ESCUELA BASICA UNITARIA LA LAGUNA DE IPURE	642	2	9	440	225	431	0	2	0	0	204	440
EDO. MONAGAS	MP. ACOSTA	CM. SAN ANTONIO	ESCUELA BASICA CONCENTRADA NUMERO 389 391 LAS PIÑAS	615	2	9	488	208	479	0	0	1	0	270	488
EDO. MONAGAS	MP. ACOSTA	CM. SAN ANTONIO	LICEO MANUEL SATURNINO PEÑALVER GOMEZ	2164	4	35	1752	783	1717	0	6	0	2	926	1752
EDO. MONAGAS	MP. ACOSTA	CM. SAN ANTONIO	ESCUELA UNITARIA CONCENTRADA NUMERO 6 11 388 439	709	2	18	530	319	512	0	1	0	0	192	530
EDO. MONAGAS	MP. ACOSTA	CM. SAN ANTONIO	ESCUELA UNITARIA SIMON RODRIGUEZ	562	1	8	451	178	443	0	2	0	0	263	451
EDO. MONAGAS	MP. ACOSTA	CM. SAN ANTONIO	ESCUELA BASICA CONCENTRADA LA CAGUA	420	1	1	331	189	330	0	2	0	0	139	331
EDO. MONAGAS	MP. LIBERTADOR	PQ. CHAGUARAMAS	ESCUELA BASICA SAN SIMON	903	2	17	769	633	752	1	4	1	0	113	769
EDO. MONAGAS	MP. LIBERTADOR	PQ. CHAGUARAMAS	ESCUELA BÁSICA CHAGUARAMAS	2210	4	35	1589	1216	1554	0	10	1	1	326	1589
EDO. MONAGAS	MP. LIBERTADOR	PQ. CHAGUARAMAS	ESCUELA TÉCNICA AGROPECUARIA FORESTAL CHAGUARAMAS	568	1	26	456	381	430	0	0	0	0	49	456
EDO. MONAGAS	MP. LIBERTADOR	CM. TEMBLADOR	JARDIN DE INFANCIA TEMBLADOR	1500	3	28	1234	844	1206	0	9	0	0	353	1234
EDO. MONAGAS	MP. LIBERTADOR	CM. TEMBLADOR	ESCUELA PRIMARIA BELQUIZ GUEVARA DE DIQUEZ	1023	2	23	847	687	824	0	5	0	0	132	847
EDO. MONAGAS	MP. LIBERTADOR	CM. TEMBLADOR	UNIDAD EDUCATIVA LIBERTADOR BOLIVAR	2247	4	32	1757	1223	1725	0	18	0	0	484	1757
EDO. MONAGAS	MP. LIBERTADOR	CM. TEMBLADOR	UNIDAD EDUCATIVA RAMON PIERLUISSI	1852	4	26	1458	842	1432	1	17	0	1	571	1458
EDO. MONAGAS	MP. LIBERTADOR	CM. TEMBLADOR	ESCUELA BASICA DORA ROMERO DE AVILA	3436	6	62	2732	1890	2670	2	24	2	0	752	2732
EDO. MONAGAS	MP. LIBERTADOR	CM. TEMBLADOR	ESCUELA BASICA BOLIVARIANA MATA DE VENADO	440	1	4	364	262	360	0	2	0	0	96	364
EDO. MONAGAS	MP. LIBERTADOR	CM. TEMBLADOR	ESCUELA BASICA INAVI	2981	6	67	2567	1804	2500	0	13	1	0	682	2567
EDO. MONAGAS	MP. LIBERTADOR	CM. TEMBLADOR	ESCUELA BÁSICA ANTONIO GÚZMAN BLANCO	3480	6	60	2775	1740	2715	0	28	2	3	942	2775
EDO. MONAGAS	MP. LIBERTADOR	CM. TEMBLADOR	ESCUELA BASICA BOLIVARIANA CARMEN DE PIAMO	802	2	17	687	552	670	0	6	0	0	112	687
EDO. MONAGAS	MP. LIBERTADOR	CM. TEMBLADOR	UNIDAD EDUCATIVA FE Y ALEGRIA TEMBLADOR	3242	6	59	2586	1943	2527	3	12	1	0	568	2586
EDO. MONAGAS	MP. LIBERTADOR	CM. TEMBLADOR	ESCUELA PRIMARIA BOLIVARIANA SAN JOSE DE YABO	320	1	6	255	224	249	0	1	0	0	24	255
EDO. MONAGAS	MP. LIBERTADOR	PQ. TABASCA	ESCUELA UNITARIA 309	233	1	5	176	124	171	0	1	0	0	46	176
EDO. MONAGAS	MP. LIBERTADOR	PQ. TABASCA	ESCUELA CREACION EL FANGAL	648	2	13	545	409	532	0	8	0	2	113	545
EDO. MONAGAS	MP. LIBERTADOR	PQ. TABASCA	ESCUELA BASICA BOLIVARIANA INDIGENA EL PAJAL	248	1	4	164	147	160	0	0	0	0	13	164
EDO. MONAGAS	MP. LIBERTADOR	PQ. TABASCA	UNIDAD EDUCATIVA ISABEL DE VERDE ORTEGA	882	2	21	679	395	658	0	1	0	0	262	679
EDO. MONAGAS	MP. LIBERTADOR	PQ. TABASCA	UNIDAD EDUCATIVA BOLIVARIANA BOCA DE URACOA	496	1	3	344	232	341	0	3	2	0	104	344
EDO. MONAGAS	MP. LIBERTADOR	PQ. TABASCA	ESCUELA BASICA INDIGENA WARAO DOJO SANUKA	208	1	3	115	94	112	0	3	1	0	14	115
EDO. MONAGAS	MP. LIBERTADOR	PQ. LAS ALHUACAS	GRUPO ESCOLAR YARUA	494	1	6	394	295	388	0	2	0	0	91	394
EDO. MONAGAS	MP. SANTA BARBARA	CM. SANTA BARBARA	ESCUELA BOLIVARIANA JUAN VICENTE BOLIVAR	2553	5	42	2029	1144	1987	0	6	0	1	836	2029
EDO. MONAGAS	MP. SANTA BARBARA	CM. SANTA BARBARA	ESCUELA BOLIVARIANA ARNOLDO GABALDON	764	2	13	637	408	624	0	5	0	0	211	637
EDO. MONAGAS	MP. SANTA BARBARA	CM. SANTA BARBARA	KINDER ARNOLDO GABALDON	744	2	18	605	339	587	0	2	0	0	246	605
EDO. MONAGAS	MP. SANTA BARBARA	CM. SANTA BARBARA	LICEO BENJAMIN BRICEÑO MARTIN	2007	4	47	1631	951	1584	0	10	0	0	623	1631
EDO. MONAGAS	MP. SANTA BARBARA	CM. SANTA BARBARA	ESCUELA BOLIVARIANA LUISA DORINA MARCANO	714	2	20	617	460	597	0	4	1	0	132	617
EDO. MONAGAS	MP. SANTA BARBARA	CM. SANTA BARBARA	ESCUELA UNITARIA NUMERO 207	400	1	11	326	220	315	0	1	0	4	90	326
EDO. MONAGAS	MP. BOLIVAR	CM. CARIPITO	ESCUELA BASICA LUIS BELTRAN PRIETO FIGUEROA	658	2	13	542	359	529	0	4	0	0	166	542
EDO. MONAGAS	MP. BOLIVAR	CM. CARIPITO	ESCUELA BASICA BOLIVARIANA LA PLENA	355	1	7	314	238	307	0	0	0	0	69	314
EDO. MONAGAS	MP. BOLIVAR	CM. CARIPITO	ESCUELA BASICA BOLIVARIANA SIMON RODRIGUEZ	635	2	9	516	324	507	0	3	1	0	179	516
EDO. MONAGAS	MP. BOLIVAR	CM. CARIPITO	ESCUELA PRIMARIA LUISA CACERES DE ARISMENDI	253	1	5	234	138	229	0	5	0	0	86	234
EDO. MONAGAS	MP. BOLIVAR	CM. CARIPITO	ESCUELA BASICA LIZANDRO ALVARADO	519	1	13	434	281	421	0	4	0	0	136	434
EDO. MONAGAS	MP. BOLIVAR	CM. CARIPITO	ESCUELA BASICA UDON PEREZ	743	2	14	595	332	581	0	2	0	0	247	595
EDO. MONAGAS	MP. BOLIVAR	CM. CARIPITO	ESCUELA BASICA CONCENTRADA 26 74 LA ACEQUIA	560	1	19	388	275	369	0	2	0	0	92	388
EDO. MONAGAS	MP. BOLIVAR	CM. CARIPITO	ESCUELA BOLIVARIANA INDÍGENA MOSÚ	123	1	2	108	102	106	0	0	0	0	4	108
EDO. MONAGAS	MP. BOLIVAR	CM. CARIPITO	CLUB DE ANCIANOS EL RINCÓN	1474	3	26	1093	731	1067	1	5	0	0	330	1093
EDO. MONAGAS	MP. BOLIVAR	CM. CARIPITO	ESCUELA PRIMARIA JOSE ANTONIO PAEZ	126	1	1	114	83	113	0	0	0	0	30	114
EDO. MONAGAS	MP. BOLIVAR	CM. CARIPITO	ESCUELA BASICA AUDENCIO DIAZ FEBRES	1466	3	24	1173	657	1149	0	3	0	1	488	1173
EDO. MONAGAS	MP. BOLIVAR	CM. CARIPITO	ESCUELA BASICA BOLIVARIANA CARMEN DE LEON	1220	3	8	841	532	833	1	6	1	0	293	841
EDO. MONAGAS	MP. BOLIVAR	CM. CARIPITO	ESCUELA BASICA JOSE GIL FORTUOL	1879	4	47	1391	857	1344	0	4	0	0	483	1391
EDO. MONAGAS	MP. BOLIVAR	CM. CARIPITO	ESCUELA BASICA ZOILA VILLAMIZAR	846	2	14	685	479	671	0	1	0	1	190	685
EDO. MONAGAS	MP. BOLIVAR	CM. CARIPITO	ESCUELA BASICA ANDRES BELLO	252	1	2	211	129	209	1	3	0	0	76	211
EDO. MONAGAS	MP. BOLIVAR	CM. CARIPITO	ESCUELA BASICA NACIONAL JOSEFINA DE FIERRO	235	1	4	212	181	208	0	2	0	0	25	212
EDO. MONAGAS	MP. BOLIVAR	CM. CARIPITO	ESCUELA BASICA BOLIVARIANA PEDRO GUAL	2894	5	37	2207	1192	2170	0	17	1	2	958	2207
EDO. MONAGAS	MP. BOLIVAR	CM. CARIPITO	ESCUELA BASICA EL AMPARO	544	1	11	410	321	399	0	1	0	0	77	410
EDO. MONAGAS	MP. BOLIVAR	CM. CARIPITO	UNIDAD EDUCATIVA FRANCISCO DE MIRANDA	524	1	4	411	276	407	0	1	0	0	130	411
EDO. MONAGAS	MP. BOLIVAR	CM. CARIPITO	ESCUELA BASICA LA CONCEPCION	158	1	5	144	108	139	0	1	0	0	30	144
EDO. MONAGAS	MP. BOLIVAR	CM. CARIPITO	ESCUELA BASICA JOSE FELIX RIBAS	266	1	1	234	182	233	0	1	0	0	50	234
EDO. MONAGAS	MP. BOLIVAR	CM. CARIPITO	ESCUELA BASICA BOLIVARIANA SIMÓN RODRIGUEZ	857	2	9	582	440	573	1	4	0	0	128	582
EDO. MONAGAS	MP. BOLIVAR	CM. CARIPITO	ESCUELA BASICA FRANCISCO DE MIRANDA	215	1	2	205	137	203	0	2	0	0	64	205
EDO. MONAGAS	MP. BOLIVAR	CM. CARIPITO	LICEO BOLIVARIANO JOSE TADEO MONAGAS	656	2	8	520	327	512	0	1	1	0	183	520
EDO. MONAGAS	MP. BOLIVAR	CM. CARIPITO	JARDIN DE INFANCIA COLINAS DE BELLO MONTE	271	1	6	250	153	244	1	0	0	0	90	250
EDO. MONAGAS	MP. BOLIVAR	CM. CARIPITO	ESCUELA BASICA CIUDAD DE LOS TEQUES	3002	6	55	2346	1378	2291	1	13	0	1	898	2346
EDO. MONAGAS	MP. BOLIVAR	CM. CARIPITO	ESCUELA NACIONAL BOLIVARIANA RAFAEL URDANETA	206	1	1	189	134	188	0	0	0	0	54	189
EDO. MONAGAS	MP. BOLIVAR	CM. CARIPITO	ESCUELA BASICA BOLIVARIANA MANUELA SAENZ	751	2	3	481	365	478	0	1	0	0	112	481
EDO. MONAGAS	MP. BOLIVAR	CM. CARIPITO	PREESCOLAR BOLIVARIANO ADELAIDA NUÑEZ SUCRE	981	2	19	728	467	709	0	1	0	0	241	728
EDO. MONAGAS	MP. BOLIVAR	CM. CARIPITO	ESCUELA NACIONAL BOLIVARIANA LIBERTADOR SIMON BOLIVAR	246	1	6	225	170	219	0	0	0	0	49	225
EDO. MONAGAS	MP. BOLIVAR	CM. CARIPITO	ESCUELA BASICA ROMULO GALLEGOS	1989	4	28	1579	714	1551	0	6	0	0	831	1579
EDO. MONAGAS	MP. BOLIVAR	CM. CARIPITO	ESCUELA BASICA VALMORE RODRIGUEZ	1723	3	35	1297	783	1262	0	8	0	0	471	1297
EDO. MONAGAS	MP. CARIPE	PQ. LA GUANOTA	ESCUELA BÁSICA RAMONA ROCCA DE LÓPEZ	1167	2	7	863	462	856	0	4	0	2	388	863
EDO. MONAGAS	MP. CARIPE	PQ. LA GUANOTA	ESCUELA BOLIVARIANA ALTAMIRA	88	1	2	81	48	79	0	2	0	0	29	81
EDO. MONAGAS	MP. CARIPE	PQ. LA GUANOTA	ESCUELA BASICA UNITARIA CONCENTRADA ALTO DE MONAGAL	519	1	4	335	258	331	0	4	2	0	67	335
EDO. MONAGAS	MP. CARIPE	PQ. LA GUANOTA	ESCUELA ESTADAL UNITARIA  486	204	1	1	116	96	115	0	1	1	0	17	116
EDO. MONAGAS	MP. CARIPE	PQ. LA GUANOTA	ESCUELA BASICA UNITARIA 1654	140	1	2	82	54	80	0	1	1	0	24	82
EDO. MONAGAS	MP. CARIPE	PQ. SAN AGUSTIN	ESCUELA BÁSICA BOLIVARIANA DOCTOR RAFAEL MARSIGLIA	1770	3	18	1277	762	1259	2	7	3	0	485	1277
EDO. MONAGAS	MP. CARIPE	PQ. SAN AGUSTIN	ESCUELA BASICA CONCENTRADA EL BANQUEADO	409	1	12	321	202	309	0	0	0	0	107	321
EDO. MONAGAS	MP. CARIPE	PQ. SAN AGUSTIN	LICEO NACIONAL SAN AGUSTIN	615	2	18	530	371	512	0	1	0	0	140	530
EDO. MONAGAS	MP. CARIPE	CM. CARIPE	ESCUELA BASICA BOLIVARIANA ELENA PEREZ DE MATA	685	2	13	544	321	531	0	1	0	0	209	544
EDO. MONAGAS	MP. CARIPE	CM. CARIPE	ESCUELA BASICA EDMUNDO ROMERO	977	2	8	806	508	798	0	3	2	1	284	806
EDO. MONAGAS	MP. CARIPE	CM. CARIPE	LICEO JULIAN PADRON	1473	3	17	1081	442	1064	1	2	1	0	618	1081
EDO. MONAGAS	MP. CARIPE	CM. CARIPE	ESCUELA BASICA CONCENTRADA 91 78 BELLA VISTA	451	1	3	329	247	326	0	1	2	0	76	329
EDO. MONAGAS	MP. CARIPE	CM. CARIPE	ESCUELA BASICA MIGUEL VECCHIO MARSIGLIA	1555	3	25	1267	692	1242	1	3	0	0	546	1267
EDO. MONAGAS	MP. CARIPE	CM. CARIPE	ESCUELA BÁSICA ABRAHAM LINCOLN	3205	6	77	2565	1085	2488	0	9	1	0	1393	2565
EDO. MONAGAS	MP. CARIPE	PQ. TERESEN	ESCUELA BASICA CREACION TERESEN	278	1	2	214	143	212	1	1	0	0	67	214
EDO. MONAGAS	MP. CARIPE	PQ. TERESEN	ESCUELA PRIMARIA ESTADAL LOS CIGARRONES	84	1	0	79	67	79	0	1	0	0	11	79
EDO. MONAGAS	MP. CARIPE	PQ. TERESEN	ESCUELA BASICA CONCENTRADA MIXTA 100 S N	363	1	2	263	203	261	0	0	1	0	57	263
EDO. MONAGAS	MP. CARIPE	PQ. TERESEN	ESCUELA BASICA CONCENTRADA 96 333 444 LA MARGARITA	284	1	3	189	114	186	0	0	0	0	72	189
EDO. MONAGAS	MP. CARIPE	PQ. TERESEN	ESCUELA BASICA CONCENTRADA 86 97 QUEBRADA GRANDE	592	1	8	378	266	370	0	1	0	0	103	378
EDO. MONAGAS	MP. CARIPE	PQ. TERESEN	ESCUELA BASICA BOLIVARIANA SANTA INES	1122	2	30	849	566	819	0	2	1	0	250	849
EDO. MONAGAS	MP. CARIPE	PQ. TERESEN	ESCUELA BÁSICA BOLIVARIANA CARIPITO	1862	4	36	1423	891	1387	1	3	0	0	492	1423
EDO. MONAGAS	MP. CARIPE	PQ. TERESEN	ESCUELA ESTADAL UNITARIA 379	143	1	2	65	53	63	0	0	0	0	10	65
EDO. MONAGAS	MP. CARIPE	PQ. TERESEN	ESCUELA BASICA ESTADAL UNITARIA 217	554	1	3	400	352	397	0	1	2	0	42	400
EDO. MONAGAS	MP. CARIPE	PQ. TERESEN	ESCUELA PRIMARIA ESTADAL LAS ACACIAS	321	1	9	290	245	281	0	0	0	0	36	290
EDO. MONAGAS	MP. CARIPE	PQ. SABANA DE PIEDRA	ESCUELA BÁSICA ARMANDO ZULOAGA BLANCO	1572	3	36	1111	536	1075	0	2	1	0	536	1111
EDO. MONAGAS	MP. CARIPE	PQ. SABANA DE PIEDRA	ESCUELA BASICA NACIONAL 2505	192	1	2	131	71	129	0	0	0	0	58	131
EDO. MONAGAS	MP. CARIPE	PQ. EL GUACHARO	UNIDAD EDUCATIVA NUMERO 37 49 16 59 PERIQUITO	792	2	12	536	245	524	0	1	0	0	278	536
EDO. MONAGAS	MP. CARIPE	PQ. EL GUACHARO	ESCUELA PRIMARIA BOLIVARIANA LA PLACETA	294	1	1	273	186	272	1	2	1	0	82	273
EDO. MONAGAS	MP. CARIPE	PQ. EL GUACHARO	ESCUELA BÁSICA BOLIVARIANA EL GUACHARO	2403	5	26	1829	1111	1803	0	5	0	1	686	1829
EDO. MONAGAS	MP. URACOA	CM. URACOA	ESCUELA UNITARIA NUMERO 315	355	1	8	283	180	275	0	1	0	0	94	283
EDO. MONAGAS	MP. URACOA	CM. URACOA	ESCUELA BASICA BOLIVARIANA PASO NUEVO	720	2	19	569	304	550	0	1	1	0	244	569
EDO. MONAGAS	MP. URACOA	CM. URACOA	ESCUELA UNITARIA NUMERO 318 319	387	1	4	291	146	287	0	2	0	1	138	291
EDO. MONAGAS	MP. URACOA	CM. URACOA	ESCUELA BASICA UNITARIA 423	357	1	5	256	112	251	0	1	0	0	138	256
EDO. MONAGAS	MP. URACOA	CM. URACOA	MEDICATURA RURAL PALOMA DE CHAMBERY	214	1	7	159	62	152	0	1	0	0	89	159
EDO. MONAGAS	MP. URACOA	CM. URACOA	ESCUELA UNITARIA 1026 1017	496	1	5	392	199	387	0	0	0	0	188	392
EDO. MONAGAS	MP. URACOA	CM. URACOA	ESCUELA BASICA BOLIVARIANA CHAIMA	3061	6	72	2483	1092	2411	1	7	2	0	1309	2483
EDO. MONAGAS	MP. URACOA	CM. URACOA	JARDIN DE INFANCIA BOLIVARIANO JOSE FELIX RIVAS	696	2	26	539	199	513	0	5	0	0	309	539
EDO. MONAGAS	MP. URACOA	CM. URACOA	JARDIN DE INFANCIA BOLIVARIANO LOMAS DEL VIENTO	1118	2	25	917	463	892	0	6	1	0	422	917
EDO. MONAGAS	CE. MATURIN	PQ. SAN SIMON	CENTRO EDUCATIVO ESTADAL GIGFREDO RIOS	940	2	15	710	624	695	1	4	2	1	63	710
EDO. MONAGAS	CE. MATURIN	PQ. SAN SIMON	BIBLIOTECA PUBLICA JULIAN PADRON	1337	3	13	1141	472	1128	0	3	2	2	649	1141
EDO. MONAGAS	CE. MATURIN	PQ. SAN SIMON	UNIVERSIDAD PEDAGOGICA EXPERIMENTAL LIBERTADOR  PEDAGOGICO DE MATURIN	3071	6	63	2513	1749	2450	0	17	1	1	682	2513
EDO. MONAGAS	CE. MATURIN	PQ. SAN SIMON	UNIDAD EDUCATIVA MARIA TERESA RODRIGUEZ DEL TORO	768	2	13	618	420	605	0	1	0	2	182	618
EDO. MONAGAS	CE. MATURIN	PQ. SAN SIMON	ESCUELA BASICA BOLIVARIANA EL CARUTO	156	1	3	140	124	137	0	0	0	0	13	140
EDO. MONAGAS	CE. MATURIN	PQ. SAN SIMON	COMPLEJO EDUCATIVO NACIONAL EL SALTO DE MORICHAL	1463	3	36	1303	1063	1267	0	8	1	0	195	1303
EDO. MONAGAS	CE. MATURIN	PQ. SAN SIMON	ESCUELA BÁSICA BOLIVARIANA ALTAMIRA	171	1	2	154	127	152	0	0	0	0	25	154
EDO. MONAGAS	CE. MATURIN	PQ. SAN SIMON	COMPLEJO EDUCATIVO NACIONAL  LA CENTELLITA	249	1	4	221	185	217	1	0	1	0	30	221
EDO. MONAGAS	CE. MATURIN	PQ. SAN SIMON	ESCUELA BÁSICA VILLA HERÓICA SUR	849	2	28	711	561	683	2	2	0	0	118	711
EDO. MONAGAS	CE. MATURIN	PQ. SAN SIMON	LICEO NACIONAL MIGUEL JOSE SANZ	3136	6	22	2526	656	2504	0	14	3	0	1831	2526
EDO. MONAGAS	CE. MATURIN	PQ. SAN SIMON	ESCUELA BASICA CONCENTRADA LOS ACEITES DE GUANIPA
EDO. MONAGAS	CE. MATURIN	PQ. SAN SIMON	COMPLEJO EDUCATIVO MANUELA SAENZ	359	1	5	322	216	317	0	1	0	0	100	322
EDO. MONAGAS	CE. MATURIN	PQ. SAN SIMON	COMPLEJO EDUCATIVO ESTADAL ROSA ADELA DE HERNÁNDEZ	1027	2	22	816	423	794	0	10	0	2	359	816
EDO. MONAGAS	CE. MATURIN	PQ. SAN SIMON	ESCUELA PRIMARIA NACIONAL JUAN FRANCISCO MILA DE LA ROCA	3481	6	55	2460	1454	2405	1	24	2	2	922	2460
EDO. MONAGAS	CE. MATURIN	PQ. SAN SIMON	UNIDAD EDUCATVA RAFAEL CELESTINO ARRIOJAS	754	2	40	561	369	521	0	1	0	0	151	561
EDO. MONAGAS	CE. MATURIN	PQ. SAN SIMON	UNIDAD EDUCATIVA PRIVADA CECILO ACOSTA	1825	4	10	1469	360	1459	0	6	0	1	1092	1469
EDO. MONAGAS	CE. MATURIN	PQ. SAN SIMON	ESCUELA BASICA MANUEL PIAR	1985	4	28	1695	722	1667	2	7	4	1	931	1695
EDO. MONAGAS	CE. MATURIN	PQ. SAN SIMON	ESCUELA BASICA CONCENTRADA EL PECHON	264	1	3	191	131	188	0	1	0	0	56	191
EDO. MONAGAS	CE. MATURIN	PQ. SAN SIMON	COMPLEJO EDUCATIVO ESTADAL SANTA BARBARA DE SOTILLO	188	1	2	167	154	165	0	0	0	0	11	167
EDO. MONAGAS	CE. MATURIN	PQ. SAN SIMON	ESCUELA BASICA ISABEL PADRINO DE CAMPOS	3177	6	33	2697	1330	2664	1	17	2	2	1312	2697
EDO. MONAGAS	CE. MATURIN	PQ. SAN SIMON	ESCUELA TECNICA ROBINSONIANA COMERCIAL FELIX ANGEL LOZADA	1460	3	20	1259	520	1239	1	14	0	2	702	1259
EDO. MONAGAS	CE. MATURIN	PQ. SAN SIMON	LICEO NACIONAL  DOCTOR MANUEL NUÑEZ TOVAR	2262	4	26	1753	989	1727	0	12	0	0	726	1753
EDO. MONAGAS	CE. MATURIN	PQ. SAN SIMON	ESCUELA BASICA SANTA INES	1549	3	22	1254	968	1232	0	11	0	0	253	1254
EDO. MONAGAS	CE. MATURIN	PQ. SAN SIMON	ESCUELA DE ARTES PLASTICAS ELOY PALACIOS	2653	5	18	2154	737	2136	1	13	0	1	1384	2154
EDO. MONAGAS	CE. MATURIN	PQ. SAN SIMON	UNIDAD EDUCATIVA PRIVADA SANTA EDUVIGIS	317	1	3	287	126	284	0	3	0	0	155	287
EDO. MONAGAS	CE. MATURIN	PQ. SAN SIMON	COMPLEJO EDUCATIVO NACIONAL  LA CARBONERA	522	1	16	469	293	453	0	4	1	0	155	469
EDO. MONAGAS	CE. MATURIN	PQ. SAN SIMON	UNIDAD EDUCATIVA LA PUENTE DE AGUA NEGRA	294	1	5	225	151	220	0	2	0	0	67	225
EDO. MONAGAS	CE. MATURIN	PQ. SAN SIMON	LICEO NACIONAL FRANCISCO ISNARDI	3169	6	46	2694	1028	2648	0	18	1	1	1600	2694
EDO. MONAGAS	CE. MATURIN	PQ. SAN SIMON	ESCUELA BASICA JOSE DAMIAN RAMIREZ LABRADOR	2095	4	27	1724	807	1697	0	4	2	1	883	1724
EDO. MONAGAS	CE. MATURIN	PQ. SAN SIMON	ESCUELA BASICA PARARE	464	1	8	431	324	423	0	2	0	0	97	431
EDO. MONAGAS	CE. MATURIN	PQ. SAN SIMON	CENTRO DE EDUCACION INICIAL IRMA SAEZ MERIDA DE GRISANTI	938	2	17	726	375	709	0	7	2	0	325	726
EDO. MONAGAS	CE. MATURIN	PQ. SAN SIMON	ESCUELA PRIMARIA NACIONAL VENTURA VARGAS	3071	6	32	2401	1043	2369	0	14	1	0	1311	2401
EDO. MONAGAS	CE. MATURIN	PQ. SAN SIMON	ESCUELA PRIMARIA NACIONAL  FELIX ANTONIO CALDERON	3605	7	34	2987	1227	2953	1	17	0	2	1706	2987
EDO. MONAGAS	CE. MATURIN	PQ. SAN SIMON	ESCUELA PRIMARIA NACIONAL LOS ARAGUANEYES	84	1	1	60	38	59	0	0	0	0	21	60
EDO. MONAGAS	CE. MATURIN	PQ. SAN SIMON	UNIDAD EDUCATIVA BOLIVARIANA SAN JOSE DE BUJA	991	2	7	643	468	636	0	1	0	0	167	643
EDO. MONAGAS	CE. MATURIN	PQ. SAN SIMON	COMPLEJO NACIONAL EDUCATICO CECILIA ELENA NARANJA PRECILLA	594	1	6	423	256	417	0	2	0	0	159	423
EDO. MONAGAS	CE. MATURIN	PQ. SAN SIMON	UNIDAD EDUCATIVA COLEGIO PRIVADO MATURÍN	1485	3	13	1297	461	1284	0	1	0	0	822	1297
EDO. MONAGAS	CE. MATURIN	PQ. SAN SIMON	ESCUELA PRIMARIA NACIONAL ALEJANDRO DE HUMBOLT	2966	6	19	2393	1092	2374	1	15	2	0	1264	2393
EDO. MONAGAS	CE. MATURIN	PQ. SAN SIMON	ESCUELA BASICA BOLIVARIANA EL RESPIRO	626	2	8	436	302	428	0	2	0	0	124	436
EDO. MONAGAS	CE. MATURIN	PQ. SAN SIMON	COMPLEJO EDUCATIVO NACIONAL EL SILENCIO DE MORICHAL LARGO	919	2	21	701	588	680	0	4	0	0	88	701
EDO. MONAGAS	CE. MATURIN	PQ. SAN SIMON	UNIVERSIDAD BOLIVARIANA DE VENEZUELA	2736	5	24	2253	1021	2229	0	8	0	0	1200	2253
EDO. MONAGAS	CE. MATURIN	PQ. SAN SIMON	UNIDAD EDUCATIVA LUIS PADRINO	3303	6	25	2814	559	2789	0	7	0	2	2221	2814
EDO. MONAGAS	CE. MATURIN	PQ. SAN SIMON	ESCUELA BASICA EL BLANQUERO	376	1	10	271	235	261	0	0	1	0	25	271
EDO. MONAGAS	CE. MATURIN	PQ. SAN SIMON	ESCUELA PRIMARIA ESTADAL MARCOS SERRES PADILLA	1236	3	22	1064	740	1042	1	14	0	0	287	1064
EDO. MONAGAS	CE. MATURIN	PQ. SAN SIMON	COMPLEJO EDUCATIVO ANTONIO JOSE DE SUCRE	1344	3	27	967	634	940	1	3	0	0	302	967
EDO. MONAGAS	CE. MATURIN	PQ. SAN SIMON	ESCUELA PRIMARIA NACIONAL   BOLIVARIANA PAULA BASTARDO	2820	5	37	2153	938	2116	0	12	0	2	1164	2153
EDO. MONAGAS	CE. MATURIN	PQ. SAN SIMON	ESCUELA INICIAL NACIONAL AÑO INTERNACIONAL DEL NIÑO	1624	3	24	1322	567	1298	0	8	1	0	722	1322
EDO. MONAGAS	CE. MATURIN	PQ. SAN SIMON	JARDIN DE INFANCIA MONAGAS	2574	5	41	2324	1042	2283	0	9	2	1	1229	2324
EDO. MONAGAS	CE. MATURIN	PQ. SAN SIMON	ESCUELA NACIONAL PERICOCO DE ARIBI	230	1	4	190	149	186	1	3	0	0	33	190
EDO. MONAGAS	CE. MATURIN	PQ. SAN SIMON	ESCUELA PRIMARIA CARATAL DEL TIGRE
EDO. MONAGAS	CE. MATURIN	PQ. SAN SIMON	UNIDAD EDUCATIVA DOCTORA LIA IMBER DE CORONIL ALBERGUE	2749	5	11	2411	497	2400	0	14	1	0	1888	2411
EDO. MONAGAS	CE. MATURIN	PQ. SAN SIMON	ESCUELA PRIMARIA ESTADAL BOYACA	2111	4	21	1842	791	1821	0	19	2	1	1008	1842
EDO. MONAGAS	CE. MATURIN	PQ. SAN SIMON	ESCUELA BASICA SAN MIGUEL	385	1	3	325	232	322	0	3	0	0	87	325
EDO. MONAGAS	CE. MATURIN	PQ. SAN SIMON	ESCUELA BASICA REPUBLICA DEL URUGUAY	3232	6	34	2629	1123	2595	1	12	0	1	1458	2629
EDO. MONAGAS	CE. MATURIN	PQ. SAN SIMON	ESCUELA BASICA UNITARIA EL CHISPERO	123	1	0	86	75	86	0	0	0	0	11	86
EDO. MONAGAS	CE. MATURIN	PQ. SAN SIMON	CASA DE NIÑOS MARIA EVA DE LISCANO	1307	3	13	1042	478	1029	0	7	0	1	543	1042
EDO. MONAGAS	CE. MATURIN	PQ. SAN SIMON	LICEO NACIONAL IDELFONSO NUÑEZ MARES	2466	5	32	1926	781	1894	0	12	1	0	1100	1926
EDO. MONAGAS	CE. MATURIN	PQ. SAN SIMON	ESCUELA BASICA NICOLAS LOPEZ	1015	2	22	671	405	649	0	4	1	0	239	671
EDO. MONAGAS	CE. MATURIN	PQ. SAN SIMON	COMPLEJO EDUCATIVO NACIONAL AGUA NEGRA	159	1	9	142	106	133	0	0	0	0	27	142
EDO. MONAGAS	CE. MATURIN	PQ. SAN SIMON	ANEXO DE LA ESCUELA BÁSICA JOSÉ TADEO MONAGAS	393	1	1	357	290	356	0	0	1	0	65	357
EDO. MONAGAS	CE. MATURIN	PQ. SAN SIMON	ESCUELA BASICA BOLIVARIANA CURIEPE	340	1	7	245	140	238	0	3	0	0	95	245
EDO. MONAGAS	CE. MATURIN	PQ. SAN SIMON	LICEO NACIONAL MARCO ANTONIO SALUZZO	3188	6	42	2616	1148	2574	0	18	0	1	1407	2616
EDO. MONAGAS	CE. MATURIN	PQ. SAN SIMON	ESCUELA BASICA JOSE TADEO MONAGAS	1698	3	26	1225	811	1199	0	7	1	0	380	1225
EDO. MONAGAS	CE. MATURIN	PQ. SAN SIMON	EDUCACION INICIAL NACIONAL EL LIBERTADOR	1132	2	8	918	347	910	0	6	1	0	556	918
EDO. MONAGAS	CE. MATURIN	PQ. SAN SIMON	COMPLEJO EDUCATIVO NACIONAL INDIGENA YABINOKO	310	1	2	135	125	133	0	0	0	0	8	135
EDO. MONAGAS	CE. MATURIN	PQ. SAN SIMON	ESCUELA BÁSICA VICENTE SALIAS	3652	7	47	3020	885	2973	0	15	0	1	2072	3020
EDO. MONAGAS	CE. MATURIN	PQ. SAN SIMON	COMPLEJO EDUCATIVO ESTADAL  LOS POZOS DE GUANIPA	125	1	5	112	82	107	0	0	1	0	24	112
EDO. MONAGAS	CE. MATURIN	PQ. SAN SIMON	UNIDAD EDUCATIVA EL RINCON DE MONAGAS	883	2	25	708	566	683	0	2	1	0	114	708
EDO. MONAGAS	CE. MATURIN	PQ. EL COROZO	ESCUELA BASICA BOLIVARIANA AMARILIS	696	2	25	585	372	560	0	4	0	0	184	585
EDO. MONAGAS	CE. MATURIN	PQ. EL COROZO	UNIDAD EDUCATIVA JOSÉ GREGORIO MONAGAS	2749	5	58	2157	1287	2099	0	12	2	3	795	2157
EDO. MONAGAS	CE. MATURIN	PQ. EL COROZO	ESCUELA BASICA BOLIVARIANA CAMILO VILLANUEVA	582	1	15	510	389	495	0	2	0	0	104	510
EDO. MONAGAS	CE. MATURIN	PQ. SANTA CRUZ	CENTRO DE EDUCACION INICIAL MARTHA LAMAS DE RENGEL	461	1	7	406	231	399	0	0	0	1	167	406
EDO. MONAGAS	CE. MATURIN	PQ. SANTA CRUZ	ESCUELA BASICA CASTOR GUEVARA	3261	6	37	2572	1456	2535	2	10	0	0	1067	2572
EDO. MONAGAS	CE. MATURIN	PQ. SANTA CRUZ	ESCUELA BASICA CARMEN EBELIA DOUGLAS	3744	7	52	3460	1490	3408	1	20	1	0	1896	3460
EDO. MONAGAS	CE. MATURIN	PQ. SANTA CRUZ	COMPLEJO EDUCACIONAL NACIONAL LAS CAROLINAS	2029	4	26	1848	982	1822	0	8	0	2	830	1848
EDO. MONAGAS	CE. MATURIN	PQ. SANTA CRUZ	UNIDAD EDUCATIVA  DIEGO SIFONTE SOSA	3173	6	43	2592	1367	2549	0	17	0	1	1164	2592
EDO. MONAGAS	CE. MATURIN	PQ. SANTA CRUZ	ESCUELA BÁSICA CARIPE	3761	7	58	2989	1542	2931	1	15	2	1	1370	2989
EDO. MONAGAS	CE. MATURIN	PQ. SANTA CRUZ	CENTRO BOLIVARIANO DE INFORMATICA Y TELEMATICA (CEBIT)	1260	3	25	1026	567	1001	0	7	2	0	425	1026
EDO. MONAGAS	CE. MATURIN	PQ. SANTA CRUZ	UNIDAD EDUCATIVA JEAN FIRMIN	2334	4	33	2077	948	2044	0	17	4	1	1074	2077
EDO. MONAGAS	CE. MATURIN	PQ. SANTA CRUZ	ESCUELA BASICA ALBERTO LOVERA	513	1	7	426	292	419	0	8	0	0	119	426
EDO. MONAGAS	CE. MATURIN	PQ. SANTA CRUZ	COMPLEJO EDUCATIVO NACIONAL PADRE JUAN VIVES SURIA	1516	3	48	1387	755	1339	0	5	1	0	578	1387
EDO. MONAGAS	CE. MATURIN	PQ. SANTA CRUZ	ESCUELA BASICA SAN JAIME	1617	3	21	1342	719	1321	0	5	1	0	596	1342
EDO. MONAGAS	CE. MATURIN	PQ. SAN VICENTE	ESCUELA BÁSICA BOLIVARIANA ISMAEL SALAZAR	2861	5	41	2183	1331	2142	0	13	1	0	797	2183
EDO. MONAGAS	CE. MATURIN	PQ. SAN VICENTE	ESCUELA INICIAL NACIONAL ISMAEL SALAZAR	538	1	9	395	238	386	1	2	0	0	145	395
EDO. MONAGAS	CE. MATURIN	PQ. SAN VICENTE	CASA DE LA CULTURA SIMON BOLIVAR	1102	2	18	913	666	895	0	3	0	0	226	913
EDO. MONAGAS	CE. MATURIN	PQ. SAN VICENTE	LICEO NACIONAL BOLIVARIANO SAN VICENTE FERRER	520	1	9	407	289	398	0	3	1	0	105	407
EDO. MONAGAS	CE. MATURIN	PQ. SAN VICENTE	ESCUELA BASICA BOLIVARIANA PUEBLO LIBRE	1350	3	12	1083	769	1071	0	10	0	1	291	1083
EDO. MONAGAS	CE. MATURIN	PQ. ALTO DE LOS GODOS	CENTRO DEL NIÑO Y LA FAMILIA BOLIVARIANO PRADO DEL SUR	1580	3	26	1226	878	1200	0	7	1	0	314	1226
EDO. MONAGAS	CE. MATURIN	PQ. ALTO DE LOS GODOS	ESCUELA PRIMERIA NACIONAL BOLIVARIANA PINTO SALINAS	2134	4	30	1755	1285	1725	0	13	2	0	425	1755
EDO. MONAGAS	CE. MATURIN	PQ. ALTO DE LOS GODOS	ESCUELA BASICA VICTORIA RAMIREZ MOLINOS	3173	6	27	2845	774	2818	2	8	0	0	2034	2845
EDO. MONAGAS	CE. MATURIN	PQ. ALTO DE LOS GODOS	LICEO NACIONAL LOS GUARITOS	4075	8	42	3549	1734	3507	0	36	2	1	1734	3549
EDO. MONAGAS	CE. MATURIN	PQ. ALTO DE LOS GODOS	ESCUELA BASICA  CACIQUE PARAMACONI	3525	7	63	2698	1715	2635	2	15	1	1	901	2698
EDO. MONAGAS	CE. MATURIN	PQ. ALTO DE LOS GODOS	COMPLEJO EDUCATIVO NACIONAL LA NEGRA MATEA	1340	3	24	1199	966	1175	0	5	1	0	203	1199
EDO. MONAGAS	CE. MATURIN	PQ. ALTO DE LOS GODOS	CENTRO DE FORMACION INTEGRAL PARA EL TRABAJO	1767	3	9	1519	718	1510	0	7	2	0	783	1519
EDO. MONAGAS	CE. MATURIN	PQ. ALTO DE LOS GODOS	CV MOVIL CANCHA DEPORTIVA LA MURALLITA	462	1	5	395	244	390	0	4	0	0	142	395
EDO. MONAGAS	CE. MATURIN	PQ. ALTO DE LOS GODOS	ESCUELA PRIMARIA  JUANA RAMIREZ	1752	3	30	1467	1056	1437	1	9	1	1	369	1467
EDO. MONAGAS	CE. MATURIN	PQ. ALTO DE LOS GODOS	JARDIN DE INFANCIA CARMEN VERONICA CUELLO	1279	3	20	1120	496	1100	0	7	1	0	596	1120
EDO. MONAGAS	CE. MATURIN	PQ. ALTO DE LOS GODOS	CV MOVIL CANCHA DEPORTIVA EL CARO DE LA PUENTE	300	1	8	245	159	237	0	1	0	0	77	245
EDO. MONAGAS	CE. MATURIN	PQ. ALTO DE LOS GODOS	ESCUELA BASICA MARIO BRICEÑO IRAGORRI	2925	5	30	2538	1273	2508	0	10	0	2	1223	2538
EDO. MONAGAS	CE. MATURIN	PQ. ALTO DE LOS GODOS	CENTRO NACIONAL EDUCATIVO CRUZ FIGUERA	3260	6	30	2516	1681	2486	0	13	1	1	790	2516
EDO. MONAGAS	CE. MATURIN	PQ. ALTO DE LOS GODOS	ESCUELA PRIMARIA NACIONAL CACIQUE GUANAGUANAI	696	2	8	652	577	644	0	3	1	0	63	652
EDO. MONAGAS	CE. MATURIN	PQ. ALTO DE LOS GODOS	LICEO BOLIVARIANO GILDA RAMIREZ	1519	3	26	1309	784	1283	0	12	0	0	487	1309
EDO. MONAGAS	CE. MATURIN	PQ. ALTO DE LOS GODOS	COLEGIO BOLIVARIANO DOCTOR ARTURO USLAR PIETRI	1809	4	28	1551	1018	1523	0	16	0	2	487	1551
EDO. MONAGAS	CE. MATURIN	PQ. ALTO DE LOS GODOS	CV MOVIL LOS PINOS	230	1	4	178	133	174	0	1	0	0	40	178
EDO. MONAGAS	CE. MATURIN	PQ. ALTO DE LOS GODOS	CENTRO DE EDUCACIÓN INICIAL ALTO DE LOS GODOS I	1172	2	12	1036	252	1024	0	3	0	0	769	1036
EDO. MONAGAS	CE. MATURIN	PQ. ALTO DE LOS GODOS	PREESCOLAR DORA TEOTISTE DE GALLEGOS	1066	2	9	819	451	810	0	4	1	0	354	819
EDO. MONAGAS	CE. MATURIN	PQ. ALTO DE LOS GODOS	ESCUELA PRIMARIA NACIONAL  ALI PRIMERA	246	1	5	210	178	205	0	1	0	0	26	210
EDO. MONAGAS	CE. MATURIN	PQ. ALTO DE LOS GODOS	ESCUELA BASICA PRIMARIA ARTURO USLAR PIETRI	236	1	2	197	136	195	0	3	0	0	56	197
EDO. MONAGAS	CE. MATURIN	PQ. ALTO DE LOS GODOS	ESCUELA PRIMARIA NACIONAL ADRIANA RENGEL DE SEQUERA	3541	7	32	2931	1502	2899	1	15	0	1	1380	2931
EDO. MONAGAS	CE. MATURIN	PQ. ALTO DE LOS GODOS	CENTRO DEL NIÑO Y LA FAMILIA SIMONCITO MOSCU	522	1	3	455	350	452	0	4	0	0	98	455
EDO. MONAGAS	CE. MATURIN	PQ. ALTO DE LOS GODOS	COMPLEJO EDUCATIVO NACIONAL FRANCISCO VERDE	3258	6	43	2665	1696	2622	1	15	2	0	908	2665
EDO. MONAGAS	CE. MATURIN	PQ. ALTO DE LOS GODOS	COMPLEJO EDUCATIVO NACIONAL JOSE ANGEL MEZA VERDE	2885	5	58	2499	1268	2441	1	17	1	1	1153	2499
EDO. MONAGAS	CE. MATURIN	PQ. ALTO DE LOS GODOS	LICEO NACIONAL BATALLA DE LA VICTORIA	1932	4	34	1761	1497	1727	0	13	0	0	217	1761
EDO. MONAGAS	CE. MATURIN	PQ. ALTO DE LOS GODOS	CENTRO DEL NIÑO Y LA FAMILIA BOLIVARIANO BELLOS HORIZONTES	780	2	7	601	496	594	0	6	1	0	91	601
EDO. MONAGAS	CE. MATURIN	PQ. ALTO DE LOS GODOS	UNIDAD EDUCATIVA BOLIVAR	808	2	9	729	513	720	0	6	0	0	201	729
EDO. MONAGAS	CE. MATURIN	PQ. ALTO DE LOS GODOS	ESCUELA BASICA ANTONIO JOSE DE SUCRE	2805	5	27	2243	1349	2216	0	16	1	1	849	2243
EDO. MONAGAS	CE. MATURIN	PQ. ALTO DE LOS GODOS	ESCUELA BASICA SAN SIMON	2616	5	40	2034	1094	1994	0	21	0	2	877	2034
EDO. MONAGAS	CE. MATURIN	PQ. ALTO DE LOS GODOS	CENTRO DE EDUCACIÓN INICIAL ALTO DE LOS GODOS 2	924	2	4	808	204	804	0	5	0	0	595	808
EDO. MONAGAS	CE. MATURIN	PQ. ALTO DE LOS GODOS	ESCUELA PRIMARIA NACIONAL CRUZ HERNANDEZ QUIJADA	739	2	18	656	394	638	0	5	0	0	239	656
EDO. MONAGAS	CE. MATURIN	PQ. ALTO DE LOS GODOS	LICEO NACIONAL FELIX ARMANDO NUÑEZ BEAPERTHUY	2596	5	15	2303	1089	2288	0	15	0	1	1183	2303
EDO. MONAGAS	CE. MATURIN	PQ. ALTO DE LOS GODOS	ESCUELA PRIMARIA NACIONAL BATALLA DE LOS GODOS	1739	3	20	1389	1130	1369	0	3	1	0	235	1389
EDO. MONAGAS	CE. MATURIN	PQ. ALTO DE LOS GODOS	ESCUELA PRIMARIA  APOLINAR CANTOR	2944	6	57	2365	1441	2308	0	8	0	2	857	2365
EDO. MONAGAS	CE. MATURIN	PQ. ALTO DE LOS GODOS	CENTRO DE EDUCACIÓN INICIAL SAN JUDAS TADEO	678	2	13	492	302	479	1	3	1	0	172	492
EDO. MONAGAS	CE. MATURIN	PQ. ALTO DE LOS GODOS	ESCUELA PRIMARIA NACIONAL  MIGUEL EDUARDO TURMERO	4872	9	50	4317	2098	4267	1	32	0	1	2135	4317
EDO. MONAGAS	CE. MATURIN	PQ. ALTO DE LOS GODOS	UNIDAD EDUCATIVA PADRE LUIS ORMIERES FE Y ALEGRIA	2594	5	32	2075	1027	2043	0	13	1	1	1001	2075
EDO. MONAGAS	CE. MATURIN	PQ. ALTO DE LOS GODOS	ESCUELA BASICA MARLENE SEQUEA DE CAMPOS	1670	3	29	1410	965	1381	0	4	2	0	410	1410
EDO. MONAGAS	CE. MATURIN	PQ. ALTO DE LOS GODOS	ESCUELA INICIAL NACIONAL BRISAS DEL MORICHAL	1067	2	19	881	617	862	0	7	0	1	237	881
EDO. MONAGAS	CE. MATURIN	PQ. ALTO DE LOS GODOS	MODULO COMUNAL LA MURALLA	1636	3	25	1353	689	1328	0	4	1	0	634	1353
EDO. MONAGAS	CE. MATURIN	PQ. ALTO DE LOS GODOS	JARDIN DE INFANCIA NACIONAL ADRIANA RENGEL DE SEQUERA	1900	4	23	1626	808	1603	0	6	0	0	789	1626
EDO. MONAGAS	CE. MATURIN	PQ. ALTO DE LOS GODOS	JARDIN DE INFANCIA LOS PINOS	1393	3	14	1161	663	1147	0	8	0	0	476	1161
EDO. MONAGAS	CE. MATURIN	PQ. ALTO DE LOS GODOS	COMPLEJO EDUCATIVO NACIONAL MANOLA LUNA SILVA	2583	5	39	2204	1042	2165	0	20	1	0	1102	2204
EDO. MONAGAS	CE. MATURIN	PQ. ALTO DE LOS GODOS	ESCUELA BASICA COLINAS DEL PARAMACONI	420	1	4	356	238	352	0	1	0	0	113	356
EDO. MONAGAS	CE. MATURIN	PQ. ALTO DE LOS GODOS	UNIDAD EDUCATIVA COLEGIO PRIVADO DOCTOR JOSÉ GIL FORTOUL	1685	3	16	1484	562	1468	0	9	0	2	895	1484
EDO. MONAGAS	CE. MATURIN	PQ. ALTO DE LOS GODOS	CENTRO DEL NIÑO Y LA FAMILIA BOLIVARIANO NUEVO HORIZONTE	2352	4	34	1923	1154	1889	0	13	0	0	722	1923
EDO. MONAGAS	CE. MATURIN	PQ. ALTO DE LOS GODOS	CV MOVIL PARQUESITO LOS GUARITOS III	356	1	8	332	165	324	0	1	0	0	158	332
EDO. MONAGAS	CE. MATURIN	PQ. BOQUERON	ESCUELA PUBLICA NACIONAL GABRIELA MISTRAL	409	1	5	346	296	341	0	3	0	0	42	346
EDO. MONAGAS	CE. MATURIN	PQ. BOQUERON	LICEO SIMÓN BOLIVAR	4976	9	58	4166	2039	4108	1	21	1	1	2045	4166
EDO. MONAGAS	CE. MATURIN	PQ. BOQUERON	ESCUELA BASICA LUISA TERESA SOSA	3363	6	40	2846	804	2806	0	8	1	3	1990	2846
EDO. MONAGAS	CE. MATURIN	PQ. BOQUERON	UNIDAD EDUCATIVA LUISA JIMENEZ DE CANELON	2053	4	59	1634	940	1575	1	10	1	0	623	1634
EDO. MONAGAS	CE. MATURIN	PQ. BOQUERON	ESCUELA BASICA BOLIVARIANA GUAYABAL	1021	2	33	828	598	795	0	5	0	0	192	828
EDO. MONAGAS	CE. MATURIN	PQ. BOQUERON	ESCUELA BÁSICA EL RINCÓN DEL COSTO	666	2	12	558	361	546	0	7	1	1	176	558
EDO. MONAGAS	CE. MATURIN	PQ. BOQUERON	ESCUELA BASICA FELIX ARMANDO NUÑEZ BEAPERTHUY	2667	5	43	2057	1065	2014	0	21	1	0	927	2057
EDO. MONAGAS	CE. MATURIN	PQ. BOQUERON	ESCUELA BASICA LUISA BELTRANA DE FIGUEROA	3306	6	50	2596	1718	2546	1	19	3	0	805	2596
EDO. MONAGAS	CE. MATURIN	PQ. BOQUERON	ESCUELA PRIMARIA NACIONAL BOLIVARIANA LA SABANA DEL ZORRO	862	2	18	722	549	704	0	7	1	0	147	722
EDO. MONAGAS	CE. MATURIN	PQ. BOQUERON	ESCUELA RURAL BOLIVARIANA SAN LUIS	505	1	7	452	234	445	0	3	0	0	208	452
EDO. MONAGAS	CE. MATURIN	PQ. BOQUERON	CV MOVIL CANCHA DEPORTIVA DOÑA MENCA 2	114	1	0	97	68	97	0	0	0	0	29	97
EDO. MONAGAS	CE. MATURIN	PQ. BOQUERON	ESCUELA PRIMERIA NACIONAL DOÑA MENCA DE LEONI	3440	7	43	2783	1738	2740	1	23	1	0	977	2783
EDO. MONAGAS	CE. MATURIN	PQ. BOQUERON	ESCUELA BASICA ANDRES BELLO	2561	5	57	1915	1088	1858	0	10	2	1	757	1915
EDO. MONAGAS	CE. MATURIN	PQ. BOQUERON	UNIDAD EDUCATIVA BOLIVARIANA TIPURO 2	572	1	3	493	243	490	0	4	0	0	243	493
EDO. MONAGAS	CE. MATURIN	PQ. BOQUERON	ESCUELA BASICA RURAL SANTA ELENA DE VIBORAL	2805	5	23	2515	835	2492	0	11	0	2	1644	2515
EDO. MONAGAS	CE. MATURIN	PQ. BOQUERON	ESCUELA BASICA BOLIVARIANA LA SARRAPIA	745	2	18	671	337	653	0	3	2	0	311	671
EDO. MONAGAS	CE. MATURIN	PQ. BOQUERON	ESCUELA BASICA AGUA CLARA	408	1	9	348	256	339	0	3	0	0	80	348
EDO. MONAGAS	CE. MATURIN	PQ. BOQUERON	LICEO NACIONAL SALVADOR ALLENDE	1199	3	17	1077	729	1060	0	6	0	0	325	1077
EDO. MONAGAS	CE. MATURIN	PQ. BOQUERON	ESCUELA BASICA ELSA BIONDI DE RIVERO	1648	3	44	1267	945	1223	0	7	0	0	271	1267
EDO. MONAGAS	CE. MATURIN	PQ. BOQUERON	ESCUELA PRIMARIA NACIONAL EL AMBIENTE	588	1	4	513	301	509	0	2	0	1	205	513
EDO. MONAGAS	CE. MATURIN	PQ. BOQUERON	ESCUELA BASICA DOCTOR. LUIS BELTRAN PRIETO FIGUEROA	822	2	17	706	380	689	1	4	0	0	304	706
EDO. MONAGAS	CE. MATURIN	PQ. BOQUERON	ESCUELA BASICA CARMEN HERNANDEZ DE MILANO	835	2	21	640	442	619	1	4	2	0	170	640
EDO. MONAGAS	CE. MATURIN	PQ. BOQUERON	ESCUELA BASICA BOLIVARIANA DEL ZAMURO	717	2	16	563	429	547	0	2	0	0	116	563
EDO. MONAGAS	CE. MATURIN	PQ. JUSEPIN	ESCUELA BASICA BOLIVARIANA SANTIAGO MARIÑO	593	1	8	466	285	458	0	3	0	0	170	466
EDO. MONAGAS	CE. MATURIN	PQ. JUSEPIN	ESCUELA BÁSICA BOLIVARIANA DOCTOR JOSE MARIA VARGAS	2626	5	42	2150	1515	2108	0	12	0	0	581	2150
EDO. MONAGAS	CE. MATURIN	PQ. JUSEPIN	ESCUELA BASICA PLACIDO MANEIRO	3116	6	39	2663	1947	2624	1	15	0	0	661	2663
EDO. MONAGAS	CE. MATURIN	PQ. JUSEPIN	ESCUELA BÁSICA BOLIVARIANA BARRANCAS	838	2	17	661	471	644	0	8	0	0	165	661
EDO. MONAGAS	CE. MATURIN	PQ. JUSEPIN	CENTRO DE EDUCACION INICIAL ANEXO DOCTOR JOSE MARIA VARGAS	719	2	18	630	469	612	1	3	0	1	138	630
EDO. MONAGAS	CE. MATURIN	PQ. JUSEPIN	UNIDAD EDUCATIVA ANATILDE SALCEDO FE Y ALEGRIA	553	1	5	484	420	479	0	1	1	0	57	484
EDO. MONAGAS	CE. MATURIN	PQ. LA PICA	CENTRO DEL NIÑO Y LA FAMILIA LA PICA	208	1	4	188	120	184	0	3	0	0	61	188
EDO. MONAGAS	CE. MATURIN	PQ. LA PICA	COMPLEJO EDUCATIVO FANNY CENTENO	1629	3	40	1199	740	1159	0	5	0	1	413	1199
EDO. MONAGAS	CE. MATURIN	PQ. LA PICA	LICEO NACIONAL JOSE FELIX RIBAS	1380	3	45	1037	612	992	0	10	1	0	369	1037
EDO. MONAGAS	CE. MATURIN	PQ. LA PICA	ESCUELA BASICA BOLIVARIANA LA HORMIGA	526	1	7	456	318	449	0	2	0	0	129	456
EDO. MONAGAS	CE. MATURIN	PQ. LA PICA	ESCUELA BASICA BOLIVARIANA LA LOCACION	228	1	7	203	149	196	0	1	0	0	46	203
EDO. MONAGAS	CE. MATURIN	PQ. LA PICA	ESCUELA BÁSICA BOLIVARIANA LA ESPERANZA	519	1	10	374	220	364	0	1	1	0	142	374
EDO. MONAGAS	CE. MATURIN	PQ. LA PICA	ESCUELA PRIMARIA ESTADAL FELIX ANGEL LOZADA	2976	6	45	2286	1343	2241	2	17	1	2	876	2286
EDO. MONAGAS	CE. MATURIN	PQ. LA PICA	LICEO BOLIVARIANO FELIX ANGEL LOZADA	526	1	4	448	296	444	0	1	0	1	146	448
EDO. MONAGAS	CE. MATURIN	PQ. LA PICA	INTERNADO JUDICIAL DE MONAGAS	498	1	8	116	87	108	0	1	0	0	20	116
EDO. MONAGAS	CE. MATURIN	PQ. LA PICA	COMPLEJO EDUCATIVO NACIONAL EL BARRIL	266	1	3	224	176	221	0	0	0	0	45	224
EDO. MONAGAS	CE. MATURIN	PQ. LA PICA	CENTRO EDUCACION INICIAL BOLIVARIANO NUESTRA SEÑORA DE LOURDES	421	1	16	371	272	355	1	3	0	0	79	371
EDO. MONAGAS	CE. MATURIN	PQ. LA PICA	UNIDAD EDUCATIVA BOLIVARIANA VUELTA LARGA	737	2	8	580	392	572	1	1	0	0	178	580
EDO. MONAGAS	CE. MATURIN	PQ. EL FURRIAL	ESCUELA BÁSICA RAFAEL MARIA BARALT	2179	4	36	1739	1104	1703	0	7	3	0	589	1739
EDO. MONAGAS	CE. MATURIN	PQ. EL FURRIAL	COMPLEJO CULTURAL JESUS JARAMILLO	1019	2	26	900	615	874	0	5	1	3	250	900
EDO. MONAGAS	CE. MATURIN	PQ. EL FURRIAL	CICLO BASICO EL FURRIAL	1524	3	27	1170	717	1143	0	10	0	1	415	1170
EDO. MONAGAS	CE. MATURIN	PQ. EL FURRIAL	CENTRO DE EDUCACIÓN INICIAL FELICIA RONDON DE CABELLO	592	1	7	507	385	500	0	4	0	0	111	507
EDO. MONAGAS	CE. MATURIN	PQ. EL FURRIAL	ESCUELA BÁSICA ROBERTO GÓMEZ DOFOURT	1436	3	32	1226	695	1194	0	8	0	0	491	1226
EDO. MONAGAS	CE. MATURIN	PQ. LAS COCUIZAS	LICEO RAFAEL MARIA PEÑA SAAVEDRA	1235	3	14	1083	420	1069	0	7	2	0	640	1083
EDO. MONAGAS	CE. MATURIN	PQ. LAS COCUIZAS	JARDIN DE INFANCIA SOLEDAD CLAVIER	1677	3	22	1386	588	1364	0	8	0	1	767	1386
EDO. MONAGAS	CE. MATURIN	PQ. LAS COCUIZAS	ESCUELA BASICA CECILIO ACOSTA	3013	6	48	2343	1373	2295	0	15	1	0	906	2343
EDO. MONAGAS	CE. MATURIN	PQ. LAS COCUIZAS	MODULO DE SERVICIOS LOS CORTIJOS	1850	4	33	1535	882	1502	0	11	1	1	607	1535
EDO. MONAGAS	CE. MATURIN	PQ. LAS COCUIZAS	COMPLEJO EDUCATIVO NACIONAL ANDRES BELLO	3539	7	72	2842	1758	2770	0	22	1	2	987	2842
EDO. MONAGAS	CE. MATURIN	PQ. LAS COCUIZAS	COMPLEJO EDUCATIVO NACIONAL LEONARDO INFANTE	4888	9	66	4310	1425	4244	0	21	0	0	2798	4310
EDO. MONAGAS	CE. MATURIN	PQ. LAS COCUIZAS	COMPLEJO EDUCATIVO GENERAL EZEQUIEL ZAMORA	715	2	24	614	432	590	0	5	1	0	152	614
EDO. MONAGAS	CE. MATURIN	PQ. LAS COCUIZAS	MODULO POLICIAL DEL PARQUE PADILLA RON	540	1	6	473	286	467	0	4	0	0	177	473
EDO. MONAGAS	CE. MATURIN	PQ. LAS COCUIZAS	INSTITUTO NACIONAL DE COOPERACIÓN EDUCATIVA (INCES)	1883	4	28	1516	810	1488	0	9	0	1	668	1516
EDO. MONAGAS	CE. MATURIN	PQ. LAS COCUIZAS	ESCUELA PRIMARIA NACIONAL MEREYAL	1295	3	30	1080	713	1050	1	10	0	1	325	1080
EDO. MONAGAS	CE. MATURIN	PQ. LAS COCUIZAS	COMPLEJO EDUCATIVO  ANGEL DE LA GUARDA FE Y ALEGRÍA	3628	7	42	2704	1864	2662	0	25	3	2	768	2704
EDO. MONAGAS	CE. MATURIN	PQ. LAS COCUIZAS	ESCUELA NACIONAL INICIAL SIMONCITO LA FLORECITA	483	1	20	416	251	396	1	4	0	1	139	416
EDO. MONAGAS	CE. MATURIN	PQ. LAS COCUIZAS	COMPLEJO EDUCATIVO CREACION EL PARQUECITO	916	2	16	788	512	772	0	7	0	0	253	788
EDO. MONAGAS	CE. MATURIN	PQ. LAS COCUIZAS	CENTRO DE SERVICIO SOCIAL RESIDENCIAL Y AMBULATORIO DOCTOR MARCOS SERRES PADILLA	405	1	7	370	269	363	0	2	1	1	90	370
EDO. MONAGAS	CE. MATURIN	PQ. LAS COCUIZAS	CV MOVIL CANCHA DEPORTIVA LA BATEA	230	1	4	208	116	204	0	2	0	0	86	208
EDO. MONAGAS	CE. MATURIN	PQ. LAS COCUIZAS	CENTRO DE EDUCACIÓN INICIAL BOLIVARIANO CECILIA NÚÑEZ SUCRE	1225	3	25	937	449	912	0	6	0	1	456	937
EDO. MONAGAS	CE. MATURIN	PQ. LAS COCUIZAS	CENTRO DE NIÑO Y FAMILIA AGUSTIN SALAZAR	1079	2	18	903	625	885	0	6	0	0	254	903
EDO. MONAGAS	CE. MATURIN	PQ. LAS COCUIZAS	CASA BOLIVARIANA DE LA MUJER LA CONSTITUYENTE	642	2	11	501	410	490	0	3	0	0	77	501
EDO. MONAGAS	CE. MATURIN	PQ. LAS COCUIZAS	ESCUELA BASICA FEDERICO HANDS	2891	5	24	2219	1078	2195	2	10	2	3	1100	2219
EDO. MONAGAS	CE. MATURIN	PQ. LAS COCUIZAS	UNIDAD EDUCATIVA JESUS DE NAZARETH	2020	4	38	1660	1235	1622	1	13	3	0	370	1660
EDO. MONAGAS	CE. MATURIN	PQ. LAS COCUIZAS	ESCUELA TECNICA AGROPECUARIA ROBINSONIANA SIMON BOLIVAR	326	1	6	290	199	284	0	2	0	0	83	290
EDO. MONAGAS	CE. MATURIN	PQ. LAS COCUIZAS	LICEO NACIONAL PABLO NERUDA	341	1	11	289	170	278	0	2	0	0	106	289
EDO. MONAGAS	CE. MATURIN	PQ. LAS COCUIZAS	ESCUELA BASICA INES BALCENA DE MOTA	1012	2	19	741	435	722	0	4	0	0	283	741
EDO. MONAGAS	CE. MATURIN	PQ. LAS COCUIZAS	ESCUELA BASICA PRIMERO DE MAYO	4007	7	66	3213	2138	3147	1	23	2	1	982	3213
EDO. MONAGAS	CE. MATURIN	PQ. LAS COCUIZAS	CASA DE ABRIGO JOSE MERCEDES SANTELIZ	665	2	13	589	398	576	0	3	0	2	173	589
EDO. MONAGAS	CE. MATURIN	PQ. LAS COCUIZAS	ESCUELA BASICA PABLO EMILIO CASTILLO	3503	6	44	2860	1398	2816	1	19	2	2	1394	2860
EDO. MONAGAS	CE. MATURIN	PQ. LAS COCUIZAS	COMPLEJO EDUCATIVO NACIONAL 4 DE FEBRERO	361	1	5	303	251	298	0	7	0	0	40	303
EDO. MONAGAS	CE. MATURIN	PQ. LAS COCUIZAS	ESCUELA BASICA FRANCISCO DE MIRANDA	1441	3	19	1182	702	1163	0	8	0	0	453	1182
EDO. MONAGAS	CE. MATURIN	PQ. LAS COCUIZAS	ESCUELA BASICA SIMON RODRIGUEZ	2023	4	31	1639	1015	1608	0	9	3	0	581	1639
EDO. MONAGAS	CE. MATURIN	PQ. LAS COCUIZAS	ESCUELA BÁSICA GREGORIO RONDÓN	3298	6	56	2579	1411	2523	0	20	1	1	1090	2579
EDO. MONAGAS	CE. MATURIN	PQ. LAS COCUIZAS	TALLER DE EDUCACION LABORAL BOLIVARIANO AYACUCHO	268	1	3	240	140	237	0	3	0	0	94	240
EDO. MONAGAS	CE. MATURIN	PQ. LAS COCUIZAS	ESCUELA BASICA BOLIVARIANA PEDRO MAXIMO CAMPOS	1543	3	23	1210	717	1187	0	6	2	0	462	1210
EDO. MONAGAS	CE. MATURIN	PQ. LAS COCUIZAS	ESCUELA TECNICA INDUSTRIAL (ETI)	1279	3	20	1069	587	1049	0	11	0	1	450	1069
EDO. MONAGAS	CE. MATURIN	PQ. LAS COCUIZAS	CENTRO DE EDUCACIÓN INICIAL DOÑA FAUSTINA SAEZ DE ALFARO	1532	3	26	1247	583	1221	0	4	0	0	634	1247
EDO. MONAGAS	CE. MATURIN	PQ. LAS COCUIZAS	COMPLEJO EDUCATIVO NACIONAL DOCTOR ERNESTO CHE GUEVARA	304	1	4	257	224	253	0	0	0	0	29	257
EDO. MONAGAS	CE. MATURIN	PQ. LAS COCUIZAS	ESCUELA BASICA DANILO ANDERSON	311	1	5	260	219	255	0	0	0	0	36	260
EDO. MONAGAS	MP. EZEQUIEL ZAMORA	CM. PUNTA DE MATA	CENTRO DE EDUCACION INICIAL JUAN JOSE LANDAETA	622	2	7	539	471	532	0	3	0	0	58	539
EDO. MONAGAS	MP. EZEQUIEL ZAMORA	CM. PUNTA DE MATA	ESCUELA BASICA MUSIPAN	816	2	30	684	509	654	0	1	0	1	143	684
EDO. MONAGAS	MP. EZEQUIEL ZAMORA	CM. PUNTA DE MATA	SIMONCITO INTERNO 24 DE JUNIO	572	1	15	510	452	495	0	1	0	0	42	510
EDO. MONAGAS	MP. EZEQUIEL ZAMORA	CM. PUNTA DE MATA	LICEO BOLIVARIANO GENERAL RAFAEL URDANETA	566	1	9	473	320	464	0	0	0	0	144	473
EDO. MONAGAS	MP. EZEQUIEL ZAMORA	CM. PUNTA DE MATA	ESCUELA BASICA CENTURION	1752	3	39	1439	749	1400	0	11	1	0	639	1439
EDO. MONAGAS	MP. EZEQUIEL ZAMORA	CM. PUNTA DE MATA	UNIDAD EDUCATIVA BOLIVARIANA DON ANDRES BELLO	271	1	9	213	176	204	0	0	0	0	28	213
EDO. MONAGAS	MP. EZEQUIEL ZAMORA	CM. PUNTA DE MATA	ESCUELA BASICA NICOLAS ARANGUREN	2658	5	54	2235	1440	2181	0	13	3	0	725	2235
EDO. MONAGAS	MP. EZEQUIEL ZAMORA	CM. PUNTA DE MATA	UNIDAD EDUCATIVA EZEQUIEL ZAMORA	1548	3	33	1267	725	1234	1	6	1	0	501	1267
EDO. MONAGAS	MP. EZEQUIEL ZAMORA	CM. PUNTA DE MATA	ESCUELA BASICA 19 DE ABRIL	2118	4	49	1744	1153	1695	0	11	1	2	528	1744
EDO. MONAGAS	MP. EZEQUIEL ZAMORA	CM. PUNTA DE MATA	ESCUELA BASICA MENCA DE LEONI	2418	5	53	2066	1074	2013	0	9	1	1	928	2066
EDO. MONAGAS	MP. EZEQUIEL ZAMORA	CM. PUNTA DE MATA	ESCUELA BASICA ALBERTO RAVELL	3014	6	50	2382	1345	2332	0	15	1	1	970	2382
EDO. MONAGAS	MP. EZEQUIEL ZAMORA	CM. PUNTA DE MATA	ESCUELA BASICA BOLIVARIANA FRANCISCO DE MIRANDA	882	2	13	767	561	754	2	8	0	0	183	767
EDO. MONAGAS	MP. EZEQUIEL ZAMORA	CM. PUNTA DE MATA	UNIDAD EDUCATIVA PRIVADA CAYETANO FARIAS	622	2	6	553	365	547	0	3	0	0	179	553
EDO. MONAGAS	MP. EZEQUIEL ZAMORA	CM. PUNTA DE MATA	ESCUELA BASICA CREACION LAS PARCELAS	2500	5	61	2056	1323	1995	1	16	1	0	654	2056
EDO. MONAGAS	MP. EZEQUIEL ZAMORA	CM. PUNTA DE MATA	ESCUELA BASICA VIRGEN DEL VALLE	1354	3	33	1152	814	1119	0	5	0	0	300	1152
EDO. MONAGAS	MP. EZEQUIEL ZAMORA	CM. PUNTA DE MATA	UNIDAD EDUCATIVA PRIVADA NUESTRA SANTA PATRONA	1071	2	10	951	466	941	1	5	0	0	469	951
EDO. MONAGAS	MP. EZEQUIEL ZAMORA	CM. PUNTA DE MATA	ESCUELA BASICA JOSE GREGORIO MONAGAS	1567	3	29	1328	717	1299	1	6	0	0	575	1328
EDO. MONAGAS	MP. EZEQUIEL ZAMORA	CM. PUNTA DE MATA	GRUPO ESCOLAR RAFAEL VILLAVICENCIO	2933	5	57	2336	1209	2279	1	13	0	2	1054	2336
EDO. MONAGAS	MP. EZEQUIEL ZAMORA	CM. PUNTA DE MATA	ESCUELA BASICA BOLIVARIANA ILAPECA	2245	4	34	1782	1083	1748	1	14	1	1	648	1782
EDO. MONAGAS	MP. EZEQUIEL ZAMORA	CM. PUNTA DE MATA	ESCUELA BASICA BOLIVARIANA EL POTRERO	547	1	14	470	323	456	0	2	0	0	131	470
EDO. MONAGAS	MP. EZEQUIEL ZAMORA	CM. PUNTA DE MATA	ESCUELA BASICA 18 DE MAYO	2884	6	46	2347	1441	2301	0	15	2	0	843	2347
EDO. MONAGAS	MP. EZEQUIEL ZAMORA	PQ. EL TEJERO	COMPLEJO EDUCATIVO NACIONAL SANTA BARBARA	775	2	25	692	461	667	1	1	0	0	204	692
EDO. MONAGAS	MP. EZEQUIEL ZAMORA	PQ. EL TEJERO	UNIDAD EDUCATIVA LUIS BELTRAN PRIETO FIGUEROA	2141	4	48	1715	1019	1667	0	8	2	1	637	1715
EDO. MONAGAS	MP. EZEQUIEL ZAMORA	PQ. EL TEJERO	ESCUELA BASICA CREACION EL TEJERO II	1874	4	43	1506	998	1463	1	4	0	0	460	1506
EDO. MONAGAS	MP. EZEQUIEL ZAMORA	PQ. EL TEJERO	ESCUELA BÁSICA LISANDRO RIVERO	2727	5	68	2247	1393	2179	0	11	0	0	775	2247
EDO. MONAGAS	MP. AGUASAY	CM. AGUASAY	CENTRO CULTURAL AGUASAY	1693	3	27	1351	752	1324	0	9	1	0	562	1351
EDO. MONAGAS	MP. AGUASAY	CM. AGUASAY	ESCUELA NACIONAL ANTONIO CILIBERTO PEREZ	2387	5	46	1957	1154	1911	0	18	1	0	738	1957
EDO. MONAGAS	MP. AGUASAY	CM. AGUASAY	ESCUELA BASICA CONCENTRADA BOCAS DE TONORO	356	1	5	281	193	276	0	5	0	0	78	281
EDO. MONAGAS	MP. AGUASAY	CM. AGUASAY	ESCUELA BASICA BOLIVARIANA ALTAMIRA	1224	3	51	967	653	916	0	2	0	0	261	967
EDO. MONAGAS	MP. AGUASAY	CM. AGUASAY	ESCUELA BASICA CONCENTRADA LA INGLESA	582	1	7	432	266	425	0	1	0	0	158	432
EDO. MONAGAS	MP. AGUASAY	CM. AGUASAY	ESCUELA BASICA UNITARIA SAN JOSE DE ÑATO	582	1	10	452	257	442	0	2	0	0	183	452
EDO. MONAGAS	MP. AGUASAY	CM. AGUASAY	ESCUELA BASICA BOLIVARIANA ORITUPANO	241	1	8	215	186	207	0	0	0	0	21	215
EDO. MONAGAS	MP. AGUASAY	CM. AGUASAY	UNIDAD EDUCATIVA FE Y ALEGRIA	1386	3	22	1108	675	1086	1	10	2	0	398	1108
EDO. MONAGAS	MP. AGUASAY	CM. AGUASAY	ESCUELA PRIMARIA NACIONAL  PERIQUITO	515	1	9	410	181	401	0	2	0	0	218	410
EDO. MONAGAS	MP. AGUASAY	CM. AGUASAY	ESCUELA PRIMARIA NACIONAL BOLIVARIANA EL CARO	710	2	9	543	368	534	0	2	0	0	164	543
EDO. MONAGAS	MP. AGUASAY	CM. AGUASAY	ESCUELA BASICA BOLIVARIANA LAS GAVIOTAS	459	1	5	361	290	356	0	2	0	0	64	361
EDO. MONAGAS	MP. AGUASAY	CM. AGUASAY	ESCUELA BASICA CONCENTRADA LA PULVIA	549	1	13	440	301	427	0	6	0	0	120	440
EDO. BOLIVAR	MP. BLVNO ANGOSTURA	PQ. SAN FRANCISCO	ESCUELA CONCENTRADA INTEGRAL SANTIAGO IZAGUIRREZ 2	545	1	11	432	301	421	0	4	0	0	116	432
EDO. BOLIVAR	MP. BLVNO ANGOSTURA	PQ. SAN FRANCISCO	UNIDAD EDUCATIVA NACIONAL SAN FRANCISCO	202	1	2	161	102	159	0	0	0	0	57	161
EDO. BOLIVAR	MP. BLVNO ANGOSTURA	PQ. SAN FRANCISCO	UNIDAD EDUCATIVA NACIONAL BASICA CHAGUARAMOS	151	1	1	133	91	132	0	0	0	0	41	133
EDO. BOLIVAR	MP. BLVNO ANGOSTURA	PQ. SAN FRANCISCO	ESCUELA BASICA NACIONAL SANTIAGO IZAGUIRRE	3130	6	61	2166	1267	2105	1	15	3	0	819	2166
EDO. BOLIVAR	MP. BLVNO ANGOSTURA	PQ. SAN FRANCISCO	ESCUELA BASICA UNITARIA JUAS JUAL 1	63	1	0	50	45	50	0	0	0	0	5	50
EDO. BOLIVAR	MP. BLVNO ANGOSTURA	PQ. SAN FRANCISCO	ESCUELA BASICA NACIONAL UNITARIA SAN ANTONIO	104	1	0	84	56	84	0	0	0	0	28	84
EDO. BOLIVAR	MP. BLVNO ANGOSTURA	PQ. SAN FRANCISCO	COLEGIO SAN JUAN BAUTISTA	97	1	0	50	49	50	0	0	0	0	1	50
EDO. BOLIVAR	MP. BLVNO ANGOSTURA	PQ. SAN FRANCISCO	ESCUELA BASICA NACIONAL UNITARIA LOS MONOS NUCLEO ESCOLAR RURAL 188	59	1	6	45	33	39	0	0	1	0	5	45
EDO. BOLIVAR	MP. BLVNO ANGOSTURA	PQ. SAN FRANCISCO	UNIDAD EDUCATIVA NACIONAL BOLIVARIANA LA ISLA NUCLEO ESCOLAR RURAL 188	268	1	2	229	196	227	0	0	1	0	30	229
EDO. BOLIVAR	MP. BLVNO ANGOSTURA	PQ. SAN FRANCISCO	ESCUELA INTEGRAL BOLIVARIANA EL CERRITO	421	1	18	327	263	309	0	3	0	0	43	327
EDO. BOLIVAR	MP. BLVNO ANGOSTURA	PQ. SAN FRANCISCO	ESCUELA BASICA NACIONAL UNITARIA LA CONQUISTA	62	1	0	56	35	56	0	0	0	0	21	56
EDO. BOLIVAR	MP. BLVNO ANGOSTURA	PQ. BARCELONETA	ESCUELA BASICA NACIONAL UNITARIA LA FRITERA
EDO. BOLIVAR	MP. BLVNO ANGOSTURA	PQ. BARCELONETA	UNIDAD EDUCATIVA FRANCISCO JAVIER YANEZ	1382	3	22	906	436	884	1	6	0	0	441	906
EDO. BOLIVAR	MP. BLVNO ANGOSTURA	PQ. BARCELONETA	ESCUELA BASICA BOLIVARIANA LA PERIQUERA
EDO. BOLIVAR	MP. BLVNO ANGOSTURA	PQ. BARCELONETA	UNIDAD EDUCATIVA NACIONAL AEROPUERTO	531	1	12	364	218	352	0	3	0	0	131	364
EDO. BOLIVAR	MP. BLVNO ANGOSTURA	PQ. BARCELONETA	ESCUELA BASICA INTEGRAL MANACAL
EDO. BOLIVAR	MP. BLVNO ANGOSTURA	PQ. BARCELONETA	ESCUELA ESTADAL CONCENTRADA Nº 292300 SAN SALVADOR DE PAUL
EDO. BOLIVAR	MP. BLVNO ANGOSTURA	PQ. BARCELONETA	ESCUELA BASICA UNITARIA EL CASABE NUMERO 236	830	2	8	400	356	392	3	1	1	0	31	400
EDO. BOLIVAR	MP. BLVNO ANGOSTURA	PQ. BARCELONETA	ESCUELA BASICA ESTADAL. EL CRISTO	717	2	8	518	243	510	0	4	0	0	263	518
EDO. BOLIVAR	MP. BLVNO ANGOSTURA	PQ. BARCELONETA	CENTRO DE EDUCACIÒN INTEGRAL BOLIVARIANO CAMPO GRANDE. EL CHIGUAO
EDO. BOLIVAR	MP. BLVNO ANGOSTURA	PQ. BARCELONETA	UNIDAD EDUCATIVA NACIONAL BASICA KARUM
EDO. BOLIVAR	MP. BLVNO ANGOSTURA	PQ. BARCELONETA	ESCUELA NACIONAL MAMA EULALIA II	147	1	1	109	93	108	0	0	2	0	13	109
EDO. BOLIVAR	MP. BLVNO ANGOSTURA	PQ. BARCELONETA	ESCUELA BASICA NACIONAL BOLIVARIANA LAS BONITAS
EDO. BOLIVAR	MP. BLVNO ANGOSTURA	PQ. BARCELONETA	ESCUELA ESTADAL UNITARIA LOS YOPITOS	336	1	4	234	183	230	0	1	1	0	45	234
EDO. BOLIVAR	MP. BLVNO ANGOSTURA	PQ. BARCELONETA	UNIDAD EDUCATIVA NACIONAL IMATACA	2842	5	41	1729	769	1688	1	16	2	1	899	1729
EDO. BOLIVAR	MP. BLVNO ANGOSTURA	PQ. BARCELONETA	ESCUELA INTEGRAL BOLIVARIANA PARUPA
EDO. BOLIVAR	MP. BLVNO ANGOSTURA	PQ. SANTA BARBARA	ESCUELA INTEGRAL BOLIVARIANA NUEVA FORTUNA	303	1	4	190	115	186	1	2	0	0	68	190
EDO. BOLIVAR	MP. BLVNO ANGOSTURA	PQ. SANTA BARBARA	ESCUELA BASICA SANTA BARBARA	1640	3	43	1213	658	1170	0	9	0	1	502	1213
EDO. BOLIVAR	MP. BLVNO ANGOSTURA	PQ. SANTA BARBARA	ESCUELA MUNICIPAL LA GRAN VIA	91	1	1	61	46	60	0	0	0	0	14	61
EDO. BOLIVAR	MP. BLVNO ANGOSTURA	PQ. SANTA BARBARA	ESCUELA UNITARIA COSTA RICA	97	1	2	41	25	39	0	0	0	0	14	41
EDO. BOLIVAR	MP. BLVNO ANGOSTURA	CM. CIUDAD PIAR	ESCUELA NACIONAL UNITARIA 3105	154	1	0	64	38	64	0	1	0	0	25	64
EDO. BOLIVAR	MP. BLVNO ANGOSTURA	CM. CIUDAD PIAR	ESCUELA BOLIVARIANA NACIONAL MEREICITO	100	1	5	81	45	76	0	2	0	1	28	81
EDO. BOLIVAR	MP. BLVNO ANGOSTURA	CM. CIUDAD PIAR	UNIDAD EDUCATIVA BOLIVARIANA TOCOMA	1785	3	27	1353	759	1326	0	9	0	1	557	1353
EDO. BOLIVAR	MP. BLVNO ANGOSTURA	CM. CIUDAD PIAR	ESCUELA CONCENTRADA ESTADAL 3 124 127 ( LUISA CACERES DE ARISMENDI )	330	1	5	219	157	214	0	1	0	0	56	219
EDO. BOLIVAR	MP. BLVNO ANGOSTURA	CM. CIUDAD PIAR	FUNDACION CULTIRAL GURI	864	2	16	691	572	675	0	4	0	0	99	691
EDO. BOLIVAR	MP. BLVNO ANGOSTURA	CM. CIUDAD PIAR	UNIDAD EDUCATIVA GENERAL PIAR	3933	7	42	3163	1191	3121	0	21	2	1	1906	3163
EDO. BOLIVAR	MP. BLVNO ANGOSTURA	CM. CIUDAD PIAR	LINO MARADEI DONATO	507	1	8	403	221	395	0	1	0	0	173	403
EDO. BOLIVAR	MP. BLVNO ANGOSTURA	CM. CIUDAD PIAR	COLEGIO DIVINA PASTORA	524	1	2	410	161	408	0	5	0	0	242	410
EDO. BOLIVAR	MP. BLVNO ANGOSTURA	CM. CIUDAD PIAR	ESCUELA ESTADAL JOSE MANUEL AGOSTO MENDEZ	392	1	2	221	166	219	0	1	0	0	52	221
EDO. BOLIVAR	MP. BLVNO ANGOSTURA	CM. CIUDAD PIAR	ESCUELA INTEGRAL BOLIBARIANA PUEBLO GURI	2527	5	32	1843	930	1811	1	9	3	1	867	1843
EDO. BOLIVAR	MP. GRAN SABANA	CM. SANTA ELENA DE UAIREN	UNIDAD EDUCATIVA NACIONAL CANAIMA	703	2	8	292	206	284	0	0	1	0	77	292
EDO. BOLIVAR	MP. GRAN SABANA	CM. SANTA ELENA DE UAIREN	CASA DE LA CULTURA LUCAS FERNANDEZ PEÑA	1862	4	31	1251	627	1220	0	9	0	0	584	1251
EDO. BOLIVAR	MP. GRAN SABANA	CM. SANTA ELENA DE UAIREN	SEDE MISION BUENA VISTA WAIPARU	201	1	4	158	138	154	1	1	1	0	13	158
EDO. BOLIVAR	MP. GRAN SABANA	CM. SANTA ELENA DE UAIREN	ESCUELA NACIONAL UNITARIA	396	1	11	275	221	264	1	0	1	1	40	275
EDO. BOLIVAR	MP. GRAN SABANA	CM. SANTA ELENA DE UAIREN	ESCUELA NACIONAL UNITARIA SIN NUMERO	923	2	8	370	302	362	2	2	2	1	53	370
EDO. BOLIVAR	MP. GRAN SABANA	CM. SANTA ELENA DE UAIREN	ESCUELA CONCENTRADA NERI 486	186	1	0	95	59	95	0	0	0	0	36	95
EDO. BOLIVAR	MP. GRAN SABANA	CM. SANTA ELENA DE UAIREN	UNIDAD EDUCATIVA COMERCIAL NICOLAS MESA	1752	3	23	1187	550	1164	0	6	0	2	606	1187
EDO. BOLIVAR	MP. GRAN SABANA	CM. SANTA ELENA DE UAIREN	ESCUELA  MANAKRI	1072	2	32	796	448	764	0	3	1	1	311	796
EDO. BOLIVAR	MP. GRAN SABANA	CM. SANTA ELENA DE UAIREN	ESCUELA BASICA NER. PARAITEPUY DE RORAIMA	174	1	0	134	101	134	0	0	0	0	33	134
EDO. BOLIVAR	MP. GRAN SABANA	CM. SANTA ELENA DE UAIREN	ESCUELA BASICA NACIONAL KANAVAYEN	725	2	18	467	302	449	2	15	2	0	128	467
EDO. BOLIVAR	MP. GRAN SABANA	CM. SANTA ELENA DE UAIREN	ESCUELA NACIONAL BASICA  DOCTOR JUAN DE HOLQUINST	2046	4	30	1334	650	1304	1	10	1	0	642	1334
EDO. BOLIVAR	MP. GRAN SABANA	CM. SANTA ELENA DE UAIREN	OFICINA  NACIONAL DE IDENTIFICACIÒN Y EXTRANJERIA DE SANTA ELENA DE UAIREN	902	2	27	632	280	605	2	3	2	0	318	632
EDO. BOLIVAR	MP. GRAN SABANA	CM. SANTA ELENA DE UAIREN	ESCUELA CONCENTRADA APOIPO NERI 486	296	1	3	185	160	182	3	4	0	0	15	185
EDO. BOLIVAR	MP. GRAN SABANA	CM. SANTA ELENA DE UAIREN	ESCUELA NACIONAL CONCENTRADA NERI MAPAURI	222	1	6	141	123	135	0	3	1	0	8	141
EDO. BOLIVAR	MP. GRAN SABANA	CM. SANTA ELENA DE UAIREN	ESCUELA BASICA NUMERO 486 SAN ANTONIO MORICHAL	253	1	2	212	142	210	0	2	0	0	66	212
EDO. BOLIVAR	MP. GRAN SABANA	CM. SANTA ELENA DE UAIREN	ESCUELA NACIONAL CONCENTRADA NUMERO 1081 URIMAN	811	2	11	183	134	172	0	1	2	0	35	183
EDO. BOLIVAR	MP. GRAN SABANA	CM. SANTA ELENA DE UAIREN	ESCUELA NACIONAL CONCENTRADA MIXTA SIN NUMERO Nº 169	611	2	12	470	300	458	0	12	2	1	143	470
EDO. BOLIVAR	MP. GRAN SABANA	CM. SANTA ELENA DE UAIREN	ESCUELA BRISAS DE UAIREN	945	2	17	723	300	706	1	4	0	1	400	723
EDO. BOLIVAR	MP. GRAN SABANA	CM. SANTA ELENA DE UAIREN	UNIDAD EDUCATIVA ESCUELA NACIONAL GRANJA WONKEN
EDO. BOLIVAR	MP. GRAN SABANA	CM. SANTA ELENA DE UAIREN	UNIDAD EDUCATIVA MUNICIPAL FRANCISCO MICHELENA Y ROJAS	489	1	10	372	137	362	0	4	1	1	219	372
EDO. BOLIVAR	MP. GRAN SABANA	CM. SANTA ELENA DE UAIREN	ESCUELA BASICA GRAN SABANA	430	1	10	316	200	306	0	4	1	0	101	316
EDO. BOLIVAR	MP. GRAN SABANA	CM. SANTA ELENA DE UAIREN	ESCUELA INTEGRAL BOLIVARIANA SANTO DOMINGO DE TURASEN	39	1	1	36	30	35	0	1	0	0	4	36
EDO. BOLIVAR	MP. GRAN SABANA	CM. SANTA ELENA DE UAIREN	CHIRICAYEN	152	1	0	141	131	141	0	1	0	0	9	141
EDO. BOLIVAR	MP. GRAN SABANA	CM. SANTA ELENA DE UAIREN	ESCUELA INTEGRAL BOLIVARIANA  WARA	194	1	3	159	130	156	0	0	1	0	25	159
EDO. BOLIVAR	MP. GRAN SABANA	CM. SANTA ELENA DE UAIREN	ESCUELA UNITARIA MAURAK NACIONAL SIN NUMERO	690	2	15	465	348	450	2	9	2	0	89	465
EDO. BOLIVAR	MP. GRAN SABANA	CM. SANTA ELENA DE UAIREN	ESCUELA MISION CAPUCHINO KUANA	79	1	1	38	36	37	0	0	0	0	1	38
EDO. BOLIVAR	MP. GRAN SABANA	CM. SANTA ELENA DE UAIREN	UNIDAD EDUCATIVA INTEGRAL SANTA RITA	503	1	5	356	157	351	0	2	0	0	192	356
EDO. BOLIVAR	MP. GRAN SABANA	CM. SANTA ELENA DE UAIREN	ESCUELA UNITARIA EULOGIO DE VILLARRIN
EDO. BOLIVAR	MP. GRAN SABANA	CM. SANTA ELENA DE UAIREN	ESCUELA NACIONAL WARIWANTEY	257	1	2	174	133	172	2	3	0	1	33	174
EDO. BOLIVAR	MP. GRAN SABANA	CM. SANTA ELENA DE UAIREN	CASA COMUNAL KEWEY I	947	2	18	700	401	682	0	0	1	3	277	700
EDO. BOLIVAR	MP. GRAN SABANA	PQ. IKABARU	ESCUELA NACIONAL EDUCACIONAL CONCENTRADA SIN NUMERO PARKUPI	178	1	2	102	73	100	1	3	0	0	23	102
EDO. BOLIVAR	MP. GRAN SABANA	PQ. IKABARU	ESCUELA BASICA NER. NUMERO 486	278	1	3	152	113	149	0	0	0	0	36	152
EDO. BOLIVAR	MP. GRAN SABANA	PQ. IKABARU	ESCUELA NACIONAL CONCENTRADA SIN  NUMERO 172	1044	2	10	467	230	457	0	0	1	0	226	467
EDO. BOLIVAR	MP. ROSCIO	CM. GUASIPATI	ESCUELA UNITARIA MIXTA NUMERO 152	507	1	12	352	180	340	0	2	0	0	158	352
EDO. BOLIVAR	MP. ROSCIO	CM. GUASIPATI	JARDIN DE INFANCIA LA TEJERIA	251	1	5	205	118	200	0	1	0	0	81	205
EDO. BOLIVAR	MP. ROSCIO	CM. GUASIPATI	UNIDAD EDUCATIVA NACIONAL AEROPUERTO	646	2	11	509	294	498	0	1	0	0	203	509
EDO. BOLIVAR	MP. ROSCIO	CM. GUASIPATI	ESCUELA BASICA RURAL UNITARIA SANTA BARBARA	211	1	3	124	41	121	0	3	0	0	77	124
EDO. BOLIVAR	MP. ROSCIO	CM. GUASIPATI	ESCUELA ESTADAL BASICA JOSE MARIA EMAZABEL	2195	4	42	1692	739	1650	0	12	1	0	898	1692
EDO. BOLIVAR	MP. ROSCIO	CM. GUASIPATI	PREPARATORIA DIVINO NIÑO	1012	2	20	774	313	754	0	5	2	0	434	774
EDO. BOLIVAR	MP. ROSCIO	CM. GUASIPATI	ESCUELA BASICA CARMITA RAVAGO	2229	4	61	1741	965	1680	1	11	1	0	702	1741
EDO. BOLIVAR	MP. ROSCIO	CM. GUASIPATI	UNIDAD EDUCATIVA DALLA ACOSTA	3240	6	71	2511	1030	2440	0	14	0	1	1395	2511
EDO. BOLIVAR	MP. ROSCIO	CM. GUASIPATI	JARDIN DE INFANCIA TORIBIO MUÑOZ	532	1	8	438	238	430	0	3	0	0	189	438
EDO. BOLIVAR	MP. ROSCIO	CM. GUASIPATI	ESCUELA NACIONAL UNITARIA NUMERO 155	733	2	14	608	324	594	0	4	0	0	266	608
EDO. BOLIVAR	MP. ROSCIO	CM. GUASIPATI	ESCUELA ESTADAL UNITARIA  240	283	1	10	213	107	203	0	0	1	0	95	213
EDO. BOLIVAR	MP. ROSCIO	CM. GUASIPATI	UNIDAD EDUCATIVA NACIONAL EDUARDO OXFORD	2177	4	25	1679	667	1654	1	12	0	1	973	1679
EDO. BOLIVAR	MP. ROSCIO	CM. GUASIPATI	ESCUELA ESTADAL UNITARIA NUMERO 189	88	1	3	58	15	55	0	0	0	0	40	58
EDO. BOLIVAR	MP. ROSCIO	CM. GUASIPATI	ESCUELA ESTADAL BASICA SIN NUMERO AGUA CLARA	379	1	8	237	135	229	0	0	1	0	93	237
EDO. BOLIVAR	MP. ROSCIO	CM. GUASIPATI	ESCUELA  ESTADAL NUMERO 311, MODESTO VILLALOBOS	1055	2	27	844	347	817	0	7	1	0	462	844
EDO. BOLIVAR	MP. ROSCIO	PQ. SALOM	ESCUELA CONCENTRADA RURAL 281 314 1282	955	2	33	728	396	695	0	6	1	0	292	728
EDO. BOLIVAR	MP. ROSCIO	PQ. SALOM	ESCUELA CONCENTRADA RURAL NUMERO 301 SIN NUMERO	465	1	11	372	119	361	0	0	0	0	242	372
EDO. BOLIVAR	MP. CEDE#O	PQ. LA URBANA	ESCUELA BASICA SIN NUMERO	498	1	3	314	258	311	0	2	1	0	50	314
EDO. BOLIVAR	MP. CEDE#O	PQ. LA URBANA	ESCUELA ESTADAL BASICA JOSE MIGUEL BIEROLD	1250	3	7	887	582	880	0	0	0	0	298	887
EDO. BOLIVAR	MP. CEDE#O	PQ. LA URBANA	ESCUELA BASICA NACIONAL UNITARIA BOLIVARIANA COLORADO	47	1	0	40	40	40	0	0	0	0	0	40
EDO. BOLIVAR	MP. CEDE#O	CM. CAICARA DEL ORINOCO	ESCUELA ESTADAL CONCENTRADA MIXTA 197 SIN NUMERO	279	1	1	196	125	195	0	1	0	0	69	196
EDO. BOLIVAR	MP. CEDE#O	CM. CAICARA DEL ORINOCO	ESCUELA BASICA SIMON BOLIVAR	1231	3	19	930	610	911	1	3	1	0	296	930
EDO. BOLIVAR	MP. CEDE#O	CM. CAICARA DEL ORINOCO	ESCUELA BASICA LUCILA PALACIOS	3069	6	58	2284	1632	2226	3	10	1	0	580	2284
EDO. BOLIVAR	MP. CEDE#O	CM. CAICARA DEL ORINOCO	ESCUELA  ESTADAL CONCENTRADA 192 354 Y SIN NUMERO	270	1	1	205	171	204	0	0	0	0	33	205
EDO. BOLIVAR	MP. CEDE#O	CM. CAICARA DEL ORINOCO	ESCUELA NACIONAL BASICA DOCTOR MANUEL SALVADOR GOMEZ	2591	5	42	1927	1092	1885	0	10	8	1	774	1927
EDO. BOLIVAR	MP. CEDE#O	CM. CAICARA DEL ORINOCO	ESCUELA NACIONAL UNITARIA MIXTA NUMERO 101	276	1	2	164	155	162	0	0	0	0	7	164
EDO. BOLIVAR	MP. CEDE#O	CM. CAICARA DEL ORINOCO	ESCUELA NACIONAL CONCENTRADA 328 SIN NUMERO	485	1	10	346	249	336	0	0	0	0	87	346
EDO. BOLIVAR	MP. CEDE#O	CM. CAICARA DEL ORINOCO	ESCUELA ESTADAL BETTY DE HERRERA	449	1	8	318	210	310	0	0	0	0	100	318
EDO. BOLIVAR	MP. CEDE#O	CM. CAICARA DEL ORINOCO	ESCUELA ESTADAL BASICA EL RODEO	184	1	0	106	74	106	0	0	0	0	32	106
EDO. BOLIVAR	MP. CEDE#O	CM. CAICARA DEL ORINOCO	UNIDAD EDUCATIVA ESTADAL JUSEPA	979	2	12	782	636	770	0	2	1	0	131	782
EDO. BOLIVAR	MP. CEDE#O	CM. CAICARA DEL ORINOCO	ESCUELA ESTADAL BASICA RURAL GUANIAMITO	375	1	4	239	176	235	0	1	0	0	58	239
EDO. BOLIVAR	MP. CEDE#O	CM. CAICARA DEL ORINOCO	ESCUELA BARBARA DE LUJAN	1027	2	17	797	498	780	0	3	0	0	279	797
EDO. BOLIVAR	MP. CEDE#O	CM. CAICARA DEL ORINOCO	ESCUELA UNITARIA MIXTA SIN NUMERO	548	1	11	353	296	342	1	0	1	1	43	353
EDO. BOLIVAR	MP. CEDE#O	CM. CAICARA DEL ORINOCO	ESCUELA ESTADAL CONCENTRADA 272 EL TIGRE	765	2	6	413	343	407	1	1	0	0	62	413
EDO. BOLIVAR	MP. CEDE#O	CM. CAICARA DEL ORINOCO	UNIDAD EDUCATIVA BOLIVARIANA CHAVIRIPA	130	1	7	122	113	115	0	0	0	0	2	122
EDO. BOLIVAR	MP. CEDE#O	CM. CAICARA DEL ORINOCO	ESC.INT.BOLIVARIANA MORICHALITO	1747	3	29	1270	743	1241	0	2	0	1	495	1270
EDO. BOLIVAR	MP. CEDE#O	CM. CAICARA DEL ORINOCO	ESCUELA NACIONAL UNITARIA NUMERO 1475	496	1	2	348	309	346	0	2	1	0	34	348
EDO. BOLIVAR	MP. CEDE#O	CM. CAICARA DEL ORINOCO	ESCUELA NACIONAL CONCENTRADA 329 358	474	1	2	244	200	242	0	3	0	0	39	244
EDO. BOLIVAR	MP. CEDE#O	CM. CAICARA DEL ORINOCO	ESCUELA ESTADAL UNITARIA NUMERO 196	240	1	1	101	84	100	0	0	1	0	15	101
EDO. BOLIVAR	MP. CEDE#O	CM. CAICARA DEL ORINOCO	ESCUELA ESTADAL UNITARIA NUMERO 195	99	1	0	65	47	65	0	1	0	0	17	65
EDO. BOLIVAR	MP. CEDE#O	CM. CAICARA DEL ORINOCO	COLEGIO TOMAS DE HERES	683	2	5	534	317	529	0	4	1	0	207	534
EDO. BOLIVAR	MP. CEDE#O	CM. CAICARA DEL ORINOCO	ESCUELA NACIONAL UNITARIA NUMERO 100 Y SIN NUMERO	340	1	2	222	180	220	0	1	1	0	38	222
EDO. BOLIVAR	MP. CEDE#O	CM. CAICARA DEL ORINOCO	LICEO NACIONAL LUCILA PALACIOS	589	1	8	482	378	474	0	2	0	0	94	482
EDO. BOLIVAR	MP. CEDE#O	CM. CAICARA DEL ORINOCO	UNIDAD EDUCATIVA MANUEL CEDEÑO	2490	5	28	1779	1106	1751	1	9	1	0	634	1779
EDO. BOLIVAR	MP. CEDE#O	CM. CAICARA DEL ORINOCO	ESCUELA ESTADAL BOLIVARIANA EL RINCON	1716	3	35	1225	749	1190	0	6	1	0	434	1225
EDO. BOLIVAR	MP. CEDE#O	CM. CAICARA DEL ORINOCO	ESCUELA BASICA MANUEL MANRIQUE	2979	6	46	2193	1302	2147	0	12	2	0	831	2193
EDO. BOLIVAR	MP. CEDE#O	CM. CAICARA DEL ORINOCO	UNIDAD EDUCATIVA ESTADAL LA TEJA	387	1	7	311	197	304	0	0	1	1	105	311
EDO. BOLIVAR	MP. CEDE#O	CM. CAICARA DEL ORINOCO	ESCUELA BASICA ROMULO GALLEGOS	2809	5	57	2020	1573	1963	0	8	1	0	381	2020
EDO. BOLIVAR	MP. CEDE#O	CM. CAICARA DEL ORINOCO	ESCUELA ESTADAL CONCENTRADA 149 SIN NUMERO	475	1	5	206	167	201	0	3	0	0	31	206
EDO. BOLIVAR	MP. CEDE#O	PQ. GUANIAMO	ESCUELA MUNICIPAL UNITARIA SIN NUMERO	115	1	0	35	22	35	0	0	0	0	13	35
EDO. BOLIVAR	MP. CEDE#O	PQ. GUANIAMO	ESCUELA EL MILAGRO
EDO. BOLIVAR	MP. CEDE#O	PQ. GUANIAMO	ESCUELA CONCENTRADA MIXTA LA SALVACION	313	1	1	127	76	126	0	0	0	0	50	127
EDO. BOLIVAR	MP. CEDE#O	PQ. GUANIAMO	ESCUELA INTEGRAL BOLIVARIANA RIMO AJE
EDO. BOLIVAR	MP. CEDE#O	PQ. PIJIGUAOS	ESCUELA BASICA RURAL LA IGUANITA	122	1	1	83	75	82	0	0	0	0	7	83
EDO. BOLIVAR	MP. CEDE#O	PQ. PIJIGUAOS	ESCUELA BASICA RURAL TIERRA BLANCA	145	1	4	70	60	66	0	0	0	0	6	70
EDO. BOLIVAR	MP. CEDE#O	PQ. PIJIGUAOS	ESCUELA BASICA MUNICIPAL EL POTRERO	236	1	6	164	124	158	1	0	1	0	32	164
EDO. BOLIVAR	MP. CEDE#O	PQ. PIJIGUAOS	ESCUELA INTEGRAL BOLIVARIANA BATALLA DE PICHINCHA	163	1	0	138	124	138	0	0	0	0	14	138
EDO. BOLIVAR	MP. CEDE#O	PQ. PIJIGUAOS	ESCUELA UNITARIA MIXTA NUMERO 265 GARZONCITO DE ORO	191	1	8	109	84	101	0	0	0	0	17	109
EDO. BOLIVAR	MP. CEDE#O	PQ. PIJIGUAOS	ESCUELA BASICA MIGUEL OTERO SILVA	2388	5	46	1749	1393	1703	1	9	1	0	299	1749
EDO. BOLIVAR	MP. CEDE#O	PQ. PIJIGUAOS	UNIDAD EDUCATIVA TRAPICHOTE	1239	3	28	996	572	968	0	9	2	0	385	996
EDO. BOLIVAR	MP. CEDE#O	PQ. PIJIGUAOS	ESCUELA INTEGRAL BOLIVARIANA TERESA CARREÑO	200	1	1	182	173	181	0	0	0	0	8	182
EDO. BOLIVAR	MP. CEDE#O	PQ. PIJIGUAOS	ESCUELA INTEGRAL BOLIVARIANA EL PALOMO	90	1	0	73	69	73	0	0	0	0	4	73
EDO. BOLIVAR	MP. CEDE#O	PQ. PIJIGUAOS	UNIDAD DUCATIVAE 215 Y 265 LOS PIJIGUAO	758	2	10	600	430	590	0	0	0	1	159	600
EDO. BOLIVAR	MP. CEDE#O	PQ. PIJIGUAOS	UNIDAD EDUCATIVA VICENTE EMILIO SOJO	34	1	0	28	24	28	0	0	0	0	4	28
EDO. BOLIVAR	MP. CEDE#O	PQ. ASCENSION FARRERAS	ESCUELA MUNICIPAL NUMERO 295	235	1	3	152	122	149	0	0	0	0	27	152
EDO. BOLIVAR	MP. CEDE#O	PQ. ASCENSION FARRERAS	SAN JOSE DE KAYAMA
EDO. BOLIVAR	MP. CEDE#O	PQ. ASCENSION FARRERAS	ESCUELA BASICA RURAL LAGUNA SUCIA	452	1	3	254	169	251	0	0	0	0	82	254
EDO. BOLIVAR	MP. CEDE#O	PQ. ASCENSION FARRERAS	ESCUELA NACIONAL BASICA CUYUNI	1693	3	37	1220	687	1183	0	13	0	1	482	1220
EDO. BOLIVAR	MP. CEDE#O	PQ. ASCENSION FARRERAS	ESCUELA NACIONAL CONCENTRADA 313 Y SIN NUMERO	116	1	2	70	49	68	0	0	0	0	19	70
EDO. BOLIVAR	MP. CEDE#O	PQ. ASCENSION FARRERAS	UNIDAD EDUCATIVA BOLIVARIANA LA COLMENA	72	1	7	62	48	55	0	0	0	0	7	62
EDO. BOLIVAR	MP. CEDE#O	PQ. ASCENSION FARRERAS	ESCUELA ESTADAL UNITARIA NUMERO 208	194	1	1	115	67	114	0	0	1	0	46	115
EDO. BOLIVAR	MP. CEDE#O	PQ. ASCENSION FARRERAS	ESCUELA CONCENTRADA NUMERO 134 SIN NUMERO	357	1	7	259	213	252	0	0	1	0	38	259
EDO. BOLIVAR	MP. CEDE#O	PQ. ASCENSION FARRERAS	ESCUELA CONCENTRADA ESTADAL MIXTA 207 224 SIN NUMERO	288	1	6	227	188	221	0	3	0	0	30	227
EDO. BOLIVAR	MP. CEDE#O	PQ. ASCENSION FARRERAS	ESCUELA ESTADAL CONCENTRADA MIXTA 202 114	425	1	3	274	135	271	0	0	0	0	136	274
EDO. BOLIVAR	MP. CEDE#O	PQ. ASCENSION FARRERAS	ESCUELA CONCENTRADA ESTADAL MIXTA 205 336	364	1	7	265	202	258	0	2	0	0	54	265
EDO. BOLIVAR	MP. CEDE#O	PQ. ASCENSION FARRERAS	ESCUELA NACIONAL CONCENTRADA SIN NUMERO	578	1	6	427	321	421	0	2	0	0	98	427
EDO. BOLIVAR	MP. CEDE#O	PQ. ASCENSION FARRERAS	ESCUELA NACIONAL UNITARIA MIXTA NUMERO 120	315	1	2	157	125	155	0	1	0	0	29	157
EDO. BOLIVAR	MP. CEDE#O	PQ. ASCENSION FARRERAS	ESCUELA ESTADAL CONCENTRADA 121 SIN NUMERO	130	1	1	93	64	92	0	1	0	0	27	93
EDO. BOLIVAR	MP. CEDE#O	PQ. ALTAGRACIA	ESCUELA ESTADAL UNITARIA MIXTA NUMERO 253	151	1	3	82	76	79	0	0	0	0	3	82
EDO. BOLIVAR	MP. CEDE#O	PQ. ALTAGRACIA	ESCUELA ESTADAL CONCENTRADA NUMERO 212 SIN NUMERO 307	434	1	6	319	282	313	0	0	0	0	31	319
EDO. BOLIVAR	MP. CEDE#O	PQ. ALTAGRACIA	ESCUELA CONCENTRADA NACIONAL NUMERO 260 3242 SIN NUMERO	693	2	30	518	399	488	0	0	0	0	89	518
EDO. BOLIVAR	MP. PIAR	CM. UPATA	ESCUELA ESTADAL CONCENTRADA Nº 286 SIN NUMERO	678	2	10	500	327	490	0	7	0	0	156	500
EDO. BOLIVAR	MP. PIAR	CM. UPATA	UNIVERSIDAD EXPERIMENTAL DE GUAYANA NUCLEO UPATA	557	1	11	478	195	467	0	1	2	0	269	478
EDO. BOLIVAR	MP. PIAR	CM. UPATA	UNIDAD EDUCATIVA ESTADAL JOSE ANTONIO ANZOATEGUI	2946	5	46	2329	881	2283	1	10	4	0	1387	2329
EDO. BOLIVAR	MP. PIAR	CM. UPATA	UNIDAD EDUCATIVA ESTADAL HUMBERTO BARTORI	627	2	19	540	253	521	0	5	0	1	262	540
EDO. BOLIVAR	MP. PIAR	CM. UPATA	ESCUELA INTEGRAL BOLIVARIANA EL BUEY
EDO. BOLIVAR	MP. PIAR	CM. UPATA	ESCUELA NACIONAL GRADUADA SANTA ROSA	1066	2	18	833	423	815	0	8	1	0	383	833
EDO. BOLIVAR	MP. PIAR	CM. UPATA	UNIDAD EDUCATIVA SIMON RODRIGUEZ	3792	7	63	2963	1496	2900	1	18	2	0	1383	2963
EDO. BOLIVAR	MP. PIAR	CM. UPATA	ESCUELA NACIONAL GRADUADA LOS ROSOS	2217	4	44	1622	906	1578	0	13	2	0	657	1622
EDO. BOLIVAR	MP. PIAR	CM. UPATA	DISTRITO ESCOLAR NUMERO 6	956	2	13	772	317	759	1	3	0	0	438	772
EDO. BOLIVAR	MP. PIAR	CM. UPATA	UNIDAD EDUCATIVA ESTADAL RAUL LEONI	1676	3	30	1350	509	1320	1	6	1	1	802	1350
EDO. BOLIVAR	MP. PIAR	CM. UPATA	UNIDAD EDUCATIVA NACIONAL SANTA MARIA	952	2	24	710	263	686	0	9	0	0	414	710
EDO. BOLIVAR	MP. PIAR	CM. UPATA	UNIDAD EDUCATIVA BOLIVARIANA ALTAGRACIA	286	1	10	247	120	237	0	2	0	0	115	247
EDO. BOLIVAR	MP. PIAR	CM. UPATA	ESCUELA ESTADAL CONCENTRADA MIXTA 92 SIN NUMERO 2913	1351	3	22	1015	513	993	0	9	1	0	470	1015
EDO. BOLIVAR	MP. PIAR	CM. UPATA	ESCUELA BASICA ESTADAL JOSE MANUEL SISO MARTINEZ	1921	4	33	1483	557	1450	0	10	2	0	881	1483
EDO. BOLIVAR	MP. PIAR	CM. UPATA	ESCUELA BASICA NACIONAL ISAURA GOMEZ DE AYALA	2108	4	37	1740	839	1703	1	3	2	0	858	1740
EDO. BOLIVAR	MP. PIAR	CM. UPATA	ESCUELA BASICA NACIONAL UPATA	1398	3	30	1179	552	1149	1	10	0	1	585	1179
EDO. BOLIVAR	MP. PIAR	CM. UPATA	ESCUELA NACIONAL BASICA SAN ANTONIO	3800	7	69	3025	1377	2956	2	24	3	0	1550	3025
EDO. BOLIVAR	MP. PIAR	CM. UPATA	ESCUELA NACIONAL BASICA SANTIAGO MARIÑO	5566	10	90	4557	1495	4467	0	31	2	0	2939	4557
EDO. BOLIVAR	MP. PIAR	CM. UPATA	CICLO DIVERSIFICADO TAVERA ACOSTA	4506	8	68	3619	1278	3551	0	35	1	2	2235	3619
EDO. BOLIVAR	MP. PIAR	CM. UPATA	INSTITUTO PRIVADO SAN ANTONIO	730	2	15	627	199	612	0	5	0	0	408	627
EDO. BOLIVAR	MP. PIAR	CM. UPATA	UNIDAD EDUCATIVA ESTADAL FRANCISCO GUEDEZ COLMENARES	1594	3	38	1308	709	1270	0	11	0	0	550	1308
EDO. BOLIVAR	MP. PIAR	CM. UPATA	COLEGIO PRIVADO MARIA INMACULADA	2293	4	45	1958	559	1913	0	13	2	0	1339	1958
EDO. BOLIVAR	MP. PIAR	CM. UPATA	ESCUELA BASICA CONCENTRADA ESTADAL MATAJEY	212	1	2	96	49	94	0	0	0	0	45	96
EDO. BOLIVAR	MP. PIAR	CM. UPATA	ESCUELA NACIONAL CONCENTRADA MIXTA 2259 1362	657	2	18	531	209	513	0	3	0	0	301	531
EDO. BOLIVAR	MP. PIAR	CM. UPATA	ESCUELA TECNICA AGROPECUARIA  MONSEOR GARCIA MOHEDANO	1042	2	27	818	352	791	0	7	0	0	432	818
EDO. BOLIVAR	MP. PIAR	CM. UPATA	ESCUELA ESTADAL CONCENTRADA CARLOS ENRIQUE ALVAREZ	1139	2	16	931	340	915	0	7	0	0	568	931
EDO. BOLIVAR	MP. PIAR	CM. UPATA	ESCUELA NACIONAL BASICA MORALES MARCANO	5458	10	91	4450	1758	4359	0	30	1	0	2570	4450
EDO. BOLIVAR	MP. PIAR	CM. UPATA	UNIDAD EDUCATIVA ESTADAL SIMON BOLIVAR	1396	3	41	1109	510	1068	1	10	1	0	546	1109
EDO. BOLIVAR	MP. PIAR	CM. UPATA	ESCUELA NACIONAL BASICA SANTO DOMINGO	3340	6	50	2710	915	2660	0	13	1	0	1731	2710
EDO. BOLIVAR	MP. PIAR	CM. UPATA	NUCLEO ESCOLAR RURAL  NUMERO 7 UNIDAD EDUCATIVA BASICA NACIONAL CONCENTRADA NUMERO 2384 3406	926	2	24	744	412	720	1	5	0	1	301	744
EDO. BOLIVAR	MP. PIAR	CM. UPATA	UNIDAD EDUCATIVA PRIVADA GENERAL MANUEL CARLOS PIAR	1023	2	21	878	373	857	0	6	0	0	478	878
EDO. BOLIVAR	MP. PIAR	CM. UPATA	UNIDAD  EDUCATIVA JOSE LUIS ARISTIGUETA	803	2	16	673	382	657	0	4	1	0	270	673
EDO. BOLIVAR	MP. PIAR	CM. UPATA	ESCUELA NACIONAL UNITARIA 924	384	1	4	267	125	263	1	4	1	0	132	267
EDO. BOLIVAR	MP. PIAR	CM. UPATA	ESCUELA ESTADAL CONCENTRADA SAN LORENZO	1654	3	39	1296	527	1257	0	8	0	0	722	1296
EDO. BOLIVAR	MP. PIAR	PQ. ANDRES ELOY BLANCO	ESCUELA ESTADAL CONCENTRADA NUMERO 85 125 143	626	2	8	465	254	457	0	4	0	0	199	465
EDO. BOLIVAR	MP. PIAR	PQ. ANDRES ELOY BLANCO	ESCUELA AUTONOMA EL PAO	1189	2	16	945	427	929	0	8	0	0	494	945
EDO. BOLIVAR	MP. PIAR	PQ. ANDRES ELOY BLANCO	ESCUELA BASICA ESTADAL DOCTOR JOSE MANUEL SISO MARTINEZ	615	2	15	493	279	478	0	3	0	0	196	493
EDO. BOLIVAR	MP. PIAR	PQ. ANDRES ELOY BLANCO	ESCUELA ESTADAL BASICA CONCENTRADA MINA ABAJO   NUCLEO ESCOLAR RURAL NUMERO 83	801	2	9	546	454	537	0	1	0	0	82	546
EDO. BOLIVAR	MP. PIAR	PQ. ANDRES ELOY BLANCO	ESCUELA NACIONAL CONCENTRADA 265	467	1	10	317	219	307	1	3	0	0	84	317
EDO. BOLIVAR	MP. PIAR	PQ. ANDRES ELOY BLANCO	ESCUELA ESTADAL GRADUADA ENRIQUETA DE PEREZ	1210	3	22	927	629	905	0	9	0	1	266	927
EDO. BOLIVAR	MP. PIAR	PQ. ANDRES ELOY BLANCO	ESCUELA ESTADAL GRADUADA ANITA A CASTRO	913	2	20	752	459	732	0	8	1	1	263	752
EDO. BOLIVAR	MP. PIAR	PQ. ANDRES ELOY BLANCO	LICEO INTEGRAL BOLIVARIANO SIMON BARCELO	463	1	4	386	234	382	1	2	0	0	145	386
EDO. BOLIVAR	MP. PIAR	PQ. PEDRO COVA	ESCUELA ESTADAL CONCENTRADA NUMERO 122 Y SIN NUMERO	665	2	6	440	219	434	0	5	0	1	209	440
EDO. BOLIVAR	MP. PIAR	PQ. PEDRO COVA	ESCUELA NACIONAL UNITARIA NUMERO 3264	217	1	3	145	67	142	0	1	0	0	74	145
EDO. BOLIVAR	MP. PIAR	PQ. PEDRO COVA	UNIDAD EDUCATIVA MORENO DE MENDOZA	4271	8	91	2800	1118	2709	0	14	0	0	1577	2800
EDO. BOLIVAR	MP. PIAR	PQ. PEDRO COVA	ESCUELA INTEGRAL BOLIVARIANA EL PLOMO	193	1	4	145	133	141	0	0	0	0	8	145
EDO. BOLIVAR	MP. PIAR	PQ. PEDRO COVA	ESCUELA BOLIVARIANA CERRO GRANDE	42	1	0	23	21	23	0	1	0	0	1	23
EDO. BOLIVAR	MP. PIAR	PQ. PEDRO COVA	UNIDAD EDUCATIVA BOLIVARIANA EL CARMEN	290	1	2	221	215	219	0	0	0	0	4	221
EDO. BOLIVAR	MP. PIAR	PQ. PEDRO COVA	ESCUELA ESTADAL UNITARIA NUMERO 147	188	1	1	113	36	112	0	1	0	0	75	113
EDO. BOLIVAR	MP. SIFONTES	PQ. DALLA COSTA	ESCUELA BASICA KAMARIA PAYAPAL	196	1	0	110	104	110	0	1	1	0	4	110
EDO. BOLIVAR	MP. SIFONTES	PQ. DALLA COSTA	LICEO MIGUEL ANTONIO MEJIAS	1149	2	15	784	519	769	0	7	0	0	243	784
EDO. BOLIVAR	MP. SIFONTES	PQ. DALLA COSTA	ESCUELA UNITARIA MIXTA SIN NUMERO	430	1	1	248	241	247	0	1	1	0	4	248
EDO. BOLIVAR	MP. SIFONTES	PQ. DALLA COSTA	ESCUELA NACIONAL CONCENTRADA SIN  NUMERO 263	712	2	6	463	444	457	2	0	0	0	11	463
EDO. BOLIVAR	MP. SIFONTES	PQ. DALLA COSTA	ESCUELA NACIONAL YURUARY	2879	5	37	1720	972	1683	4	20	0	0	687	1720
EDO. BOLIVAR	MP. SIFONTES	CM. TUMEREMO	ESCUELA ESTADAL HORACIO CABRERA SIFONTES	1859	4	34	1367	582	1333	0	9	0	0	742	1367
EDO. BOLIVAR	MP. SIFONTES	CM. TUMEREMO	ESCUELA LA MANGA	3510	7	47	2382	1264	2335	1	19	3	0	1048	2382
EDO. BOLIVAR	MP. SIFONTES	CM. TUMEREMO	ESCUELA ESTADAL CONCENTRADA NUMERO 115 219 LAS TRES ROSAS	1939	4	31	1454	565	1423	0	8	0	3	847	1454
EDO. BOLIVAR	MP. SIFONTES	CM. TUMEREMO	ESCUELA BASICA NACIONAL UNITARIA SAN JUAN DE VENAMO NUCLEO ESCOLAR RRURAL 495
EDO. BOLIVAR	MP. SIFONTES	CM. TUMEREMO	UNIDAD EDUCATIVA NACIONAL  LA CARATICA	2390	5	31	1574	641	1543	1	13	1	1	886	1574
EDO. BOLIVAR	MP. SIFONTES	CM. TUMEREMO	ESCUELA NACIONAL UNITARIA SIN NUMERO	635	2	7	325	247	318	0	8	0	0	63	325
EDO. BOLIVAR	MP. SIFONTES	CM. TUMEREMO	UNIDAD EDUCATIVA BOLIVARIANA DOCTOR  JOSE MIGUEL NUÑEZ	855	2	26	588	261	562	0	5	1	0	295	588
EDO. BOLIVAR	MP. SIFONTES	CM. TUMEREMO	LICEO MONSEÑOR ZABALETA	1389	3	22	992	461	970	2	13	1	0	493	992
EDO. BOLIVAR	MP. SIFONTES	CM. TUMEREMO	ESCUELA UNITARIA ESPERANZA KILOMETRO 50 FE Y ALEGRIA	299	1	1	148	145	147	0	1	0	0	1	148
EDO. BOLIVAR	MP. SIFONTES	CM. TUMEREMO	ESCUELA CONCENTRADA NUMERO 217 EL PARICHE	921	2	43	643	245	600	0	10	1	1	343	643
EDO. BOLIVAR	MP. SIFONTES	CM. TUMEREMO	ESCUELA NACIONAL BASICA VICENTE MARCANO	3868	7	75	2567	1088	2492	2	21	1	0	1380	2567
EDO. BOLIVAR	MP. SIFONTES	CM. TUMEREMO	ESCUELA MUNICIPAL SIFONTES	802	2	24	586	316	562	0	5	1	0	240	586
EDO. BOLIVAR	MP. SIFONTES	PQ. SAN ISIDRO	ESCUELA NACIONAL CONCENTRADA SIN NUMERO	1116	2	21	614	372	593	1	12	1	1	206	614
EDO. BOLIVAR	MP. SIFONTES	PQ. SAN ISIDRO	ESCUELA ESTADAL CONCENTRADA SANTA TERESITA DE GUAYANA	514	1	4	286	231	282	0	0	0	0	51	286
EDO. BOLIVAR	MP. SIFONTES	PQ. SAN ISIDRO	FE Y ALEGRIA	558	1	7	364	277	357	0	7	0	1	72	364
EDO. BOLIVAR	MP. SIFONTES	PQ. SAN ISIDRO	MISION JUAN XXIII	3806	7	82	2380	1633	2298	4	24	2	0	635	2380
EDO. BOLIVAR	MP. EL CALLAO	CM. EL CALLAO	ESCUELA ESTADAL CONCENTRADA 164	730	2	7	528	178	521	1	4	0	0	338	528
EDO. BOLIVAR	MP. EL CALLAO	CM. EL CALLAO	ESCUELA NACIONAL BASICA JOSE SOLANO	735	2	18	509	213	491	0	3	0	0	275	509
EDO. BOLIVAR	MP. EL CALLAO	CM. EL CALLAO	UNIDAD EDUCATIVA BOLIVARIANA NACUPAY	406	1	13	270	84	257	0	1	0	0	172	270
EDO. BOLIVAR	MP. EL CALLAO	CM. EL CALLAO	ESCUELA CONCENTRADA LA RAMONA	777	2	20	605	314	585	0	6	1	0	264	605
EDO. BOLIVAR	MP. EL CALLAO	CM. EL CALLAO	ESCUELA RURAL SIN NUMERO. EL CHOCO	305	1	7	230	111	223	0	1	0	0	111	230
EDO. BOLIVAR	MP. EL CALLAO	CM. EL CALLAO	ESCUELA NACIONAL BASICA NICOLAS ANTONIO FARRERA	5060	9	125	3809	1236	3684	2	15	0	2	2429	3809
EDO. BOLIVAR	MP. EL CALLAO	CM. EL CALLAO	UNIDAD EDUCATIVA NACIONAL JOSE MANUEL AGOSTO MENDEZ	2832	5	50	2260	733	2210	0	10	1	1	1465	2260
EDO. BOLIVAR	MP. EL CALLAO	CM. EL CALLAO	CENTRO DE EDUCACION INICIAL NELLYS SANCHEZ DE ANDRADE (SIMONCITO)	1014	2	17	815	354	798	0	5	0	0	439	815
EDO. BOLIVAR	MP. EL CALLAO	CM. EL CALLAO	ESCUELA UNITARIA NUMERO 135	500	1	5	354	118	349	1	0	0	0	230	354
EDO. BOLIVAR	MP. EL CALLAO	CM. EL CALLAO	ESCUELA ESTADAL UNITARIA NUMERO 239	988	2	22	724	260	702	1	3	0	0	438	724
EDO. BOLIVAR	MP. EL CALLAO	CM. EL CALLAO	ESCUELA BASICA RURAL LA GASOLINA	2383	5	78	1791	841	1713	2	14	1	0	855	1791
EDO. BOLIVAR	MP. EL CALLAO	CM. EL CALLAO	ESCUELA NACIONAL CONCENTRADA NUMERO 123	634	2	13	439	222	426	0	6	0	0	198	439
EDO. BOLIVAR	MP. CARONI	PQ. YOCOIMA	ESCUELA ESTADAL CONCENTRADA 12 301	1004	2	16	656	435	640	1	6	0	0	198	656
EDO. BOLIVAR	MP. CARONI	PQ. YOCOIMA	ESCUELA ESTADAL BASICA 11 DE ABRIL	1983	4	34	1589	1188	1555	1	16	3	0	347	1589
EDO. BOLIVAR	MP. CARONI	PQ. YOCOIMA	ESCUELA CONCENTRADA JUANA DE CAMPOS	1558	3	24	1164	813	1140	2	9	0	2	314	1164
EDO. BOLIVAR	MP. CARONI	PQ. YOCOIMA	ESCUELA NACIONAL CONCENTRADA 2246 2972 2989 3171	1261	3	24	963	628	939	1	7	1	0	302	963
EDO. BOLIVAR	MP. CARONI	PQ. YOCOIMA	ESCUELA MUNICIPAL CONCENTRADA VICENTE SALIAS	1822	4	20	1373	983	1353	0	9	2	0	359	1373
EDO. BOLIVAR	MP. CARONI	PQ. YOCOIMA	ESCUELA INTEGRAL BOLIVARIANA BATALLA DE CHIRICA	361	1	7	296	247	289	0	1	1	0	40	296
EDO. BOLIVAR	MP. CARONI	PQ. YOCOIMA	UNIDAD EDUCATIVA NACIONAL EL ROSARIO	105	1	3	78	62	75	0	1	0	0	12	78
EDO. BOLIVAR	MP. CARONI	PQ. YOCOIMA	ESCUELA BASICA RURAL 19 DE ABRIL II	76	1	1	48	36	47	0	0	0	0	11	48
EDO. BOLIVAR	MP. CARONI	PQ. SIMON BOLIVAR	UNIDAD EDUCATIVA NACIONAL ALEJANDRO OTERO	4460	8	104	3941	1951	3837	0	35	2	4	1845	3941
EDO. BOLIVAR	MP. CARONI	PQ. SIMON BOLIVAR	ESCUELA ESTADAL BASICA JOSE LUIS GUZMAN	1572	3	22	1227	752	1205	1	8	1	0	443	1227
EDO. BOLIVAR	MP. CARONI	PQ. SIMON BOLIVAR	ESCUELA TECNICA INDUSTRIAL RAUL LEONI OTERO	664	2	11	549	289	538	1	7	1	0	240	549
EDO. BOLIVAR	MP. CARONI	PQ. SIMON BOLIVAR	INCE INDUSTRIAL METAL MECANICO	134	1	4	118	61	114	0	2	0	0	51	118
EDO. BOLIVAR	MP. CARONI	PQ. SIMON BOLIVAR	CENTRO COMUNAL CORPORACIÓN  VENEZOLANA GUAYANA	480	1	7	396	207	389	0	1	0	0	181	396
EDO. BOLIVAR	MP. CARONI	PQ. SIMON BOLIVAR	FUNDACION LA SALLE	2391	5	26	2086	921	2060	1	8	1	3	1126	2086
EDO. BOLIVAR	MP. CARONI	PQ. SIMON BOLIVAR	ESCUELA NACIONAL BASICA JUAN VICENTE CARDOZO	3906	7	50	3361	1377	3311	0	14	1	1	1918	3361
EDO. BOLIVAR	MP. CARONI	PQ. SIMON BOLIVAR	CENTRO DE EDUCACION INICIAL LA UNIDAD	317	1	17	257	152	240	0	1	0	0	87	257
EDO. BOLIVAR	MP. CARONI	PQ. SIMON BOLIVAR	ESCUELA CONCENTRADA NACIONAL NUMERO 2212	674	2	9	559	315	550	0	4	2	1	228	559
EDO. BOLIVAR	MP. CARONI	PQ. SIMON BOLIVAR	ESCUELA BASICA NACIONAL BACHILLER FELIPE HERNANDEZ	3163	6	47	2582	1591	2535	2	20	1	1	920	2582
EDO. BOLIVAR	MP. CARONI	PQ. SIMON BOLIVAR	ESCUELA NACIONAL BASICA MIGUEL MARMION	3061	6	38	2519	1279	2481	1	18	1	1	1181	2519
EDO. BOLIVAR	MP. CARONI	PQ. SIMON BOLIVAR	ESCUELA NACIONAL BASICA CIUDAD PIAR	3324	6	50	2767	1415	2717	0	15	4	1	1282	2767
EDO. BOLIVAR	MP. CARONI	PQ. SIMON BOLIVAR	UNIDAD EDUCATIVA NACIONAL JOSE GABRIEL MACHADO	1581	3	13	1392	567	1379	1	3	2	0	806	1392
EDO. BOLIVAR	MP. CARONI	PQ. SIMON BOLIVAR	CICLO DIVERSIFIVADO MANUEL PIAR	3074	6	37	2511	1223	2474	1	13	2	3	1232	2511
EDO. BOLIVAR	MP. CARONI	PQ. SIMON BOLIVAR	JARDIN DE INFANCIA BOLIVARIANO DOCTOR JOSE ANGEL RUIZ	875	2	14	691	385	677	1	7	0	0	284	691
EDO. BOLIVAR	MP. CARONI	PQ. SIMON BOLIVAR	CENTRO COMUNAL SAN RAFAEL	294	1	3	261	170	258	0	1	0	0	87	261
EDO. BOLIVAR	MP. CARONI	PQ. SIMON BOLIVAR	ESCUELA NACIONAL BASICA JOSE ANGEL RUIZ	1901	4	29	1533	843	1504	1	21	1	0	638	1533
EDO. BOLIVAR	MP. CARONI	PQ. SIMON BOLIVAR	ESCUELA NACIONAL BASICA JOSE TOMAS MACHADO	1571	3	15	1369	479	1354	1	7	0	0	867	1369
EDO. BOLIVAR	MP. CARONI	PQ. SIMON BOLIVAR	INSTITUTO ESCUELA ESPECIAL SIMON BOLIVAR	1378	3	20	1182	485	1162	0	5	0	1	671	1182
EDO. BOLIVAR	MP. CARONI	PQ. SIMON BOLIVAR	ESCUELA NACIONAL BASICA SAN FELIX	2015	4	29	1542	783	1513	0	18	1	2	709	1542
EDO. BOLIVAR	MP. CARONI	PQ. SIMON BOLIVAR	ESCUELA NACIONAL BASICA LA RINCONADA	2526	5	36	2010	1305	1974	0	24	1	2	642	2010
EDO. BOLIVAR	MP. CARONI	PQ. SIMON BOLIVAR	FUNDACION CENTRO DE FORMACION DE TRABAJADORES DE GUAYANA	1326	3	15	1092	606	1077	0	7	0	0	464	1092
EDO. BOLIVAR	MP. CARONI	PQ. SIMON BOLIVAR	JARDIN DE INFANCIA BOLIVARIANO BACHILLER FELIPE HERNANDEZ	1021	2	21	831	529	810	2	6	0	0	273	831
EDO. BOLIVAR	MP. CARONI	PQ. SIMON BOLIVAR	ESCUELA ESTADAL BASICA SILVANA DE IRADI	3214	6	82	2541	1322	2459	1	13	0	0	1123	2541
EDO. BOLIVAR	MP. CARONI	PQ. SIMON BOLIVAR	CICLO BASICO INTEGRAL CECILIO ACOSTA	1053	2	15	841	489	826	0	6	0	0	331	841
EDO. BOLIVAR	MP. CARONI	PQ. SIMON BOLIVAR	CASA DEL MAESTRO	165	1	2	143	97	141	0	0	0	0	44	143
EDO. BOLIVAR	MP. CARONI	PQ. SIMON BOLIVAR	ESCUELA NACIONAL BASICA MERCEDES PROSPERT	1487	3	14	1172	568	1158	0	8	0	1	581	1172
EDO. BOLIVAR	MP. CARONI	PQ. SIMON BOLIVAR	ESCUELA BASICA PRIVADA EMMANUEL I	897	2	11	610	226	599	0	9	0	0	364	610
EDO. BOLIVAR	MP. CARONI	PQ. SIMON BOLIVAR	LICEO NACIONAL BICENTENARIO	193	1	4	167	95	163	0	2	0	0	66	167
EDO. BOLIVAR	MP. CARONI	PQ. SIMON BOLIVAR	CICLO BASICO COMUN RAMON ANTONIO PEREZ	2228	4	57	1822	1203	1765	0	15	0	0	547	1822
EDO. BOLIVAR	MP. CARONI	PQ. SIMON BOLIVAR	ESCUELA UNITARIA MUNICIPAL HUMBERTO CAPARONI	124	1	1	107	91	106	0	1	1	0	13	107
EDO. BOLIVAR	MP. CARONI	PQ. SIMON BOLIVAR	JARDIN DE INFANCIA MERCEDES PROSPERT	803	2	9	642	331	633	0	5	0	0	297	642
EDO. BOLIVAR	MP. CARONI	PQ. SIMON BOLIVAR	UNIDAD EDUCATIVA PALUA	1531	3	19	1267	676	1248	0	12	0	0	560	1267
EDO. BOLIVAR	MP. CARONI	PQ. SIMON BOLIVAR	ESCUELA JOSE FELIX RIBAS	1384	3	21	1061	637	1040	2	7	0	0	394	1061
EDO. BOLIVAR	MP. CARONI	PQ. SIMON BOLIVAR	ESCUELA NACIONAL BASICA ANTONIO DE BERRIOS	3899	7	59	2840	1524	2781	2	21	3	2	1229	2840
EDO. BOLIVAR	MP. CARONI	PQ. VISTA AL SOL	CASA COMUNAL RAFAEL URDANETA	136	1	0	107	86	107	0	0	0	0	21	107
EDO. BOLIVAR	MP. CARONI	PQ. VISTA AL SOL	ESCUELA TECNICA COMERCIAL MANUEL JARA COLMENARES	3473	6	47	2660	1913	2613	1	20	2	1	676	2660
EDO. BOLIVAR	MP. CARONI	PQ. VISTA AL SOL	ESCUELA BASICA CREACION LA VICTORIA	1708	3	42	1411	1110	1369	0	6	0	0	253	1411
EDO. BOLIVAR	MP. CARONI	PQ. VISTA AL SOL	ESCUELA NACIONAL BASICA VISTA AL SOL	4686	9	64	3597	2455	3533	1	31	5	2	1039	3597
EDO. BOLIVAR	MP. CARONI	PQ. VISTA AL SOL	ESCUELA ESTADAL CRISTOBAL COLON	3404	6	56	2603	1938	2547	1	19	4	1	584	2603
EDO. BOLIVAR	MP. CARONI	PQ. VISTA AL SOL	ESCUELA BASICA FE Y ALEGRIA NUEVA GUAYANA	6410	12	139	5012	3558	4873	2	38	1	1	1273	5012
EDO. BOLIVAR	MP. CARONI	PQ. VISTA AL SOL	UNIDAD EDUCATIVA DIVINO NIÑO DE LA FE VALLE	83	1	1	64	37	63	0	1	0	0	25	64
EDO. BOLIVAR	MP. CARONI	PQ. VISTA AL SOL	ESCUELA GENERAL RAFAEL URDANETA	2539	5	35	2021	1421	1986	0	18	0	1	546	2021
EDO. BOLIVAR	MP. CARONI	PQ. VISTA AL SOL	ESCUELA BASICA ESTADAL HECTOR GUILLERMO VILLALOBOS	919	2	34	786	619	752	0	3	0	0	130	786
EDO. BOLIVAR	MP. CARONI	PQ. VISTA AL SOL	ESCUELA ESTADAL PABLO VICENTE BASTARDO	5027	9	57	4216	2798	4159	1	24	2	0	1334	4216
EDO. BOLIVAR	MP. CARONI	PQ. VISTA AL SOL	UNIDAD EDUCATIVA COLEGIO ANDRES ELOY BLANCO	143	1	1	111	72	110	0	0	0	0	38	111
EDO. BOLIVAR	MP. CARONI	PQ. VISTA AL SOL	CENTRO INICIAL LA VICTORIA	224	1	7	187	152	180	0	0	0	0	28	187
EDO. BOLIVAR	MP. CARONI	PQ. VISTA AL SOL	PRE ESCOLAR ANDRES BELLO	3443	6	77	2837	1940	2760	2	27	2	2	787	2837
EDO. BOLIVAR	MP. CARONI	PQ. VISTA AL SOL	CENTRO EDUCACION INFANTE CRISTOBA COLON	2064	4	67	1553	1205	1486	0	9	3	0	269	1553
EDO. BOLIVAR	MP. CARONI	PQ. VISTA AL SOL	ESCUELA MUNICIPAL AUGUSTO ARIDU	3918	7	70	3082	2242	3012	3	25	3	1	738	3082
EDO. BOLIVAR	MP. CARONI	PQ. VISTA AL SOL	UNIDAD EDUCATIVA BETTY BRAVO DE NAVARRO	269	1	4	226	153	222	0	4	0	0	65	226
EDO. BOLIVAR	MP. CARONI	PQ. VISTA AL SOL	LICEO BOLIVARIANO JOSE FELIX RIVAS	380	1	8	335	224	327	0	4	0	0	99	335
EDO. BOLIVAR	MP. CARONI	PQ. VISTA AL SOL	UNIDAD EDUCATIVA TRAPICHITO	311	1	7	241	184	234	0	1	0	0	49	241
EDO. BOLIVAR	MP. CARONI	PQ. VISTA AL SOL	ESCUELA MUNICPAL ANTONIO PINTO SALINAS	3842	7	85	3033	2319	2948	0	25	1	1	602	3033
EDO. BOLIVAR	MP. CARONI	PQ. VISTA AL SOL	JUNTA PARROQUIAL VISTA AL SOL	607	2	14	465	314	451	0	6	1	0	130	465
EDO. BOLIVAR	MP. CARONI	PQ. CHIRICA	UNIDAD EDUCATIVA NACIONAL PROVINCIA DE GUAYANA	965	2	10	788	611	778	0	3	1	0	163	788
EDO. BOLIVAR	MP. CARONI	PQ. CHIRICA	UNIDAD EDUCATIVA INTEGRAL PRIVADA CARLOS SOUBLETTE	229	1	1	202	161	201	0	3	0	0	37	202
EDO. BOLIVAR	MP. CARONI	PQ. CHIRICA	CICLO BASICO COMUN JOAQUINA SANCHEZ	3726	7	37	2926	1932	2889	0	23	0	2	932	2926
EDO. BOLIVAR	MP. CARONI	PQ. CHIRICA	MODULO DE SALUD Y BIENESTAR NUEVA CHIRICA	1778	3	17	1476	952	1459	0	8	0	0	499	1476
EDO. BOLIVAR	MP. CARONI	PQ. CHIRICA	ESCUELA ESTADAL GUAICAIPURO	341	1	14	278	206	264	0	2	0	0	56	278
EDO. BOLIVAR	MP. CARONI	PQ. CHIRICA	ESCUELA NACIONAL BASICA PRIMERO DE MAYO II	3600	7	48	2898	1836	2850	1	23	1	2	987	2898
EDO. BOLIVAR	MP. CARONI	PQ. CHIRICA	CENTRO DE EDUCACION INICIAL  NUEVA CHIRICA	265	1	4	212	142	208	0	2	0	0	64	212
EDO. BOLIVAR	MP. CARONI	PQ. CHIRICA	ESCUELA BASICA  MUNICIPAL BRICEÑO IRAGORRI	1364	3	22	993	679	971	0	8	0	2	282	993
EDO. BOLIVAR	MP. CARONI	PQ. CHIRICA	ESCUELA BASICA SAN JOSE	2111	4	38	1633	1220	1595	1	10	0	0	364	1633
EDO. BOLIVAR	MP. CARONI	PQ. CHIRICA	CICLO BASICO COMUN VISTA ALEGRE	4378	8	62	3551	2401	3489	0	26	1	1	1060	3551
EDO. BOLIVAR	MP. CARONI	PQ. CHIRICA	UNIDAD EDUCATIVA SIMON RODRIGUEZ	3820	7	92	3096	2014	3004	0	15	5	1	969	3096
EDO. BOLIVAR	MP. CARONI	PQ. CHIRICA	ESCUELA MUNICIPAL CREACION VISTA ALEGRE.	2729	5	53	2185	1435	2132	2	20	0	0	675	2185
EDO. BOLIVAR	MP. CARONI	PQ. CHIRICA	ESCUELA CONCENTRADA MUNICIPAL LUIS HURTADO HIGUERA	4140	8	65	3337	2248	3272	2	27	0	0	995	3337
EDO. BOLIVAR	MP. CARONI	PQ. CHIRICA	ESCUELA ESTADAL BASICA TERESA DE LA PARRA	3814	7	54	2862	1933	2808	2	32	1	0	840	2862
EDO. BOLIVAR	MP. CARONI	PQ. CHIRICA	UNIDAD EDUCATIVA BOLIVARIANA MARIA ELENA DE MORA	3300	6	35	2617	1713	2582	0	19	3	2	845	2617
EDO. BOLIVAR	MP. CARONI	PQ. CHIRICA	CENTRO DE EDUCACION INICIAL EL NAZARENO	287	1	3	252	197	249	1	3	0	0	48	252
EDO. BOLIVAR	MP. CARONI	PQ. CHIRICA	ESCUELA BASICA NACIONAL TAGUAPIRE	532	1	18	444	352	426	0	0	1	0	73	444
EDO. BOLIVAR	MP. CARONI	PQ. CHIRICA	UNIDAD EDUCATIVA COLEGIO SAN JUAN APOSTOL	181	1	4	163	101	159	0	1	0	0	57	163
EDO. BOLIVAR	MP. CARONI	PQ. CHIRICA	ESCUELA BASICA NACIONAL FE Y ALEGRIA ANTONIO LAURO	1919	4	39	1616	1256	1577	0	11	2	1	307	1616
EDO. BOLIVAR	MP. CARONI	PQ. CHIRICA	UNIDAD EDUCATIVA NACIONAL LUISA CASERES DE ARISMENDI	234	1	3	189	161	186	0	4	0	0	21	189
EDO. BOLIVAR	MP. CARONI	PQ. CHIRICA	CENTRO TALLER NUCLEARIZADO CLARET	236	1	9	208	142	199	0	4	0	0	53	208
EDO. BOLIVAR	MP. CARONI	PQ. CHIRICA	ESCUELA ESTATAL NELLYS DE SOFIA	4068	7	54	3195	2182	3141	0	34	2	1	922	3195
EDO. BOLIVAR	MP. CARONI	PQ. CHIRICA	ESCUELA BASICA ESTADAL ANTONIO JOSE DE SUCRE	3219	6	37	2394	1668	2357	0	23	2	0	664	2394
EDO. BOLIVAR	MP. CARONI	PQ. CHIRICA	UNIDAD EDUCATIVA COLEGIO  LEOPOLDO SUCRE FIGARELLA	312	1	6	262	165	256	0	2	0	0	89	262
EDO. BOLIVAR	MP. CARONI	PQ. CHIRICA	ESCUELA ESTADAL JUAN FRANCISCO REYES	1944	4	58	1611	1231	1553	0	21	1	0	300	1611
EDO. BOLIVAR	MP. CARONI	PQ. CHIRICA	UNIDAD EDUCATIVA PRIVADA AQUILES NAZOA	184	1	3	156	102	153	0	1	0	0	50	156
EDO. BOLIVAR	MP. CARONI	PQ. CHIRICA	ESCUELA NACIONAL PRIMERO DE MAYO 2	1463	3	22	1150	753	1128	1	11	1	0	362	1150
EDO. BOLIVAR	MP. CARONI	PQ. CHIRICA	JARDIN DE INFANCIA CARONI	1196	2	33	970	637	937	0	11	2	1	286	970
EDO. BOLIVAR	MP. CARONI	PQ. CHIRICA	CENTRO DE EDUCACION INICIAL  FE Y ALEGRIA GABRIELA MISTRAL	263	1	2	218	170	216	0	2	0	0	44	218
EDO. BOLIVAR	MP. CARONI	PQ. CHIRICA	JARDIN DE INFANCIA LUIS HURTADO HIGUERA	1250	3	21	1037	716	1016	0	6	0	0	294	1037
EDO. BOLIVAR	MP. CARONI	PQ. CHIRICA	PREESCOLAR TERESA DE LA PARRA	1443	3	23	1085	727	1062	0	10	0	0	325	1085
EDO. BOLIVAR	MP. CARONI	PQ. CHIRICA	UNIDAD EDUCATIVA COLEGIO PRIVADO VICTOR ANGULO	345	1	9	288	207	279	0	1	0	1	70	288
EDO. BOLIVAR	MP. CARONI	PQ. CHIRICA	UNIDAD EDUCATIVA NACIONAL 15 DE NOVIEMBRE	326	1	10	282	236	272	0	1	0	1	34	282
EDO. BOLIVAR	MP. CARONI	PQ. CHIRICA	UNIDAD EDUCATIVA COLEGIO JESUS MARIA Y JOSE	382	1	2	308	225	306	0	1	0	0	80	308
EDO. BOLIVAR	MP. CARONI	PQ. CHIRICA	FE Y ALEGRIA PABLO SEXTO	348	1	6	293	209	287	1	1	1	0	75	293
EDO. BOLIVAR	MP. CARONI	PQ. CACHAMAY	ESCUELA NACIONAL BASICA WENCELAUS MONSERRATTE	2390	5	34	1824	939	1790	0	13	3	2	833	1824
EDO. BOLIVAR	MP. CARONI	PQ. CACHAMAY	LICEO OSCAR LUIS PERFETTI	2340	4	19	1905	590	1886	0	7	1	1	1287	1905
EDO. BOLIVAR	MP. CARONI	PQ. CACHAMAY	ESCUELA NACIONAL BASICA VILLA COLOMBIA	5034	9	38	4217	1337	4179	1	16	3	1	2821	4217
EDO. BOLIVAR	MP. CARONI	PQ. CACHAMAY	COLEGIO NAZARET	4267	8	26	3681	492	3655	0	6	0	5	3152	3681
EDO. BOLIVAR	MP. CARONI	PQ. CACHAMAY	ESCUELA NACIONAL BASICA PUERTO ORDAZ	3772	7	33	3182	837	3149	0	10	0	2	2300	3182
EDO. BOLIVAR	MP. CARONI	PQ. CACHAMAY	CASA COMUNAL VILLA COLOMBIA	1348	3	9	1227	387	1218	0	2	1	1	827	1227
EDO. BOLIVAR	MP. CARONI	PQ. CACHAMAY	JARDIN DE INFANCIA ALFONZO ESCALONA	1702	3	19	1457	485	1438	0	6	0	0	947	1457
EDO. BOLIVAR	MP. CARONI	PQ. CACHAMAY	ESCUELA BASICA NACIONAL TUMEREMO	2454	5	31	2076	712	2045	0	5	1	0	1327	2076
EDO. BOLIVAR	MP. CARONI	PQ. CACHAMAY	ESCUELA BASICA PRIVADA FE Y ALEGRIA NAZARET	3610	7	65	3011	914	2946	0	13	1	1	2017	3011
EDO. BOLIVAR	MP. CARONI	PQ. CACHAMAY	UNIVERSIDAD NACIONAL EXPERIMENTAL GUAYANA.	1951	4	6	1590	133	1584	1	4	0	0	1446	1590
EDO. BOLIVAR	MP. CARONI	PQ. CACHAMAY	ESCUELA MUNICIPAL DOCTOR RAUL LEONI	1101	2	17	927	526	910	0	5	0	1	378	927
EDO. BOLIVAR	MP. CARONI	PQ. CACHAMAY	ESCUELA DIEGO DE ORDAZ II	959	2	9	803	219	794	0	5	0	2	568	803
EDO. BOLIVAR	MP. CARONI	PQ. CACHAMAY	ESCUELA NACIONAL BASICA RORAIMA	2050	4	46	1575	868	1529	1	11	1	1	647	1575
EDO. BOLIVAR	MP. CARONI	PQ. CACHAMAY	ESCUELA BASICA NACIONAL GUAYANA	1583	3	9	1311	240	1302	0	2	1	2	1057	1311
EDO. BOLIVAR	MP. CARONI	PQ. CACHAMAY	ESCUELA DIEGO DE ORDAZ	3548	6	27	2985	749	2958	0	11	0	2	2196	2985
EDO. BOLIVAR	MP. CARONI	PQ. UNARE	CENTRO DE EDUCACION INICIAL COGESTIONARIO NUESTROS NIÑOS	952	2	16	864	312	848	0	6	0	1	529	864
EDO. BOLIVAR	MP. CARONI	PQ. UNARE	ESCUELA TECNICA INDUSTRIAL SIMON RODRIGUEZ	3443	7	41	3050	1247	3009	1	19	0	1	1741	3050
EDO. BOLIVAR	MP. CARONI	PQ. UNARE	ESCUELA NACIONAL BASICA ROMULO GALLEGOS	535	1	7	458	267	451	0	5	1	0	178	458
EDO. BOLIVAR	MP. CARONI	PQ. UNARE	ESCUELA BASICA BOLIVARIANA EZEQUIEL ZAMORA II	330	1	10	290	212	280	0	2	0	0	66	290
EDO. BOLIVAR	MP. CARONI	PQ. UNARE	CENTRO DE EDUCACION INICIAL GRAN SABANA	1190	2	17	984	577	967	1	5	2	0	382	984
EDO. BOLIVAR	MP. CARONI	PQ. UNARE	PRE ESCOLAR ESTADAL RIO CAURA	2889	5	32	2590	779	2558	0	11	0	2	1766	2590
EDO. BOLIVAR	MP. CARONI	PQ. UNARE	ESCUELA INTEGRAL BOLIVARIANA CACHAMAY	1864	4	13	1667	512	1654	0	5	0	0	1137	1667
EDO. BOLIVAR	MP. CARONI	PQ. UNARE	UNIDAD EDUCATIVA COLEGIO MARIE PAPE CARPENTIER	479	1	2	436	130	434	0	0	0	0	304	436
EDO. BOLIVAR	MP. CARONI	PQ. UNARE	FE Y ALEGRIA VIRGEN NIÑA I	1794	4	13	1542	615	1529	0	11	0	0	903	1542
EDO. BOLIVAR	MP. CARONI	PQ. UNARE	UNIDAD EDUCATIVA AUYANTEPUY	5839	11	63	4976	2090	4913	0	19	2	4	2798	4976
EDO. BOLIVAR	MP. CARONI	PQ. UNARE	ESCUELA BASICA LAS AMAZONAS	3403	6	45	2834	2251	2789	1	16	3	2	516	2834
EDO. BOLIVAR	MP. CARONI	PQ. UNARE	ESCUELA TECNICA COMERCIAL ANDRES BELLO	4839	9	60	4171	1637	4111	0	26	5	0	2443	4171
EDO. BOLIVAR	MP. CARONI	PQ. UNARE	CLUB CAMPESTRE GUAYANA	1870	4	35	1614	854	1579	0	12	1	0	712	1614
EDO. BOLIVAR	MP. CARONI	PQ. UNARE	LICEO UNARE III	4036	8	44	3408	1452	3364	0	22	2	6	1882	3408
EDO. BOLIVAR	MP. CARONI	PQ. UNARE	ESCUELA BASICA UNARE II	7249	13	63	6451	2144	6388	0	28	5	4	4207	6451
EDO. BOLIVAR	MP. CARONI	PQ. UNARE	UNIDAD EDUCATIVA ESTADAL DOCTOR RAFAEL VEGAS	2093	4	39	1764	1222	1725	0	6	3	0	494	1764
EDO. BOLIVAR	MP. CARONI	PQ. UNARE	UNIDAD EDUCATIVA BOLIVARIANA RURAL ARICHUNA, NUCLEO ESCOLAR RURAL 333	219	1	5	198	141	193	1	2	0	0	49	198
EDO. BOLIVAR	MP. CARONI	PQ. UNARE	ESCUELA BASICA JULIA RODRIGUEZ VIA	8547	15	80	7586	2965	7506	0	30	1	9	4501	7586
EDO. BOLIVAR	MP. CARONI	PQ. UNARE	UNIDAD EDUCATIVA NACIONAL DOCTOR LUIS BELTRAN PRIETO FIGUEROA	5664	10	75	4717	2568	4642	1	21	3	1	2048	4717
EDO. BOLIVAR	MP. CARONI	PQ. UNARE	ESCUELA CONCENTRADA BATALLA DE CARABOBO	1068	2	16	794	516	778	0	4	0	0	258	794
EDO. BOLIVAR	MP. CARONI	PQ. UNARE	UNIDAD EDUCATIVA NUESTRA SEÑORA DEL CARMEN	517	1	13	414	256	401	0	1	0	0	144	414
EDO. BOLIVAR	MP. CARONI	PQ. UNARE	ESCUELA ESTADAL UNITARIA 282 321	1530	3	31	1193	775	1162	1	12	3	0	371	1193
EDO. BOLIVAR	MP. CARONI	PQ. UNARE	FE Y ALEGRIA LA CONSOLACION	3260	6	38	2839	1055	2801	0	17	1	4	1724	2839
EDO. BOLIVAR	MP. CARONI	PQ. UNARE	JARDIN DE INFANCIA ALCASA	2510	5	25	2253	825	2228	2	9	0	6	1386	2253
EDO. BOLIVAR	MP. CARONI	PQ. UNARE	ESCUELA BASICA GRAN SABANA FE Y ALEGRÍA	8273	15	107	6800	4675	6693	6	43	2	3	1964	6800
EDO. BOLIVAR	MP. CARONI	PQ. UNARE	JARDIN DE INFANCIA RIO UNARE	1104	2	14	960	399	946	0	3	0	2	542	960
EDO. BOLIVAR	MP. CARONI	PQ. UNARE	UNIDAD EDUCATIVA MUNICIPAL GENERAL EZEQUIEL ZAMORA	930	2	10	809	651	799	0	6	0	0	142	809
EDO. BOLIVAR	MP. CARONI	PQ. UNARE	COLEGIO FE Y ALEGRIA CRISTO REY	2657	5	24	2258	845	2234	0	10	2	0	1377	2258
EDO. BOLIVAR	MP. CARONI	PQ. UNARE	ESCUELA BASICA VIRGEN NIÑA	5090	9	64	4306	1966	4242	0	27	6	6	2237	4306
EDO. BOLIVAR	MP. CARONI	PQ. UNARE	ESCUELA BASICA BOLIVARIANA VILLA BAHIA	2009	4	44	1708	1229	1664	1	16	1	0	417	1708
EDO. BOLIVAR	MP. CARONI	PQ. UNARE	ESCUELA BASICA ESTADAL CAURA	1521	3	13	1400	398	1387	0	3	0	1	985	1400
EDO. BOLIVAR	MP. CARONI	PQ. UNARE	LICEO LAS AMAZONAS	564	1	8	456	338	448	0	1	0	0	109	456
EDO. BOLIVAR	MP. CARONI	PQ. UNARE	UNIDAD EDUCATIVA RURAL CASACOYMA	592	1	7	505	383	498	0	3	1	0	111	505
EDO. BOLIVAR	MP. CARONI	PQ. UNARE	ESCUELA BASICA RURAL  UNITARIA CHIRERE	134	1	0	112	65	112	0	0	0	0	47	112
EDO. BOLIVAR	MP. CARONI	PQ. UNARE	JARDIN DE INFANCIA AÑO INTERNACIONAL DEL NIÑO	1442	3	14	1264	586	1250	0	9	0	3	652	1264
EDO. BOLIVAR	MP. CARONI	PQ. DALLA COSTA	ESCUELA NACIONAL BASICA LUCILA PALACIO	4378	8	49	3591	2187	3542	0	24	0	2	1329	3591
EDO. BOLIVAR	MP. CARONI	PQ. DALLA COSTA	ESCUELA BASICA CREACION UNIDAD DE DESARROLLO 146	1299	3	18	1119	687	1101	0	10	0	1	403	1119
EDO. BOLIVAR	MP. CARONI	PQ. DALLA COSTA	ESCUELA BASICA NACIONAL LUIS TOVAR	2088	4	34	1764	1021	1730	0	24	0	1	684	1764
EDO. BOLIVAR	MP. CARONI	PQ. DALLA COSTA	ESCUELA NACIONAL BASICA LIBERTADOR BOLIVAR	3661	7	38	3234	1619	3196	0	16	0	0	1561	3234
EDO. BOLIVAR	MP. CARONI	PQ. DALLA COSTA	ESCUELA BOLIVARIANA ANTONIO RICAUTE	2668	5	53	2179	1278	2126	1	16	1	2	828	2179
EDO. BOLIVAR	MP. CARONI	PQ. DALLA COSTA	RADIO LA LLOVIZNA	185	1	3	169	105	166	1	3	0	0	57	169
EDO. BOLIVAR	MP. CARONI	PQ. DALLA COSTA	ESCUELA BASICA COLEGIO PRIVADO SINAI	430	1	2	386	254	384	0	3	0	1	126	386
EDO. BOLIVAR	MP. CARONI	PQ. DALLA COSTA	COLEGIO JUAN VICENTE GONZALEZ	190	1	6	168	115	162	0	0	0	0	47	168
EDO. BOLIVAR	MP. CARONI	PQ. DALLA COSTA	ESCUELA MUNICIPAL CONSUELO NAVAS TOVAR	2158	4	24	1829	1358	1805	1	15	1	0	430	1829
EDO. BOLIVAR	MP. CARONI	PQ. DALLA COSTA	CICLO BASICO COMUN RAMON ISIDRO MONTES	1651	3	16	1367	536	1351	0	6	1	0	808	1367
EDO. BOLIVAR	MP. CARONI	PQ. DALLA COSTA	JARDIN DE INFANCIA UD 146	277	1	3	251	181	248	0	2	0	0	65	251
EDO. BOLIVAR	MP. CARONI	PQ. DALLA COSTA	COLEGIO FE Y ALEGRIA CARONI	3612	7	71	3055	1788	2984	0	18	1	0	1177	3055
EDO. BOLIVAR	MP. CARONI	PQ. DALLA COSTA	JARDIN DE INFANCIA ARAGUANEY	1440	3	18	1229	737	1211	1	4	0	1	468	1229
EDO. BOLIVAR	MP. CARONI	PQ. DALLA COSTA	ESCUELA NACIONAL BASICA LOS SABANALES	1440	3	16	1188	726	1172	0	6	0	0	440	1188
EDO. BOLIVAR	MP. CARONI	PQ. DALLA COSTA	ESCUELA NACIONAL BASICA PUERTO AYACUCHO	2655	5	29	2110	1471	2081	0	10	6	2	592	2110
EDO. BOLIVAR	MP. CARONI	PQ. DALLA COSTA	COLEGIO PRIVADO SANTO TOME DE GUAYANA	479	1	5	415	244	410	0	3	0	0	163	415
EDO. BOLIVAR	MP. CARONI	PQ. DALLA COSTA	MODULO DE SERVICIOS LOS SABANALES.	800	2	16	680	382	664	0	6	1	1	274	680
EDO. BOLIVAR	MP. CARONI	PQ. DALLA COSTA	ESCUELA NACIONAL BASICA MANOA	3727	7	78	3028	2000	2950	0	23	2	2	923	3028
EDO. BOLIVAR	MP. CARONI	PQ. DALLA COSTA	ESCUELA MUNICIPAL SIMON RODRIGUEZ	1681	3	34	1318	994	1284	1	4	1	0	284	1318
EDO. BOLIVAR	MP. CARONI	PQ. DALLA COSTA	JUNTA PARROQUIAL DALLA COSTA	173	1	5	156	96	151	0	1	0	0	54	156
EDO. BOLIVAR	MP. CARONI	PQ. DALLA COSTA	JARDIN DE INFANCIA MANOA	1192	2	15	938	616	923	0	3	2	0	302	938
EDO. BOLIVAR	MP. CARONI	PQ. DALLA COSTA	ESCUELA NACIONAL BASICA ANDRES BELLO	4492	8	64	3623	2217	3559	2	31	5	0	1304	3623
EDO. BOLIVAR	MP. CARONI	PQ. DALLA COSTA	JARDIN DE INFANCIA LUCERITO	174	1	2	162	91	160	0	1	0	0	68	162
EDO. BOLIVAR	MP. CARONI	PQ. DALLA COSTA	ESCUELA BASICA ESTADAL LAS MALVINAS	629	2	14	552	383	538	0	2	0	0	153	552
EDO. BOLIVAR	MP. CARONI	PQ. DALLA COSTA	JARDIN DE INFANCIA UNIDAD DE DESARROLLO 145	1643	3	27	1438	781	1411	0	10	2	1	617	1438
EDO. BOLIVAR	MP. CARONI	PQ. DALLA COSTA	PRE ESCOLAR ASISTENCIAL NUEVO MUNDO	1458	3	17	1181	727	1164	0	6	1	0	430	1181
EDO. BOLIVAR	MP. CARONI	PQ. DALLA COSTA	UNIDAD EDUCATIVA CANAIMA	1664	3	58	1316	830	1258	0	14	2	0	412	1316
EDO. BOLIVAR	MP. CARONI	PQ. DALLA COSTA	ESCUELA MUNICIPAL MANUEL PIAR	2135	4	45	1704	1269	1659	0	19	1	2	368	1704
EDO. BOLIVAR	MP. CARONI	PQ. DALLA COSTA	ESCUELA NACIONAL BASICA NUEVO MUNDO	4493	8	64	3588	2189	3524	0	23	3	0	1309	3588
EDO. BOLIVAR	MP. CARONI	PQ. UNIVERSIDAD	UNIVERSIDAD NACIONAL EXPERIMENTAL DE GUAYANA	876	2	11	779	195	768	1	0	0	0	572	779
EDO. BOLIVAR	MP. CARONI	PQ. UNIVERSIDAD	CICLO DIVERSIFICADO LOS OLIVOS	5832	11	57	5119	952	5062	1	12	4	4	4089	5119
EDO. BOLIVAR	MP. CARONI	PQ. UNIVERSIDAD	ESCUELA BASICA  PUERTO ORDAZ (TERCERA ETAPA)	1873	4	12	1611	331	1599	0	5	1	2	1260	1611
EDO. BOLIVAR	MP. CARONI	PQ. UNIVERSIDAD	ESCUELA BASICA JARDIN LEVANTE	3428	6	18	3003	544	2985	1	6	1	0	2433	3003
EDO. BOLIVAR	MP. CARONI	PQ. UNIVERSIDAD	JARDIN DE INFANCIA LUISA CASERES ARISMENDI	3346	6	26	3069	668	3043	0	6	0	0	2369	3069
EDO. BOLIVAR	MP. CARONI	PQ. UNIVERSIDAD	CICLO  BASICO COMUN ALTA VISTA SUR	4357	8	25	3804	773	3779	0	14	3	1	2988	3804
EDO. BOLIVAR	MP. CARONI	PQ. UNIVERSIDAD	ESCUELA NACIONAL BASICA YOCOIMA	4666	9	24	3970	733	3946	0	13	0	5	3195	3970
EDO. BOLIVAR	MP. CARONI	PQ. UNIVERSIDAD	JARDIN DE INFANCIA YOCOIMA	1880	4	17	1592	230	1575	0	8	0	0	1337	1592
EDO. BOLIVAR	MP. CARONI	PQ. UNIVERSIDAD	UNIDAD EDUCATIVA ALTA VISTA SUR	3997	7	33	3438	734	3405	0	11	0	0	2660	3438
EDO. BOLIVAR	MP. CARONI	PQ. UNIVERSIDAD	ESCUELA MUNICIPAL LA ESPERANZA	2389	5	67	1950	1285	1883	0	14	1	0	583	1950
EDO. BOLIVAR	MP. CARONI	PQ. UNIVERSIDAD	UNIDAD EDUCATIVA COLEGIO INTERNACIONAL MIGUEL OTERO SILVA	4881	9	35	4358	904	4323	1	9	1	0	3408	4358
EDO. BOLIVAR	MP. CARONI	PQ. ONCE DE ABRIL	ESCUELA NACIONAL BASICA LAS AMERICAS	4163	8	57	3323	2218	3266	1	28	1	1	1017	3323
EDO. BOLIVAR	MP. CARONI	PQ. ONCE DE ABRIL	ESCUELA NACIONAL BASICA GENERAL FRANCISCO CONDE	2045	4	36	1587	1050	1551	0	10	1	0	490	1587
EDO. BOLIVAR	MP. CARONI	PQ. ONCE DE ABRIL	CASA COMUNAL 25 DE MARZO SECTOR 2	1368	3	35	1041	775	1006	0	8	0	0	223	1041
EDO. BOLIVAR	MP. CARONI	PQ. ONCE DE ABRIL	ESCUELA NACIONAL BASICA GUAYANA	2571	5	36	2123	1180	2087	2	12	1	0	892	2123
EDO. BOLIVAR	MP. CARONI	PQ. ONCE DE ABRIL	ESCUELA ESTADAL JOSE FELIX BLANCO	1511	3	22	1275	881	1253	0	9	2	0	361	1275
EDO. BOLIVAR	MP. CARONI	PQ. ONCE DE ABRIL	ESCUELA BASICA NACIONAL MIGUEL ANTONIO CARO	303	1	8	267	227	259	0	1	0	0	31	267
EDO. BOLIVAR	MP. CARONI	PQ. ONCE DE ABRIL	UNIDAD EDUCATIVA JESUS DE NAZARET	258	1	5	231	153	226	0	4	0	0	69	231
EDO. BOLIVAR	MP. CARONI	PQ. ONCE DE ABRIL	ESCUELA NACIONAL BASICA GUEDEZ COLMENARES	3524	6	45	2846	1615	2801	0	29	1	1	1155	2846
EDO. BOLIVAR	MP. CARONI	PQ. ONCE DE ABRIL	CENTRO DE EDUCACION INICIAL ESTADAL SAN JOSE DE CACAHUAL	407	1	4	346	267	342	0	5	0	0	70	346
EDO. BOLIVAR	MP. CARONI	PQ. ONCE DE ABRIL	ESCUELA BASICA NACIONAL ALTAMIRA I	328	1	3	273	221	270	0	3	2	0	44	273
EDO. BOLIVAR	MP. CARONI	PQ. ONCE DE ABRIL	UNIDAD EDUCATIVA NACIONAL RURAL ANA EMILIA DELON	900	2	10	719	552	709	0	3	1	0	153	719
EDO. BOLIVAR	MP. CARONI	PQ. ONCE DE ABRIL	ESCUELA NACIONAL BASICA CREACION 11 DE ABRIL	4365	8	72	3209	2326	3137	0	31	4	1	775	3209
EDO. BOLIVAR	MP. CARONI	PQ. ONCE DE ABRIL	CENTRO DE EDUCACION INICIAL ESTADAL 25 DE MARZO	357	1	8	294	206	286	0	1	0	0	79	294
EDO. BOLIVAR	MP. CARONI	PQ. ONCE DE ABRIL	GRUPO ESCOLAR LOYD PETERSON	2168	4	32	1609	1242	1577	0	18	2	0	315	1609
EDO. BOLIVAR	MP. CARONI	PQ. ONCE DE ABRIL	ESCUELA NACIONAL BASICA 25 DE MARZO	3941	7	52	3008	2151	2956	1	31	2	2	769	3008
EDO. BOLIVAR	MP. CARONI	PQ. ONCE DE ABRIL	FE Y ALEGRIA  25 DE MARZO	892	2	33	741	490	708	0	4	0	0	214	741
EDO. BOLIVAR	MP. CARONI	PQ. ONCE DE ABRIL	CENTRO DE CAPACITACION JUVENIL MONSEOR ZABALETA	1567	3	29	1238	768	1209	0	6	0	0	435	1238
EDO. BOLIVAR	MP. CARONI	PQ. ONCE DE ABRIL	CENTRO DE EDUCACION INICIAL LLOYD PETTERSON	406	1	12	322	245	310	1	3	0	0	61	322
EDO. BOLIVAR	MP. CARONI	PQ. ONCE DE ABRIL	ESCUELA NACIONAL BASICA BELLA VISTA	6738	12	124	5493	3426	5369	4	45	4	1	1889	5493
EDO. BOLIVAR	MP. CARONI	PQ. ONCE DE ABRIL	CICLO BASICO JOAQUIN MORENO DE MENDOZA	1952	4	40	1589	1030	1549	0	17	1	1	500	1589
EDO. BOLIVAR	MP. CARONI	PQ. ONCE DE ABRIL	JARDIN DE INFANCIA FRANCISCO CONDE	685	2	18	541	317	523	1	4	0	0	201	541
EDO. BOLIVAR	MP. CARONI	PQ. ONCE DE ABRIL	CENTRO DE EDUCACION INICIAL GUAYANA	261	1	6	223	142	217	0	2	0	0	73	223
EDO. BOLIVAR	MP. CARONI	PQ. ONCE DE ABRIL	PDVAL	292	1	11	256	201	245	0	1	0	1	42	256
EDO. BOLIVAR	MP. CARONI	PQ. ONCE DE ABRIL	CASA COMUNAL INTEGRAL MANUELITA SAENZ	107	1	1	93	79	92	0	0	0	0	13	93
EDO. BOLIVAR	MP. CARONI	PQ. ONCE DE ABRIL	UNIDAD EDUCATIVA NACIONAL BRISAS DEL ORINOCO	2493	5	42	2039	1654	1997	0	13	0	1	329	2039
EDO. BOLIVAR	MP. CARONI	PQ. ONCE DE ABRIL	UNIDAD EDUCATIVA COLEGIO LA PRADERA	352	1	5	295	211	290	0	2	0	0	77	295
EDO. BOLIVAR	MP. CARONI	PQ. ONCE DE ABRIL	PRE ESCOLAR 19 DE ABRIL	1772	3	29	1337	963	1308	1	12	1	0	331	1337
EDO. BOLIVAR	MP. CARONI	PQ. ONCE DE ABRIL	ESCUELA BASICA NACIONAL SAN JOSE DE CACAHUAL	4620	8	95	3551	2639	3456	1	29	2	0	785	3551
EDO. BOLIVAR	MP. CARONI	PQ. ONCE DE ABRIL	UNIDAD EDUCATIVA COLEGIO SAN LUIS	178	1	6	154	91	148	0	0	0	0	57	154
EDO. BOLIVAR	MP. CARONI	PQ. ONCE DE ABRIL	UNIDAD EDUCATIVA COLEGIO EMMANUEL	317	1	5	273	154	268	0	2	1	0	111	273
EDO. BOLIVAR	MP. CARONI	PQ. ONCE DE ABRIL	JARDIN DE INFANCIA LAS AMERICAS	1138	2	22	910	564	888	0	5	2	1	316	910
EDO. BOLIVAR	MP. CARONI	PQ. POZO VERDE	ESCUELA MUNICIPAL CONCENTRADA CLORINDO PAREDES	1614	3	25	1161	889	1136	0	8	0	0	239	1161
EDO. BOLIVAR	MP. CARONI	PQ. POZO VERDE	UNIDAD EDUCATIVA BOLIVARIANA ESTADAL JOSE REINAL AYALA	733	2	17	511	355	494	0	5	0	0	134	511
EDO. BOLIVAR	MP. CARONI	PQ. POZO VERDE	ESCUELA BASICA CARONI	1986	4	29	1451	1062	1422	2	7	4	0	347	1451
EDO. BOLIVAR	MP. CARONI	PQ. POZO VERDE	UNIDAD EDUCATIVA NACIONAL CONCENTRADA MANANTIAL DE FE	256	1	9	214	186	205	0	2	0	0	17	214
EDO. BOLIVAR	MP. CARONI	PQ. POZO VERDE	ESCUELA MUNICIPAL CONCENTRADA MENCA DE LEONI	680	2	12	518	377	506	0	5	2	0	122	518
EDO. BOLIVAR	MP. CARONI	PQ. POZO VERDE	ESCUELA ESTADAL GRADUADA LEONCIO MARTINEZ	2106	4	46	1581	1128	1535	2	11	0	1	393	1581
EDO. BOLIVAR	MP. CARONI	PQ. POZO VERDE	CASA COMUNAL MINA ABAJO	340	1	3	267	240	264	1	0	1	0	22	267
EDO. BOLIVAR	MP. CARONI	PQ. POZO VERDE	UNIDA EDUCATIVA NACIONAL FUENTE DE GRACIA	77	1	5	62	52	57	0	0	0	0	5	62
EDO. BOLIVAR	MP. CARONI	PQ. POZO VERDE	ESCUELA BOLIVARIANA SIMON BOLIVAR	99	1	1	82	75	81	0	0	0	0	6	82
EDO. BOLIVAR	MP. CARONI	PQ. POZO VERDE	ESCUELA MUNICIPAL ROMAN VALECILLOS	94	1	3	82	70	79	0	0	0	0	9	82
EDO. BOLIVAR	MP. CARONI	PQ. POZO VERDE	ESCUELA BASICA ESTADAL CONCENTRADA SIMON RODRIGUEZ	2247	4	48	1707	1301	1659	3	12	4	2	337	1707
EDO. BOLIVAR	MP. CARONI	PQ. POZO VERDE	ESCUELA INTEGRAL BOLIVARIANA JUAN BAUTISTA ARISMENDI	561	1	18	474	337	456	0	0	0	0	119	474
EDO. BOLIVAR	MP. SUCRE	PQ. MOITACO	ESCUELA CONCENTRADA NACIONAL CAMURICA	285	1	7	228	169	221	0	0	0	0	52	228
EDO. BOLIVAR	MP. SUCRE	PQ. MOITACO	UNIDAD EDUCATIVA NACIONAL FELIPE DE INCIARTE	939	2	16	645	321	629	1	6	0	0	301	645
EDO. BOLIVAR	MP. SUCRE	PQ. MOITACO	ESCUELA CONCENTRADA NUMERO 178 861 PERAMANAL	668	2	8	430	308	422	0	0	0	0	114	430
EDO. BOLIVAR	MP. SUCRE	PQ. MOITACO	ESCUELA INTEGRAL BOLIVARIANA TRES MORICHES	124	1	1	114	88	113	0	3	0	0	22	114
EDO. BOLIVAR	MP. SUCRE	PQ. MOITACO	ESCUELA ESTADAL CONCENTRADA MIXTA NUMERO 278 249 ESMERALDA	809	2	13	519	371	506	0	3	1	0	131	519
EDO. BOLIVAR	MP. SUCRE	PQ. MOITACO	ESCUELA ESTADAL UNITARIA NUMERO 248 LA DANTA	106	1	1	77	56	76	0	1	0	0	19	77
EDO. BOLIVAR	MP. SUCRE	PQ. MOITACO	ESCUELA ESTADAL CONCENTRADA MIXTA NUMERO 186 SIN NUMERO	322	1	2	200	157	198	0	1	0	0	40	200
EDO. BOLIVAR	MP. SUCRE	PQ. MOITACO	ESCUELA ESTADAL CONCENTRADA MIXTA NUMERO 182 SARRAPIO	480	1	9	360	269	351	1	1	0	0	80	360
EDO. BOLIVAR	MP. SUCRE	PQ. MOITACO	ESCUELA ESTADAL CONCENTRADA SAN ANTONIO NUMERO 180 247	317	1	5	261	152	256	0	1	0	0	103	261
EDO. BOLIVAR	MP. SUCRE	PQ. MOITACO	ESCUELA CONCENTRADA ESTADAL NUMERO 287 CANAGUAPANA	390	1	8	300	170	292	0	2	1	0	119	300
EDO. BOLIVAR	MP. SUCRE	PQ. MOITACO	ESCUELA ESTADAL CONCENTRADA MIXTA NUMERO 268 SAN JOSE DEL PAO	279	1	8	161	104	153	0	0	0	0	49	161
EDO. BOLIVAR	MP. SUCRE	PQ. MOITACO	COMPLEJO EDUCATIVO LOMA BONITA	65	1	2	55	42	53	0	0	0	0	11	55
EDO. BOLIVAR	MP. SUCRE	CM. MARIPA	ESCUELA UNITARIA ESTADAL SAN PERDO DEL TAUCA	185	1	2	103	67	101	0	0	1	0	33	103
EDO. BOLIVAR	MP. SUCRE	CM. MARIPA	FRANK RISQUEZ IRIBARREN	1013	2	21	741	494	720	0	13	3	0	210	741
EDO. BOLIVAR	MP. SUCRE	CM. MARIPA	UNIDAD EDUCATIVA NACIONAL MARIPA	2470	5	92	1475	793	1383	0	12	1	0	577	1475
EDO. BOLIVAR	MP. SUCRE	PQ. GUARATARO	ESCUELA ESTADAL CONCENTRADA NUMERO 112 177 185 TIGRERA	606	2	15	428	303	413	0	1	0	0	109	428
EDO. BOLIVAR	MP. SUCRE	PQ. GUARATARO	ESCUELA BASICA NACIONAL GUARATARO	2508	5	31	1693	1309	1662	0	8	2	2	341	1693
EDO. BOLIVAR	MP. SUCRE	PQ. GUARATARO	ESCUELA BASICA NACIONAL SIMON RODRIGUEZ	294	1	7	223	182	216	0	2	0	0	32	223
EDO. BOLIVAR	MP. SUCRE	PQ. GUARATARO	UNIDAD EDUCATIVA NACIONAL LICEO BOLIVARIANO EL GUARATARO	560	1	6	437	330	431	0	2	0	0	99	437
EDO. BOLIVAR	MP. SUCRE	PQ. GUARATARO	ESCUELA BASICA NACIONAL  ALFREDO SADEL	1652	3	16	1154	890	1138	1	7	1	2	237	1154
EDO. BOLIVAR	MP. SUCRE	PQ. GUARATARO	UNIDAD EDUCATIVA NACIONAL BOLIVARIANA MI REFUGIO	160	1	4	121	95	117	0	0	0	0	22	121
EDO. BOLIVAR	MP. SUCRE	PQ. LAS MAJADAS	ESCUELA CONCENTRADA MIXTA 183 184 229 340 LAS MAJADAS	583	1	12	360	202	348	0	0	0	0	146	360
EDO. BOLIVAR	MP. SUCRE	PQ. LAS MAJADAS	ESCUELA CONCENTRADA NUMERO 176 SIN NUMERO	179	1	6	108	47	102	0	0	0	0	55	108
EDO. BOLIVAR	MP. SUCRE	PQ. ARIPAO	ESCUELA BASICA NACIONAL CAMPO ALEGRE	322	1	10	166	123	156	0	1	0	0	32	166
EDO. BOLIVAR	MP. SUCRE	PQ. ARIPAO	ESCUELA ESTADAL CONCENTRADA NUMERO 1960 68 ARIPAO	721	2	13	431	265	418	0	3	2	0	148	431
EDO. BOLIVAR	MP. SUCRE	PQ. ARIPAO	CAMPAMENTO ENTRERIOS
EDO. BOLIVAR	MP. SUCRE	PQ. ARIPAO	UNIDAD EDUCATIVA BOLIVARIANA SANTA MARIA DE EREBATO
EDO. BOLIVAR	MP. SUCRE	PQ. ARIPAO	ESCUELA ESTADAL UNITARIA PUERTO CABELLO DEL CAURA	269	1	6	144	104	138	0	0	0	0	34	144
EDO. BOLIVAR	MP. SUCRE	PQ. ARIPAO	ESCUELA BOLIVARIANA SHIMARAÑA
EDO. BOLIVAR	MP.PADRE PEDRO CHIEN	CM. EL PALMAR	UNIDAD EDUCATIVA NACIONAL GUASIPATI	783	2	6	633	380	627	0	8	0	0	239	633
EDO. BOLIVAR	MP.PADRE PEDRO CHIEN	CM. EL PALMAR	UNIDA EDUCATIVA BASICA CUATRO CASA	871	2	14	680	445	666	0	3	0	0	218	680
EDO. BOLIVAR	MP.PADRE PEDRO CHIEN	CM. EL PALMAR	ESCUELA JOSEFINA OSUNA	863	2	17	580	281	563	0	8	2	0	272	580
EDO. BOLIVAR	MP.PADRE PEDRO CHIEN	CM. EL PALMAR	UNIDA EDUCATIVA BASICA EL PERICO	771	2	8	617	321	609	0	5	3	0	280	617
EDO. BOLIVAR	MP.PADRE PEDRO CHIEN	CM. EL PALMAR	UNIDA EDUCATIVA BASICA QUILINA	929	2	11	731	389	720	0	7	2	1	321	731
EDO. BOLIVAR	MP.PADRE PEDRO CHIEN	CM. EL PALMAR	ESCUELA NACIONAL UNITARIA NUMERO 148 JUAN DE DIOS	488	1	7	383	231	376	0	3	3	0	139	383
EDO. BOLIVAR	MP.PADRE PEDRO CHIEN	CM. EL PALMAR	ESCUELA NACIONAL BASICA FEDERICO CHIRINOS	2551	5	39	2029	972	1990	0	4	0	0	1014	2029
EDO. BOLIVAR	MP.PADRE PEDRO CHIEN	CM. EL PALMAR	ESCUELA ESTADAL CONCENTRADA 132 135 107 306	1099	2	19	821	451	802	0	2	0	0	349	821
EDO. BOLIVAR	MP.PADRE PEDRO CHIEN	CM. EL PALMAR	UNIDA EDUCATIVA BASICA CURAIMA	247	1	11	214	136	203	0	0	0	0	67	214
EDO. BOLIVAR	MP.PADRE PEDRO CHIEN	CM. EL PALMAR	UNIDAD EDUCATIVA BOLIVARIANA JOSE EUGENIO SANCHEZ AFANADOR	743	2	17	557	294	540	0	4	0	0	242	557
EDO. BOLIVAR	MP.PADRE PEDRO CHIEN	CM. EL PALMAR	ESCUELA NACIONAL MIXTA CHIGUIRE	517	1	8	372	220	364	0	2	0	0	142	372
EDO. BOLIVAR	MP.PADRE PEDRO CHIEN	CM. EL PALMAR	ESCUELA NACIONAL CONCENTRADA 239 SIN NUMERO	693	2	13	534	242	521	0	4	1	0	274	534
EDO. BOLIVAR	CE. HERES	PQ. CATEDRAL	DESAYUNO INFANTIL SANTA LUCIA	487	1	11	386	199	375	0	2	0	1	173	386
EDO. BOLIVAR	CE. HERES	PQ. CATEDRAL	LICEO BOLIVARIANO ERNESTO SIFONTES	102	1	4	86	37	82	0	1	0	0	44	86
EDO. BOLIVAR	CE. HERES	PQ. CATEDRAL	ESCUELA DE MUSICA CARLOS AFANADOR	802	2	5	647	238	642	0	5	0	1	398	647
EDO. BOLIVAR	CE. HERES	PQ. CATEDRAL	CENTRO EDUCACION INICIAL CARLOS HERNANDEZ ACOSTA	76	1	2	69	32	67	0	0	0	0	35	69
EDO. BOLIVAR	CE. HERES	PQ. CATEDRAL	CICLO BASICO INDUSTRIAL EL CAMBAO	1703	3	58	1316	656	1258	0	10	0	0	592	1316
EDO. BOLIVAR	CE. HERES	PQ. CATEDRAL	COLEGIO NUESTRA SEÑORA DE LAS NIEVES	2454	5	21	2100	343	2079	0	4	2	2	1728	2100
EDO. BOLIVAR	CE. HERES	PQ. CATEDRAL	ESCUELA BASICA NACIONAL EL MEREYAL	2479	5	45	1927	1110	1882	1	14	0	2	755	1927
EDO. BOLIVAR	CE. HERES	PQ. CATEDRAL	ESCUELA ESTADAL DIVINO NIÑO	1110	2	16	938	466	922	0	7	0	1	448	938
EDO. BOLIVAR	CE. HERES	PQ. CATEDRAL	ESCUELA BASICA JUAN BAUTISTA FARRERAS	1465	3	21	1138	594	1117	1	6	0	0	516	1138
EDO. BOLIVAR	CE. HERES	PQ. CATEDRAL	CICLO BASICO COMUN TOMAS DE HERES	1288	3	12	1047	303	1035	0	5	0	0	727	1047
EDO. BOLIVAR	CE. HERES	PQ. CATEDRAL	ESCUELA BASICA BOLIVAR	40	1	1	31	14	30	0	0	0	0	16	31
EDO. BOLIVAR	CE. HERES	PQ. CATEDRAL	ESCUELA ESTADAL BASICA MARIA ANTONIA MEJIAS	3089	6	55	2460	1155	2405	0	34	0	2	1214	2460
EDO. BOLIVAR	CE. HERES	PQ. CATEDRAL	ESCUELA BASICA BLANCA SOSA DE VARGAS	2512	5	44	2054	881	2010	0	4	0	1	1124	2054
EDO. BOLIVAR	CE. HERES	PQ. CATEDRAL	ESCUELA TECNICA ASISTENCIAL ROBINSONIANA ANGOSTURA	114	1	5	93	61	88	0	0	0	0	27	93
EDO. BOLIVAR	CE. HERES	PQ. CATEDRAL	ESCUELA BASICA CAÑAFISTOLA	1325	3	41	1034	539	993	0	8	0	0	446	1034
EDO. BOLIVAR	CE. HERES	PQ. CATEDRAL	CICLO DIVERSIFICADO FERNANDO PEÑALVER	2298	4	20	1779	537	1759	0	12	0	0	1210	1779
EDO. BOLIVAR	CE. HERES	PQ. CATEDRAL	CENTRO DE EDUCACION INICIAL LA  LLOVIZNA	124	1	2	99	40	97	0	0	0	0	57	99
EDO. BOLIVAR	CE. HERES	PQ. CATEDRAL	ESCUELA ZEA	819	2	13	639	241	626	0	5	0	0	380	639
EDO. BOLIVAR	CE. HERES	PQ. CATEDRAL	UNIDAD EDUCATIVA ESTADAL TOMAS DE HERES	390	1	5	349	220	344	0	3	0	1	120	349
EDO. BOLIVAR	CE. HERES	PQ. CATEDRAL	ESCUELA BASICA NACIONAL LA LORENA	1260	3	24	1010	570	986	1	8	0	1	406	1010
EDO. BOLIVAR	CE. HERES	PQ. CATEDRAL	GRUPO ESCOLAR MANUEL PALACIO FAJARDO	497	1	10	422	164	412	0	2	0	0	246	422
EDO. BOLIVAR	CE. HERES	PQ. CATEDRAL	ESCUELA ESTADAL SIMON BOLIVAR	1118	2	17	900	416	883	0	4	1	0	462	900
EDO. BOLIVAR	CE. HERES	PQ. CATEDRAL	CENTRO DE EDUCACION INICIAL SIMONCITO GUAYANA	73	1	2	64	32	62	0	0	0	0	30	64
EDO. BOLIVAR	CE. HERES	PQ. CATEDRAL	ESCUELA MUNICIPAL ROMULO GALLEGOS	694	2	8	576	301	568	0	6	0	1	260	576
EDO. BOLIVAR	CE. HERES	PQ. CATEDRAL	ESCUELA BASICA HERES	689	2	11	551	229	540	0	4	1	0	306	551
EDO. BOLIVAR	CE. HERES	PQ. CATEDRAL	ESCUELA DE MEDICINA DE LA UNIVERSIDAD DE ORIENTE	2120	4	27	1754	661	1727	0	17	0	2	1047	1754
EDO. BOLIVAR	CE. HERES	PQ. CATEDRAL	ESCUELA JOSE LUIS ARISTIGUETA	1138	2	19	885	435	866	0	6	2	0	423	885
EDO. BOLIVAR	CE. HERES	PQ. CATEDRAL	LICEO SUCRE	473	1	7	409	115	402	0	2	0	0	285	409
EDO. BOLIVAR	CE. HERES	PQ. CATEDRAL	CENTRO DE EDUCACION INICIAL SIMONCITO RAMON ANTONIO PEREZ	169	1	4	138	77	134	0	0	0	0	57	138
EDO. BOLIVAR	CE. HERES	PQ. CATEDRAL	ESCUELA ESTADAL TEODORA MENDEZ DE MONTES	2562	5	40	2075	1056	2035	1	22	1	3	952	2075
EDO. BOLIVAR	CE. HERES	PQ. CATEDRAL	ESCUELA BASICA ESTADAL RAMON ANTONIO PEREZ	2862	5	46	2268	1142	2222	2	15	0	0	1063	2268
EDO. BOLIVAR	CE. HERES	PQ. CATEDRAL	ESCUELA BASICA ESTADO MERIDA	2180	4	31	1482	527	1451	0	12	0	0	912	1482
EDO. BOLIVAR	CE. HERES	PQ. CATEDRAL	ESCUELA BASICA NACIONAL NUMERO 136 EL ROTARY	1548	3	50	1203	709	1153	0	9	1	0	434	1203
EDO. BOLIVAR	CE. HERES	PQ. CATEDRAL	UNIVERSIDAD BOLIVARIANA DE VENEZUELA	251	1	8	206	108	198	0	3	0	0	87	206
EDO. BOLIVAR	CE. HERES	PQ. CATEDRAL	ESCUELA BASICA NIÑOS PREGONEROS	2962	6	38	2116	1060	2078	0	11	1	0	1006	2116
EDO. BOLIVAR	CE. HERES	PQ. CATEDRAL	COLEGIO DIVINA PASTORA	2005	4	19	1764	463	1745	0	6	0	0	1276	1764
EDO. BOLIVAR	CE. HERES	PQ. CATEDRAL	ESCUELA BASICA ESTADAL BOLIVARIANA ALEJANDRO VARGAS	108	1	2	95	57	93	0	0	0	0	36	95
EDO. BOLIVAR	CE. HERES	PQ. CATEDRAL	UNIDAD EDUCATIVA ESTADAL BOLIVARIANA BACHILLER NARCISO FRAGACHAN	131	1	4	119	63	115	0	0	0	0	52	119
EDO. BOLIVAR	CE. HERES	PQ. CATEDRAL	ESCUELA BASICA FELIX MONTES	590	1	11	515	163	504	1	2	0	0	338	515
EDO. BOLIVAR	CE. HERES	PQ. CATEDRAL	JARDIN DE INFANCIA LOS COQUITOS	2649	5	50	2178	1082	2128	1	15	1	3	1026	2178
EDO. BOLIVAR	CE. HERES	PQ. CATEDRAL	UNIDAD EDUCATIVA ESTADAL SAN JOSE DE LAS MOREAS	94	1	1	71	30	70	0	1	0	0	39	71
EDO. BOLIVAR	CE. HERES	PQ. MARHUANTA	ESCUELA TECNICA DE SALUD FRANCISCO VITANZA	451	1	7	332	193	325	0	1	0	0	131	332
EDO. BOLIVAR	CE. HERES	PQ. MARHUANTA	UNIDAD EDUCATIVA NACIONAL LAS GARZAS NUCLEO ESCOLAR RURAL 308	194	1	5	166	126	161	0	0	0	0	35	166
EDO. BOLIVAR	CE. HERES	PQ. MARHUANTA	UNIDAD EDUCATIVA BOLIVARIANA 24 DE JULIO	891	2	14	717	457	703	0	4	0	0	242	717
EDO. BOLIVAR	CE. HERES	PQ. MARHUANTA	CENTRO DE EDUCACION INICIAL SIMONCITO ALTOS DE CAYAURIMA	155	1	6	140	109	134	0	0	0	0	25	140
EDO. BOLIVAR	CE. HERES	PQ. MARHUANTA	ESCUELA BASICA VENEZUELA	1616	3	41	1227	718	1186	0	12	0	0	456	1227
EDO. BOLIVAR	CE. HERES	PQ. MARHUANTA	ESCUELA BASICA BACHILLER FELIPE HERNANDEZ	3777	7	68	2902	1896	2834	3	20	2	1	912	2902
EDO. BOLIVAR	CE. HERES	PQ. MARHUANTA	ESCUELA BASICA MAIPURE II	1634	3	41	1251	738	1210	0	8	2	1	461	1251
EDO. BOLIVAR	CE. HERES	PQ. MARHUANTA	ESCUELA INTEGRAL BOLIVARIANA SAMUEL ROBINSON	1839	4	31	1633	842	1602	1	15	0	1	743	1633
EDO. BOLIVAR	CE. HERES	PQ. MARHUANTA	ESCUELA INTEGRAL BOLIVARIANA MONSEÑOR CESAR ORTEGA HERRERA	283	1	5	239	163	234	0	2	0	0	69	239
EDO. BOLIVAR	CE. HERES	PQ. MARHUANTA	UNIDAD EDUCATIVA NACIONAL PROFESOR CARMELO CASTILLO	1585	3	38	1211	741	1173	1	9	0	0	422	1211
EDO. BOLIVAR	CE. HERES	PQ. MARHUANTA	UNIDAD EDUCATIVA MUNICIPAL DOCTOR LUIS PASARELLA	671	2	18	552	347	534	1	8	0	1	177	552
EDO. BOLIVAR	CE. HERES	PQ. MARHUANTA	UNIDAD EDUCATIVA BOLIVARIANA  JOSE GIL FORTOUL NUCLEO ESCOLAR RURAL  308	170	1	9	150	80	141	0	2	1	0	58	150
EDO. BOLIVAR	CE. HERES	PQ. MARHUANTA	ESCUELA CONCENTRADA MENCA DE LEONI	1912	4	31	1449	815	1418	1	12	0	0	590	1449
EDO. BOLIVAR	CE. HERES	PQ. MARHUANTA	UNIDAD EDUCATIVA SECTOR MAHRUANTA SUR	297	1	8	246	164	238	0	2	0	0	72	246
EDO. BOLIVAR	CE. HERES	PQ. MARHUANTA	UNIDAD EDUCATIVA NACIONAL SAN VALENTIN	377	1	9	314	217	305	0	3	0	0	85	314
EDO. BOLIVAR	CE. HERES	PQ. MARHUANTA	UNIDAD EDUCATIVA BOLIVARIANA  CASANOVA SUR I NUCLEO ESCOLAR RURAL 308	64	1	0	42	31	42	0	0	0	0	11	42
EDO. BOLIVAR	CE. HERES	PQ. VISTA HERMOSA	UNIDAD EDUCATIVA NACIONAL PROFESOR JOSE FRANCISCO MIRANDA	138	1	2	112	67	110	0	0	0	0	43	112
EDO. BOLIVAR	CE. HERES	PQ. VISTA HERMOSA	UNIDAD EDUCATIVA ESTADAL ANGOSTURITA II	339	1	4	286	182	282	0	4	1	0	95	286
EDO. BOLIVAR	CE. HERES	PQ. VISTA HERMOSA	ESCUELA BASICA MANUEL PIAR	1094	2	8	960	225	952	0	6	0	0	721	960
EDO. BOLIVAR	CE. HERES	PQ. VISTA HERMOSA	ESCUELA ESTADAL VIRGEN DEL VALLE	3502	6	71	2861	1262	2790	0	16	2	1	1509	2861
EDO. BOLIVAR	CE. HERES	PQ. VISTA HERMOSA	DISTRITO ESCOLAR NUMERO 5	117	1	1	41	27	40	0	1	0	0	12	41
EDO. BOLIVAR	CE. HERES	PQ. VISTA HERMOSA	CARCEL NACIONAL CIUDAD BOLIVAR	1144	2	9	456	383	447	1	3	1	1	58	456
EDO. BOLIVAR	CE. HERES	PQ. VISTA HERMOSA	ESCUELA ESTADAL ELENA ACOSTA YANEZ	1482	3	25	1213	525	1188	0	11	0	0	652	1213
EDO. BOLIVAR	CE. HERES	PQ. VISTA HERMOSA	ESCUELA BASICA EXPERIMENTAL LA PARAGUA	2941	6	24	2550	865	2526	0	16	0	4	1641	2550
EDO. BOLIVAR	CE. HERES	PQ. VISTA HERMOSA	JARDIN DE INFANCIA JOSEFA PASCAL	1771	3	21	1556	444	1535	0	5	0	1	1085	1556
EDO. BOLIVAR	CE. HERES	PQ. VISTA HERMOSA	ESCUELA BASICA BOLIVARIANA ANGOSTURA	1921	4	35	1531	836	1496	0	11	1	3	645	1531
EDO. BOLIVAR	CE. HERES	PQ. VISTA HERMOSA	UNIDAD EDUCATIVA NACIONAL DE FORMACION DEPORTIVA BOLIVAR	270	1	3	241	77	238	0	2	0	0	159	241
EDO. BOLIVAR	CE. HERES	PQ. VISTA HERMOSA	UNIDAD EDUCATIVA TERESA DE LA PARRA	1121	2	23	983	521	960	0	9	1	4	425	983
EDO. BOLIVAR	CE. HERES	PQ. VISTA HERMOSA	ESCUELA BASICA NACIONAL AGOSTO MENDEZ	1345	3	23	1099	334	1076	0	6	0	0	736	1099
EDO. BOLIVAR	CE. HERES	PQ. VISTA HERMOSA	ESCUELA TECNICA COMERCIAL DALLA COSTA	2760	5	25	2259	507	2234	1	11	0	0	1715	2259
EDO. BOLIVAR	CE. HERES	PQ. VISTA HERMOSA	INSTITUTO DE COOPERACION NACIONAL EDUCATIVA	1888	4	32	1631	670	1599	0	4	0	1	924	1631
EDO. BOLIVAR	CE. HERES	PQ. VISTA HERMOSA	ESCUELA NACIONAL BASICA VISTA HERMOSA	3647	7	53	3081	764	3028	1	14	1	0	2248	3081
EDO. BOLIVAR	CE. HERES	PQ. VISTA HERMOSA	ESCUELA BASICA FE Y ALEGRIA	2700	5	43	2101	1120	2058	0	15	0	1	922	2101
EDO. BOLIVAR	CE. HERES	PQ. VISTA HERMOSA	ESCUELA ESTADAL JOSE LUIS ORSETTI	1010	2	14	865	298	851	0	4	0	0	549	865
EDO. BOLIVAR	CE. HERES	PQ. VISTA HERMOSA	UNIDAD EDUCATIVA NACIONAL ARMANDO REVERÒN	367	1	7	322	228	315	0	0	0	0	87	322
EDO. BOLIVAR	CE. HERES	PQ. VISTA HERMOSA	ESCUELA COLUMBO SILVA BOLIVAR	1297	3	13	1073	454	1060	0	7	1	1	597	1073
EDO. BOLIVAR	CE. HERES	PQ. VISTA HERMOSA	COLEGIO MARIA MONTESSORI	1146	2	10	987	169	977	0	3	0	0	805	987
EDO. BOLIVAR	CE. HERES	PQ. VISTA HERMOSA	ESCUELA BASICA CARMEN LUNA LEZAMA	3383	6	17	2854	640	2837	2	10	0	2	2183	2854
EDO. BOLIVAR	CE. HERES	PQ. VISTA HERMOSA	JARDIN DE INFANCIA VISTA HERMOSA	174	1	0	160	40	160	0	0	0	0	120	160
EDO. BOLIVAR	CE. HERES	PQ. VISTA HERMOSA	CICLO DIVERSIFICADO ANTONIO DIAZ	1340	3	11	1174	243	1163	0	3	0	2	915	1174
EDO. BOLIVAR	CE. HERES	PQ. VISTA HERMOSA	ESCUELA GRADUADA NEGRO PRIMERO NUMERO 2877	1552	3	34	1236	551	1202	0	9	0	1	641	1236
EDO. BOLIVAR	CE. HERES	PQ. VISTA HERMOSA	COLEGIO CRISTO REY	997	2	4	833	222	829	0	0	1	2	604	833
EDO. BOLIVAR	CE. HERES	PQ. VISTA HERMOSA	ESCUELA BASICA ISABEL SALOM	2449	5	58	2075	667	2017	0	9	2	3	1336	2075
EDO. BOLIVAR	CE. HERES	PQ. VISTA HERMOSA	ESCUELA MUNICIPAL DOCTOR JUVENAL MONTES	471	1	6	382	236	376	0	1	0	0	139	382
EDO. BOLIVAR	CE. HERES	PQ. PANAPANA	UNIDAD EDUCATIVA NACIONAL PUEBLO NUEVO	62	1	5	59	50	54	0	0	0	0	4	59
EDO. BOLIVAR	CE. HERES	PQ. PANAPANA	ESCUELA BASICA NACIONAL ANGOSTURITA SIN NUMERO	64	1	1	57	35	56	1	0	0	0	20	57
EDO. BOLIVAR	CE. HERES	PQ. PANAPANA	UNIDAD EDUCATIVA BOLIVARIANA EL ROSARIO	145	1	3	127	85	124	0	0	1	0	38	127
EDO. BOLIVAR	CE. HERES	PQ. PANAPANA	ESCUELA BOLIVARIANA SIN NUMERO, LOS NEGRITOS	96	1	3	85	63	82	0	2	1	1	15	85
EDO. BOLIVAR	CE. HERES	PQ. PANAPANA	UNIDAD EDUCATIVA BOLIVARIANA PALMARITO	379	1	10	304	229	294	0	2	0	0	63	304
EDO. BOLIVAR	CE. HERES	PQ. PANAPANA	UNIDAD EDUCATIVA ESTADAL BOCA DE MARHUANTA	51	1	3	51	45	48	0	0	0	0	3	51
EDO. BOLIVAR	CE. HERES	PQ. PANAPANA	UNIDAD EDUCATIVA BOLIVARIANA BONGO	513	1	14	384	282	370	1	5	0	1	81	384
EDO. BOLIVAR	CE. HERES	PQ. PANAPANA	UNIDAD EDUCATIVA BOLIVARIANA NUMERO 1186. GUAIMIRE	506	1	17	411	324	394	0	0	0	0	70	411
EDO. BOLIVAR	CE. HERES	PQ. JOSE ANTONIO PAEZ	UNIDAD BOLIVARIANA LOS LIRIOS NUCLEO RURAL 582   GUAIMIRE	100	1	4	90	52	86	0	0	0	0	34	90
EDO. BOLIVAR	CE. HERES	PQ. JOSE ANTONIO PAEZ	ESCUELA INTEGRAL BOLIVARIANA LOS CARIBES	145	1	4	126	93	122	0	0	0	0	29	126
EDO. BOLIVAR	CE. HERES	PQ. JOSE ANTONIO PAEZ	UNIDAD EDUCATIVA SANTA ROSA DE LIMA FE Y ALEGRIA	1404	3	31	1084	700	1053	1	10	1	0	341	1084
EDO. BOLIVAR	CE. HERES	PQ. JOSE ANTONIO PAEZ	UNIDAD EDUCATIVA COLINAS BOLIVARIANAS	236	1	2	190	138	188	0	3	0	0	47	190
EDO. BOLIVAR	CE. HERES	PQ. JOSE ANTONIO PAEZ	UNIDAD EDUCATIVA BOLIVARIANA CHUPADERO NUCLEO ESCOLAR RURAL 582   GUAIMIRE	124	1	1	96	51	95	0	1	1	0	42	96
EDO. BOLIVAR	CE. HERES	PQ. JOSE ANTONIO PAEZ	UNIDAD EDUCATIVA BOLIVARIANA CARDOZO NUCLEO ESCOLAR RURAL 582	237	1	2	217	171	215	0	0	0	0	44	217
EDO. BOLIVAR	CE. HERES	PQ. JOSE ANTONIO PAEZ	ESCUELA BASICA ESTADAL MANUEL CARLOS PIAR	1649	3	29	1188	795	1159	1	9	2	0	352	1188
EDO. BOLIVAR	CE. HERES	PQ. JOSE ANTONIO PAEZ	ESCUELA BASICA JOSE ANTONIO PAEZ	3899	7	79	2918	1660	2839	1	29	1	1	1147	2918
EDO. BOLIVAR	CE. HERES	PQ. JOSE ANTONIO PAEZ	ESCUELA NACIONAL UNITARIA SIN NUMERO	274	1	2	150	96	148	0	0	0	0	52	150
EDO. BOLIVAR	CE. HERES	PQ. JOSE ANTONIO PAEZ	UNIDAD EDUCATIVA BOLIVARIANA RURAL 19 DE ABRIL	653	2	13	555	347	542	1	5	3	0	186	555
EDO. BOLIVAR	CE. HERES	PQ. JOSE ANTONIO PAEZ	UNIDAD EDUCATIVA COLEGIO PRIVADO VILLA DEL SUR FE Y ALEGRIA	208	1	10	162	103	152	0	1	0	0	48	162
EDO. BOLIVAR	CE. HERES	PQ. JOSE ANTONIO PAEZ	PRE  ESCOLAR RAYITO DE LUZ	224	1	6	192	160	186	0	0	1	0	25	192
EDO. BOLIVAR	CE. HERES	PQ. JOSE ANTONIO PAEZ	ESCUELA BASICA CONCENTRADA MANUEL PIAR EL DORADO	2524	5	54	1948	1331	1894	0	24	0	0	539	1948
EDO. BOLIVAR	CE. HERES	PQ. JOSE ANTONIO PAEZ	ESCUELA ANTONIO JOSE DE SUCRE	777	2	9	610	362	601	0	2	0	0	237	610
EDO. BOLIVAR	CE. HERES	PQ. JOSE ANTONIO PAEZ	ESCUELA BASICA CREACION EL CHAPARRAL	61	1	1	57	45	56	0	0	0	0	11	57
EDO. BOLIVAR	CE. HERES	PQ. JOSE ANTONIO PAEZ	ESCUELA BASICA NACIONAL MARIA ZULIA DE MORALES	3815	7	92	2804	1785	2712	1	39	3	0	884	2804
EDO. BOLIVAR	CE. HERES	PQ. JOSE ANTONIO PAEZ	UNIDAD EDUCATIVA ELEAZAR LOPEZ CONTRERAS	617	2	11	476	255	465	0	1	2	0	207	476
EDO. BOLIVAR	CE. HERES	PQ. JOSE ANTONIO PAEZ	UNIDAD EDUCATIVA COLEGIO SAN PABLO	595	1	8	454	318	446	0	3	0	0	125	454
EDO. BOLIVAR	CE. HERES	PQ. LA SABANITA	UNIDAD EDUCATIVA ESTADAL BOLIVARIANA  PROFESOR  JUAN BAUTISTA GONZALEZ	128	1	0	114	69	114	0	1	0	0	44	114
EDO. BOLIVAR	CE. HERES	PQ. LA SABANITA	UNIDAD EDUCATIVA COLEGIO DIVINO NIÑO JESUS	92	1	1	68	45	67	0	0	0	0	22	68
EDO. BOLIVAR	CE. HERES	PQ. LA SABANITA	UNIDAD EDUCATIVA COLEGIO PRIVADO LA OCTAVA ESTRELLA	100	1	3	83	47	80	0	1	0	0	32	83
EDO. BOLIVAR	CE. HERES	PQ. LA SABANITA	UNIDAD EDUCATIVA BOLIVARIANA  SIMON BOLIVAR	3761	7	58	2872	1780	2814	2	19	0	0	1013	2872
EDO. BOLIVAR	CE. HERES	PQ. LA SABANITA	UNIDAD EDUCATIVA ESTADAL BOLIVARIANA JESUS SOTO	149	1	3	139	76	136	0	1	0	0	59	139
EDO. BOLIVAR	CE. HERES	PQ. LA SABANITA	ESCUELA BASICA NACIONAL LIBERTADOR	3646	7	64	2854	1407	2790	1	25	6	3	1348	2854
EDO. BOLIVAR	CE. HERES	PQ. LA SABANITA	ESCUELA FE Y ALEGRIA LA INMACULADA	3053	6	48	2289	1261	2241	0	18	0	0	962	2289
EDO. BOLIVAR	CE. HERES	PQ. LA SABANITA	UNIDAD EDUCATIVA ESTADAL JOSE LUIS AFANADOR	2164	4	34	1714	736	1680	1	6	3	1	933	1714
EDO. BOLIVAR	CE. HERES	PQ. LA SABANITA	ESCUELA BASICA ELSA MONTES DE RIVAS	2174	4	42	1681	724	1639	1	10	0	0	904	1681
EDO. BOLIVAR	CE. HERES	PQ. LA SABANITA	CENTRO EDUCACION INICIAL JOSE MANUEL SISO MARTINEZ	79	1	4	74	26	70	0	0	0	0	44	74
EDO. BOLIVAR	CE. HERES	PQ. LA SABANITA	ESCUELA BASICA ESTADAL ANITA RAMIREZ	4412	8	59	3582	1745	3523	2	31	1	0	1744	3582
EDO. BOLIVAR	CE. HERES	PQ. LA SABANITA	UNIDAD EDUCATIVA ESTADAL BRISAS DEL ESTE II	76	1	1	58	44	57	0	1	0	0	12	58
EDO. BOLIVAR	CE. HERES	PQ. LA SABANITA	CENTRO DE EDUCACION INICIAL CARLOS AFANADOR REAL	265	1	7	202	94	195	0	0	0	1	100	202
EDO. BOLIVAR	CE. HERES	PQ. LA SABANITA	UNIDAD EDUCATIVA BOLIVARIANA BICENTENARIO	82	1	2	62	36	60	0	0	0	0	24	62
EDO. BOLIVAR	CE. HERES	PQ. LA SABANITA	ESCUELA TECNICA LUIS MARIA OLASO FE Y ALEGRIA	87	1	2	72	47	70	0	0	0	0	23	72
EDO. BOLIVAR	CE. HERES	PQ. LA SABANITA	CENTRO DE  EDUCACION INICIAL  BOLIVARIANO PEDRO RAFAEL BUCARITO	154	1	5	120	61	115	0	0	0	0	54	120
EDO. BOLIVAR	CE. HERES	PQ. LA SABANITA	ESCUELA BASICA MUNICIPAL BETANIA	102	1	1	90	65	89	0	0	0	0	24	90
EDO. BOLIVAR	CE. HERES	PQ. LA SABANITA	UNIDAD EDUCATIVA COLEGIO PRIVADO MORAL Y LUCES	93	1	4	76	38	72	0	0	0	0	34	76
EDO. BOLIVAR	CE. HERES	PQ. LA SABANITA	ESCUELA ESTADAL NUESTRA SEÑORA DE COROMOTO	3571	7	60	2849	1276	2789	1	15	0	0	1497	2849
EDO. BOLIVAR	CE. HERES	PQ. LA SABANITA	CENTRO EDUCACION INICIAL LA SAPOARITA	120	1	3	105	54	102	0	0	0	0	48	105
EDO. BOLIVAR	CE. HERES	PQ. LA SABANITA	INSTITUTO DE EDUCACION ESPECIAL SABANITA	109	1	0	86	39	86	0	0	0	0	47	86
EDO. BOLIVAR	CE. HERES	PQ. LA SABANITA	UNIDAD EDUCATIVA JESUS SOTO	46	1	1	41	15	40	0	2	0	0	23	41
EDO. BOLIVAR	CE. HERES	PQ. LA SABANITA	ESCUELA BASICA MARGINAL JERUSALEN	2531	5	34	1965	1103	1931	1	19	0	0	808	1965
EDO. BOLIVAR	CE. HERES	PQ. LA SABANITA	UNIDAD EDUCATIVA ESTADAL INTEGRAL LAS MARGARITA	134	1	2	124	92	122	0	1	0	0	29	124
EDO. BOLIVAR	CE. HERES	PQ. LA SABANITA	UNIDAD EDUCATIVA BOLIVARIANA  BRISAS DEL ESTE I	121	1	4	88	53	84	0	0	0	0	31	88
EDO. BOLIVAR	CE. HERES	PQ. LA SABANITA	ESCUELA CONCENTRADA ESTADAL GENERAL ANTONIO GUZMAN BLANCO 100 35	827	2	13	656	415	643	1	4	0	0	223	656
EDO. BOLIVAR	CE. HERES	PQ. LA SABANITA	ESCUELA BASICA SIMON RODRIGUEZ CENTRO EDUCACION ADULTOS ACEITICO II	2440	5	27	2055	873	2028	0	9	0	0	1146	2055
EDO. BOLIVAR	CE. HERES	PQ. LA SABANITA	ESCUELA MIXTA LA TRINIDAD	2360	4	64	1781	1041	1717	0	13	3	1	659	1781
EDO. BOLIVAR	CE. HERES	PQ. LA SABANITA	ESCUELA BASICA ROSA LUSINCHI DE CENTENO	3038	6	41	2467	1152	2426	0	15	3	1	1255	2467
EDO. BOLIVAR	CE. HERES	PQ. LA SABANITA	UNIDAD EDUCATIVA COLEGIO PRIVADO INTEGRAL BOLIVAR	119	1	1	97	46	96	0	0	0	1	49	97
EDO. BOLIVAR	CE. HERES	PQ. LA SABANITA	ESCUELA BASICA CARLOS AFANADOR REAL	2730	5	45	2153	937	2108	0	17	1	2	1151	2153
EDO. BOLIVAR	CE. HERES	PQ. LA SABANITA	CENTRO EDUCACION INICIAL  PASTORA DE REQUEZ	83	1	5	76	35	71	0	0	0	0	36	76
EDO. BOLIVAR	CE. HERES	PQ. LA SABANITA	CICLO BASICO COMUN CARLOS EMILIANO SALOM	3526	6	64	2636	1166	2572	2	25	2	0	1377	2636
EDO. BOLIVAR	CE. HERES	PQ. LA SABANITA	ESCUELA BASICA DON BRIGIDO NATERA RICCI	141	1	4	111	73	107	0	1	0	0	33	111
EDO. BOLIVAR	CE. HERES	PQ. LA SABANITA	UNIDAD EDUCATIVA ESTADAL DIVINA MISERICORDIA	190	1	6	163	98	157	0	0	0	0	59	163
EDO. BOLIVAR	CE. HERES	PQ. LA SABANITA	ESCUELA ESTADAL BASICA ANDRES BELLO	2263	4	29	1650	945	1621	0	11	0	1	664	1650
EDO. BOLIVAR	CE. HERES	PQ. LA SABANITA	CENTRO DE EDUCACION INICIAL EL MIRADOR	306	1	5	260	195	255	0	3	1	0	56	260
EDO. BOLIVAR	CE. HERES	PQ. LA SABANITA	UNIDAD EDUCATIVA MUNICIPAL ESTADO NUEVA ESPARTA	145	1	3	129	69	126	0	3	0	0	54	129
EDO. BOLIVAR	CE. HERES	PQ. LA SABANITA	CENTRO EDUCACION INICIAL  BUEN PASTOR	89	1	0	79	53	79	1	1	0	0	24	79
EDO. BOLIVAR	CE. HERES	PQ. LA SABANITA	UNIDAD EDUCATIVA COLEGIO PRIVADO SION II	105	1	3	86	49	83	0	0	0	0	34	86
EDO. BOLIVAR	CE. HERES	PQ. LA SABANITA	UNIDAD EDUCATIVA MUNICIPAL DOCTOR JOSE MANUEL AGOSTO MENDEZ	61	1	0	56	21	56	0	0	0	0	35	56
EDO. BOLIVAR	CE. HERES	PQ. LA SABANITA	ESCUELA BASICA CRUZ DEL VALLE RODRIGUEZ	2221	4	24	1825	812	1801	0	15	1	0	973	1825
EDO. BOLIVAR	CE. HERES	PQ. LA SABANITA	ESCUELA DE CAPACITACION FEMENINA TERESA DE GRUBER	842	2	21	631	310	610	0	2	0	2	296	631
EDO. BOLIVAR	CE. HERES	PQ. LA SABANITA	ESCUELA INTEGRAL BOLIVARIANA MERCEDES VARGAS	657	2	9	545	333	536	1	5	0	0	197	545
EDO. BOLIVAR	CE. HERES	PQ. LA SABANITA	ESCUELA BASICA NACIONAL LAS BEATRICES	1567	3	22	1194	573	1172	0	13	1	2	583	1194
EDO. BOLIVAR	CE. HERES	PQ. LA SABANITA	ESCUELA BASICA NACIONAL JOSE LUIS AFANADOR	4356	8	93	3323	1773	3230	2	34	0	0	1421	3323
EDO. BOLIVAR	CE. HERES	PQ. AGUA SALADA	UNIDAD EDUCATIVA MONSEÑOR CRISANTO MATA COVA FE Y ALEGRIA	78	1	4	58	41	54	0	0	0	0	13	58
EDO. BOLIVAR	CE. HERES	PQ. AGUA SALADA	UNIDAD EDUCATIVA VILLA BOLIVAR	625	2	11	491	386	480	0	4	1	1	88	491
EDO. BOLIVAR	CE. HERES	PQ. AGUA SALADA	CENTRO DE EDUCACIÒN INICIAL SIMONCITO ANTONIO JOSE DE SUCRE	247	1	3	221	108	218	0	1	1	0	108	221
EDO. BOLIVAR	CE. HERES	PQ. AGUA SALADA	CENTRO DE EDUCACION INICIAL SIMON RODRIGUEZ	109	1	3	96	40	93	0	1	0	0	52	96
EDO. BOLIVAR	CE. HERES	PQ. AGUA SALADA	UNIDAD EDUCATIVA INTEGRAL PRIVADO LOS PROCERES	307	1	6	257	131	251	0	0	0	1	119	257
EDO. BOLIVAR	CE. HERES	PQ. AGUA SALADA	PREESCOLAR ASISTENCIAL JOSE TOMAS RAMOS	522	1	4	459	252	455	0	5	0	1	197	459
EDO. BOLIVAR	CE. HERES	PQ. AGUA SALADA	ESCUELA BASICA ESTADAL SAN JOSE DEL PERU	282	1	11	242	151	231	0	2	1	0	77	242
EDO. BOLIVAR	CE. HERES	PQ. AGUA SALADA	UNIDAD EDUCATIVA ESTADAL SANTA EDUVIGES	1619	3	40	1274	741	1234	1	8	0	2	482	1274
EDO. BOLIVAR	CE. HERES	PQ. AGUA SALADA	ESCUELA INTEGRAL BOLIVARIANA SAN JONOTE	488	1	11	408	285	397	0	2	0	0	110	408
EDO. BOLIVAR	CE. HERES	PQ. AGUA SALADA	UNIDAD EDUCTIVA COLEGIO PRIVADO ALFA Y OMEGA	912	2	25	701	404	676	0	5	1	1	265	701
EDO. BOLIVAR	CE. HERES	PQ. AGUA SALADA	CENTRO DE EDUCACION INICIAL  MUNDO DE COLORES	249	1	7	200	114	193	1	1	0	0	77	200
EDO. BOLIVAR	CE. HERES	PQ. AGUA SALADA	UNIDAD EDUCATIVA NACIONAL SUCRE	787	2	16	675	435	659	0	5	0	0	219	675
EDO. BOLIVAR	CE. HERES	PQ. AGUA SALADA	LICEO BOLIVARIANO MONSEÑOR RAMON IGNACIO LIZARDI	646	2	9	524	319	515	1	5	1	0	189	524
EDO. BOLIVAR	CE. HERES	PQ. AGUA SALADA	ESCUELA BASICA NACIONAL LOS PROCERES II	3962	7	56	3065	1693	3009	1	22	0	2	1291	3065
EDO. BOLIVAR	CE. HERES	PQ. AGUA SALADA	ESCUELA ESTADAL BASICA VICTOR MONDRAGON	2346	5	41	1832	937	1791	0	14	0	3	837	1832
EDO. BOLIVAR	CE. HERES	PQ. AGUA SALADA	ESCUELA BASICA NACIONAL EL PERU	4152	8	72	3326	1763	3254	1	27	0	6	1457	3326
EDO. BOLIVAR	CE. HERES	PQ. AGUA SALADA	ESCUELA ESTADAL BASICA  AGUA SALADA	4140	8	75	3116	1584	3041	0	23	0	1	1433	3116
EDO. BOLIVAR	CE. HERES	PQ. AGUA SALADA	ESCUELA NACIONAL BUENA VISTA	627	2	26	503	305	477	0	2	0	0	170	503
EDO. BOLIVAR	CE. HERES	PQ. AGUA SALADA	KINDER LA PARAGUA	2111	4	49	1724	929	1675	0	11	2	2	731	1724
EDO. BOLIVAR	CE. HERES	PQ. AGUA SALADA	UNIDAD EDUCATIVA LOS PROCERES	4708	9	59	3801	2015	3742	1	32	2	0	1692	3801
EDO. BOLIVAR	CE. HERES	PQ. AGUA SALADA	UNIDAD EDUCATIVA NACIONAL  MANUEL YANEZ	126	1	6	113	87	107	0	1	0	0	19	113
EDO. BOLIVAR	CE. HERES	PQ. AGUA SALADA	PREESCOLAR SAGRADO CORAZON DE JESUS.	1220	3	14	984	523	970	0	7	1	1	438	984
EDO. BOLIVAR	CE. HERES	PQ. AGUA SALADA	ESCUELA BASICA SALTO ANGEL	3585	7	55	2939	1219	2884	1	17	1	1	1645	2939
EDO. BOLIVAR	CE. HERES	PQ. AGUA SALADA	CENTRO DE EDUCACION INICIAL LOS AZULEJOS	754	2	21	667	287	646	0	2	0	0	357	667
EDO. BOLIVAR	CE. HERES	PQ. AGUA SALADA	PREESCOLAR EL PERU.	1435	3	22	1186	505	1164	1	3	0	2	653	1186
EDO. BOLIVAR	CE. HERES	PQ. AGUA SALADA	CENTRO DE EDUCACION INICIAL FRANCIA SALAZAR	113	1	0	94	66	94	0	2	0	0	26	94
EDO. BOLIVAR	CE. HERES	PQ. AGUA SALADA	UNIDAD EDUCATIVA BOLIVARIANA ESTADAL LUIS BELTRAN PRIETO FIGUEROA	81	1	1	69	38	68	0	2	0	0	28	69
EDO. BOLIVAR	CE. HERES	PQ. AGUA SALADA	UNIDAD EDUCATIVA ESTADAL DOCTOR RAUL LEONI	700	2	15	606	393	591	0	2	0	0	196	606
EDO. BOLIVAR	CE. HERES	PQ. AGUA SALADA	ESCUELA INTEGRAL BOLIVARIANA NUMERO 3298 609 LAS FLORES	412	1	14	275	152	261	0	0	0	0	109	275
EDO. BOLIVAR	CE. HERES	PQ. ORINOCO	ESCUELA INTEGRAL BOLIVARIANA MAYAGUA	526	1	9	432	290	423	0	2	0	0	131	432
EDO. BOLIVAR	CE. HERES	PQ. ORINOCO	ESCUELA BASICA NACIONAL UNITARIA RAUL LEONI	224	1	3	132	86	129	1	0	0	1	41	132
EDO. BOLIVAR	CE. HERES	PQ. ORINOCO	UNIDA EDUCATIVA INTEGRAL BOLIVARIANA CURIAPO	77	1	0	64	44	64	0	2	0	0	18	64
EDO. BOLIVAR	CE. HERES	PQ. ORINOCO	UNIDAD EDUCATIVA BOLIVARIANA NUMERO 34 EL ALMACEN	637	2	9	478	364	469	0	2	1	0	102	478
EDO. BOLIVAR	CE. HERES	PQ. ZEA	ESCUELA BASICA BOLIVARIANA NUMERO 56 LOS PIQUITOS	113	1	1	69	54	68	0	1	0	0	13	69
EDO. BOLIVAR	CE. HERES	PQ. ZEA	ESCUELA ESTADAL CONCENTRADA NACIONAL 45 55  LOS HICOTEOS	230	1	2	155	108	153	0	1	0	0	44	155
EDO. BOLIVAR	CE. HERES	PQ. ZEA	ESCUELA ESTADAL CONCENTRADA NUMERO 115	123	1	2	64	39	62	0	0	0	0	23	64
EDO. BOLIVAR	CE. HERES	PQ. ZEA	UNIDAD EDUCATIVA INTEGRAL BOLIVARIANA LA MATA DE TAPAQUIRE	313	1	6	202	120	196	0	1	0	1	74	202
EDO. BOLIVAR	CE. HERES	PQ. ZEA	UNIDAD EDUCATIVA INTEGRAL BOLIVARIANA LA ESPERANZA	153	1	4	105	80	101	0	1	0	0	20	105
EDO. BOLIVAR	CE. HERES	PQ. ZEA	UNIDAD EDUCATIVA INTEGRAL BOLIVARIANA LA FLOR	294	1	5	205	102	200	0	0	0	0	98	205
EDO. BOLIVAR	CE. HERES	PQ. ZEA	UNIDAD EDUCATIVA INTEGRAL BOLIVARIANA LA CAROLINA	246	1	4	157	93	153	0	1	0	0	59	157
EDO. BOLIVAR	CE. HERES	PQ. ZEA	ESCUELA INTEGRAL BOLIVARIANA CERRO E MONO	169	1	10	136	80	126	0	0	0	0	46	136
EDO. BOLIVAR	CE. HERES	PQ. ZEA	ESCUELA ESTADAL UNITARIA NUMERO 52	114	1	1	62	40	61	0	0	0	0	21	62
EDO. MIRANDA	MP. INDEPENDENCIA	PQ. STA TERESA DEL TUY	ESCUELA BASICA ESTADO PORTUGUESA	868	2	19	727	463	708	0	1	0	0	244	727
EDO. MIRANDA	MP. INDEPENDENCIA	PQ. STA TERESA DEL TUY	ESCUELA BASICA NACIONAL JUAN ANTONIO ROMAN VALECILLOS	3268	6	47	2654	1769	2607	1	16	2	3	816	2654
EDO. MIRANDA	MP. INDEPENDENCIA	PQ. STA TERESA DEL TUY	LICEO NACIONAL  DOS LAGUNAS	2584	5	51	2113	1650	2062	0	7	3	0	402	2113
EDO. MIRANDA	MP. INDEPENDENCIA	PQ. STA TERESA DEL TUY	UNIDAD EDUCATIVA ESTADAL SANTA BARBARA	1291	3	22	1064	903	1042	0	4	0	0	135	1064
EDO. MIRANDA	MP. INDEPENDENCIA	PQ. STA TERESA DEL TUY	CENTRO CULTURAL  JUAN ESPAÑA	1629	3	29	1336	935	1307	0	2	0	0	370	1336
EDO. MIRANDA	MP. INDEPENDENCIA	PQ. STA TERESA DEL TUY	UNIDAD EDUCATIVA PRIVADA CONGRESO DE ANGOSTURA	1556	3	23	1279	760	1256	0	4	0	0	492	1279
EDO. MIRANDA	MP. INDEPENDENCIA	PQ. STA TERESA DEL TUY	UNIDAD EDUCATIVA SEUCE	2028	4	35	1536	1393	1501	4	6	4	0	94	1536
EDO. MIRANDA	MP. INDEPENDENCIA	PQ. STA TERESA DEL TUY	UNIVERSIDAD NACIONAL EXPERIMENTAL SIMON RODRIGUEZ	1473	3	21	1229	670	1208	0	3	0	0	535	1229
EDO. MIRANDA	MP. INDEPENDENCIA	PQ. STA TERESA DEL TUY	UNIDAD EDUCATIVA PRIVADA FRANCISCO TAMAYO	1038	2	20	847	474	827	0	1	1	0	351	847
EDO. MIRANDA	MP. INDEPENDENCIA	PQ. STA TERESA DEL TUY	ESCUELA BASICA NACIONAL CIUDAD LOZADA	3576	7	40	2833	2210	2793	0	10	4	1	568	2833
EDO. MIRANDA	MP. INDEPENDENCIA	PQ. STA TERESA DEL TUY	CENTRO DE EDUCACION INICIAL CIUDAD LOZADA	492	1	5	378	315	373	0	1	0	1	56	378
EDO. MIRANDA	MP. INDEPENDENCIA	PQ. STA TERESA DEL TUY	ESCUELA BASICA NACIONAL 24 DE JUNIO	4129	8	68	3407	2650	3339	1	13	4	2	669	3407
EDO. MIRANDA	MP. INDEPENDENCIA	PQ. STA TERESA DEL TUY	UNIDAD EDUCATIVA NACIONAL SAN JOSE DE RIO CHICO	2913	5	85	2311	1473	2226	2	12	2	2	735	2311
EDO. MIRANDA	MP. INDEPENDENCIA	PQ. STA TERESA DEL TUY	UNIDAD EDUCATIVA ESTADAL SIMON BOLIVAR	338	1	6	280	248	274	1	0	0	0	25	280
EDO. MIRANDA	MP. INDEPENDENCIA	PQ. STA TERESA DEL TUY	CENTRO DE EDUCACION INICIAL NACIONAL  EZEQUIEL ZAMORA PREESCOLAR	408	1	10	345	244	335	0	3	0	0	88	345
EDO. MIRANDA	MP. INDEPENDENCIA	PQ. STA TERESA DEL TUY	UNIDAD EDUCATIVA NACIONAL  DOLORES GONZALEZ	1883	4	36	1520	808	1484	0	6	0	2	668	1520
EDO. MIRANDA	MP. INDEPENDENCIA	PQ. STA TERESA DEL TUY	UNIDAD EDUCATIVA ESTADAL MIGUEL HERNANDEZ	440	1	3	393	335	390	1	4	0	0	50	393
EDO. MIRANDA	MP. INDEPENDENCIA	PQ. STA TERESA DEL TUY	UNIDAD EDUCATIVA ESTADAL 15 DE OCTUBRE	1548	3	29	1273	1010	1244	0	1	1	0	232	1273
EDO. MIRANDA	MP. INDEPENDENCIA	PQ. STA TERESA DEL TUY	LICEO PRIVADO JOSE LEONARDO CHIRINOS	377	1	1	311	168	310	0	1	0	0	141	311
EDO. MIRANDA	MP. INDEPENDENCIA	PQ. STA TERESA DEL TUY	UNIDAD EDUCATIVA PRIVADA FRANCISCO LINARES ALCANTARA	1304	3	18	1068	638	1050	0	4	1	0	407	1068
EDO. MIRANDA	MP. INDEPENDENCIA	PQ. STA TERESA DEL TUY	CONCENTRACION RURAL MOROCOPITO	532	1	6	414	342	408	1	3	1	0	61	414
EDO. MIRANDA	MP. INDEPENDENCIA	PQ. STA TERESA DEL TUY	PREESCOLAR LAS CAMPANITAS	1704	3	25	1433	1112	1408	0	1	1	0	294	1433
EDO. MIRANDA	MP. INDEPENDENCIA	PQ. STA TERESA DEL TUY	UNIDAD EDUCATIVA PRIVADA AGUSTIN AVELEDO	3374	6	38	2857	1175	2819	1	15	1	2	1625	2857
EDO. MIRANDA	MP. INDEPENDENCIA	PQ. STA TERESA DEL TUY	UNIDAD EDUCATIVA ESTADAL PEDRO RODRIGUEZ VALDIVIEZO	3631	7	85	2917	2391	2832	2	12	3	1	423	2917
EDO. MIRANDA	MP. INDEPENDENCIA	PQ. STA TERESA DEL TUY	GRUPO ESCOLAR EZEQUIEL ZAMORA	3330	6	36	2617	1559	2581	0	9	1	1	1011	2617
EDO. MIRANDA	MP. INDEPENDENCIA	PQ. EL CARTANAL	CENTRO DE EDUCACION INICIAL ABILIO REYES PREESCOLAR	679	2	11	558	417	547	0	4	0	0	126	558
EDO. MIRANDA	MP. INDEPENDENCIA	PQ. EL CARTANAL	LICEO BOLIVARIANO CARTANAL II	4736	9	59	3846	2875	3787	1	21	2	3	885	3846
EDO. MIRANDA	MP. INDEPENDENCIA	PQ. EL CARTANAL	UNIDAD EDUCATIVA ESTADAL BOLIVARIANA AGUSTINA MARTINA BLANCO	837	2	6	724	676	718	0	2	0	0	40	724
EDO. MIRANDA	MP. INDEPENDENCIA	PQ. EL CARTANAL	UNIDAD EDUCATIVA ESTADAL CARTANAL I	3399	6	53	2748	2045	2695	0	13	2	2	633	2748
EDO. MIRANDA	MP. INDEPENDENCIA	PQ. EL CARTANAL	ESCUELA BASICA NACIONAL CARTANAL  VICENTE EMILIO  SOJO	6589	12	91	5510	4068	5419	1	33	5	3	1309	5510
EDO. MIRANDA	MP. INDEPENDENCIA	PQ. EL CARTANAL	ESCUELA BASICA NACIONAL PEDRO VICENTE NU EZ	2609	5	65	2251	1423	2186	0	12	1	0	750	2251
EDO. MIRANDA	MP. INDEPENDENCIA	PQ. EL CARTANAL	CONCENTRACION NACIONAL 3626	2463	5	54	2107	1545	2053	1	10	0	2	495	2107
EDO. MIRANDA	MP. INDEPENDENCIA	PQ. EL CARTANAL	ESCUELA BASICA NACIONAL CARTANAL II	4039	7	81	3332	2359	3251	2	11	4	3	872	3332
EDO. MIRANDA	MP. INDEPENDENCIA	PQ. EL CARTANAL	CENTRO DE EDUCACION INICIAL NACIONAL MARVELIA HERNANDEZ FERRER	171	1	2	151	133	149	0	0	0	0	16	151
EDO. MIRANDA	MP. INDEPENDENCIA	PQ. EL CARTANAL	CENTRO DE EDUCACION INICIAL NACIONAL  DOS LAGUNAS PREESCOLAR	245	1	6	200	141	194	0	0	0	0	53	200
EDO. MIRANDA	MP. INDEPENDENCIA	PQ. EL CARTANAL	UNIDAD EDUCATIVA NACIONAL 12 DE MARZO	1981	4	54	1653	1275	1599	1	11	0	1	311	1653
EDO. MIRANDA	MP. INDEPENDENCIA	PQ. EL CARTANAL	UNIDAD EDUCATIVA ESTADAL MANUEL DIAZ RODRIGUEZ	1472	3	21	1141	919	1120	0	8	1	1	191	1141
EDO. MIRANDA	MP. INDEPENDENCIA	PQ. EL CARTANAL	UNIDAD EDUCATIVA NACIONAL GUILLERMO COVA	5875	11	130	4931	3396	4801	0	23	3	10	1369	4931
EDO. MIRANDA	MP. INDEPENDENCIA	PQ. EL CARTANAL	ESCUELA BASICA ESTADAL CARTANAL II (LAS CASITAS)	1162	2	21	985	721	964	0	4	0	2	237	985
EDO. MIRANDA	MP. INDEPENDENCIA	PQ. EL CARTANAL	CENTRO EDUCACION INICIAL BOLIVARIANO TITO SALAS	355	1	6	299	244	293	0	1	1	1	46	299
EDO. MIRANDA	MP. INDEPENDENCIA	PQ. EL CARTANAL	ESCUELA BASICA DOS LAGUNAS 2 LUIS BELTRAN PRIETO FIGUEROA	3125	6	57	2546	1754	2489	0	14	1	0	720	2546
EDO. MIRANDA	MP. INDEPENDENCIA	PQ. EL CARTANAL	ESCUELA BASICA DOS LAGUNAS RAUL LEONI	2966	5	59	2465	1819	2406	1	13	0	2	571	2465
EDO. MIRANDA	MP. BARUTA	PQ. BARUTA	ESCUELA  MUNICIPAL MONSEÑOR LUCAS GUILLERMO CASTILLO	1431	3	23	1127	407	1104	1	4	2	0	690	1127
EDO. MIRANDA	MP. BARUTA	PQ. BARUTA	UNIDAD EDUCATIVA INSTITUTO ARTURO MICHELENA	3093	6	11	2385	195	2374	0	2	0	2	2175	2385
EDO. MIRANDA	MP. BARUTA	PQ. BARUTA	LICEO NACIONAL JOSE ALBERTO VELANDIA	2403	5	9	1952	195	1943	0	1	0	0	1747	1952
EDO. MIRANDA	MP. BARUTA	PQ. BARUTA	LICEO LOS ARCOS	3827	7	20	3066	119	3046	0	1	0	1	2925	3066
EDO. MIRANDA	MP. BARUTA	PQ. BARUTA	UNIDAD EDUCATIVA COLEGIO LAS CUMBRES	5717	10	16	4257	314	4241	1	11	0	1	3914	4257
EDO. MIRANDA	MP. BARUTA	PQ. BARUTA	UNIDAD EDUCATIVA COLEGIO EMIL FRIEDMAN	3249	6	12	2492	117	2480	0	3	0	0	2360	2492
EDO. MIRANDA	MP. BARUTA	PQ. BARUTA	INSTITUTO LEOPARDI	3197	6	12	2231	266	2219	0	8	0	2	1943	2231
EDO. MIRANDA	MP. BARUTA	PQ. BARUTA	UNIDAD EDUCATIVA NACIONAL SOROCAIMA	2122	4	12	1585	215	1573	0	5	3	0	1350	1585
EDO. MIRANDA	MP. BARUTA	PQ. BARUTA	CASA DE TODOS Y JUSTICIA DE PAZ	1872	4	24	1539	578	1515	0	4	0	1	932	1539
EDO. MIRANDA	MP. BARUTA	PQ. BARUTA	UNIDAD EDUCATIVA COLEGIO LOS RISCOS	3430	6	13	2584	281	2571	0	3	1	1	2285	2584
EDO. MIRANDA	MP. BARUTA	PQ. BARUTA	INSTITUTO UNIVERSITARIO DE TECNOLOGIA INDUSTRIAL RODOLFO LOERO ARISMENDI	280	1	3	252	76	249	0	0	0	1	172	252
EDO. MIRANDA	MP. BARUTA	PQ. BARUTA	COMPLEJO EDUCATIVO PRIVADO INSTITUTO ESCUELA	10093	19	28	7826	377	7798	1	7	1	4	7408	7826
EDO. MIRANDA	MP. BARUTA	PQ. BARUTA	UNIDAD EDUCATIVA FE Y ALEGRIA COLEGIO MONTERREY	2746	5	43	2275	882	2232	0	4	1	2	1343	2275
EDO. MIRANDA	MP. BARUTA	PQ. BARUTA	UNIDAD EDUCATIVA NACIONAL REPUBLICA DE INDONESIA	3168	6	26	2472	544	2446	1	4	0	2	1895	2472
EDO. MIRANDA	MP. BARUTA	PQ. BARUTA	UNIDAD EDUCATIVA CENTRO DE EDUCACION ACTIVA MARIA MONTESSORI	2135	4	9	1734	93	1725	0	2	0	0	1630	1734
EDO. MIRANDA	MP. BARUTA	PQ. BARUTA	INSTITUTO UNIVERSITARIO DE NUEVAS PROFESIONES	117	1	4	91	17	87	0	0	0	0	70	91
EDO. MIRANDA	MP. BARUTA	PQ. BARUTA	CENTRO VENEZOLANO AMERICANO	4084	8	30	2930	494	2900	2	8	2	3	2391	2930
EDO. MIRANDA	MP. BARUTA	PQ. BARUTA	UNIDAD EDUCATIVA COLEGIO LA CONCEPCION	5541	10	42	4340	383	4298	0	8	1	3	3903	4340
EDO. MIRANDA	MP. BARUTA	PQ. BARUTA	PRE ESCOLAR NUESTRA SEÑORA DEL ROSARIO	4427	8	71	3505	1418	3434	1	10	2	4	1999	3505
EDO. MIRANDA	MP. BARUTA	PQ. BARUTA	COLEGIO DE MEDICOS DEL DISTRITO METROPOLITANO DE CARACAS	3924	7	14	3138	255	3124	0	2	0	2	2865	3138
EDO. MIRANDA	MP. BARUTA	PQ. BARUTA	COLEGIO SANTO TOMAS DE VILLANUEVA	4990	9	31	3476	209	3445	0	1	0	4	3231	3476
EDO. MIRANDA	MP. BARUTA	PQ. BARUTA	UNIDAD EDUCATIVA RURAL MANUELITA SAENZ	714	2	15	574	402	559	0	2	0	1	154	574
EDO. MIRANDA	MP. BARUTA	PQ. BARUTA	CENTRO EDUCATIVO ASOCIACION PROFESORES UNIVERSIDAD CENTRAL DE VENEZUELA  (CEAPUCV)	1827	4	14	1362	206	1348	0	2	0	3	1137	1362
EDO. MIRANDA	MP. BARUTA	PQ. BARUTA	ASOCIACION DESARROLLO INTEGRAL COMUNITARIO	1565	3	11	1210	417	1199	0	1	0	1	780	1210
EDO. MIRANDA	MP. BARUTA	PQ. BARUTA	UNIDAD EDUCATIVA INICIAL SIMONCITO EZEQUIEL ZAMORA	1135	2	11	1051	1012	1040	0	2	0	0	26	1051
EDO. MIRANDA	MP. BARUTA	PQ. BARUTA	ESCUELA BASICA NACIONAL HERMANAS MARIA LORENZA	1185	2	8	919	156	911	0	4	0	0	751	919
EDO. MIRANDA	MP. BARUTA	PQ. BARUTA	UNIDAD EDUCATIVA PRIVADA COLEGIO ALTO PRADO	3582	7	8	2840	184	2832	0	1	0	1	2646	2840
EDO. MIRANDA	MP. BARUTA	PQ. BARUTA	UNIDAD EDUCATIVA JOSE TADEO MONAGAS	3329	6	70	2717	1940	2647	4	8	3	3	689	2717
EDO. MIRANDA	MP. BARUTA	PQ. BARUTA	UNIDAD EDUCATIVA COLEGIO NUESTRA SEÑORA DE LA CONSOLACION	1496	3	7	1212	124	1205	0	1	0	0	1080	1212
EDO. MIRANDA	MP. BARUTA	PQ. BARUTA	INSTITUTO DIDACTICO ANTONIO JOSE DE SUCRE	1669	3	6	1272	95	1266	0	2	0	1	1168	1272
EDO. MIRANDA	MP. BARUTA	PQ. BARUTA	COLEGIO LA CONCORDIA	3468	6	20	2632	362	2612	1	6	0	1	2242	2632
EDO. MIRANDA	MP. BARUTA	PQ. BARUTA	AMBULATORIO URBANO TIPO 1 DOCTOR ANGEL GUEDES	587	1	7	493	182	486	1	2	0	0	301	493
EDO. MIRANDA	MP. BARUTA	PQ. BARUTA	UNIDAD EDUCATIVA COLEGIO FRAY LUIS AMIGO	7090	13	40	5268	619	5228	1	7	2	5	4594	5268
EDO. MIRANDA	MP. BARUTA	PQ. BARUTA	LICEO NACIONAL ALEJO FORTIQUE	4742	9	53	3819	1328	3766	0	14	0	6	2418	3819
EDO. MIRANDA	MP. BARUTA	PQ. BARUTA	UNIDAD EDUCATIVA PRIVADA MINERVA I	807	2	8	641	60	633	0	1	0	0	572	641
EDO. MIRANDA	MP. BARUTA	PQ. BARUTA	COLEGIO MATER SALVATORI	2484	5	10	1892	126	1882	0	2	0	1	1753	1892
EDO. MIRANDA	MP. BARUTA	PQ. BARUTA	JARDIN DE INFANCIA PREESCOLAR MANUEL FELIPE RUGELES	304	1	0	274	189	274	0	2	0	0	83	274
EDO. MIRANDA	MP. BARUTA	PQ. BARUTA	UNIDAD EDUCATIVA ESTADAL LINO DE CLEMENTE	3223	6	23	2580	267	2557	1	3	1	0	2285	2580
EDO. MIRANDA	MP. BARUTA	PQ. BARUTA	UNIDAD EDUCATIVA COLEGIO MADRE MATILDE	2877	5	13	2132	95	2119	0	4	0	0	2020	2132
EDO. MIRANDA	MP. BARUTA	PQ. BARUTA	JARDIN DE INFANCIA DON ROMULO BENTANCOURT	528	1	5	462	247	457	0	0	0	1	209	462
EDO. MIRANDA	MP. BARUTA	PQ. BARUTA	PREESCOLAR GUSTAVO ARISMENDI ITURBE	1214	3	15	995	666	980	0	4	2	1	307	995
EDO. MIRANDA	MP. BARUTA	PQ. BARUTA	ESCUELA MUNICIPAL NUMERO 05 MIGUEL JOSE SANZ	3496	6	65	2866	1255	2801	0	9	4	3	1530	2866
EDO. MIRANDA	MP. BARUTA	PQ. BARUTA	ESCUELA BASICA NACIONAL SANTA CRUZ DEL ESTE	4166	8	55	3302	1785	3247	2	7	1	1	1451	3302
EDO. MIRANDA	MP. BARUTA	PQ. BARUTA	COLEGIO PROMESAS PATRIAS	2984	6	26	2360	387	2334	0	6	0	5	1936	2360
EDO. MIRANDA	MP. BARUTA	PQ. BARUTA	MODULO DE SERVICIO DE OJO DE AGUA	2807	5	52	2271	1298	2219	3	8	1	2	907	2271
EDO. MIRANDA	MP. BARUTA	PQ. BARUTA	PRE ESCOLAR LAS LOMITAS	3104	6	8	2535	141	2527	2	2	0	0	2382	2535
EDO. MIRANDA	MP. BARUTA	PQ. BARUTA	ESCUELA BASICA NACIONAL CENTRO COMUNAL	1358	3	16	1077	597	1061	0	3	1	1	459	1077
EDO. MIRANDA	MP. BARUTA	PQ. BARUTA	CENTRO DE EDUCACION INICIAL MUNICIPAL EL CARMEN	102	1	3	89	48	86	0	0	0	0	38	89
EDO. MIRANDA	MP. BARUTA	PQ. BARUTA	UNIVERSIDAD SIMON BOLIVAR	4556	8	59	3646	763	3587	2	6	1	1	2814	3646
EDO. MIRANDA	MP. BARUTA	PQ. BARUTA	ESCUELA BASICA MUNICIPAL GENERAL JOSE ANTONIO PAEZ	2013	4	24	1639	941	1615	0	3	3	1	667	1639
EDO. MIRANDA	MP. BARUTA	PQ. BARUTA	UNIDAD EDUCATIVA NUESTRA SEÑORA DEL ROSARIO	5533	10	33	4322	523	4289	0	9	0	2	3755	4322
EDO. MIRANDA	MP. BARUTA	PQ. BARUTA	UNIDAD EDUCATIVA COLEGIO LA COROMOTO	1778	3	12	1430	196	1418	0	1	0	2	1219	1430
EDO. MIRANDA	MP. BARUTA	PQ. EL CAFETAL	UNIDAD EDUCATIVA COLEGIO CAURIMARE UNO	1617	3	6	1206	81	1200	0	2	0	1	1116	1206
EDO. MIRANDA	MP. BARUTA	PQ. EL CAFETAL	CAMARA DE INDUSTRIALES DEL ESTADO BOLIVARIANO DE MIRANDA	2727	5	10	1967	154	1957	1	0	0	1	1801	1967
EDO. MIRANDA	MP. BARUTA	PQ. EL CAFETAL	CENTRO ESCOLAR AULA NUEVA	3772	7	11	2933	159	2922	2	2	0	1	2758	2933
EDO. MIRANDA	MP. BARUTA	PQ. EL CAFETAL	INSTITUTO MADISON	1647	3	9	1260	77	1251	0	2	0	2	1170	1260
EDO. MIRANDA	MP. BARUTA	PQ. EL CAFETAL	UNIDAD EDUCATIVA COLEGIO CHAMPAGNAT ASOCIACION CIVIL V.E.A.S.	4701	9	24	3680	197	3656	0	7	1	1	3450	3680
EDO. MIRANDA	MP. BARUTA	PQ. EL CAFETAL	ESCUELA NACIONAL JESUS MARIA ALFARO ZAMORA	4981	9	25	3797	422	3772	0	8	0	2	3340	3797
EDO. MIRANDA	MP. BARUTA	PQ. EL CAFETAL	UNIDAD EDUCATIVA COLEGIO  LOS ARAYANES	1134	2	5	911	122	906	0	0	0	2	782	911
EDO. MIRANDA	MP. BARUTA	PQ. EL CAFETAL	INSTITUTO CENTRO APRENDIZAJE MADISON	1587	3	3	1278	75	1275	0	1	0	0	1199	1278
EDO. MIRANDA	MP. BARUTA	PQ. EL CAFETAL	CENTRO INFANTIL AMERICA	1120	2	3	899	64	896	0	1	0	0	831	899
EDO. MIRANDA	MP. BARUTA	PQ. EL CAFETAL	UNIDAD EDUCATIVA COLEGIO SAN LUIS DE CARACAS	6623	12	30	5047	373	5017	1	3	1	2	4637	5047
EDO. MIRANDA	MP. BARUTA	PQ. EL CAFETAL	ESCUELA BASICA NACIONAL BOLIVARIANA EUTIMIO RIVAS	1309	3	6	981	115	975	0	1	0	1	858	981
EDO. MIRANDA	MP. BARUTA	PQ. EL CAFETAL	UNIDAD EDUCATIVA NACIONAL JOSEFA IRAUSQUIN LOPEZ.	1911	4	3	1419	96	1416	1	2	0	2	1315	1419
EDO. MIRANDA	MP. BARUTA	PQ. EL CAFETAL	UNIDAD EDUCATIVA CHUAO	575	1	3	402	43	399	0	0	0	1	355	402
EDO. MIRANDA	MP. BARUTA	PQ. EL CAFETAL	INSTITUTO CUMBRES DE CARACAS ASOCIACION CIVIL	2166	4	6	1729	62	1723	1	2	0	0	1658	1729
EDO. MIRANDA	MP. BARUTA	PQ. EL CAFETAL	UNIDAD EDUCATIVA COLEGIO EL ANGEL	2446	5	7	1792	105	1785	0	4	1	0	1675	1792
EDO. MIRANDA	MP. BARUTA	PQ. EL CAFETAL	GUARDERIA PRE ESCOLAR VIGERLI	493	1	1	378	46	377	0	0	0	0	331	378
EDO. MIRANDA	MP. BARUTA	PQ. EL CAFETAL	UNIDAD EDUCATIVA NACIONAL FRANCISCO ESPEJO	1375	3	7	1000	88	993	0	0	1	1	903	1000
EDO. MIRANDA	MP. BARUTA	PQ. EL CAFETAL	BIBLIOTECA PUBLICA DOCTOR RAUL LEONI	2984	6	12	2322	225	2310	0	2	0	0	2083	2322
EDO. MIRANDA	MP. BARUTA	PQ. LAS MINAS DE BARUTA	ESCUELA MUNICIPAL JERMAN UBALDO LIRA	1811	4	27	1519	761	1492	0	2	0	3	726	1519
EDO. MIRANDA	MP. BARUTA	PQ. LAS MINAS DE BARUTA	COLEGIO  SANTA ROSA DE LIMA	8621	16	45	6550	485	6505	1	12	2	2	6003	6550
EDO. MIRANDA	MP. BARUTA	PQ. LAS MINAS DE BARUTA	COMPLEJO EDUCATIVO COLEGIO AMERICANO	5672	10	71	4678	1499	4607	1	17	3	0	3087	4678
EDO. MIRANDA	MP. BARUTA	PQ. LAS MINAS DE BARUTA	REGISTRO CIVIL DE LA PARROQUIA LAS MINAS	1983	4	19	1614	728	1595	0	2	1	0	864	1614
EDO. MIRANDA	MP. BARUTA	PQ. LAS MINAS DE BARUTA	UNIDAD EDUCATIVA NACIONAL TITO SALAS	4823	9	56	3785	1978	3729	1	8	2	2	1738	3785
EDO. MIRANDA	MP. BARUTA	PQ. LAS MINAS DE BARUTA	COLEGIO INTERNACIONAL DE CARACAS	3724	7	49	3075	977	3026	1	9	4	2	2033	3075
EDO. MIRANDA	MP. BARUTA	PQ. LAS MINAS DE BARUTA	UNIDAD EDUCATIVA ESTADAL  ADOLFO NAVAS  CORONADO	5222	10	100	4288	2129	4188	0	13	1	2	2043	4288
EDO. MIRANDA	MP. BARUTA	PQ. LAS MINAS DE BARUTA	COLEGIO DE FARMACEUTICOS DISTRITO METROPOLITANO DE CARACAS  Y EL ESTADO MIRANDA	1276	3	3	923	54	920	0	1	0	1	864	923
EDO. MIRANDA	MP. BARUTA	PQ. LAS MINAS DE BARUTA	ESCUELA BASICA NACIONAL  LAS MINITAS	2844	5	28	2205	1182	2177	0	7	0	0	988	2205
EDO. MIRANDA	MP. SIMON BOLIVAR	PQ. S ANTONIO DE YARE	UNIDAD EDUCATIVA NACIONAL 28 DE MARZO	683	2	11	580	462	569	0	1	1	0	105	580
EDO. MIRANDA	MP. SIMON BOLIVAR	PQ. S ANTONIO DE YARE	CENTRO PENITENCIARIO REGION CAPITAL YARE II	104	1	2	24	20	22	0	0	0	0	2	24
EDO. MIRANDA	MP. SIMON BOLIVAR	PQ. S ANTONIO DE YARE	CONCENTRACION ESCOLAR SIN NUMERO PUENTE CARRERA	257	1	7	225	189	218	0	2	0	1	26	225
EDO. MIRANDA	MP. SIMON BOLIVAR	PQ. S ANTONIO DE YARE	CONCENTRACION ESCOLAR SIN NUMERO EL LECHOZAL	219	1	7	171	136	164	0	0	0	0	28	171
EDO. MIRANDA	MP. SIMON BOLIVAR	PQ. S ANTONIO DE YARE	UNIDAD EDUCATIVA ESTADAL SAN ANTONIO DE PADUA	2450	5	50	2003	1589	1953	0	4	1	3	356	2003
EDO. MIRANDA	MP. SIMON BOLIVAR	PQ. S ANTONIO DE YARE	UNIDAD EDUCATIVA ESTADAL ARTURO USLAR PIETRI	2462	5	40	2046	1672	2006	0	17	1	2	314	2046
EDO. MIRANDA	MP. SIMON BOLIVAR	PQ. S ANTONIO DE YARE	UNIDAD EDUCATIVA NACIONAL CACIQUE YARE	377	1	7	315	258	308	0	1	1	1	47	315
EDO. MIRANDA	MP. SIMON BOLIVAR	PQ. SAN FCO DE YARE	ESCUELA BASICA NACIONAL CHACAO	4538	8	81	3774	2477	3693	1	17	2	3	1193	3774
EDO. MIRANDA	MP. SIMON BOLIVAR	PQ. SAN FCO DE YARE	CASA DE LA CULTURA	678	2	7	570	456	563	0	2	0	0	105	570
EDO. MIRANDA	MP. SIMON BOLIVAR	PQ. SAN FCO DE YARE	UNIDAD  EDUCATIVA ESTILITA DE ALZURU	2267	4	33	1828	1415	1795	0	8	2	0	370	1828
EDO. MIRANDA	MP. SIMON BOLIVAR	PQ. SAN FCO DE YARE	UNIDAD EDUCATIVA ESTADAL BOLIVARIANA LA VIRGEN DE COROMOTO	977	2	26	791	668	765	0	2	0	0	95	791
EDO. MIRANDA	MP. SIMON BOLIVAR	PQ. SAN FCO DE YARE	CASA COMUNAL NUESTRA SENORA DE LOUDES	106	1	1	88	68	87	0	0	0	0	19	88
EDO. MIRANDA	MP. SIMON BOLIVAR	PQ. SAN FCO DE YARE	PARADOR TURISTICO SAN FRANCISCO DE YARE	1386	3	20	1128	701	1108	0	6	2	0	399	1128
EDO. MIRANDA	MP. SIMON BOLIVAR	PQ. SAN FCO DE YARE	CENTRO DE EDUCACION INICIAL BENITA RIVAS TORO	510	1	2	464	273	462	0	3	0	0	186	464
EDO. MIRANDA	MP. SIMON BOLIVAR	PQ. SAN FCO DE YARE	UNIDAD EDUCATIVA NACIONAL BOLIVARIANA JOSE TADEO MONAGAS	256	1	4	219	156	215	0	2	0	0	57	219
EDO. MIRANDA	MP. SIMON BOLIVAR	PQ. SAN FCO DE YARE	UNIDAD EDUCATIVA NACIONAL LIBERTADOR	2619	5	79	2193	1447	2114	3	2	1	0	661	2193
EDO. MIRANDA	MP. SIMON BOLIVAR	PQ. SAN FCO DE YARE	UNIDAD EDUCATIVA NACIONAL BOLIVARIANA ESTADO MIRANDA	177	1	3	135	115	132	0	0	0	0	17	135
EDO. MIRANDA	MP. SIMON BOLIVAR	PQ. SAN FCO DE YARE	UNIDAD EDUCATIVA ESTADAL LUISA DE JACOTTE	407	1	9	361	299	352	0	1	1	0	51	361
EDO. MIRANDA	MP. SIMON BOLIVAR	PQ. SAN FCO DE YARE	CONCENTRACION ESCOLAR SIN NUMERO CAMBAMBE	969	2	23	813	631	790	0	2	0	0	157	813
EDO. MIRANDA	MP. SIMON BOLIVAR	PQ. SAN FCO DE YARE	UNIDAD EDUCATIVA ESTADAL BENITA RIBAS TORO	2308	4	29	2048	850	2019	0	6	0	0	1163	2048
EDO. MIRANDA	MP. SIMON BOLIVAR	PQ. SAN FCO DE YARE	UNIDAD EDUCATIVA PRIVADA CORONEL ANTONIO NICOLAS BRICENO	217	1	6	189	142	183	0	0	0	0	41	189
EDO. MIRANDA	MP. SIMON BOLIVAR	PQ. SAN FCO DE YARE	UNIDAD EDUCATIVA ESTADAL QUEBRADA SECA	1112	2	29	928	672	899	0	4	0	3	220	928
EDO. MIRANDA	MP. SIMON BOLIVAR	PQ. SAN FCO DE YARE	UNIDAD EDUCATIVA LOS ANILES	677	2	8	584	460	576	0	2	0	3	111	584
EDO. MIRANDA	MP. PLAZA	PQ. GUARENAS	CENTRO DE EDUCACIÓN INICIAL DOÑA VIRGINIA BELLO DE BETANCOURT	391	1	8	341	217	333	0	1	0	1	114	341
EDO. MIRANDA	MP. PLAZA	PQ. GUARENAS	CASA COMUNAL PINAL II PARTE ALTA	276	1	1	260	234	259	0	0	1	0	24	260
EDO. MIRANDA	MP. PLAZA	PQ. GUARENAS	ESCUELA MARTIN VERA GUERRA	1524	3	18	1339	875	1321	0	6	0	1	439	1339
EDO. MIRANDA	MP. PLAZA	PQ. GUARENAS	UNIDAD EDUCATIVA NACIONAL BOLIVARIANA MIGUEL OTERO SILVA	6052	11	198	4809	3534	4611	1	15	3	6	1052	4809
EDO. MIRANDA	MP. PLAZA	PQ. GUARENAS	ESCUELA NACIONAL GRADUADA JUDITH DALO SANDON	2919	5	62	2429	1586	2367	1	6	2	1	771	2429
EDO. MIRANDA	MP. PLAZA	PQ. GUARENAS	ESCUELA TECNICA INDUSTRIAL ROBINSONIANA RUBEN GONZALEZ	3001	6	37	2542	1326	2505	0	11	0	1	1167	2542
EDO. MIRANDA	MP. PLAZA	PQ. GUARENAS	CENTRO DE EDUCACIÓN INICIAL  LOS AZULEJOS	336	1	7	311	212	304	0	1	0	1	90	311
EDO. MIRANDA	MP. PLAZA	PQ. GUARENAS	CIUDAD DE LOS MUCHACHOS FE Y ALEGRIA	1083	2	8	944	585	936	0	2	0	1	348	944
EDO. MIRANDA	MP. PLAZA	PQ. GUARENAS	ALDEA UNIVERSITARIA CORONELA MANUELITA SAENZ	373	1	4	333	218	329	0	0	0	0	111	333
EDO. MIRANDA	MP. PLAZA	PQ. GUARENAS	CENTRO DE EDUCACIÓN INICIAL NACIONAL   LUCERITO	546	1	10	487	375	477	0	2	1	0	99	487
EDO. MIRANDA	MP. PLAZA	PQ. GUARENAS	CENTRO DE EDUCACION INICIAL TERESA DE LA PARRA	460	1	11	432	288	421	0	0	0	1	132	432
EDO. MIRANDA	MP. PLAZA	PQ. GUARENAS	GRUPO ESCOLAR MENCA DE LEONI II	4916	9	68	4198	2475	4130	0	19	5	6	1625	4198
EDO. MIRANDA	MP. PLAZA	PQ. GUARENAS	CENTRO COMUNAL GUARENAS	2372	4	53	1872	1317	1819	2	7	0	2	491	1872
EDO. MIRANDA	MP. PLAZA	PQ. GUARENAS	GRUPO ESCOLAR RUIZ PINEDA	3870	7	65	3144	1911	3079	0	11	4	1	1152	3144
EDO. MIRANDA	MP. PLAZA	PQ. GUARENAS	ESCUELA  BOLIVARIANA HORACIO REQUENA QUINTERO	218	1	7	192	157	185	0	2	0	0	26	192
EDO. MIRANDA	MP. PLAZA	PQ. GUARENAS	LICEO BOLIVARIANO ANTONIO MARIA PIÑATE	592	1	7	511	324	504	0	0	0	0	180	511
EDO. MIRANDA	MP. PLAZA	PQ. GUARENAS	PRE ESCOLAR YOLANDA MARTINEZ	517	1	5	458	294	453	0	3	0	0	156	458
EDO. MIRANDA	MP. PLAZA	PQ. GUARENAS	CENTRO CULTURAL MAGO	1719	3	33	1426	1075	1393	0	6	0	1	311	1426
EDO. MIRANDA	MP. PLAZA	PQ. GUARENAS	GRUPO ESCOLAR AMBROSIO PLAZA	4518	8	70	3753	2150	3683	0	16	2	1	1514	3753
EDO. MIRANDA	MP. PLAZA	PQ. GUARENAS	COLEGIO PARROQUIAL  JESUS MARIA MARRERO	6636	12	118	5627	2183	5509	0	16	4	4	3302	5627
EDO. MIRANDA	MP. PLAZA	PQ. GUARENAS	ESCUELA RURAL BOLIVARIANA CAMPO ALEGRE 028	187	1	0	167	160	167	0	0	0	0	7	167
EDO. MIRANDA	MP. PLAZA	PQ. GUARENAS	ESCUELA BASICA BOLIVARIANA RICARDO MONTILLA	3754	7	50	3170	1745	3120	4	16	2	5	1348	3170
EDO. MIRANDA	MP. PLAZA	PQ. GUARENAS	CENTRO DE EDUCACIÓN INICIAL  AMBROSIO PLAZA	833	2	16	742	468	726	0	4	0	1	253	742
EDO. MIRANDA	MP. PLAZA	PQ. GUARENAS	UNIVERSIDAD NACIONAL EXPERIMENTAL POLITECNICA LUIS CABALLERO MEJIAS	531	1	9	482	274	473	0	1	0	0	198	482
EDO. MIRANDA	MP. PLAZA	PQ. GUARENAS	LICEO ALONSO ANDREA DE LEDEZMA	3846	7	66	3217	2064	3151	1	11	1	4	1070	3217
EDO. MIRANDA	MP. PLAZA	PQ. GUARENAS	CENTRO DE FORMACIÓN SOCIALISTA INSTITUTO NACIONAL DE CAPACITACIÓN Y EDUCACIÓN SOCIALISTA COMERCIAL	507	1	12	446	296	434	0	1	0	0	137	446
EDO. MIRANDA	MP. PLAZA	PQ. GUARENAS	ESCUELA ESTADAL ROSENDO URPIANO ARMAS	2875	5	55	2375	1764	2320	0	14	2	2	538	2375
EDO. MIRANDA	MP. PLAZA	PQ. GUARENAS	ESCUELA ESTADAL NERY RANGEL DE LOPEZ	1306	3	26	1107	793	1081	0	3	1	0	284	1107
EDO. MIRANDA	MP. PLAZA	PQ. GUARENAS	ESCUELA ESTADAL ABEL GONZALEZ LIMA	926	2	20	802	649	782	0	5	0	0	128	802
EDO. MIRANDA	MP. PLAZA	PQ. GUARENAS	CASA TALLER LUISA CACERES DE ARISMENDI	529	1	10	486	308	476	0	2	0	0	166	486
EDO. MIRANDA	MP. PLAZA	PQ. GUARENAS	UNIDAD EDUCATIVA ADVENTISTA ALEJANDRO OROPEZA CASTILLO	663	2	10	612	286	602	0	1	0	0	315	612
EDO. MIRANDA	MP. PLAZA	PQ. GUARENAS	ESCUELA BASICA EXPERIMENTAL CARMEN CABRILES	2914	5	34	2522	1375	2488	0	15	0	3	1095	2522
EDO. MIRANDA	MP. PLAZA	PQ. GUARENAS	UNIDAD EDUCATIVA BENITO CANONICO	3713	7	64	3114	1534	3050	0	7	0	2	1507	3114
EDO. MIRANDA	MP. PLAZA	PQ. GUARENAS	CENTRO DE EDUCACIÓN INICIAL ESTADAL   CARMEN ESPERANZA GARCÍA	196	1	3	179	149	176	0	0	0	0	27	179
EDO. MIRANDA	MP. PLAZA	PQ. GUARENAS	ESCUELA ESTADAL ANTONIO MARIA PIÑATE	1564	3	34	1251	915	1217	0	5	0	0	297	1251
EDO. MIRANDA	MP. PLAZA	PQ. GUARENAS	ESCUELA ESTADAL BASICA ANITA LLANES	1525	3	37	1240	810	1203	1	12	0	2	378	1240
EDO. MIRANDA	MP. PLAZA	PQ. GUARENAS	GRUPO ESCOLAR SIMON RODRIGUEZ	3402	6	51	2710	1888	2659	3	9	1	2	756	2710
EDO. MIRANDA	MP. PLAZA	PQ. GUARENAS	CENTRO CULTURAL MIGUEL PARRA	3465	7	69	2913	1742	2844	1	16	2	3	1080	2913
EDO. MIRANDA	MP. PLAZA	PQ. GUARENAS	SIMONCITO CIUDAD BELEN	1138	2	22	1045	995	1023	0	1	1	0	26	1045
EDO. MIRANDA	MP. PLAZA	PQ. GUARENAS	UNIDAD EDUCATIVA ANTONIO JOSE ROJAS	1669	3	18	1364	949	1346	0	3	0	0	394	1364
EDO. MIRANDA	MP. PLAZA	PQ. GUARENAS	ESCUELA BASICA NACIONAL LAUDELINO MEJIAS	3101	6	43	2704	1478	2661	0	10	0	5	1168	2704
EDO. MIRANDA	MP. PLAZA	PQ. GUARENAS	COLEGIO SAN NICOLAS DE BARI	9456	17	78	8406	1819	8328	0	25	2	4	6478	8406
EDO. MIRANDA	MP. PLAZA	PQ. GUARENAS	UNIDAD ESTADAL FELIX MANUEL LUCES	1134	2	27	997	785	970	0	4	0	0	181	997
EDO. MIRANDA	MP. PLAZA	PQ. GUARENAS	UNIDAD EDUCATIVA PRIVADA  INSTITUTO PREMILITAR  AURELIO BALDOR	234	1	3	219	127	216	0	0	0	0	89	219
EDO. MIRANDA	MP. PLAZA	PQ. GUARENAS	UNIDAD BASICA EDUCATIVA ALBERTO SEQUIN VERA	2728	5	34	2389	1416	2355	0	9	0	4	926	2389
EDO. MIRANDA	MP. PLAZA	PQ. GUARENAS	UNIDAD EDUCATIVA  REGULO RICO	1532	3	15	1314	1001	1299	0	4	1	0	293	1314
EDO. MIRANDA	MP. PLAZA	PQ. GUARENAS	ESCUELA ESTADAL GRADUADA EULALIA BUROZ	3007	6	52	2556	1839	2504	0	11	0	2	652	2556
EDO. MIRANDA	MP. PLAZA	PQ. GUARENAS	ESCUELA TECNICA COMERCIAL ROBINSONIANA NORBERTO PRADO	3335	6	47	2858	1469	2811	0	13	3	3	1323	2858
EDO. MIRANDA	MP. PLAZA	PQ. GUARENAS	UNIDAD EDUCATIVA NACIONAL ALBERTO LOVERA	137	1	8	128	109	120	0	0	0	0	11	128
EDO. MIRANDA	MP. PLAZA	PQ. GUARENAS	LICEO BOLIVARIANO ANTONIO JOSE DE SUCRE	2062	4	49	1732	963	1683	0	7	1	1	711	1732
EDO. MIRANDA	MP. PLAZA	PQ. GUARENAS	CONCENTRACION GUACARAPA	395	1	4	347	302	343	0	0	0	0	41	347
EDO. MIRANDA	MP. PLAZA	PQ. GUARENAS	ESCUELA BASICA PRIVADA  LIBERTADORA MANUELITA SAENZ	347	1	3	290	220	287	0	1	0	0	66	290
EDO. MIRANDA	MP. PLAZA	PQ. GUARENAS	CASA COMUNAL CIUDAD BELEN	703	2	13	626	594	613	0	1	0	0	18	626
EDO. MIRANDA	MP. PLAZA	PQ. GUARENAS	UNIDAD EDUCATIVA MENCA DE LEONI I	5917	11	90	5041	3052	4951	3	25	2	10	1859	5041
EDO. MIRANDA	MP. PLAZA	PQ. GUARENAS	ESCUELA BASICA ESTADAL LINO BRAVO	1663	3	48	1299	906	1251	1	9	0	0	335	1299
EDO. MIRANDA	MP. PLAZA	PQ. GUARENAS	UNIDAD EDUCATIVA BUEN PASTOR PRESBITERIANO	1434	3	19	1174	752	1155	1	7	1	1	393	1174
EDO. MIRANDA	MP. PLAZA	PQ. GUARENAS	ESCUELA BASICA 14 DE FEBRERO	760	2	24	639	503	615	0	4	0	0	108	639
EDO. MIRANDA	MP. PLAZA	PQ. GUARENAS	UNIDAD EDUCATIVA PRIVADA  VICENTE EMILIO SOJO	536	1	6	490	244	484	0	2	0	0	238	490
EDO. MIRANDA	MP. PLAZA	PQ. GUARENAS	UNIDAD EDUCATIVA ANDRES BELLO	1525	3	11	1443	577	1432	1	8	1	1	844	1443
EDO. MIRANDA	MP. PLAZA	PQ. GUARENAS	SIMONCITO COMUNITARIO CRECIENDO FELIZ	464	1	5	432	292	427	0	1	0	0	134	432
EDO. MIRANDA	MP. PLAZA	PQ. GUARENAS	PRE ESCOLAR LA ESTRELLA	1017	2	29	825	608	796	2	7	0	1	178	825
EDO. MIRANDA	MP. PLAZA	PQ. GUARENAS	CENTRO DE EDUCACION INICIAL IRAMA MARTINEZ DE ORTA	471	1	7	437	354	430	0	2	0	1	73	437
EDO. MIRANDA	MP. PLAZA	PQ. GUARENAS	PRE ESCOLAR TERRAZAS DEL ESTE	1669	3	20	1566	524	1546	0	7	2	1	1012	1566
EDO. MIRANDA	MP. PLAZA	PQ. GUARENAS	COLEGIO CIUDAD CASARAPA	3093	6	23	2871	785	2848	1	10	0	3	2049	2871
EDO. MIRANDA	MP. PLAZA	PQ. GUARENAS	UNIDAD EDUCATIVA COLEGIO CEPA	1048	2	11	909	731	898	0	3	0	0	164	909
EDO. MIRANDA	MP. PLAZA	PQ. GUARENAS	ESCUELA NACIONAL EL TAMARINDO	4063	8	95	3309	2430	3214	0	20	2	1	761	3309
EDO. MIRANDA	MP. PLAZA	PQ. GUARENAS	ESCUELA PRIMARIA CREACION TRAPICHITO	4813	9	84	4131	2372	4047	0	13	0	4	1658	4131
EDO. MIRANDA	MP. PLAZA	PQ. GUARENAS	ESCUELA BASICA ZENOBIA VERGARA  DE CHIQUITO	1039	2	12	869	737	857	1	2	2	0	115	869
EDO. MIRANDA	MP. SUCRE	PQ. PETARE	CENTRO DE EDUCACION INICIAL ELVIRA PARILLI DE SENIOR	1252	3	21	1032	583	1011	0	11	0	1	416	1032
EDO. MIRANDA	MP. SUCRE	PQ. PETARE	COLEGIO ARMANDO REVERON	4650	9	58	3756	2394	3698	3	13	0	2	1286	3756
EDO. MIRANDA	MP. SUCRE	PQ. PETARE	COLEGIO CRUZ CARRILLO	2245	4	6	1809	171	1803	0	3	0	1	1628	1809
EDO. MIRANDA	MP. SUCRE	PQ. PETARE	UNIDAD EDUCATIVA RAUL LEONI	3716	7	65	3227	1904	3162	1	5	2	0	1250	3227
EDO. MIRANDA	MP. SUCRE	PQ. PETARE	COLEGIO DULCE NOMBRE DE JESUS	2097	4	43	1723	745	1680	0	2	1	4	928	1723
EDO. MIRANDA	MP. SUCRE	PQ. PETARE	COMEDOR DE LA FORTALEZA CASA BOLIVARIANA	1478	3	22	1191	683	1169	0	7	1	2	476	1191
EDO. MIRANDA	MP. SUCRE	PQ. PETARE	FUERZA SALUD Y VIGOR CLUB DE LOS ABUELOS	49	1	2	39	23	37	0	0	0	1	13	39
EDO. MIRANDA	MP. SUCRE	PQ. PETARE	CENTRO DE EDUCACION INICIAL NACIONAL EL LLANITO	3814	7	40	2887	991	2847	1	8	1	1	1845	2887
EDO. MIRANDA	MP. SUCRE	PQ. PETARE	CASA DE LA CULTURA JOSE FELIX RIBAS	1234	3	15	1046	761	1031	3	4	2	4	257	1046
EDO. MIRANDA	MP. SUCRE	PQ. PETARE	CENTROS DE ESTUDIOS CECILIO ACOSTA	2293	4	19	1743	403	1724	0	7	0	2	1312	1743
EDO. MIRANDA	MP. SUCRE	PQ. PETARE	CASA COMUNAL ANTONIO JOSE DE SUCRE	501	1	6	412	315	406	0	2	0	0	89	412
EDO. MIRANDA	MP. SUCRE	PQ. PETARE	COLEGIO SAN JOSE	4580	8	38	3906	672	3868	1	9	2	2	3182	3906
EDO. MIRANDA	MP. SUCRE	PQ. PETARE	ESCUELA NACIONAL BARTOLOME SALOM	6477	12	82	5178	3257	5096	0	32	4	3	1800	5178
EDO. MIRANDA	MP. SUCRE	PQ. PETARE	UNIVERSIDAD SIMON RODRIGUEZ	3222	6	39	2579	813	2540	0	7	1	2	1717	2579
EDO. MIRANDA	MP. SUCRE	PQ. PETARE	ESCUELA BASICA MUNICIPAL PASTOR OROPEZA	461	1	3	402	329	399	0	1	0	0	69	402
EDO. MIRANDA	MP. SUCRE	PQ. PETARE	UNIDAD EDUCATIVA MUNICIPAL LUIS CORREA	2812	5	38	2245	1620	2207	0	16	2	1	568	2245
EDO. MIRANDA	MP. SUCRE	PQ. PETARE	COLEGIO MANUEL MUNOZ TEBAR	2331	4	10	1747	167	1737	1	4	0	1	1564	1747
EDO. MIRANDA	MP. SUCRE	PQ. PETARE	UNIDAD EDUCATIVA COLEGIO MARA	1767	3	52	1516	906	1464	0	6	0	1	551	1516
EDO. MIRANDA	MP. SUCRE	PQ. PETARE	COLEGIO PRESIDENTE KENNEDY	4052	7	61	3295	2321	3234	0	16	1	3	893	3295
EDO. MIRANDA	MP. SUCRE	PQ. PETARE	PRE ESCOLAR DON BOSCO	358	1	3	296	228	293	2	2	0	0	61	296
EDO. MIRANDA	MP. SUCRE	PQ. PETARE	GRUPO ESCOLAR RAFAEL NAPOLEON BAUTE	9045	17	150	7223	4747	7073	2	50	9	6	2259	7223
EDO. MIRANDA	MP. SUCRE	PQ. PETARE	UNIVERSIDAD SANTA MARIA	3687	7	22	3043	392	3021	1	4	0	1	2623	3043
EDO. MIRANDA	MP. SUCRE	PQ. PETARE	PRE ESCOLAR ADELA DE CALVANI OCASIS	383	1	2	356	277	354	0	0	1	1	75	356
EDO. MIRANDA	MP. SUCRE	PQ. PETARE	UNIDAD BASICA MUNICIPAL SOCORRO GONZALEZ GUINAN	1541	3	18	1262	632	1244	1	5	0	0	606	1262
EDO. MIRANDA	MP. SUCRE	PQ. PETARE	COOPERATIVA 12 DE OCTUBRE	236	1	6	183	109	177	0	0	1	0	67	183
EDO. MIRANDA	MP. SUCRE	PQ. PETARE	BIBLIOTECA JOSE FELIX RIBAS	3008	6	59	2239	1513	2180	1	12	1	3	650	2239
EDO. MIRANDA	MP. SUCRE	PQ. PETARE	UNIDAD EDUCATIVA MUNICIPAL FRANCISCO ESPEJO	3590	7	43	2636	1496	2593	1	12	0	2	1082	2636
EDO. MIRANDA	MP. SUCRE	PQ. PETARE	UNIDAD EDUCATIVA NINO JESUS DE ESCUQUE	1114	2	8	948	218	940	0	0	0	0	722	948
EDO. MIRANDA	MP. SUCRE	PQ. PETARE	COOPERATIVA ZONA 3	381	1	6	320	223	314	0	0	0	0	91	320
EDO. MIRANDA	MP. SUCRE	PQ. PETARE	ESCUELA BASICA NACIONAL COSME DAMIAN PEÑA	2672	5	19	2075	368	2056	0	2	0	0	1686	2075
EDO. MIRANDA	MP. SUCRE	PQ. PETARE	UNIDAD EDUCATIVA MUNICIPAL SIMON BOLIVAR	3747	7	37	3056	1624	3019	2	10	2	3	1378	3056
EDO. MIRANDA	MP. SUCRE	PQ. PETARE	CASA DE LA CULTURA UBALDO LIRA	1159	3	20	864	528	844	1	9	0	1	305	864
EDO. MIRANDA	MP. SUCRE	PQ. PETARE	JARDIN DE INFANCIA AQUILES NAZOA	1671	3	33	1433	850	1400	0	9	0	2	539	1433
EDO. MIRANDA	MP. SUCRE	PQ. PETARE	UNIDAD EDUCATIVA LEONCIO MARTINEZ	1028	2	21	860	329	839	0	2	0	1	507	860
EDO. MIRANDA	MP. SUCRE	PQ. PETARE	ESCUELA GRAN MARISCAL DE AYACUCHO	4212	8	70	3381	1813	3311	0	19	4	0	1475	3381
EDO. MIRANDA	MP. SUCRE	PQ. PETARE	ESCUELA BASICA ESTADAL SIMÓN BOLÍVAR	7712	14	248	5811	3431	5563	3	24	5	7	2093	5811
EDO. MIRANDA	MP. SUCRE	PQ. PETARE	MODULO DE BARRIO ADENTRO CECILIO ACOSTA	599	1	8	420	306	412	1	1	0	0	104	420
EDO. MIRANDA	MP. SUCRE	PQ. PETARE	ESCUELA ESTADAL DON TITO SALAS	3330	6	54	2589	1848	2535	1	12	2	1	671	2589
EDO. MIRANDA	MP. SUCRE	PQ. PETARE	COLEGIO YALE	2488	5	9	1891	132	1882	0	3	0	1	1746	1891
EDO. MIRANDA	MP. SUCRE	PQ. PETARE	ESCUELA ESTADO BARINAS	2966	6	50	2385	1550	2335	0	17	3	1	764	2385
EDO. MIRANDA	MP. SUCRE	PQ. PETARE	ESCUELA BASICA ARMANDO CASTILLO PLAZA	1100	2	9	911	360	902	0	3	0	1	538	911
EDO. MIRANDA	MP. SUCRE	PQ. PETARE	PREESCOLAR MANANTIAL	96	1	1	87	74	86	0	0	0	0	12	87
EDO. MIRANDA	MP. SUCRE	PQ. PETARE	CENTRO DE FORMACIÓN INDUSTRIAL DEL ESTE INCES	2690	5	31	2250	736	2219	0	11	0	3	1469	2250
EDO. MIRANDA	MP. SUCRE	PQ. PETARE	ESCUELA  ROCA VIVA	3658	7	55	2925	1870	2870	0	18	0	2	980	2925
EDO. MIRANDA	MP. SUCRE	PQ. PETARE	DESARROLLO URBANISTICO LA URBINA	111	1	3	106	99	103	0	0	0	0	4	106
EDO. MIRANDA	MP. SUCRE	PQ. PETARE	CASA COMUNAL ALCABALA	589	1	11	506	362	495	0	5	0	0	128	506
EDO. MIRANDA	MP. SUCRE	PQ. PETARE	KINDER LAS CASITAS	89	1	1	71	41	70	0	2	0	0	27	71
EDO. MIRANDA	MP. SUCRE	PQ. PETARE	UNIDAD EDUCATIVA COLEGIO JUAN PABLO II	3733	7	14	2775	306	2761	2	5	1	3	2444	2775
EDO. MIRANDA	MP. SUCRE	PQ. PETARE	CENTRO DE EDUCACION INICIAL NACIONAL JACINTO LARA	2774	5	36	2250	687	2214	0	4	1	3	1519	2250
EDO. MIRANDA	MP. SUCRE	PQ. PETARE	ESCUELA BASICA BARRIO NUEVO	359	1	2	330	252	328	0	0	1	0	75	330
EDO. MIRANDA	MP. SUCRE	PQ. PETARE	COLEGIO FE Y ALEGRIA	4575	8	50	3313	1972	3263	1	12	1	2	1275	3313
EDO. MIRANDA	MP. SUCRE	PQ. PETARE	ESCUELA MUNICIPAL COROMOTO	5579	10	69	4594	3037	4525	3	29	1	6	1449	4594
EDO. MIRANDA	MP. SUCRE	PQ. PETARE	INSTITUTO EDUCATIVO CLAPAREDE	616	2	7	380	133	373	0	0	0	0	240	380
EDO. MIRANDA	MP. SUCRE	PQ. PETARE	ESCUELA BASICA NACIONAL JULIO CALCAÑO	4326	8	67	3401	1990	3334	0	17	2	2	1323	3401
EDO. MIRANDA	MP. SUCRE	PQ. PETARE	ESCUELA ESTADAL GRADUADA CONSUELO NAVAS TOVAR	4757	9	77	3773	2605	3696	0	16	1	3	1071	3773
EDO. MIRANDA	MP. SUCRE	PQ. PETARE	INSTITUTO DIDACTICO ANDRES BELLO	1232	3	8	877	117	869	0	2	0	0	750	877
EDO. MIRANDA	MP. SUCRE	PQ. PETARE	ESCUELA ESTADAL JOSE ANTONIO PAEZ	1657	3	44	1294	903	1250	0	7	0	1	339	1294
EDO. MIRANDA	MP. SUCRE	PQ. PETARE	JARDIN DE INFANCIA CARMEN VERONICA COELLO	1685	3	24	1278	721	1254	1	3	2	1	526	1278
EDO. MIRANDA	MP. SUCRE	PQ. PETARE	COLEGIO JOSE DE JESUS AROCHA	8253	15	120	5848	3433	5728	2	36	2	1	2254	5848
EDO. MIRANDA	MP. SUCRE	PQ. PETARE	UNIDAD EDUCATIVA DOCTOR NUÑEZ PONTE	739	2	8	612	419	604	0	4	0	1	180	612
EDO. MIRANDA	MP. SUCRE	PQ. PETARE	KINDER JOSE GREGORIO MONAGAS	986	2	23	825	395	802	0	3	0	0	404	825
EDO. MIRANDA	MP. SUCRE	PQ. PETARE	COLEGIO MADRE DEL DIVINO PASTOR	6543	12	29	4985	423	4956	2	4	1	2	4524	4985
EDO. MIRANDA	MP. SUCRE	PQ. PETARE	MINI DEPORTIVO CAMELIA DE REGGETTI	847	2	0	686	95	686	1	0	1	0	589	686
EDO. MIRANDA	MP. SUCRE	PQ. PETARE	UNIDAD EDUCATIVA INSTITUTO VENEZUELA NUEVA	2173	4	2	1771	163	1769	0	2	0	2	1602	1771
EDO. MIRANDA	MP. SUCRE	PQ. PETARE	CENTRO EDUCACION INICIAL NACIONAL PEDRO ZARAZO	580	1	8	521	390	513	0	3	3	0	117	521
EDO. MIRANDA	MP. SUCRE	PQ. PETARE	COLEGIO SAN AGUSTIN	1604	3	12	1200	135	1188	1	0	0	1	1051	1200
EDO. MIRANDA	MP. SUCRE	PQ. PETARE	UNIDAD EDUCATIVA MUNICIPAL ROMULO GALLEGOS	2521	5	47	2091	1195	2044	0	12	0	2	835	2091
EDO. MIRANDA	MP. SUCRE	PQ. PETARE	COLEGIO NUESTRA SEÑORA DE LA GUIA	1773	3	18	1406	161	1388	0	1	0	1	1225	1406
EDO. MIRANDA	MP. SUCRE	PQ. PETARE	CASA COMUNITARIA JULIAN BLANCO	888	2	18	685	507	667	0	2	1	0	157	685
EDO. MIRANDA	MP. SUCRE	PQ. PETARE	UNIDAD EDUCATIVA ENRIQUE DE OSSO	359	1	3	324	124	321	0	0	1	1	195	324
EDO. MIRANDA	MP. SUCRE	PQ. PETARE	UNIDAD EDUCATIVA COLEGIO  JOSÉ ANTONIO MAITIN	1127	2	5	965	131	960	0	1	0	1	827	965
EDO. MIRANDA	MP. SUCRE	PQ. PETARE	UNIDAD EDUCATIVA NACIONAL LICEO MARIANO PICON SALAS	4041	7	49	3234	1624	3185	1	16	3	4	1537	3234
EDO. MIRANDA	MP. SUCRE	PQ. PETARE	COLEGIO MANUEL PIAR	1682	3	26	1356	426	1330	0	4	1	0	899	1356
EDO. MIRANDA	MP. SUCRE	PQ. PETARE	GUARDERIA Y PREESCOLAR MI BELLA ILUCION	1023	2	14	813	553	799	0	2	1	2	241	813
EDO. MIRANDA	MP. SUCRE	PQ. PETARE	COLEGIO UNIVERSITARIO PROFESOR LORENZO PEREZ RODRIGUEZ	456	1	9	390	136	381	1	0	0	0	244	390
EDO. MIRANDA	MP. SUCRE	PQ. PETARE	BIBLIOTECA MISIA INFANTE	481	1	8	398	255	390	0	1	0	0	134	398
EDO. MIRANDA	MP. SUCRE	PQ. PETARE	UNIDAD EDUCATIVA COLEGIO ESDRAS	1829	4	33	1513	931	1480	1	6	1	0	541	1513
EDO. MIRANDA	MP. SUCRE	PQ. PETARE	ESCUELA NACIONAL MAGALI BURGOS DE LOPEZ	1456	3	22	1057	460	1035	0	1	0	0	574	1057
EDO. MIRANDA	MP. SUCRE	PQ. PETARE	PREESCOLAR MATEA BOLIVAR	620	2	11	548	351	537	0	3	1	0	182	548
EDO. MIRANDA	MP. SUCRE	PQ. PETARE	ESCUELA BASICA NACIONAL . ANTONIO ORDONEZ	4386	8	93	3555	1788	3462	2	12	4	3	1653	3555
EDO. MIRANDA	MP. SUCRE	PQ. PETARE	FUNDACION JOSE ANGEL LAMAS	887	2	8	675	376	667	0	2	1	4	284	675
EDO. MIRANDA	MP. SUCRE	PQ. PETARE	INSTITUTO NACIONAL DE CAPACITACION SOCIALISTA	3369	6	31	2580	390	2549	0	3	1	2	2153	2580
EDO. MIRANDA	MP. SUCRE	PQ. PETARE	ESCUELA MUNICIPAL 5 DE JULIO	3583	7	85	2761	1597	2676	0	13	2	0	1064	2761
EDO. MIRANDA	MP. SUCRE	PQ. PETARE	JARDIN DE INFANCIA AGUSTIN AVELEDO	1389	3	26	1037	589	1011	0	1	1	0	420	1037
EDO. MIRANDA	MP. SUCRE	PQ. PETARE	UNIDAD EDUCATIVA ESTADAL 12 DE FEBRERO	2001	4	52	1639	913	1587	1	12	2	1	658	1639
EDO. MIRANDA	MP. SUCRE	PQ. PETARE	PREESCOLAR AMINTA DE MANZANILLA	1033	2	8	791	134	783	1	1	1	0	646	791
EDO. MIRANDA	MP. SUCRE	PQ. PETARE	CANCHA TECHADA LA BOMBILLA SECTOR 3	1879	4	27	1665	1303	1638	0	6	0	0	329	1665
EDO. MIRANDA	MP. SUCRE	PQ. PETARE	UNIDAD EDUCATIVA INSTITUTO SAN LUCAS	4916	9	54	4042	1256	3988	0	6	2	2	2722	4042
EDO. MIRANDA	MP. SUCRE	PQ. PETARE	CANCHA ASOCIACION DE VECINOS URBANIZACION EL LLANITO	134	1	1	116	36	115	0	0	0	0	79	116
EDO. MIRANDA	MP. SUCRE	PQ. PETARE	UNIDAD EDUCATIVA MUNICIPAL LISANDRO ALVARADO	3556	7	89	2753	1663	2664	0	17	2	2	980	2753
EDO. MIRANDA	MP. SUCRE	PQ. PETARE	UNIDAD EDUCATIVA NACIONAL ELISA RISKEL DOMINGUEZ	3971	7	84	3265	1934	3181	0	11	0	1	1235	3265
EDO. MIRANDA	MP. SUCRE	PQ. PETARE	UNIDAD EDUCATIVA COLEGIO MARIA SANTISIMA	1795	4	7	1472	102	1465	0	1	0	0	1362	1472
EDO. MIRANDA	MP. SUCRE	PQ. PETARE	ESCUELA MUNICIPAL ANDRES ELOY BLANCO	5169	9	66	4259	1619	4193	0	15	4	4	2551	4259
EDO. MIRANDA	MP. SUCRE	PQ. PETARE	UNIDAD EDUCATIVA  COLEGIO  SIMON BOLIVAR Y GARIBALDI	2121	4	11	1614	112	1603	0	1	1	2	1487	1614
EDO. MIRANDA	MP. SUCRE	PQ. PETARE	UNIDAD EDUCATIVA MUNICIPAL GUAICAIPURO	1904	4	33	1569	1016	1536	0	3	0	0	517	1569
EDO. MIRANDA	MP. SUCRE	PQ. PETARE	UNIDAD EDUCATIVA PRIVADA MIGUEL SURIAGA	228	1	2	192	137	190	0	2	0	0	51	192
EDO. MIRANDA	MP. SUCRE	PQ. PETARE	BIBLIOTECA PUBLICA PAUL HARRIS	740	2	9	669	455	660	0	2	0	0	203	669
EDO. MIRANDA	MP. SUCRE	PQ. PETARE	UNIDAD EDUCATIVA MUNICIPAL ABAJO CADENAS	5132	9	59	4044	2748	3985	9	18	7	2	1201	4044
EDO. MIRANDA	MP. SUCRE	PQ. PETARE	UNIDAD EDUCATIVA ESTADAL.GENERAL SANTIAGO MARIÑO	1674	3	29	1332	910	1303	0	5	0	1	387	1332
EDO. MIRANDA	MP. SUCRE	PQ. PETARE	UNIDAD EDUCATIVA PREESCOLAR AMALIVAC	1131	2	5	905	135	900	0	1	0	0	764	905
EDO. MIRANDA	MP. SUCRE	PQ. PETARE	LICEO BOLIVARIANO LINO DE CLEMENTE	4399	8	26	3335	530	3309	1	3	1	5	2769	3335
EDO. MIRANDA	MP. SUCRE	PQ. PETARE	ESCUELA MUNICIPAL FERMIN TORO	3967	7	51	3199	2078	3148	1	18	1	1	1049	3199
EDO. MIRANDA	MP. SUCRE	PQ. PETARE	PREESCOLAR MIRIAM ACUÑA	245	1	5	214	173	209	0	2	0	0	34	214
EDO. MIRANDA	MP. SUCRE	PQ. PETARE	ESCUELA TECNICA LEONARDO INFANTE	3745	7	47	2936	1510	2889	1	9	0	7	1362	2936
EDO. MIRANDA	MP. SUCRE	PQ. PETARE	TEATRO CESAR RENGIFO	1963	4	38	1507	880	1469	1	4	3	1	580	1507
EDO. MIRANDA	MP. SUCRE	PQ. PETARE	JARDIN DE INFANCIA CADAFITO	3505	6	17	2622	585	2605	0	5	1	3	2011	2622
EDO. MIRANDA	MP. SUCRE	PQ. PETARE	CENTRO DE EDUCACION INICIAL PRE ESCOLAR CINTHIA ROSEMBERG	3826	7	23	3143	430	3120	1	7	2	1	2679	3143
EDO. MIRANDA	MP. SUCRE	PQ. PETARE	BIBLIOTECA PUBLICA CAMPO RICO	158	1	0	134	94	134	0	1	0	1	38	134
EDO. MIRANDA	MP. SUCRE	PQ. PETARE	UNIDAD EDUCATIVA ALBERTO RAVELL	5701	10	66	4495	2705	4429	3	20	6	4	1691	4495
EDO. MIRANDA	MP. SUCRE	PQ. PETARE	CENTRO EDUCATIVO RECREACIONAL LUISA CACERES DE ARISMENDI	4907	9	108	3865	2361	3757	0	24	1	0	1371	3865
EDO. MIRANDA	MP. SUCRE	PQ. PETARE	PREESCOLAR DOÑA CARMEN	115	1	7	102	62	95	0	1	0	0	32	102
EDO. MIRANDA	MP. SUCRE	PQ. PETARE	UNIDAD EDUCATIVA COLEGIO BELTRAN RUSSEL	2134	4	17	1803	405	1786	0	2	0	1	1378	1803
EDO. MIRANDA	MP. SUCRE	PQ. PETARE	UNIDAD EDUCATIVA MUNICIPAL SIMON RODRIGUEZ	1962	4	16	1575	244	1559	0	0	0	0	1315	1575
EDO. MIRANDA	MP. SUCRE	PQ. PETARE	CENTRO DE EDUCACION INICIAL ESTADAL EZEQUIEL ZAMORA	604	2	15	550	409	535	0	2	0	0	124	550
EDO. MIRANDA	MP. SUCRE	PQ. PETARE	CANCHA DEL BARRIO METROPOLITANO	477	1	2	388	286	386	1	4	1	0	94	388
EDO. MIRANDA	MP. SUCRE	PQ. PETARE	UNIVERSIDAD METROPOLITANA	7138	13	41	5937	514	5896	1	8	1	0	5372	5937
EDO. MIRANDA	MP. SUCRE	PQ. PETARE	ESCUELA JOSE MERCEDES SANTELIZ	1260	3	12	1105	642	1093	0	3	0	1	447	1105
EDO. MIRANDA	MP. SUCRE	PQ. PETARE	UNIDAD EDUCATIVA MUNICIPAL AGUSTIN AVELEDO	2426	5	25	1922	992	1897	0	7	0	5	893	1922
EDO. MIRANDA	MP. SUCRE	PQ. PETARE	CENTRO COMUNITARIO C E N C O N	1056	2	32	862	449	830	0	3	1	1	376	862
EDO. MIRANDA	MP. SUCRE	PQ. PETARE	ESCUELA NACIONAL MANUEL AGUIRRE ELORRIAGA	5266	10	69	4237	3092	4168	0	14	2	2	1058	4237
EDO. MIRANDA	MP. SUCRE	PQ. PETARE	UNIDAD EDUCATIVA ALTERNATIVA EL CARMEN	627	2	7	543	435	536	0	2	0	1	98	543
EDO. MIRANDA	MP. SUCRE	PQ. PETARE	CENTRO DE ORIENTACION Y EDUCACION COMUNITARIA	1323	3	23	1137	837	1114	0	6	1	2	268	1137
EDO. MIRANDA	MP. SUCRE	PQ. PETARE	UNIDAD EDUCATIVA COLEGIO MACARACUAY	2444	5	6	1889	149	1883	0	1	1	0	1732	1889
EDO. MIRANDA	MP. SUCRE	PQ. PETARE	BIBLIOTECA PUBLICA PILOTO LA URBINA	404	1	9	346	245	337	0	2	0	0	90	346
EDO. MIRANDA	MP. SUCRE	PQ. PETARE	CASA CUNA PETARE	1699	3	24	1298	791	1274	0	3	0	1	479	1298
EDO. MIRANDA	MP. SUCRE	PQ. PETARE	COLEGIO JESUS MAESTRO	2992	6	58	2377	1645	2319	1	14	1	1	657	2377
EDO. MIRANDA	MP. SUCRE	PQ. PETARE	INSTITUTO EDUCATIVO SAN JUDAS TADEO	1317	3	13	1128	252	1115	0	4	2	0	857	1128
EDO. MIRANDA	MP. SUCRE	PQ. PETARE	INSTITUTO MAGISTERIAL VENEZUELA	981	2	16	752	349	736	1	4	1	1	380	752
EDO. MIRANDA	MP. SUCRE	PQ. PETARE	TECNICA.TITO SPORT	385	1	10	322	224	312	0	0	0	1	87	322
EDO. MIRANDA	MP. SUCRE	PQ. PETARE	UNIDAD EDUCATIVA COLEGIO SAN ANTONIO DE MACARACUAY	7692	14	36	5981	486	5945	0	9	0	6	5444	5981
EDO. MIRANDA	MP. SUCRE	PQ. PETARE	DESARROLLO URBANISTICO CIUDAD LEBRUN	78	1	1	76	75	75	0	0	0	0	0	76
EDO. MIRANDA	MP. SUCRE	PQ. PETARE	UNIDAD EDUCATIVA MUNICIPAL ROMULO BETANCOURT	722	2	15	654	507	639	0	2	0	0	130	654
EDO. MIRANDA	MP. SUCRE	PQ. PETARE	UNIDAD EDUCATIVA MUNICIPAL CECILIO ACOSTA	3407	6	78	2788	1553	2710	0	11	2	2	1142	2788
EDO. MIRANDA	MP. SUCRE	PQ. CAUCAGUITA	UNIDAD EDUCATIVA FE Y ALEGRIA PADRE JOAQUIN LOPEZ	4482	8	66	3767	1955	3701	1	11	0	4	1730	3767
EDO. MIRANDA	MP. SUCRE	PQ. CAUCAGUITA	LICEO NEGRO PRIMERO	3452	6	56	2697	1748	2641	0	12	3	3	875	2697
EDO. MIRANDA	MP. SUCRE	PQ. CAUCAGUITA	DOÑA MENCA DE LEONI	123	1	5	105	62	100	0	0	0	0	38	105
EDO. MIRANDA	MP. SUCRE	PQ. CAUCAGUITA	ESCUELA MUNICIPAL ANTONIO JOSE DE SUCRE	5818	11	132	4556	3181	4424	2	18	0	5	1218	4556
EDO. MIRANDA	MP. SUCRE	PQ. CAUCAGUITA	FUNDACION NACIONAL EL NINO SIMON CENTRO EDUCACION INICIAL LAS AVEJITAS	1561	3	29	1358	1027	1329	1	8	2	2	289	1358
EDO. MIRANDA	MP. SUCRE	PQ. CAUCAGUITA	CENTRO MARITIMO DE VENEZUELA	3891	7	79	3027	1329	2948	0	8	0	1	1610	3027
EDO. MIRANDA	MP. SUCRE	PQ. CAUCAGUITA	ESCUELA BASICA ESTADAL NEGRO PRIMERO II	4949	9	95	3941	2657	3846	2	11	4	2	1170	3941
EDO. MIRANDA	MP. SUCRE	PQ. CAUCAGUITA	CENTRO DE ATENCION INTEGRAL AL CIUDADANO	373	1	2	323	251	321	0	1	0	0	69	323
EDO. MIRANDA	MP. SUCRE	PQ. CAUCAGUITA	UNIDAD EDUCATIVA MUNICIPAL JOSE ANTONIO CALCAÑO	4176	8	110	3285	1826	3175	1	25	1	2	1320	3285
EDO. MIRANDA	MP. SUCRE	PQ. CAUCAGUITA	GRUPO ESCOLAR DOCTOR JOSE MARIA VARGAS	1639	3	28	1344	998	1316	1	6	1	0	310	1344
EDO. MIRANDA	MP. SUCRE	PQ. CAUCAGUITA	ESCUELA BASICA NACIONAL LICEO JOSE ANTONIO CALCAÑO	792	2	20	620	361	600	0	4	0	0	235	620
EDO. MIRANDA	MP. SUCRE	PQ. CAUCAGUITA	UNIDAD EDUCATIVA NACIONAL TURUMO	1546	3	32	1162	654	1130	0	5	1	1	469	1162
EDO. MIRANDA	MP. SUCRE	PQ. LEONCIO MARTINEZ	ESCUELA MUNICIPAL FRANCISCO DE MIRANDA	2264	4	36	1718	711	1682	0	2	0	0	969	1718
EDO. MIRANDA	MP. SUCRE	PQ. LEONCIO MARTINEZ	INSTITUTO MEJORAMIENTO PROFESIONAL DEL MAGISTERIO	2675	5	18	1978	362	1960	0	5	2	2	1589	1978
EDO. MIRANDA	MP. SUCRE	PQ. LEONCIO MARTINEZ	INSTITUTO NUESTRA SEÑORA DE FATIMA	786	2	6	637	103	631	0	2	0	0	526	637
EDO. MIRANDA	MP. SUCRE	PQ. LEONCIO MARTINEZ	COLEGIO FRANCIA	6216	12	91	4630	1071	4539	0	5	3	1	3459	4630
EDO. MIRANDA	MP. SUCRE	PQ. LEONCIO MARTINEZ	INSTITUTO CICLO BASICO ESTEBAN GIL BORGES	1514	3	15	1074	287	1059	0	2	0	1	769	1074
EDO. MIRANDA	MP. SUCRE	PQ. LEONCIO MARTINEZ	COLEGIO AMERICO VESPUCIO	2047	4	16	1556	219	1540	1	0	0	2	1318	1556
EDO. MIRANDA	MP. SUCRE	PQ. LEONCIO MARTINEZ	COLEGIO RODRIGUEZ PAZ	1257	3	8	958	157	950	0	1	0	1	791	958
EDO. MIRANDA	MP. SUCRE	PQ. LEONCIO MARTINEZ	COLEGIO MARIA AUXILIADORA	2195	4	25	1785	322	1760	0	1	0	1	1436	1785
EDO. MIRANDA	MP. SUCRE	PQ. LEONCIO MARTINEZ	ESCUELA NACIONAL RICARDO ZULUAGA	1647	3	14	1257	277	1243	1	6	0	3	956	1257
EDO. MIRANDA	MP. SUCRE	PQ. LEONCIO MARTINEZ	COLEGIO MADRE EMILIA	4329	8	30	3293	610	3263	1	11	0	2	2639	3293
EDO. MIRANDA	MP. SUCRE	PQ. LEONCIO MARTINEZ	COLEGIO MARIA INMACULADA	1639	3	10	1278	187	1268	1	1	2	1	1076	1278
EDO. MIRANDA	MP. SUCRE	PQ. LEONCIO MARTINEZ	INSTITUTO DE NUEVAS PROFESIONES	4131	8	41	3038	478	2997	3	5	1	1	2509	3038
EDO. MIRANDA	MP. SUCRE	PQ. LEONCIO MARTINEZ	PREESCOLAR EUGENIA RABASCO	1075	2	4	850	96	846	0	2	0	1	747	850
EDO. MIRANDA	MP. SUCRE	PQ. LEONCIO MARTINEZ	COLEGIO ALA BLANCA	1451	3	11	1093	322	1082	0	4	1	1	754	1093
EDO. MIRANDA	MP. SUCRE	PQ. LEONCIO MARTINEZ	INSTITUTO MARIA MICAELA	2173	4	25	1742	416	1717	0	6	0	1	1294	1742
EDO. MIRANDA	MP. SUCRE	PQ. LEONCIO MARTINEZ	LICEO JUAN BAUTISTA PLAZA	845	2	12	633	176	621	0	0	0	2	443	633
EDO. MIRANDA	MP. SUCRE	PQ. LEONCIO MARTINEZ	CENTRO DE EDUCACIÓN INICIAL BASE AÉREA GENERALISIMO FRANCISCO DE MIRANDA	286	1	2	271	255	269	0	0	0	0	14	271
EDO. MIRANDA	MP. SUCRE	PQ. LEONCIO MARTINEZ	CENTRO DE FORMACION SOCIALISTA LOS RUICES	173	1	2	164	159	162	0	0	0	0	3	164
EDO. MIRANDA	MP. SUCRE	PQ. LEONCIO MARTINEZ	INSTITUTO DE FORMACION INTEGRAL LOS PROCERES	520	1	5	423	53	418	0	0	0	1	364	423
EDO. MIRANDA	MP. SUCRE	PQ. LEONCIO MARTINEZ	ESCUELA TECNICA POPULAR DON BOSCO	9607	18	108	7191	1505	7083	0	18	2	5	5553	7191
EDO. MIRANDA	MP. SUCRE	PQ. LEONCIO MARTINEZ	UNIDAD  EDUCATIVA COLEGIO SANTA GEMA	5151	9	30	3919	443	3889	2	4	0	6	3434	3919
EDO. MIRANDA	MP. SUCRE	PQ. LEONCIO MARTINEZ	COLEGIO NUESTRA SEÑORA DE COROMOTO	1118	2	5	796	159	791	0	3	0	0	629	796
EDO. MIRANDA	MP. SUCRE	PQ. LEONCIO MARTINEZ	COLEGIO PATRIA	1111	2	3	914	123	911	0	1	1	1	785	914
EDO. MIRANDA	MP. SUCRE	PQ. LEONCIO MARTINEZ	UNIDAD EDUCATIVA ESTADAL MARIA ANGELICA LUSINCHI	1748	3	29	1490	751	1461	0	6	0	2	702	1490
EDO. MIRANDA	MP. SUCRE	PQ. LEONCIO MARTINEZ	COLEGIO ELENA DE BUENO	1345	3	5	1060	70	1055	0	0	0	1	984	1060
EDO. MIRANDA	MP. SUCRE	PQ. LEONCIO MARTINEZ	UNIDAD EDUCATIVA NACIONAL MARTINEZ CENTENO	2767	5	9	2013	305	2004	0	3	0	1	1695	2013
EDO. MIRANDA	MP. SUCRE	PQ. LEONCIO MARTINEZ	UNIDAD EDUCATIVA EXPERIMENTAL NACIONAL LUIS BELTRAN PRIETO FIGUEROA	559	1	12	507	272	495	1	1	0	0	221	507
EDO. MIRANDA	MP. SUCRE	PQ. LA DOLORITA	UNIDAD EDUCATIVA NACIONAL JERMAN UBALDO LIRA	4008	7	70	3218	2208	3148	4	22	4	3	907	3218
EDO. MIRANDA	MP. SUCRE	PQ. LA DOLORITA	UNIDAD EDUCATIVA JUAN XXIII	734	2	12	640	476	628	0	2	0	0	150	640
EDO. MIRANDA	MP. SUCRE	PQ. LA DOLORITA	ESCUELA  ESTADAL FRANCISCO ISNARDI	2491	5	76	2059	1509	1983	2	13	5	3	451	2059
EDO. MIRANDA	MP. SUCRE	PQ. LA DOLORITA	ESCUELA MUNICIPAL CARMEN BALVERDE	2284	4	60	1837	1182	1777	2	7	1	0	585	1837
EDO. MIRANDA	MP. SUCRE	PQ. LA DOLORITA	CASA DE LA CULTURA ARMANDO REVERON	776	2	17	669	537	652	1	9	0	0	105	669
EDO. MIRANDA	MP. SUCRE	PQ. LA DOLORITA	UNIDAD EDUCATIVA NACIONAL MARISCAL SUCRE	5191	10	85	4047	2842	3962	1	27	3	6	1083	4047
EDO. MIRANDA	MP. SUCRE	PQ. LA DOLORITA	CENTRO EDUCATIVO INICIAL MUNICIPAL ZAIDA LAGER	567	1	14	466	366	452	0	2	0	0	84	466
EDO. MIRANDA	MP. SUCRE	PQ. LA DOLORITA	ESCUELA BASICA JOSE NICOMEDES MARRERO	2030	4	55	1677	1066	1622	0	9	1	1	545	1677
EDO. MIRANDA	MP. SUCRE	PQ. LA DOLORITA	JARDIN DE INFANCIA JUAN PABLO PEREZ ALFONSO	590	1	4	426	283	422	0	1	1	0	137	426
EDO. MIRANDA	MP. SUCRE	PQ. LA DOLORITA	ESCUELA MUNICIPAL PAZ CASTILLO	1226	3	23	1028	511	1005	0	3	0	0	491	1028
EDO. MIRANDA	MP. SUCRE	PQ. LA DOLORITA	UNIDAD EDUCATIVA COLEGIO FUENTE DE SALVACION	1516	3	45	1267	775	1222	0	4	2	0	441	1267
EDO. MIRANDA	MP. SUCRE	PQ. FILAS DE MARICHES	MARIA TERESA NEZER	2202	4	32	1774	1159	1742	1	6	0	1	575	1774
EDO. MIRANDA	MP. SUCRE	PQ. FILAS DE MARICHES	CENTRO DE EDUCACION INICIAL NACIONAL CIUDAD MARICHE	677	2	5	635	611	630	0	1	1	0	17	635
EDO. MIRANDA	MP. SUCRE	PQ. FILAS DE MARICHES	UNIDAD EDUCATIVA NACIONAL CECILIO ACOSTA	1488	3	22	1104	891	1082	1	4	1	0	185	1104
EDO. MIRANDA	MP. SUCRE	PQ. FILAS DE MARICHES	CENTRO DE CAPACITACION INDUSTRIAL DON BOSCO	3316	6	75	2569	1309	2494	0	8	3	0	1174	2569
EDO. MIRANDA	MP. SUCRE	PQ. FILAS DE MARICHES	COLEGIO GENERALISIMO FRANCISCO DE MIRANDA	3894	7	70	3182	2467	3112	3	16	1	2	623	3182
EDO. MIRANDA	MP. SUCRE	PQ. FILAS DE MARICHES	ESCUELA MUNICIPAL TITO SALAS	4935	9	80	3679	2567	3599	4	20	5	0	1003	3679
EDO. MIRANDA	MP. SUCRE	PQ. FILAS DE MARICHES	CASA COMUNAL LA ARBOLEDA	496	1	9	418	361	409	0	2	0	0	46	418
EDO. MIRANDA	MP. SUCRE	PQ. FILAS DE MARICHES	UNIDAD EDUCATIVA NACIONAL BOLIVARIANA ANA MARIA CAMPOS	347	1	6	289	221	283	0	1	1	0	60	289
EDO. MIRANDA	MP. SUCRE	PQ. FILAS DE MARICHES	UNIDAD EDUCATIVA ALMIRANTE LUIS BRION	3849	7	52	3046	2241	2994	0	17	2	1	733	3046
EDO. MIRANDA	MP. SUCRE	PQ. FILAS DE MARICHES	DESARROLLO URBANISTICO LA HACIENDITA	123	1	1	117	115	116	0	0	0	0	1	117
EDO. MIRANDA	MP. SUCRE	PQ. FILAS DE MARICHES	UNIDAD EDUCATIVA PROFESORA BELEN SAN JUAN	315	1	8	261	207	253	0	0	0	0	46	261
EDO. MIRANDA	MP. BUROZ	PQ. MAMPORAL	CONCENTRACION ESTADAL BOLIVARIANA LOS SERRANOS	188	1	9	161	122	152	0	1	0	0	29	161
EDO. MIRANDA	MP. BUROZ	PQ. MAMPORAL	UNIDAD EDUCATIVA EULALIA SANCHEZ DE CHAMBERLAIN	1120	2	12	937	653	925	0	2	0	1	269	937
EDO. MIRANDA	MP. BUROZ	PQ. MAMPORAL	ESCUELA UNITARIA NACIONAL SIN NUMERO	225	1	3	149	136	146	0	1	0	0	9	149
EDO. MIRANDA	MP. BUROZ	PQ. MAMPORAL	CONCENTRACION ESTADADAL SIN NUMERO BELEN LA VEGA	319	1	7	278	230	271	0	1	0	1	39	278
EDO. MIRANDA	MP. BUROZ	PQ. MAMPORAL	LICEO BOLIVARIANO ALMIRANTE LUIS BRION	1037	2	17	843	575	826	1	1	0	1	248	843
EDO. MIRANDA	MP. BUROZ	PQ. MAMPORAL	CENTRO DE EDUCACION INICIAL AGUSTIN PAEZ	670	2	12	551	379	539	0	2	0	0	158	551
EDO. MIRANDA	MP. BUROZ	PQ. MAMPORAL	ESCUELA BASICA MAMPORAL	3783	7	78	2959	1778	2881	0	21	2	1	1079	2959
EDO. MIRANDA	MP. BUROZ	PQ. MAMPORAL	CONCENTRACION NACIONAL BASICA 28	1552	3	49	1201	873	1152	0	4	0	0	275	1201
EDO. MIRANDA	MP. BUROZ	PQ. MAMPORAL	ESCUELA ESTADAL EL BAMBU	358	1	8	282	202	274	0	2	1	0	69	282
EDO. MIRANDA	MP. BUROZ	PQ. MAMPORAL	CONCENTRACION ESCOLAR ESTATAL SIN NUMERO	522	1	12	429	253	417	0	0	0	0	164	429
EDO. MIRANDA	MP. BUROZ	PQ. MAMPORAL	ESCUELA GASPAR LANDAEZ	1077	2	24	821	588	797	0	3	0	0	206	821
EDO. MIRANDA	MP. BUROZ	PQ. MAMPORAL	UNIDAD EDUCATIVA LOS VELASQUEZ	318	1	4	288	243	284	0	0	0	0	41	288
EDO. MIRANDA	MP. BUROZ	PQ. MAMPORAL	UNIDAD EDUCATIVA PRIVADA PEDRO VICENTE SOSA HERNANDEZ	386	1	14	324	203	310	0	0	0	0	107	324
EDO. MIRANDA	MP. BUROZ	PQ. MAMPORAL	ESCUELA ESTATAL UNITARIA NUMERO 32	355	1	6	294	186	288	0	0	1	0	101	294
EDO. MIRANDA	MP. BUROZ	PQ. MAMPORAL	CONCENTRACION ESTADAL LOS HERNANDEZ	159	1	3	152	133	149	0	2	0	0	14	152
EDO. MIRANDA	MP. BUROZ	PQ. MAMPORAL	UNIDAD EDUCATIVA NUMERO 31	1443	3	20	1073	790	1053	0	3	1	0	259	1073
EDO. MIRANDA	MP. BUROZ	PQ. MAMPORAL	GRUPO ESCOLAR SAN JUAN	882	2	12	656	426	644	0	2	0	0	216	656
EDO. MIRANDA	MP. BUROZ	PQ. MAMPORAL	UNIDAD EDUCATIVA MAURICA	1715	3	36	1448	958	1412	0	6	0	0	448	1448
EDO. MIRANDA	MP. EL HATILLO	PQ. EL HATILLO	UNIDAD EDUCATIVA COLEGIO ACADEMIA MERICI	1918	4	13	1566	62	1553	0	4	0	0	1487	1566
EDO. MIRANDA	MP. EL HATILLO	PQ. EL HATILLO	POLIDEPORTIVO LA BOYERA	6110	11	14	4942	369	4928	0	5	1	1	4552	4942
EDO. MIRANDA	MP. EL HATILLO	PQ. EL HATILLO	CENTRO CIVICO MANUEL RAMOS MARCOS	2316	4	20	1776	358	1756	0	0	0	1	1397	1776
EDO. MIRANDA	MP. EL HATILLO	PQ. EL HATILLO	ESCUELA MUNICIPAL GRADUADA MARIA MAY	1975	4	27	1629	624	1602	1	3	1	1	972	1629
EDO. MIRANDA	MP. EL HATILLO	PQ. EL HATILLO	COLEGIO CLARET	2749	5	14	2266	110	2252	0	1	0	0	2141	2266
EDO. MIRANDA	MP. EL HATILLO	PQ. EL HATILLO	CONCENTRACION NACIONAL TURGUA	1158	2	27	909	615	882	0	4	0	0	263	909
EDO. MIRANDA	MP. EL HATILLO	PQ. EL HATILLO	CENTRO DEPORTIVO VINICIO MATA	748	2	6	648	185	642	0	0	0	2	455	648
EDO. MIRANDA	MP. EL HATILLO	PQ. EL HATILLO	CLUB URBANIZACION EL TREBOL	2330	4	10	1838	150	1828	0	1	0	0	1677	1838
EDO. MIRANDA	MP. EL HATILLO	PQ. EL HATILLO	ESCUELA MUNICIPAL JUAN MANUEL CAJIGAL	3311	6	48	2684	659	2636	0	8	1	1	1967	2684
EDO. MIRANDA	MP. EL HATILLO	PQ. EL HATILLO	COLEGIO CANIGUA	3720	7	33	3074	421	3041	0	10	0	3	2607	3074
EDO. MIRANDA	MP. EL HATILLO	PQ. EL HATILLO	UNIDAD EDUCATIVA NACIONAL JUAN DE ESCALONA	1912	4	18	1465	345	1447	0	4	0	1	1097	1465
EDO. MIRANDA	MP. EL HATILLO	PQ. EL HATILLO	UNIVERSIDAD NUEVA ESPARTA	7951	15	23	6391	307	6368	1	5	5	4	6046	6391
EDO. MIRANDA	MP. EL HATILLO	PQ. EL HATILLO	CLUB LA LAGUNITA	3444	6	11	2842	113	2831	0	3	0	0	2715	2842
EDO. MIRANDA	MP. EL HATILLO	PQ. EL HATILLO	UNIDAD EDUCATIVA NACIONAL BOLIVARIANA LA UNION	573	1	5	513	199	508	0	2	0	1	306	513
EDO. MIRANDA	MP. EL HATILLO	PQ. EL HATILLO	UNIDAD EDUCATIVA NACIONAL BOLIVARIANA CONOPOIMA	5375	10	37	4216	422	4179	0	11	0	1	3745	4216
EDO. MIRANDA	MP. EL HATILLO	PQ. EL HATILLO	ESCUELA ESTADAL GRADUADA ABILIO REYES OCHOA	3407	6	73	2759	1486	2686	1	16	5	2	1176	2759
EDO. MIRANDA	MP. EL HATILLO	PQ. EL HATILLO	COMPLEJO GUSTAVO GARCIA LUJAN (SALESIANAS)	338	1	9	292	175	283	0	2	1	0	105	292
EDO. MIRANDA	MP. EL HATILLO	PQ. EL HATILLO	UNIDAD EDUCATIVA MUNICIPAL ARMANDO REVERON	1319	3	19	996	729	977	1	3	2	0	242	996
EDO. MIRANDA	MP. LOS SALIAS	PQ. SAN ANTONIO LOS ALTOS	UNIDAD EDUCATIVA ESTADAL ESTADO ARAGUA	2194	4	33	1763	646	1730	1	3	0	4	1076	1763
EDO. MIRANDA	MP. LOS SALIAS	PQ. SAN ANTONIO LOS ALTOS	UNIDAD EDUCATIVA MARIANO PICON SALAS	1264	3	12	1005	542	993	1	6	1	0	443	1005
EDO. MIRANDA	MP. LOS SALIAS	PQ. SAN ANTONIO LOS ALTOS	UNIDAD EDUCATIVA LUIS EDUARDO EGUI	6278	12	52	5277	999	5225	0	5	2	4	4215	5277
EDO. MIRANDA	MP. LOS SALIAS	PQ. SAN ANTONIO LOS ALTOS	UNIDAD EDUCATIVA ESTADAL DILIA DELGADO DE BELLO	1837	4	28	1510	302	1482	0	0	2	1	1177	1510
EDO. MIRANDA	MP. LOS SALIAS	PQ. SAN ANTONIO LOS ALTOS	COLEGIO EL BUEN CONSEJO	5357	10	40	4333	988	4293	1	8	0	3	3293	4333
EDO. MIRANDA	MP. LOS SALIAS	PQ. SAN ANTONIO LOS ALTOS	UNIDAD EDUCATIVA ESTADAL BOLIVARIANA NUESTRA SEÑORA DE LOS DOLORES	1571	3	13	1353	323	1340	0	2	0	1	1014	1353
EDO. MIRANDA	MP. LOS SALIAS	PQ. SAN ANTONIO LOS ALTOS	LICEO JOSE MIGUEL SANZ	4199	8	25	3573	686	3548	0	7	1	2	2852	3573
EDO. MIRANDA	MP. LOS SALIAS	PQ. SAN ANTONIO LOS ALTOS	CENTRO EDUCATIVO INTEGRAL SIMONCITO LA ROSALEDA	5554	10	39	4978	1678	4939	2	7	3	5	3244	4978
EDO. MIRANDA	MP. LOS SALIAS	PQ. SAN ANTONIO LOS ALTOS	UNIDAD EDUCATIVA PROFESOR BORIS BOSSIO VIVAS	4944	9	27	3921	596	3894	1	7	1	4	3285	3921
EDO. MIRANDA	MP. LOS SALIAS	PQ. SAN ANTONIO LOS ALTOS	ESCUELA BASICA LOS SALIAS	3675	7	19	3003	801	2984	0	8	2	3	2170	3003
EDO. MIRANDA	MP. LOS SALIAS	PQ. SAN ANTONIO LOS ALTOS	UNIDAD EDUCATIVA DON GUADALUPE HERNANDEZ	1777	3	19	1471	407	1452	0	4	1	1	1039	1471
EDO. MIRANDA	MP. LOS SALIAS	PQ. SAN ANTONIO LOS ALTOS	ESCUELA DE DANZA LOS CASTORES	540	1	4	481	101	477	0	1	0	1	374	481
EDO. MIRANDA	MP. LOS SALIAS	PQ. SAN ANTONIO LOS ALTOS	UNIDAD EDUCATIVA JOSE MANUEL SISO MARTINEZ	3032	6	16	2570	483	2554	1	4	2	5	2059	2570
EDO. MIRANDA	MP. LOS SALIAS	PQ. SAN ANTONIO LOS ALTOS	UNIDAD EDUCATIVA MUNICIPAL ELSA NUÑEZ VARGAS	570	1	7	505	234	498	0	0	0	1	263	505
EDO. MIRANDA	MP. LOS SALIAS	PQ. SAN ANTONIO LOS ALTOS	COLEGIO MASTER DEY	4559	8	37	3915	446	3878	1	4	1	4	3422	3915
EDO. MIRANDA	MP. LOS SALIAS	PQ. SAN ANTONIO LOS ALTOS	UNIDAD EDUCATIVA LOS CASTORES	3426	6	20	2833	417	2813	0	1	2	3	2390	2833
EDO. MIRANDA	MP. LOS SALIAS	PQ. SAN ANTONIO LOS ALTOS	UNIDAD EDUCATIVA ENRIQUE MARIA DUBUC	1266	3	8	1129	171	1121	1	0	2	0	947	1129
EDO. MIRANDA	MP. LOS SALIAS	PQ. SAN ANTONIO LOS ALTOS	UNIDAD EDUCUCATIVA LAS MINAS	2071	4	70	1676	875	1606	0	6	1	0	724	1676
EDO. MIRANDA	MP. LOS SALIAS	PQ. SAN ANTONIO LOS ALTOS	PRE ESCOLAR TIA ALICIA POJAN	992	2	5	926	167	921	0	1	0	0	753	926
EDO. MIRANDA	MP. ANDRES BELLO	PQ. CUMBO	UNIDAD EDUCATIVA COTO PAÚL	863	2	23	622	345	599	1	2	0	0	251	622
EDO. MIRANDA	MP. ANDRES BELLO	PQ.SAN JOSE DE BARLOVENTO	CONCENTRACION ESCOLAR NO 23	822	2	4	623	543	619	1	1	1	0	73	623
EDO. MIRANDA	MP. ANDRES BELLO	PQ.SAN JOSE DE BARLOVENTO	CONCENTRACION ESTADAL SIN NUMERO EL MANGUITO	103	1	1	86	63	85	0	1	0	0	21	86
EDO. MIRANDA	MP. ANDRES BELLO	PQ.SAN JOSE DE BARLOVENTO	CONCENTRACION ESTADAL SIN NUMERO  LA LUCHA	285	1	9	258	211	249	1	0	0	0	37	258
EDO. MIRANDA	MP. ANDRES BELLO	PQ.SAN JOSE DE BARLOVENTO	JARDIN DE INFANCIA CARLOS HERNANDEZ BAEZ	1181	3	23	946	614	923	0	2	0	0	307	946
EDO. MIRANDA	MP. ANDRES BELLO	PQ.SAN JOSE DE BARLOVENTO	ESCUELA INTEGRAL BOLIVARIANA LOS GALPONES ADSCRITA AL NUCLEO ESCOLAR RURAL  026	162	1	6	153	120	147	0	2	0	0	25	153
EDO. MIRANDA	MP. ANDRES BELLO	PQ.SAN JOSE DE BARLOVENTO	CONCENTRACION ESTADAL NO 81 26	777	2	10	559	420	549	1	4	0	1	123	559
EDO. MIRANDA	MP. ANDRES BELLO	PQ.SAN JOSE DE BARLOVENTO	CENTRO DE EDUCACION INICIAL SIMONCITO LUISA ARRAMBIDE DE PACANINS	265	1	3	247	209	244	0	1	0	0	34	247
EDO. MIRANDA	MP. ANDRES BELLO	PQ.SAN JOSE DE BARLOVENTO	ESCUELA UNITARIA NACIONAL Nº 22	396	1	3	303	186	300	0	0	0	0	114	303
EDO. MIRANDA	MP. ANDRES BELLO	PQ.SAN JOSE DE BARLOVENTO	CONCENTRACION ESTADAL SIN NUMERO  LA DEFENSA	84	1	0	82	77	82	0	0	0	0	5	82
EDO. MIRANDA	MP. ANDRES BELLO	PQ.SAN JOSE DE BARLOVENTO	ESCUELA BOLIVARIANA ESTADAL ELIA MARQUEZ DE ESPINOZA	387	1	6	344	304	338	0	0	0	0	34	344
EDO. MIRANDA	MP. ANDRES BELLO	PQ.SAN JOSE DE BARLOVENTO	ESCUELA INTEGRAL BOLIVARIANA BURGUILLOS	426	1	13	292	178	279	0	0	1	0	100	292
EDO. MIRANDA	MP. ANDRES BELLO	PQ.SAN JOSE DE BARLOVENTO	ESCUELA BÁSICA LANDER	2454	5	42	1979	1208	1937	1	11	1	1	715	1979
EDO. MIRANDA	MP. ANDRES BELLO	PQ.SAN JOSE DE BARLOVENTO	INSTITUTO DE EDUCACION ESPECIAL BOLIVARIANO OSWALDO MIJARES	939	2	11	802	526	791	0	3	0	1	261	802
EDO. MIRANDA	MP. ANDRES BELLO	PQ.SAN JOSE DE BARLOVENTO	CASA DE LA CULTURA ANDRES BELLO	1400	3	46	1176	773	1130	0	4	2	0	351	1176
EDO. MIRANDA	MP. ANDRES BELLO	PQ.SAN JOSE DE BARLOVENTO	ESCUELA CONCENTRADA NACIONAL S N	311	1	9	230	156	221	0	0	0	0	65	230
EDO. MIRANDA	MP. ANDRES BELLO	PQ.SAN JOSE DE BARLOVENTO	ESCUELA UNITARIA NUMERO  145
EDO. MIRANDA	MP. ANDRES BELLO	PQ.SAN JOSE DE BARLOVENTO	CONCENTRACIÓN ESTADAL S N EL DELIRIO	614	2	20	501	369	481	0	0	0	0	112	501
EDO. MIRANDA	MP. ANDRES BELLO	PQ.SAN JOSE DE BARLOVENTO	ESCUELA BOLIVARIANA SAN JOSÉ	1835	4	56	1407	854	1351	0	6	0	0	491	1407
EDO. MIRANDA	MP. ANDRES BELLO	PQ.SAN JOSE DE BARLOVENTO	ESCUELA FRAY JOSE ZAPICO	1712	3	30	1353	792	1323	0	6	1	1	523	1353
EDO. MIRANDA	MP. PEDRO GUAL	PQ. CUPIRA	ESCUELA  NACIONAL BOLIVARIANA BARTOLOME BLANDIN	2099	4	49	1656	959	1607	0	8	0	0	640	1656
EDO. MIRANDA	MP. PEDRO GUAL	PQ. CUPIRA	UNIDAD EDUCATIVA SAN JUAN
EDO. MIRANDA	MP. PEDRO GUAL	PQ. CUPIRA	CONCENTRACION ESTADAL RURAL SIN NUMERO GOLFO RICO	523	1	5	379	182	374	0	3	1	1	187	379
EDO. MIRANDA	MP. PEDRO GUAL	PQ. CUPIRA	CONCENTRACION ESTADAL SIN NUMERO ONOVA	794	2	22	606	253	584	0	7	0	1	323	606
EDO. MIRANDA	MP. PEDRO GUAL	PQ. CUPIRA	ESCUELA PALO BLANCO	903	2	27	681	396	654	2	7	0	0	249	681
EDO. MIRANDA	MP. PEDRO GUAL	PQ. CUPIRA	JARDÍN DE INFANCIA BOLIVARIANO CABO CODERA	246	1	2	191	108	189	0	0	0	0	81	191
EDO. MIRANDA	MP. PEDRO GUAL	PQ. CUPIRA	ESCUELA  ESTADAL DEL CASERIO BOCA DE CASUPO	381	1	0	291	209	291	0	0	0	0	82	291
EDO. MIRANDA	MP. PEDRO GUAL	PQ. CUPIRA	CONCENTRACION ESTADAL SIN NUMERO LA COLOMBINA	159	1	2	96	39	94	0	0	0	0	55	96
EDO. MIRANDA	MP. PEDRO GUAL	PQ. CUPIRA	ESCUELA BOLIVARIANA CALABAZA	741	2	16	573	360	557	0	3	1	0	193	573
EDO. MIRANDA	MP. PEDRO GUAL	PQ. CUPIRA	JARDIN DE INFANCIA COLINAS DE CUPIRA	176	1	4	153	105	149	1	1	0	0	42	153
EDO. MIRANDA	MP. PEDRO GUAL	PQ. CUPIRA	ESCUELA NER 131 PALO QUEMAO	382	1	13	280	176	267	0	3	0	0	88	280
EDO. MIRANDA	MP. PEDRO GUAL	PQ. CUPIRA	ESCUELA GRADUADA JUAN VICENTE GONZALEZ	2232	4	39	1649	1175	1610	0	10	1	1	423	1649
EDO. MIRANDA	MP. PEDRO GUAL	PQ. CUPIRA	ESCUELA NACIONAL BASICA CUPIRA	2429	5	65	1863	1076	1798	1	13	1	0	707	1863
EDO. MIRANDA	MP. PEDRO GUAL	PQ. CUPIRA	ESCUELA INTEGRAL BOLIVARIANA Nº 39 32 EL GUACUCO	618	2	12	491	335	479	1	1	0	0	142	491
EDO. MIRANDA	MP. PEDRO GUAL	PQ. CUPIRA	CONCENTRADA ESTADAL NUMERO 78	436	1	10	386	257	376	0	1	0	1	117	386
EDO. MIRANDA	MP. PEDRO GUAL	PQ. CUPIRA	INSTITUTO AUTONOMO CULTURA PEDRO GUAL	152	1	3	120	79	117	0	2	0	0	36	120
EDO. MIRANDA	MP. PEDRO GUAL	PQ. CUPIRA	LICEO BOLIVARIANO 8 DE DICIEMBRE	464	1	13	359	227	346	0	3	0	0	116	359
EDO. MIRANDA	MP. PEDRO GUAL	PQ. MACHURUCUTO	ESCUELA INTEGRAL BOLIVARIANA PEDRO GUAL	944	2	15	741	380	726	0	3	0	0	343	741
EDO. MIRANDA	MP. PAZ CASTILLO	PQ. SANTA LUCIA	CENTRO DE EDUCACION INICIAL GUAICAIPURO	396	1	4	336	275	332	0	1	0	0	56	336
EDO. MIRANDA	MP. PAZ CASTILLO	PQ. SANTA LUCIA	ESCUELA BASICA NACIONAL NINOS DE LA PATRIA	300	1	6	268	243	262	0	0	0	0	19	268
EDO. MIRANDA	MP. PAZ CASTILLO	PQ. SANTA LUCIA	UNIDAD EDUCATIVA ESTADAL CONCENTRACION ARENAZA	277	1	4	254	230	250	0	2	0	0	18	254
EDO. MIRANDA	MP. PAZ CASTILLO	PQ. SANTA LUCIA	ESCUELA BASICA BOLIVARIANA LA CALCETA	2322	4	54	1833	1260	1779	0	3	2	2	512	1833
EDO. MIRANDA	MP. PAZ CASTILLO	PQ. SANTA LUCIA	UNIDAD EDUCATIVA JOSE MANUEL DE LOS RIOS	2145	4	65	1792	1085	1727	0	8	0	3	631	1792
EDO. MIRANDA	MP. PAZ CASTILLO	PQ. SANTA LUCIA	CONCENTRACION SIN NUMERO LA FLORIDA	267	1	3	242	220	239	0	0	0	0	19	242
EDO. MIRANDA	MP. PAZ CASTILLO	PQ. SANTA LUCIA	UNIDAD EDUCATIVA ESTADAL XIOMARA DEL CARMEN MOLLETON	1292	3	37	1136	843	1099	0	9	1	2	244	1136
EDO. MIRANDA	MP. PAZ CASTILLO	PQ. SANTA LUCIA	ESCUELA BASICA ESTADAL EL ROSARIO	711	2	11	630	465	619	0	1	1	0	152	630
EDO. MIRANDA	MP. PAZ CASTILLO	PQ. SANTA LUCIA	ESCUELA BASICA GENARO GOMEZ	2888	5	46	2405	1860	2359	1	13	4	0	481	2405
EDO. MIRANDA	MP. PAZ CASTILLO	PQ. SANTA LUCIA	ESCUELA BASICA NACIONAL DOCTOR FCO. ESPEJO	3094	6	58	2409	1568	2351	0	6	0	1	776	2409
EDO. MIRANDA	MP. PAZ CASTILLO	PQ. SANTA LUCIA	UNIDAD EDUCATIVA PRIVADA PRINCIPE DE PAZ	599	1	10	510	382	500	0	3	0	0	115	510
EDO. MIRANDA	MP. PAZ CASTILLO	PQ. SANTA LUCIA	LICEO DOCTOR JOSE FRANCISCO TORREALBA	1439	3	16	1141	578	1125	2	10	0	2	533	1141
EDO. MIRANDA	MP. PAZ CASTILLO	PQ. SANTA LUCIA	UNIDAD EDUCATIVA BOLIVARIANA TERESA CARRENO	2298	4	34	1821	1435	1787	0	8	0	1	343	1821
EDO. MIRANDA	MP. PAZ CASTILLO	PQ. SANTA LUCIA	CENTRO DE EDUCACION INICIAL NACIONAL DOCTOR FRANCISCO ESPEJO	482	1	14	379	257	365	0	3	0	0	105	379
EDO. MIRANDA	MP. PAZ CASTILLO	PQ. SANTA LUCIA	NUCLEO ESCOLAR RURAL  225 CONCENTRADA ALICIA PIETRI DE CALDERA	774	2	9	660	521	651	0	2	0	0	128	660
EDO. MIRANDA	MP. PAZ CASTILLO	PQ. SANTA LUCIA	ESCUELA BASICA BOLIVARIANA POTRERITO	439	1	5	381	314	376	0	3	1	0	58	381
EDO. MIRANDA	MP. PAZ CASTILLO	PQ. SANTA LUCIA	ESCUELA TECNICA AGRICOLA NACIONAL SANTA RITA	269	1	2	224	201	222	0	1	0	0	20	224
EDO. MIRANDA	MP. PAZ CASTILLO	PQ. SANTA LUCIA	JARDIN DE INFANCIA MANGUITO 1	661	2	14	589	409	575	0	6	1	1	158	589
EDO. MIRANDA	MP. PAZ CASTILLO	PQ. SANTA LUCIA	UNIDAD EDUCATIVA ESTADO VARGAS	1816	4	23	1602	1254	1579	0	11	0	1	313	1602
EDO. MIRANDA	MP. PAZ CASTILLO	PQ. SANTA LUCIA	UNIDAD EDUCATIVA CENTRO PROFESIONAL SANTA LUCIA	1754	3	33	1410	872	1377	0	5	0	0	500	1410
EDO. MIRANDA	MP. PAZ CASTILLO	PQ. SANTA LUCIA	ESCUELA BASICA VENEZUELA	1222	3	23	1059	807	1036	0	12	0	1	216	1059
EDO. MIRANDA	MP. PAZ CASTILLO	PQ. SANTA LUCIA	CONCENTRACION ESCOLAR LOS GUAYABITOS	126	1	1	122	121	121	0	0	0	0	0	122
EDO. MIRANDA	MP. PAZ CASTILLO	PQ. SANTA LUCIA	UNIDAD EDUCATIVA NACIONAL BOLIVARIANA GUAICAIPURO	886	2	9	756	647	747	0	1	0	0	99	756
EDO. MIRANDA	MP. PAZ CASTILLO	PQ. SANTA LUCIA	ESCUELA BASICA CESAR ARMANDO CISNEROS	3519	7	35	2723	2362	2688	1	4	0	0	321	2723
EDO. MIRANDA	MP. PAZ CASTILLO	PQ. SANTA LUCIA	ESCUELA BASICA NACIONAL LA CEIBA DEL ALTO	7272	13	111	5909	4539	5798	3	36	2	4	1214	5909
EDO. MIRANDA	MP. PAZ CASTILLO	PQ. SANTA LUCIA	UNIDAD EDUCATIVA CREACION SOAPIRE	840	2	7	724	632	717	0	1	0	1	83	724
EDO. MIRANDA	MP. PAZ CASTILLO	PQ. SANTA LUCIA	UNIDAD EDUCATIVA ESTADAL EL LIMON	463	1	12	416	349	404	0	2	0	0	53	416
EDO. MIRANDA	MP. PAZ CASTILLO	PQ. SANTA LUCIA	UNIDAD EDUCATIVA ESTADAL FRANCISCO DE MIRANDA	2536	5	45	2062	1139	2017	1	7	2	2	866	2062
EDO. MIRANDA	MP. PAZ CASTILLO	PQ. SANTA LUCIA	UNIDAD EDUCATIVA ESTADAL LIA IMBER DE CORONIL	3893	7	75	3233	2358	3158	1	16	3	1	779	3233
EDO. MIRANDA	MP. PAZ CASTILLO	PQ. SANTA LUCIA	UNIDAD EDUCATIVA  JUANA TERESA HERRERA	1504	3	28	1310	715	1282	0	2	0	0	565	1310
EDO. MIRANDA	MP. PAZ CASTILLO	PQ. SANTA LUCIA	UNIDAD EDUCATIVA ESTADAL ROMULO GALLEGOS	857	2	11	700	526	689	0	5	1	0	157	700
EDO. MIRANDA	MP. PAZ CASTILLO	PQ. SANTA LUCIA	ESCUELA ESTADO YARACUY	1786	3	26	1313	972	1287	0	6	0	1	308	1313
EDO. MIRANDA	MP. PAZ CASTILLO	PQ. SANTA LUCIA	UNIDAD EDUCATIVA NACIONAL BOLIVARIANA CREACION NUEVA VIRGINIA	613	2	10	558	474	548	0	4	0	1	69	558
EDO. MIRANDA	MP. PAZ CASTILLO	PQ. SANTA LUCIA	ESCUELA BASICA RURAL SAN BENITO	407	1	20	363	291	343	0	1	0	1	50	363
EDO. MIRANDA	MP. PAZ CASTILLO	PQ. SANTA LUCIA	CONCENTRACION NACIONAL NO 6 LA MOCA	1000	2	28	770	642	742	0	2	0	0	98	770
EDO. MIRANDA	MP. PAZ CASTILLO	PQ. SANTA LUCIA	ESCUELA NACIONAL MANUEL PIAR	2651	5	48	2163	1747	2115	0	11	1	1	355	2163
EDO. MIRANDA	MP. PAZ CASTILLO	PQ. SANTA LUCIA	ESCUELA BASICA MANGUITO I	3469	6	59	2868	2089	2809	0	17	3	4	696	2868
EDO. MIRANDA	MP. PAZ CASTILLO	PQ. SANTA LUCIA	CASA MUNICIPAL DE LAS MISIONES	217	1	0	179	120	179	0	2	0	0	57	179
EDO. MIRANDA	MP. PAZ CASTILLO	PQ. SANTA LUCIA	ESCUELA RURAL NACIONAL BOLIVARIANA INES MARIA BOLIVAR	1213	3	41	994	677	953	0	2	2	0	272	994
EDO. MIRANDA	MP. PAZ CASTILLO	PQ. SANTA LUCIA	UNIDAD EDUCATIVA ESTADAL ESTADO MERIDA	3507	6	37	2741	2093	2704	2	5	4	3	597	2741
EDO. MIRANDA	MP. PAZ CASTILLO	PQ. SANTA LUCIA	UNIDAD EDUCATIVA ARMANDO ESCOBAR	895	2	4	732	665	728	2	3	1	0	57	732
EDO. MIRANDA	MP. CRISTOBAL ROJAS	PQ. CHARALLAVE	CENTRO DE FORMACION SOCIALISTA  EZEQUIEL ZAMORA	239	1	0	223	167	223	0	0	0	0	56	223
EDO. MIRANDA	MP. CRISTOBAL ROJAS	PQ. CHARALLAVE	UNIDAD EDUCATIVA ESTADAL CARMEN RUIZ	4099	8	72	3378	2237	3306	2	16	1	4	1046	3378
EDO. MIRANDA	MP. CRISTOBAL ROJAS	PQ. CHARALLAVE	UNIDAD EDUCATIVA ESTADAL CAUJARITO	3569	7	71	2889	2389	2818	1	16	2	3	407	2889
EDO. MIRANDA	MP. CRISTOBAL ROJAS	PQ. CHARALLAVE	UNIDAD EDUCATIVA NACIONAL CECILIO ACOSTA	5001	9	75	4375	3459	4300	2	19	2	2	816	4375
EDO. MIRANDA	MP. CRISTOBAL ROJAS	PQ. CHARALLAVE	ESCUELA BOLIVARIANA POLICARPO FARRERA	3781	7	62	3141	1566	3079	0	26	3	3	1481	3141
EDO. MIRANDA	MP. CRISTOBAL ROJAS	PQ. CHARALLAVE	PREESCOLAR JUAN ESPAÑA	212	1	8	184	130	176	0	0	0	0	46	184
EDO. MIRANDA	MP. CRISTOBAL ROJAS	PQ. CHARALLAVE	ESCUELA BASICA ESTADAL JABILLITO	3225	6	92	2617	2037	2525	1	9	2	2	474	2617
EDO. MIRANDA	MP. CRISTOBAL ROJAS	PQ. CHARALLAVE	INSTITUTO DE EDUCACION ESPECIAL VIRGEN DEL CARMEN	145	1	2	124	73	122	0	0	0	0	49	124
EDO. MIRANDA	MP. CRISTOBAL ROJAS	PQ. CHARALLAVE	UNIDAD EDUCATIVA PRIVADA NUESTRA SEÑORA DE LA COROMOTO	3531	7	89	3021	1369	2932	1	7	0	3	1552	3021
EDO. MIRANDA	MP. CRISTOBAL ROJAS	PQ. CHARALLAVE	UNIDAD EDUCATIVA ESTADAL BOLIVARIANA ARICHUNA	570	1	5	515	284	510	0	0	1	0	225	515
EDO. MIRANDA	MP. CRISTOBAL ROJAS	PQ. CHARALLAVE	UNIDAD EDUCATIVA PRIVADA COLEGIO SAGRADO CORAZON DE JESUS	4945	9	63	4205	1571	4142	2	24	0	2	2543	4205
EDO. MIRANDA	MP. CRISTOBAL ROJAS	PQ. CHARALLAVE	LICEO NOCTURNO FRANCISCO TOSTA GARCIA	39	1	1	34	19	33	1	1	0	0	12	34
EDO. MIRANDA	MP. CRISTOBAL ROJAS	PQ. CHARALLAVE	UNIDAD EDUCATIVA PRIVADA DOCTOR JOSE GREGORIO HERNANDEZ	3339	6	57	2786	1236	2729	0	5	1	2	1485	2786
EDO. MIRANDA	MP. CRISTOBAL ROJAS	PQ. CHARALLAVE	CONCENTRACION ESCOLAR SIN NUMERO LA CHIVERA	688	2	8	566	390	558	0	2	2	0	164	566
EDO. MIRANDA	MP. CRISTOBAL ROJAS	PQ. CHARALLAVE	UNIDAD EDUCATIVA NACIONAL EXTENCION TERESA DE BOLIVAR	485	1	7	410	218	403	0	2	0	0	183	410
EDO. MIRANDA	MP. CRISTOBAL ROJAS	PQ. CHARALLAVE	ESCUELA BOLIVARIANA DOCTOR CARLOS AROCHA LUNA	1137	2	23	1028	691	1005	0	3	0	1	310	1028
EDO. MIRANDA	MP. CRISTOBAL ROJAS	PQ. CHARALLAVE	UNIVERSIDAD NACIONAL EXPERIMENTAL ANTONIO JOSE DE SUCRE	984	2	24	902	570	878	0	3	0	0	305	902
EDO. MIRANDA	MP. CRISTOBAL ROJAS	PQ. CHARALLAVE	UNIDAD EDUCATIVA BOLIVARIANA MARIA TERESA DEL TORO	639	2	9	506	414	497	0	3	2	0	78	506
EDO. MIRANDA	MP. CRISTOBAL ROJAS	PQ. CHARALLAVE	CENTRO DE EDUCACION INICIAL ALI PRIMERA	365	1	6	317	249	311	0	1	0	0	61	317
EDO. MIRANDA	MP. CRISTOBAL ROJAS	PQ. CHARALLAVE	CENTRO DE  EDUCACION INICIAL ESTE NIÑO DON SIMON	2971	6	32	2668	1339	2636	1	9	1	2	1284	2668
EDO. MIRANDA	MP. CRISTOBAL ROJAS	PQ. CHARALLAVE	COMPLEJO EDUCATIVO NACIONAL JUAN ESPANA	3853	7	82	3104	2257	3022	1	17	1	1	745	3104
EDO. MIRANDA	MP. CRISTOBAL ROJAS	PQ. CHARALLAVE	DESARROLLO URBANISTICO CHARALLAVE NORTE	64	1	2	51	47	49	0	0	0	1	1	51
EDO. MIRANDA	MP. CRISTOBAL ROJAS	PQ. CHARALLAVE	UNIDAD EDUCATIVA ESTADAL TEOTISTA AROCHA DE GALLEGOS	1204	3	36	1027	755	991	0	7	0	3	226	1027
EDO. MIRANDA	MP. CRISTOBAL ROJAS	PQ. CHARALLAVE	UNIDAD EDUCATIVA PRIVADA SAGRADO CORAZON DE JESUS	2509	5	40	2111	998	2071	0	5	1	3	1064	2111
EDO. MIRANDA	MP. CRISTOBAL ROJAS	PQ. CHARALLAVE	CENTRO DE EDUCACION INICIAL JARDIN DE INFANCIA JABILLITO	649	2	27	538	418	511	0	1	0	0	92	538
EDO. MIRANDA	MP. CRISTOBAL ROJAS	PQ. CHARALLAVE	ESCUELA PITAHAYA	3923	7	60	3254	2250	3194	0	12	1	2	929	3254
EDO. MIRANDA	MP. CRISTOBAL ROJAS	PQ. CHARALLAVE	JARDIN DE INFANCIA CHARALLAVE	369	1	4	332	192	328	0	4	0	1	131	332
EDO. MIRANDA	MP. CRISTOBAL ROJAS	PQ. CHARALLAVE	COMPLEJO EDUCATIVO ESTADAL JUAN GERMAN ROSCIO	3042	6	62	2428	1875	2366	2	17	0	2	470	2428
EDO. MIRANDA	MP. CRISTOBAL ROJAS	PQ. CHARALLAVE	UNIDAD EDUCATIVA NACIONAL FRANCISCO TOSTA GARCIA	425	1	6	381	181	375	0	1	0	1	192	381
EDO. MIRANDA	MP. CRISTOBAL ROJAS	PQ. CHARALLAVE	GRUPO ESCOLAR TERESA DE BOLIVAR	3070	6	55	2546	1258	2491	2	12	2	1	1216	2546
EDO. MIRANDA	MP. CRISTOBAL ROJAS	PQ. CHARALLAVE	UNIDAD EDUCATIVA ESTADAL DIVIDIVI	1766	3	73	1488	1185	1415	0	7	2	0	221	1488
EDO. MIRANDA	MP. CRISTOBAL ROJAS	PQ. CHARALLAVE	ESCUELA BASICA ESTADAL CHARALLAVE	2399	5	68	2014	1579	1946	0	7	0	3	357	2014
EDO. MIRANDA	MP. CRISTOBAL ROJAS	PQ. CHARALLAVE	UNNIDAD EDUCATIVA NACIONAL BOLIVARIANA CREACION CHARALLAVE	4581	8	92	3961	2139	3869	1	26	1	6	1696	3961
EDO. MIRANDA	MP. CRISTOBAL ROJAS	PQ. LAS BRISAS	COMPLEJO EDUCATIVO ANDRES ELOY BLANCO	975	2	16	816	603	800	1	2	0	1	193	816
EDO. MIRANDA	MP. CRISTOBAL ROJAS	PQ. LAS BRISAS	CONCETRACION ESCOLAR RURAL SABANETA	829	2	14	653	292	639	0	3	0	1	343	653
EDO. MIRANDA	MP. CRISTOBAL ROJAS	PQ. LAS BRISAS	UNIDAD EDUCATIVA ESTADAL BOLIVARIANA TERESA DE LA PARRA	345	1	16	305	189	289	0	0	1	1	98	305
EDO. MIRANDA	MP. CRISTOBAL ROJAS	PQ. LAS BRISAS	UNIDAD EDUCATIVA ESPECIAL DE DEFICIENCIA AUDITIVA TURPIALITO	343	1	3	268	205	265	0	0	0	0	60	268
EDO. MIRANDA	MP. CRISTOBAL ROJAS	PQ. LAS BRISAS	UNIDAD EDUCATIVA ESTADAL LUIS D' ZUSE NAVARRO	1680	3	36	1376	1052	1340	0	7	1	1	279	1376
EDO. MIRANDA	MP. CRISTOBAL ROJAS	PQ. LAS BRISAS	UNIDAD EDUCATIVA ESTADAL  ANDRES ELOY BLANCO	3557	7	74	2749	1717	2675	3	15	1	4	935	2749
EDO. MIRANDA	MP. CRISTOBAL ROJAS	PQ. LAS BRISAS	UNIDAD EDUCATIVA ESTADAL LUISA CACERES DE ARISMENDI	713	2	26	553	419	527	0	5	0	2	101	553
EDO. MIRANDA	MP. CRISTOBAL ROJAS	PQ. LAS BRISAS	UNIDAD EDUCATIVA ESTADAL CRISTOBAL ROJAS	2226	4	62	1770	1384	1708	1	9	3	0	311	1770
EDO. MIRANDA	MP. CARRIZAL	PQ. CARRIZAL	UNIDAD EDUCATIVA NACIONAL ANEXO ANDRES BELLO	354	1	5	283	168	278	0	1	0	0	109	283
EDO. MIRANDA	MP. CARRIZAL	PQ. CARRIZAL	CENTRO DE EDUCACIÓN INICIAL MONTAÑA ALTA	3735	7	30	3223	820	3193	0	9	1	6	2357	3223
EDO. MIRANDA	MP. CARRIZAL	PQ. CARRIZAL	UNIDAD ESCOLAR ESTADAL SIMON BOLIVAR	251	1	8	218	122	210	0	0	0	0	88	218
EDO. MIRANDA	MP. CARRIZAL	PQ. CARRIZAL	ESCUELA BÁSICA TERRITORIO FEDERAL DELTA AMACURO	1701	3	21	1429	717	1408	0	5	0	1	685	1429
EDO. MIRANDA	MP. CARRIZAL	PQ. CARRIZAL	UNIDAD EDUCATIVA NACIONAL ANDRÉS BELLO	3278	6	81	2695	1761	2614	1	7	1	0	844	2695
EDO. MIRANDA	MP. CARRIZAL	PQ. CARRIZAL	UNIDAD EDUCATIVA COLEGIO JESUS ADOLECENTE	1270	3	20	1120	733	1100	0	5	0	0	362	1120
EDO. MIRANDA	MP. CARRIZAL	PQ. CARRIZAL	UNIDAD EDUCATIVA PRIVADA THOMAS DE JESUS QUINTERO	390	1	6	363	117	357	0	0	0	1	239	363
EDO. MIRANDA	MP. CARRIZAL	PQ. CARRIZAL	CENTRO DE EDUCACION INICIAL SIMONCITO CACIQUE EPOIMA	262	1	5	228	154	223	0	2	0	0	67	228
EDO. MIRANDA	MP. CARRIZAL	PQ. CARRIZAL	INSTITUTO MADRE ISABEL	2021	4	25	1631	427	1606	1	3	0	6	1169	1631
EDO. MIRANDA	MP. CARRIZAL	PQ. CARRIZAL	PRE ESCOLAR MARTHA DE CALECA	474	1	9	440	271	431	0	2	1	0	157	440
EDO. MIRANDA	MP. CARRIZAL	PQ. CARRIZAL	CICLO BASICO CARLOS GAUNA	3802	7	38	3238	910	3200	0	1	1	4	2284	3238
EDO. MIRANDA	MP. CARRIZAL	PQ. CARRIZAL	UNIDAD  EDUCATIVA NACIONAL JOSE  MANUEL ALVAREZ	3325	6	73	2669	1165	2596	2	12	4	2	1411	2669
EDO. MIRANDA	MP. CARRIZAL	PQ. CARRIZAL	UNIDAD EDUCATIVA COLEGIO VALLE ALTO	1393	3	8	1283	244	1275	0	1	0	5	1025	1283
EDO. MIRANDA	MP. CARRIZAL	PQ. CARRIZAL	UNIDAD EDUCATIVA PRIVADA VIRGEN DE LA CONSAGRACIÓN	3530	6	54	2814	1118	2760	3	12	4	5	1618	2814
EDO. MIRANDA	MP. CARRIZAL	PQ. CARRIZAL	UNIDAD EDUCATIVA VICTOR PADILLA	4185	8	70	3563	1670	3493	0	10	2	1	1810	3563
EDO. MIRANDA	MP. CARRIZAL	PQ. CARRIZAL	LICEO MANUEL MARIA VILLALOBOS	2568	5	33	2061	1080	2028	1	8	6	3	930	2061
EDO. MIRANDA	MP. CARRIZAL	PQ. CARRIZAL	ESCUELA TECNICA AGROPECUARIA CARRIZAL	222	1	10	186	119	176	0	0	0	0	57	186
EDO. MIRANDA	MP. CARRIZAL	PQ. CARRIZAL	UNIDAD EDUCATIVA ESTADAL FRANCISCO DE MIRANDA	3115	6	33	2538	1222	2505	0	23	1	5	1254	2538
EDO. MIRANDA	MP. CHACAO	PQ. CHACAO	GIMNASIO VERTICAL	668	2	11	572	310	561	0	2	2	0	247	572
EDO. MIRANDA	MP. CHACAO	PQ. CHACAO	CENTRO DEPORTIVO EUGENIO MENDOZA	204	1	5	186	41	181	0	0	0	0	140	186
EDO. MIRANDA	MP. CHACAO	PQ. CHACAO	ESCUELA BASICA FERNANDO PEÑALVER	1742	3	20	1252	302	1232	0	1	1	0	928	1252
EDO. MIRANDA	MP. CHACAO	PQ. CHACAO	UNIDAD EDUCATIVA COLEGIO BASICA MUNICIPAL CARLOS SOUBLETTE	1335	3	42	1020	338	978	1	4	2	3	630	1020
EDO. MIRANDA	MP. CHACAO	PQ. CHACAO	CENTRO MEDICO CARLOS DIEZ DEL INSTITUTO VENEZOLANO DE SEGURO SOCIAL CHACAO	295	1	8	253	141	245	0	2	0	1	101	253
EDO. MIRANDA	MP. CHACAO	PQ. CHACAO	UNIDAD EDUCATIVA POPULAR COLEGIO EL ALBA	2194	4	19	1602	188	1583	1	4	0	0	1390	1602
EDO. MIRANDA	MP. CHACAO	PQ. CHACAO	UNIDAD EDUCATIVA COLEGIO PARROQUIAL SAGRADO CORAZON DE JESUS	734	2	10	651	147	641	0	2	1	0	491	651
EDO. MIRANDA	MP. CHACAO	PQ. CHACAO	UNIDAD EDUCATIVA POPULAR SANTO TOMAS DE AQUINO	2038	4	14	1691	143	1677	0	3	1	1	1529	1691
EDO. MIRANDA	MP. CHACAO	PQ. CHACAO	INSTITUTO UNIVERSITARIO NUEVAS PROFESIONES	5322	10	37	3687	568	3650	1	8	6	7	3060	3687
EDO. MIRANDA	MP. CHACAO	PQ. CHACAO	INSTITUTO EINSTEIN	3409	6	19	2530	430	2511	2	2	0	3	2074	2530
EDO. MIRANDA	MP. CHACAO	PQ. CHACAO	UNIDAD EDUCATIVA  POPULAR COLEGIO SAN IGNACIO DE LOYOLA	5517	10	40	4221	415	4181	0	8	1	3	3754	4221
EDO. MIRANDA	MP. CHACAO	PQ. CHACAO	INSTITUTO EDUCACIONAL LANDER	951	2	11	700	160	689	0	3	0	0	526	700
EDO. MIRANDA	MP. CHACAO	PQ. CHACAO	UNIDAD EDUCATIVA MUNICIPAL ANDRES BELLO	7899	15	70	5975	1244	5905	0	16	2	4	4639	5975
EDO. MIRANDA	MP. CHACAO	PQ. CHACAO	UNIDAD EDUCATIVA  POPULAR  COLEGIO NUESTRA SEÑORA DE FATIMA	3076	6	28	2353	742	2325	0	7	1	0	1575	2353
EDO. MIRANDA	MP. CHACAO	PQ. CHACAO	UNIDAD EDUCATIVA POPULAR COLEGIO MAS LUZ	3663	7	26	2716	709	2690	1	9	4	1	1966	2716
EDO. MIRANDA	MP. CHACAO	PQ. CHACAO	UNIDAD EDUCATIVA POPULAR CRISTO REY	3141	6	18	2193	137	2175	0	3	1	0	2034	2193
EDO. MIRANDA	MP. CHACAO	PQ. CHACAO	UNIDAD EDUCATIVA GUSTAVO HERRERA	5204	9	75	3508	1145	3433	0	16	0	1	2271	3508
EDO. MIRANDA	MP. CHACAO	PQ. CHACAO	COLEGIO UNIVERSITARIO  MONSEÑOR DE TALAVERA	1230	3	10	824	93	814	1	3	1	1	715	824
EDO. MIRANDA	MP. CHACAO	PQ. CHACAO	UNIDAD EDUCATIVA POPULAR COLEGIO DON BOSCO	3813	7	19	2645	315	2626	0	3	1	1	2306	2645
EDO. MIRANDA	MP. CHACAO	PQ. CHACAO	JARDIN DE INFANCIA EL LIBERTADOR.	1246	3	13	969	263	956	0	2	1	0	690	969
EDO. MIRANDA	MP. CHACAO	PQ. CHACAO	UNIDAD EDUCATIVA POPULAR SAN FRANCISCO DE ASIS	1921	4	12	1363	150	1351	0	2	0	2	1197	1363
EDO. MIRANDA	MP. CHACAO	PQ. CHACAO	UNIVERSIDAD  JOSE MARIA VARGAS	735	2	5	496	110	491	1	3	0	0	377	496
EDO. MIRANDA	MP. CHACAO	PQ. CHACAO	COLEGIO SANTO DOMINGO DE GUZMAN	2631	5	14	1976	198	1962	0	2	0	2	1760	1976
EDO. MIRANDA	MP. CHACAO	PQ. CHACAO	UNIDAD EDUCATIVA BASICA MUNICIPAL JUAN DE DIOS GUANCHE	2688	5	45	2209	589	2164	0	4	0	2	1569	2209
EDO. MIRANDA	MP. CHACAO	PQ. CHACAO	UNIDAD EDUCATIVA COLEGIO SANTIAGO DE LEON CARACAS	3140	6	19	2378	243	2359	2	0	0	0	2114	2378
EDO. MIRANDA	MP. CHACAO	PQ. CHACAO	UNIDAD EDUCATIVA EL LIBERTADOR	5086	9	43	3636	894	3593	1	7	1	3	2687	3636
EDO. MIRANDA	MP. CHACAO	PQ. CHACAO	COLEGIO SCHONTHAL	7133	13	47	5383	607	5336	2	6	0	3	4718	5383
EDO. MIRANDA	MP. CHACAO	PQ. CHACAO	UNIDAD EDUCATIVA POPULAR MARIA AUXILIADORA	4565	8	18	3088	288	3070	0	6	0	2	2774	3088
EDO. MIRANDA	MP. ZAMORA	PQ. BOLIVAR	NUCLEO ESCOLAR RURAL 020 ORUSA	251	1	0	228	222	228	0	0	0	0	6	228
EDO. MIRANDA	MP. ZAMORA	PQ. BOLIVAR	UNIDAD EDUCATIVA  JORGE ANTONIO RODRIGUEZ	112	1	5	84	62	79	0	0	0	0	17	84
EDO. MIRANDA	MP. ZAMORA	PQ. BOLIVAR	CONCENTRACION BOLIVARIANA RURAL REBENTON	197	1	4	177	142	173	0	0	1	0	30	177
EDO. MIRANDA	MP. ZAMORA	PQ. BOLIVAR	UNIDAD EDUCATIVA CONCENTRADA NUMERO 3619	607	2	7	430	348	423	0	2	0	1	72	430
EDO. MIRANDA	MP. ZAMORA	PQ. BOLIVAR	CONCENTRACION ESTADAL NUMERO 11	1662	3	23	1178	920	1155	1	3	0	1	230	1178
EDO. MIRANDA	MP. ZAMORA	PQ. BOLIVAR	ESCUELA ESTADAL LAS TEJERIAS	235	1	1	176	158	175	0	1	0	0	16	176
EDO. MIRANDA	MP. ZAMORA	PQ. BOLIVAR	ESCUELA BASICA ESTADAL CONCENTRADA MACANILLAR (NUCLEO ESCOLAR RURAL 030)	248	1	2	222	209	220	0	0	0	0	11	222
EDO. MIRANDA	MP. ZAMORA	PQ. BOLIVAR	UNIDAD EDUCATIVA  NACIONAL BOLIVARIANA ARAIRA	4708	9	78	3821	2104	3743	0	13	2	6	1618	3821
EDO. MIRANDA	MP. ZAMORA	PQ. BOLIVAR	COLEGIO DE EDUCACION INICIAL QUEBRADA SECA NUMERO 021	297	1	7	258	211	251	0	1	1	0	38	258
EDO. MIRANDA	MP. ZAMORA	PQ. BOLIVAR	UNIDAD EDUCATIVA BASICA SANTA ROSALIA	401	1	4	364	256	360	0	1	0	0	103	364
EDO. MIRANDA	MP. ZAMORA	PQ. BOLIVAR	UNIDAD EDUCATIVA 030 LA LUCHA	136	1	1	110	102	109	1	0	0	0	6	110
EDO. MIRANDA	MP. ZAMORA	PQ. BOLIVAR	ESCUELA CONCENTRADA SIN NUMERO	250	1	5	176	108	171	0	2	1	0	60	176
EDO. MIRANDA	MP. ZAMORA	PQ. BOLIVAR	UNIDAD EDUCATIVA NACIONAL BOLIVARIANA TERESA DE LA PARRA	1241	3	23	1037	720	1014	0	4	0	1	289	1037
EDO. MIRANDA	MP. ZAMORA	PQ. BOLIVAR	GRUPO ESCOLAR GUZMAN BLANCO	2710	5	42	2202	1617	2160	0	7	1	0	535	2202
EDO. MIRANDA	MP. ZAMORA	PQ. BOLIVAR	JOSEFINA GUTIERREZ DE RUIZ NUCLEO ESCOLAR RURAL 029	225	1	3	182	158	179	0	0	0	0	21	182
EDO. MIRANDA	MP. ZAMORA	PQ. BOLIVAR	LICEO BOLIVARIANO PAZ CASTILLO, EXTENSION LAS LUISAS	605	2	16	498	392	482	0	0	1	1	88	498
EDO. MIRANDA	MP. ZAMORA	PQ. GUATIRE	PEESCOLAR BOLIVARIANO	1957	4	43	1577	1275	1534	1	8	0	0	250	1577
EDO. MIRANDA	MP. ZAMORA	PQ. GUATIRE	UNIDAD EDUCATIVA MARIA TERESA TORO	1685	3	17	1559	871	1542	0	3	0	3	665	1559
EDO. MIRANDA	MP. ZAMORA	PQ. GUATIRE	ESCUELA EL INGENIO	5826	11	149	5185	2615	5036	0	11	2	5	2403	5185
EDO. MIRANDA	MP. ZAMORA	PQ. GUATIRE	CENTRO DE EDUCACION INICIAL PRIVADA SANTA CRUZ DE PACAIRIGUA	364	1	8	322	251	314	0	2	0	1	60	322
EDO. MIRANDA	MP. ZAMORA	PQ. GUATIRE	COLEGIO ROMULO BETANCOURT	6980	13	113	6092	2563	5979	2	20	1	5	3388	6092
EDO. MIRANDA	MP. ZAMORA	PQ. GUATIRE	PRE ESCOLAR UNIDAD EDUCATIVA MANUELITA SAENZ	4037	7	76	3636	1282	3560	1	11	1	2	2263	3636
EDO. MIRANDA	MP. ZAMORA	PQ. GUATIRE	COLEGIO PACARIGUA II	6805	12	62	6086	1959	6024	0	21	2	12	4030	6086
EDO. MIRANDA	MP. ZAMORA	PQ. GUATIRE	COLEGIO VILLA HEROICA	784	2	8	708	454	700	0	3	2	0	241	708
EDO. MIRANDA	MP. ZAMORA	PQ. GUATIRE	GRUPO ESCOLAR GUATIRE	3205	6	66	2633	1967	2567	0	19	0	0	581	2633
EDO. MIRANDA	MP. ZAMORA	PQ. GUATIRE	CASA PARROQUIAL DE GUATIRE	1443	3	28	1163	618	1135	1	8	1	3	504	1163
EDO. MIRANDA	MP. ZAMORA	PQ. GUATIRE	COLEGIO SAN JOSE	329	1	7	296	113	289	0	1	0	0	175	296
EDO. MIRANDA	MP. ZAMORA	PQ. GUATIRE	ESCUELA ESTADAL ESTADO MONAGAS	3358	6	78	2713	2044	2635	0	7	4	0	580	2713
EDO. MIRANDA	MP. ZAMORA	PQ. GUATIRE	ESCUELA NACIONAL EDUARDO CHURION	4409	8	63	3511	2768	3448	0	22	2	1	655	3511
EDO. MIRANDA	MP. ZAMORA	PQ. GUATIRE	INTERNADO JUDICIAL EL RODEO	1219	3	21	336	255	315	0	0	0	0	60	336
EDO. MIRANDA	MP. ZAMORA	PQ. GUATIRE	INSTITUTO DE CICLO BASICO JUAN JOSE ABREU	4810	9	98	3985	2259	3887	0	16	1	3	1608	3985
EDO. MIRANDA	MP. ZAMORA	PQ. GUATIRE	UNIDAD EDUCATIVA EZEQUIEL ZAMORA	713	2	12	652	511	640	0	5	2	1	121	652
EDO. MIRANDA	MP. ZAMORA	PQ. GUATIRE	GRUPO ESCOLAR RAMON ALFONZO BLANCO	2371	5	47	2049	1365	2002	1	10	2	1	623	2049
EDO. MIRANDA	MP. ZAMORA	PQ. GUATIRE	GRUPO ESCOLAR ELIAS CALIXTO POMPA	4066	8	85	3297	1614	3212	0	11	2	1	1584	3297
EDO. MIRANDA	MP. ZAMORA	PQ. GUATIRE	COLEGIO PACAIRIGUA	5888	11	81	5187	2000	5106	0	12	1	5	3088	5187
EDO. MIRANDA	MP. ZAMORA	PQ. GUATIRE	ESCUELA CONCENTRADA ESTADAL NUMERO 266 166	575	1	7	344	293	337	1	5	0	0	38	344
EDO. MIRANDA	MP. ZAMORA	PQ. GUATIRE	COMPLEJO EDUCATIVO ARTISTICO	954	2	23	780	363	757	0	2	1	0	391	780
EDO. MIRANDA	MP. ZAMORA	PQ. GUATIRE	UNIDAD EDUACATIVA BASICA LIGIA GOUBERNIER	1505	3	41	1399	743	1358	0	8	2	1	604	1399
EDO. MIRANDA	MP. ZAMORA	PQ. GUATIRE	UNIDAD EDUCATIVA NUESTRA SEÑORA DEL CAMINO	5657	10	58	5267	948	5209	0	7	1	7	4246	5267
EDO. MIRANDA	MP. ZAMORA	PQ. GUATIRE	UNIDAD EDUCATIVA PRIVADA BELAGUA	2728	5	54	2481	957	2427	0	5	0	4	1461	2481
EDO. MIRANDA	MP. ZAMORA	PQ. GUATIRE	CASA DE LA CULTURA SAN PEDRO	1162	2	22	999	673	977	0	4	2	1	297	999
EDO. MIRANDA	MP. ZAMORA	PQ. GUATIRE	CENTRO DE EDUCACION INICIAL  VICTORIA MACHADO DE PLAZA	361	1	6	322	260	316	0	0	1	0	55	322
EDO. MIRANDA	MP. ZAMORA	PQ. GUATIRE	UNIDAD EDUCATIVA ESTADAL EUGENIO P` DE BELLARD	5655	10	121	4674	3391	4553	2	27	4	2	1127	4674
EDO. MIRANDA	MP. ZAMORA	PQ. GUATIRE	UNIDAD EDUCATIVA BASICA PRE ESCOLAR ARTURO MICHELENA	541	1	16	485	433	469	0	0	1	0	35	485
EDO. MIRANDA	MP. ZAMORA	PQ. GUATIRE	LICEO VICENTE EMILIO SOJO	2529	5	36	2249	1168	2213	0	7	0	2	1036	2249
EDO. MIRANDA	MP. ZAMORA	PQ. GUATIRE	ESCUELA ESTADAL SANTA MARIA GORETTI	8605	16	103	7391	2599	7288	1	30	3	6	4649	7391
EDO. MIRANDA	MP. ZAMORA	PQ. GUATIRE	INTERNADO JUDICIAL EL RODEO II	82	1	0	37	32	37	0	0	0	0	5	37
EDO. MIRANDA	MP. ZAMORA	PQ. GUATIRE	UNIDAD EDUCATIVA PRIVADA  CIUDAD FAJARDO DE GUATIRE	139	1	1	125	61	124	0	0	0	1	62	125
EDO. MIRANDA	MP. ZAMORA	PQ. GUATIRE	ESCUELA ESTADAL  VICENTE EMILIO SOJO	1321	3	38	1060	795	1022	0	3	0	3	221	1060
EDO. MIRANDA	MP. ZAMORA	PQ. GUATIRE	CAPILLA NUESTRA SEÑORA DEL CARMEN	485	1	5	412	364	407	0	2	1	0	40	412
EDO. MIRANDA	MP. ZAMORA	PQ. GUATIRE	LICEO JOSE FRANCISCO BERMUDEZ	2954	6	95	2425	1895	2330	0	7	0	0	428	2425
EDO. MIRANDA	MP. ZAMORA	PQ. GUATIRE	CASA SINDICAL LUIS MORENO	667	2	10	598	367	588	0	4	0	0	217	598
EDO. MIRANDA	MP. ZAMORA	PQ. GUATIRE	ESCUELA BASICA PRIVADA  SAN VICENTE DE PAUL	189	1	4	166	108	162	0	0	0	0	54	166
EDO. MIRANDA	MP. ZAMORA	PQ. GUATIRE	COLEGIO SAN MARTIN DE PORRES	3971	7	38	3442	979	3404	0	11	1	3	2410	3442
EDO. MIRANDA	MP. ZAMORA	PQ. GUATIRE	UNIVERSIDAD NACIONAL EXPERIMENTAL DE LA FUERZA ARMADA NACIONAL  UNEFA	1173	2	26	1073	921	1047	0	1	1	0	124	1073
EDO. MIRANDA	MP. ZAMORA	PQ. GUATIRE	SERVICIO DE PROTECCIÒN INTEGRAL A LA NIÑEZ Y ADOLESCENCIA	944	2	19	824	558	805	0	3	0	0	244	824
EDO. MIRANDA	MP. ZAMORA	PQ. GUATIRE	CONCENTRACION ESTADAL SIN NUMERO ARENALES	1221	3	26	1003	802	977	1	5	0	0	169	1003
EDO. MIRANDA	MP. BRION	PQ. HIGUEROTE	UNIDAD EDUCATIVA ESTADAL INDALECIA MEJIA GARCIA	550	1	10	444	321	434	0	2	0	0	111	444
EDO. MIRANDA	MP. BRION	PQ. HIGUEROTE	UNIDAD EDUCATIVA NUMERO 3 DE JUNIO	524	1	6	464	332	458	1	2	1	0	122	464
EDO. MIRANDA	MP. BRION	PQ. HIGUEROTE	ESCUELA NACIONAL BOLIVARIANA CHIRIMENA	829	2	24	669	401	645	0	5	0	0	239	669
EDO. MIRANDA	MP. BRION	PQ. HIGUEROTE	ESCUELA BASICA CARMEN HELENA SOTO DE TERAN	2233	4	67	1787	1155	1720	0	8	0	2	555	1787
EDO. MIRANDA	MP. BRION	PQ. HIGUEROTE	ESCUELA EL CARMEN GUEDEZ GOPAR	2047	4	40	1643	883	1603	0	6	1	0	713	1643
EDO. MIRANDA	MP. BRION	PQ. HIGUEROTE	UNIDAD EDUCATIVA NUESTRA SEÑORA DEL CARMEN	800	2	9	650	335	641	1	2	1	0	302	650
EDO. MIRANDA	MP. BRION	PQ. HIGUEROTE	ESCUELA BASICA GABRIEL EMILIO MUÑOZ	5009	9	126	4034	2078	3908	0	18	5	1	1806	4034
EDO. MIRANDA	MP. BRION	PQ. HIGUEROTE	CONCENTRACIÓN NACIONAL BOLIVARIANA NUMEROº 19	529	1	4	432	262	428	0	0	0	0	166	432
EDO. MIRANDA	MP. BRION	PQ. HIGUEROTE	UNIDAD EDUCATIVA FERMIN TORO	1697	3	30	1382	826	1352	1	6	0	2	517	1382
EDO. MIRANDA	MP. BRION	PQ. HIGUEROTE	CONCENTRACION ESCOLAR NUMERO 34	382	1	2	280	164	278	0	2	1	1	110	280
EDO. MIRANDA	MP. BRION	PQ. HIGUEROTE	UNIDAD EDUCATIVA AREVALO GONZALEZ	4037	7	106	3242	1686	3136	1	12	1	3	1433	3242
EDO. MIRANDA	MP. BRION	PQ. HIGUEROTE	UNIDAD EDUCATIVA ESTADAL MESA GRANDE	512	1	18	432	294	414	0	1	0	2	117	432
EDO. MIRANDA	MP. BRION	PQ. HIGUEROTE	CENTRO DE EDUCACION INICIAL GABRIEL EMILIO MUÑOZ	1081	2	34	897	511	863	0	4	1	0	347	897
EDO. MIRANDA	MP. BRION	PQ. HIGUEROTE	UNIVERSIDAD PEDAGOGICA ARGELIA LAYA	866	2	27	735	390	708	0	6	1	0	311	735
EDO. MIRANDA	MP. BRION	PQ. CURIEPE	UNIDAD EDUCATIVA JUAN PABLO SOJO	2461	5	52	1926	1223	1874	0	6	3	1	641	1926
EDO. MIRANDA	MP. BRION	PQ. CURIEPE	ESCUELA GRADUADA ESTADO TRUJILLO	885	2	15	676	382	661	1	7	0	1	270	676
EDO. MIRANDA	MP. BRION	PQ. CURIEPE	ESCUELA CONCENTRACION SIN NUMERO	247	1	7	187	135	180	0	0	0	0	45	187
EDO. MIRANDA	MP. BRION	PQ. CURIEPE	PRE ESCOLAR JARDIN DE INFANCIA SIXTO DOMINGO LOPEZ	1934	4	50	1619	1120	1569	0	10	2	1	436	1619
EDO. MIRANDA	MP. BRION	PQ. CURIEPE	LICEO NACIONAL PEDRO MARIA JOSE	1436	3	20	1130	918	1110	0	3	0	0	189	1130
EDO. MIRANDA	MP. BRION	PQ. CURIEPE	ESCUELA BASICA MORON	681	2	16	552	419	536	0	1	0	0	116	552
EDO. MIRANDA	MP. BRION	PQ. CURIEPE	ESCUELA ESTADAL BOLIVARIANA TACARIGUITA	641	2	15	503	318	488	1	0	1	0	168	503
EDO. MIRANDA	MP. BRION	PQ. TACARIGUA	UNIDAD EDUCATIVA GAMELOTAL	1064	2	28	857	561	829	0	7	0	2	259	857
EDO. MIRANDA	MP. BRION	PQ. TACARIGUA	ESCUELA BOLIVARIANA LA FUNDACIÓN	614	2	20	490	299	470	0	1	0	1	169	490
EDO. MIRANDA	MP. BRION	PQ. TACARIGUA	CENTRO TECNOLOGICO LA ARBOLEDA	339	1	19	301	212	282	0	1	0	0	69	301
EDO. MIRANDA	MP. BRION	PQ. TACARIGUA	ESCUELA BOLIVARIANA ESTILITO DIAZ APONTE	661	2	18	542	331	524	0	5	0	0	188	542
EDO. MIRANDA	MP. BRION	PQ. TACARIGUA	BIBLIOTECA LAS CORALIAS	357	1	5	313	253	308	0	1	0	0	54	313
EDO. MIRANDA	MP. BRION	PQ. TACARIGUA	ESCUELA BOLIVARIANA LAS GONZÁLEZ	648	2	25	545	303	520	0	4	0	0	213	545
EDO. MIRANDA	MP. BRION	PQ. TACARIGUA	ESCUELA BOLIVARIANA LAS MARTINEZ	1019	2	22	844	543	822	0	3	0	0	276	844
EDO. MIRANDA	MP. BRION	PQ. TACARIGUA	UNIDAD EDUCATIVA ESTADAL MATURIN	567	1	5	500	397	495	0	2	1	0	95	500
EDO. MIRANDA	MP. BRION	PQ. TACARIGUA	UNIDAD EDUCATIVA BARLOVENTO	4158	8	46	3276	1784	3230	0	18	1	5	1422	3276
EDO. MIRANDA	MP. URDANETA	PQ. NUEVA CUA	UNIDAD EDUCATIVA NACIONAL EXTENSION RAFAEL RAFAEL RANGEL	483	1	7	419	336	412	0	3	0	0	73	419
EDO. MIRANDA	MP. URDANETA	PQ. NUEVA CUA	CONCENTRACION ESCOLAR ESTADAL SIN NUMERO ANIAGUA NUCLEO ESCOLAR RURAL 127	404	1	8	274	217	266	0	2	0	0	47	274
EDO. MIRANDA	MP. URDANETA	PQ. NUEVA CUA	ESCUELA BASICA ESTADAL NUEVA CUA	342	1	5	277	236	272	0	1	0	0	35	277
EDO. MIRANDA	MP. URDANETA	PQ. NUEVA CUA	ESCUELA BASICA CREACION CUA	3967	7	71	3382	2390	3311	3	18	0	3	897	3382
EDO. MIRANDA	MP. URDANETA	PQ. NUEVA CUA	UNIDAD EDUCATIVA RURAL BOLIVARIANA QUEBRADA HONDA	1169	2	36	884	665	848	0	6	1	0	176	884
EDO. MIRANDA	MP. URDANETA	PQ. NUEVA CUA	CONCENTRACION ESTADAL SIN NUMERO LOS ROSOS	654	2	9	497	370	488	0	1	1	0	116	497
EDO. MIRANDA	MP. URDANETA	PQ. NUEVA CUA	ESCUELA BASICA NACIONAL NUEVA CUA	3069	6	76	2507	1883	2431	1	10	1	2	534	2507
EDO. MIRANDA	MP. URDANETA	PQ. NUEVA CUA	ESCUELA BASICA ESTADAL BOLIVARIANA LA PROVIDENCIA	589	1	15	422	346	407	0	4	1	0	56	422
EDO. MIRANDA	MP. URDANETA	PQ. NUEVA CUA	ESCUELA BASICA BOLIVARIANA JOSE LEONARDO CHIRINOS	2206	4	35	1855	1366	1820	0	7	0	0	447	1855
EDO. MIRANDA	MP. URDANETA	PQ. NUEVA CUA	CASA DE LA CULTURA	971	2	13	792	605	779	1	6	2	1	164	792
EDO. MIRANDA	MP. URDANETA	PQ. NUEVA CUA	SIMONCITO COMUNITARIO SIMON BOLIVAR	108	1	3	78	63	75	0	0	0	0	12	78
EDO. MIRANDA	MP. URDANETA	PQ. NUEVA CUA	CONCENTRACION ESCOLAR ESTADAL SIN NUMERO LA PALMA	68	1	4	63	58	59	0	0	0	0	1	63
EDO. MIRANDA	MP. URDANETA	PQ. NUEVA CUA	CONCENTRACION ESTADAL SUTIL	142	1	5	128	105	123	0	0	0	0	18	128
EDO. MIRANDA	MP. URDANETA	PQ. NUEVA CUA	UNIDAD EDUCATIVA ESTADAL ANDRES BELLO	1614	3	38	1372	978	1334	2	6	2	3	343	1372
EDO. MIRANDA	MP. URDANETA	PQ. NUEVA CUA	UNIDAD EDUCATIVA ESTADAL LA GUADALUPE	807	2	16	668	517	652	0	3	1	0	131	668
EDO. MIRANDA	MP. URDANETA	PQ. NUEVA CUA	UNIDAD EDUCATIVA ESTADAL BOLIVARIANA SAN JUAN BAUTISTA	371	1	9	328	263	319	0	3	1	0	52	328
EDO. MIRANDA	MP. URDANETA	PQ. NUEVA CUA	UNIDAD EDUCATIVA ESTADAL JOSE GIL FORTOUL	1111	2	17	911	723	894	1	2	1	0	167	911
EDO. MIRANDA	MP. URDANETA	PQ. NUEVA CUA	CONCENTRACION ESCOLAR NUMERO 110 CAMPO VERDE	211	1	3	173	137	170	1	2	0	0	30	173
EDO. MIRANDA	MP. URDANETA	PQ. NUEVA CUA	CONCENTRACION ESCOLAR ESTADAL SIN NUMERO PALMIRA	167	1	0	129	78	129	0	2	0	0	49	129
EDO. MIRANDA	MP. URDANETA	PQ. NUEVA CUA	CONCENTRACION ESCOLAR ESTADAL BOLIVARIANA LOS CHAGUARAMOS	242	1	10	215	169	205	0	1	0	0	35	215
EDO. MIRANDA	MP. URDANETA	PQ. NUEVA CUA	ESCUELA NACIONAL BOLIVARIANA MANUELITA SAENZ	1237	3	23	915	698	892	1	4	1	1	187	915
EDO. MIRANDA	MP. URDANETA	PQ. NUEVA CUA	CONCENTRACION ESCOLAR SIN NUMERO AGUA AMARILLA DEL NER 27	274	1	4	211	175	207	0	3	0	0	29	211
EDO. MIRANDA	MP. URDANETA	PQ. NUEVA CUA	UNIDAD EDUCATIVA NACIONAL RAFAEL RANGEL	2520	5	54	1995	1479	1941	1	4	1	0	456	1995
EDO. MIRANDA	MP. URDANETA	PQ. NUEVA CUA	UNIDAD EDUCATIVA NACIONAL 12  DE OCTUBRE	352	1	9	258	215	249	0	0	0	0	34	258
EDO. MIRANDA	MP. URDANETA	PQ. NUEVA CUA	UNIVERSIDAD SISO MARTINEZ	2596	5	32	2147	1638	2115	3	14	0	2	458	2147
EDO. MIRANDA	MP. URDANETA	PQ. CUA	UNIDAD EDUCATIVA NACIONAL BOLIVARINA EZEQUIEL ZAMORA	3748	7	61	3107	2115	3046	1	21	2	4	903	3107
EDO. MIRANDA	MP. URDANETA	PQ. CUA	CENTRO DE EDUCACION INICIAL FELIPA TORO	383	1	6	337	223	331	0	1	2	0	105	337
EDO. MIRANDA	MP. URDANETA	PQ. CUA	ESCUELA BASICA NACIONAL CRISTOBAL ROJAS	3630	7	66	2976	1605	2910	0	5	3	1	1296	2976
EDO. MIRANDA	MP. URDANETA	PQ. CUA	UNIDAD ESTADAL MINISTERIO DE AGRICULTURA Y TIERRA	609	2	5	531	280	526	0	1	1	2	242	531
EDO. MIRANDA	MP. URDANETA	PQ. CUA	CONCENTRACION ESCOLAR ESTADAL SIN NUMERO SACUA	222	1	7	129	105	122	0	0	0	0	17	129
EDO. MIRANDA	MP. URDANETA	PQ. CUA	ESCUELA NACIONAL LESBIA PLATERS	3940	7	77	3316	2032	3239	2	23	3	2	1177	3316
EDO. MIRANDA	MP. URDANETA	PQ. CUA	UNIDAD EDUCATIVA NACIONAL VICENTE LECUNA	568	1	6	506	403	500	0	0	0	1	96	506
EDO. MIRANDA	MP. URDANETA	PQ. CUA	UNIDAD EDUCATIVA NACIONAL BOLIVARIANA LIBERTADOR SIMON BOLIVAR	1986	4	22	1630	1115	1608	1	7	1	1	483	1630
EDO. MIRANDA	MP. URDANETA	PQ. CUA	ESCUELA ESTADAL CONSUELO HERNANDEZ	4761	9	127	3852	2312	3725	1	15	2	2	1393	3852
EDO. MIRANDA	MP. URDANETA	PQ. CUA	ESCUELA BASICA ESTADAL CREACION BICENTENARIA	1693	3	46	1408	1199	1362	1	3	0	1	158	1408
EDO. MIRANDA	MP. URDANETA	PQ. CUA	UNIDAD EDUCATIVA NACIONAL RAFAEL URDANETA EXTENCION ATENEO	3253	6	64	2719	1264	2655	1	18	3	6	1363	2719
EDO. MIRANDA	MP. URDANETA	PQ. CUA	ESCUELA BASICA ESTADAL  JOSE MARIA CARRE O	2732	5	46	2213	1624	2167	1	9	0	0	533	2213
EDO. MIRANDA	MP. URDANETA	PQ. CUA	PREESCOLAR NACIONAL CRISTOBAL ROJAS	1150	2	22	950	499	928	0	3	0	0	426	950
EDO. MIRANDA	MP. URDANETA	PQ. CUA	CONCENTRACION ESCOLAR SIN NUMERO MUME ABAJO	268	1	2	231	211	229	0	2	0	0	16	231
EDO. MIRANDA	MP. URDANETA	PQ. CUA	UNIDAD EDUCATIVA NACIONAL RAFAEL URDANETA	1460	3	16	1362	596	1346	1	4	0	2	743	1362
EDO. MIRANDA	MP. URDANETA	PQ. CUA	UNIDAD EDUCATIVA ESTADAL CONSUELO PORTILLO	936	2	18	760	565	742	0	4	1	0	172	760
EDO. MIRANDA	MP. URDANETA	PQ. CUA	CONCENTRACION ESCOLAR RURAL NUMERO 17	2102	4	31	1659	1177	1628	1	5	1	0	444	1659
EDO. MIRANDA	MP. URDANETA	PQ. CUA	UNIDAD EDUCATIVA ESTADAL GENERAL RAFAEL URDANETA	2417	5	42	2222	851	2180	2	3	0	3	1321	2222
EDO. MIRANDA	MP. URDANETA	PQ. CUA	UNIDAD ESCOLAR NACIONAL DISTRITO CAPITAL	2213	4	82	1858	1472	1776	0	9	1	1	293	1858
EDO. MIRANDA	MP. URDANETA	PQ. CUA	CENTRO INFANTIL EDUCATIVO EULALIA BUROZ	2467	5	51	1985	976	1934	0	7	0	4	947	1985
EDO. MIRANDA	MP. URDANETA	PQ. CUA	UNIDAD EDUCATIVA NACIONAL JOSE DE SAN MARTIN	4641	9	65	3857	2385	3792	1	19	2	3	1382	3857
EDO. MIRANDA	MP. URDANETA	PQ. CUA	ESCUELA TECNICA INDUSTRIAL CRUZ VILLEGAS	1916	4	60	1723	1016	1663	0	8	1	2	636	1723
EDO. MIRANDA	MP. URDANETA	PQ. CUA	CASA DE LA CULTURA PANCHO PRIN	957	2	21	850	385	829	0	5	1	1	437	850
EDO. MIRANDA	MP. URDANETA	PQ. CUA	COMEDOR MUNICIPAL PAULA CORREA	1269	3	29	1120	756	1091	1	5	0	1	328	1120
EDO. MIRANDA	MP. URDANETA	PQ. CUA	CICLO BASICO CUA	3200	6	66	2892	1270	2826	0	8	3	6	1539	2892
EDO. MIRANDA	MP. URDANETA	PQ. CUA	PLAZA BOLIVAR DE CUA	115	1	5	88	52	83	0	1	0	0	30	88
EDO. MIRANDA	MP. URDANETA	PQ. CUA	ESCUELA BOLIVARIANA CONCENTRACION ESCOLAR RURAL LAS CASITAS	51	1	1	47	37	46	0	0	0	0	9	47
EDO. MIRANDA	MP. URDANETA	PQ. CUA	UNIDAD EDUCATIVA NACIONAL EZEQUIEL ZAMORA	2529	5	50	2090	1303	2040	0	12	1	6	718	2090
EDO. MIRANDA	MP. URDANETA	PQ. CUA	ESCUELA BASICA ESTADAL PROFESOR JESUS MARIA RANGEL	365	1	7	334	273	327	0	0	0	0	54	334
EDO. MIRANDA	MP. LANDER	PQ. LA DEMOCRACIA	CONCENTRACION ESCOLAR LOS CONFINES N.E.R 011	294	1	6	189	155	183	0	0	0	0	28	189
EDO. MIRANDA	MP. LANDER	PQ. LA DEMOCRACIA	CONCENTRACION ESCOLAR NUMERO 69 QUIRIPITAL	429	1	10	282	204	272	0	0	0	0	68	282
EDO. MIRANDA	MP. LANDER	PQ. LA DEMOCRACIA	ESCUELA BOLIVARIANA ESTADAL SAN VICENTE	195	1	1	176	137	175	0	0	0	0	38	176
EDO. MIRANDA	MP. LANDER	PQ. LA DEMOCRACIA	CONCENTRACION ESCOLAR SIN NUMERO GUAYAMURAL	367	1	3	272	210	269	0	2	0	0	57	272
EDO. MIRANDA	MP. LANDER	PQ. SANTA BARBARA	UNIDAD EDUCATIVA NACIONAL LILIA DE PIÑERO	3681	7	62	2986	2142	2924	0	12	1	2	767	2986
EDO. MIRANDA	MP. LANDER	PQ. SANTA BARBARA	UNIDAD EDUCATIVA ESTADAL  MATA PRINERA	541	1	6	483	413	477	0	1	0	0	63	483
EDO. MIRANDA	MP. LANDER	PQ. SANTA BARBARA	UNIDAD EDUCATIVA NACIONAL JUANA RAMIREZ	2108	4	42	1910	1806	1868	2	1	2	1	56	1910
EDO. MIRANDA	MP. LANDER	PQ. SANTA BARBARA	UNIDAD EDUCATIVA TECNICA AGROPECUARIA PIÑATE	1537	3	44	1290	870	1246	0	4	2	2	368	1290
EDO. MIRANDA	MP. LANDER	PQ. OCUMARE DEL TUY	UNIDAD EDUCATIVA NACIONAL BOLIVARIANA BATALLA DE CARABOBO	612	2	6	453	411	447	1	0	1	1	33	453
EDO. MIRANDA	MP. LANDER	PQ. OCUMARE DEL TUY	ESCUELA BASICA  SAN BASILIO	146	1	1	121	109	120	0	0	0	0	11	121
EDO. MIRANDA	MP. LANDER	PQ. OCUMARE DEL TUY	CENTRO DE EDUCACION INICIAL VALLECITO	706	2	9	629	523	620	1	2	0	0	94	629
EDO. MIRANDA	MP. LANDER	PQ. OCUMARE DEL TUY	UNIDAD EDUCATIVA ESTADAL ESTADO TACHIRA	2849	5	27	2186	1663	2159	2	13	0	1	480	2186
EDO. MIRANDA	MP. LANDER	PQ. OCUMARE DEL TUY	ESCUELA BASICA ESTADAL DOCTOR JOSE MARIA VARGAS	903	2	8	781	699	773	0	1	0	0	73	781
EDO. MIRANDA	MP. LANDER	PQ. OCUMARE DEL TUY	UNIDAD EDUCATIVA ESTADAL PABLO CALZADILLA	404	1	4	332	279	328	0	1	1	0	47	332
EDO. MIRANDA	MP. LANDER	PQ. OCUMARE DEL TUY	CENTRO DE EDUCACION INICIAL BOLIVARIANO SENDERO DE LUZ	481	1	7	420	361	413	1	1	0	0	50	420
EDO. MIRANDA	MP. LANDER	PQ. OCUMARE DEL TUY	CONCENTRACION ESCOLAR CAICITA	625	2	8	444	374	436	0	3	0	0	59	444
EDO. MIRANDA	MP. LANDER	PQ. OCUMARE DEL TUY	UNIDAD EDUCATIVA NACIONAL MANUEL DE ALESON	939	2	14	736	421	722	0	5	1	0	295	736
EDO. MIRANDA	MP. LANDER	PQ. OCUMARE DEL TUY	CENTRO DE EDUCACION INICIAL  MATA DE COCO	762	2	14	681	595	667	0	7	2	0	63	681
EDO. MIRANDA	MP. LANDER	PQ. OCUMARE DEL TUY	UNIDAD EDUCATIVA ESTADAL JOSE FELIX RIBAS	2539	5	28	2054	1767	2026	0	12	3	0	244	2054
EDO. MIRANDA	MP. LANDER	PQ. OCUMARE DEL TUY	INSTITUTO UNIVERSITARIO TOMAS LANDER	1302	3	17	1177	467	1160	0	1	0	0	692	1177
EDO. MIRANDA	MP. LANDER	PQ. OCUMARE DEL TUY	UNIDAD EDUCATIVA COLEGIO TOMAS LANDER	1655	3	37	1349	657	1312	1	7	0	1	646	1349
EDO. MIRANDA	MP. LANDER	PQ. OCUMARE DEL TUY	UNIDAD EDUCATIVA ESTADAL ANA MARIA DE DELGADO	1600	3	26	1455	795	1429	0	7	0	3	624	1455
EDO. MIRANDA	MP. LANDER	PQ. OCUMARE DEL TUY	CENTRO DE EDUCACION INICIAL  MARIA SOSA DE BELVIS	2247	4	28	1915	1608	1887	1	6	0	0	272	1915
EDO. MIRANDA	MP. LANDER	PQ. OCUMARE DEL TUY	ESCUELA BASICA ESTADAL MERCEDEZ DE PEREZ	3153	6	51	2608	1930	2557	1	20	0	2	604	2608
EDO. MIRANDA	MP. LANDER	PQ. OCUMARE DEL TUY	COMPLEJO EDUCATIVO NACIONAL ALBERTO SMITH	5667	10	123	4662	3080	4539	0	27	5	3	1424	4662
EDO. MIRANDA	MP. LANDER	PQ. OCUMARE DEL TUY	CENTRO DE EDUCACION INICIAL NACIONAL 13 DE MARZO DE 1814	507	1	10	454	411	444	0	0	0	0	33	454
EDO. MIRANDA	MP. LANDER	PQ. OCUMARE DEL TUY	UNIDAD EDUCATIVA ESTADAL ARAGUITA I	2151	4	54	1839	1130	1785	0	6	0	0	649	1839
EDO. MIRANDA	MP. LANDER	PQ. OCUMARE DEL TUY	CASA DE LA CULTURA JOSE FELIX RIBAS	2117	4	31	1769	1041	1738	0	5	0	0	692	1769
EDO. MIRANDA	MP. LANDER	PQ. OCUMARE DEL TUY	CENTRO DE FORMACION DE RECURSOS HUMANOS SAN JUAN BAUTISTA DE LA SALLE	388	1	11	361	238	350	0	0	0	0	112	361
EDO. MIRANDA	MP. LANDER	PQ. OCUMARE DEL TUY	UNIDAD EDUCATIVA ESTADAL MONSEÑOR RAFAEL PEREZ LEON	3141	6	61	2554	1867	2493	0	14	1	3	608	2554
EDO. MIRANDA	MP. LANDER	PQ. OCUMARE DEL TUY	CONCENTRACION EDUCATIVO VALLES DEL TUY	3084	6	66	2438	1794	2372	2	10	4	2	560	2438
EDO. MIRANDA	MP. LANDER	PQ. OCUMARE DEL TUY	COMPLEJO EDUCATIVO NACIONAL MERCEDES RASCO	5704	10	100	4665	3834	4565	2	14	3	5	707	4665
EDO. MIRANDA	MP. LANDER	PQ. OCUMARE DEL TUY	UNIDAD EDUCATIVA ESTADAL BOLIVARIANA LA UVERITA	335	1	15	300	269	285	0	0	0	0	16	300
EDO. MIRANDA	MP. LANDER	PQ. OCUMARE DEL TUY	GRUPO ESCOLAR DOCTOR  OBDULIO ALVAREZ	2749	5	41	2245	1456	2204	0	7	0	3	738	2245
EDO. MIRANDA	MP. LANDER	PQ. OCUMARE DEL TUY	IPASME OCUMARE DEL TUY	1724	3	50	1411	980	1361	0	9	0	2	370	1411
EDO. MIRANDA	MP. LANDER	PQ. OCUMARE DEL TUY	CONCETRACION ESCOLAR QUEBRADA DE MIGUEL	180	1	0	116	110	116	0	0	0	1	5	116
EDO. MIRANDA	MP. LANDER	PQ. OCUMARE DEL TUY	ESCUELA BASICA ESTADAL CHAMICERO	2230	4	56	1824	1298	1768	1	10	3	1	455	1824
EDO. MIRANDA	MP. LANDER	PQ. OCUMARE DEL TUY	CENTRO DE EDUCACION INICIAL VIRGEN DE BETANIA	1174	2	12	1019	939	1007	1	4	0	0	63	1019
EDO. MIRANDA	MP. LANDER	PQ. OCUMARE DEL TUY	UNIDAD EDUCATIVA ESTADAL ANTONIO JOSE DE SUCRE	2193	4	38	1763	1419	1725	0	14	1	0	291	1763
EDO. MIRANDA	MP. LANDER	PQ. OCUMARE DEL TUY	ESCUELA BASICA NACIONAL ARAGUITA	3526	7	72	2836	2020	2764	0	12	1	3	728	2836
EDO. MIRANDA	MP. LANDER	PQ. OCUMARE DEL TUY	UNIDAD EDUCATIVA NACIONAL EXTENSION ROSA PENA	548	1	10	475	410	465	0	2	0	0	53	475
EDO. MIRANDA	MP. LANDER	PQ. OCUMARE DEL TUY	UNIDAD EDUCATIVA ESTADAL PILONCITO	1039	2	32	893	679	861	0	3	2	1	176	893
EDO. MIRANDA	MP. LANDER	PQ. OCUMARE DEL TUY	ESCUELA PRIMARIA BOLIVARIANA MIRANDA	2931	6	52	2370	1359	2318	0	8	0	2	949	2370
EDO. MIRANDA	MP. LANDER	PQ. OCUMARE DEL TUY	UNIDAD EDUCATIVA NACIONAL  JUAN ANTONIO PEREZ BONALDE	2635	5	63	2207	1281	2144	1	14	4	2	842	2207
EDO. MIRANDA	MP. LANDER	PQ. OCUMARE DEL TUY	UNIDAD EDUCATIVA FE Y ALEGRIA PAMPERO	3599	7	61	2974	2196	2913	1	8	2	3	703	2974
EDO. MIRANDA	MP. LANDER	PQ. OCUMARE DEL TUY	UNIDAD EDUCATIVA ESTADAL EVA DE TERAN	2578	5	73	2033	1372	1960	0	15	1	1	571	2033
EDO. MIRANDA	MP. LANDER	PQ. OCUMARE DEL TUY	UNIDAD EDUCATIVA NACIONAL OCUMARE	1407	3	43	1081	744	1038	0	5	1	0	288	1081
EDO. MIRANDA	MP. LANDER	PQ. OCUMARE DEL TUY	CASA COMUNAL LA VERANIEGA	245	1	3	222	207	219	0	1	0	0	11	222
EDO. MIRANDA	MP. LANDER	PQ. OCUMARE DEL TUY	ESCUELA BASICA ESTADAL TERRITORIO FEDERAL  AMAZONAS	2210	4	27	1793	1536	1766	2	9	0	3	216	1793
EDO. MIRANDA	MP. LANDER	PQ. OCUMARE DEL TUY	UNIDAD EDUCATIVA NACIONAL BOLIVARIANA DOCTOR LUIS RAZETTI	844	2	24	688	548	664	0	3	0	1	112	688
EDO. MIRANDA	MP. LANDER	PQ. OCUMARE DEL TUY	UNIDAD EDUCATIVA ESTADAL GRAN MARISCAL DE AYACUCHO	309	1	10	297	262	287	0	2	0	0	23	297
EDO. MIRANDA	MP. LANDER	PQ. OCUMARE DEL TUY	UNIDAD EDUCATIVA NACIONAL  ROSA PEÑA	3475	6	46	2888	1889	2842	0	21	2	0	930	2888
EDO. MIRANDA	MP. ACEVEDO	PQ. AREVALO GONZALEZ	CONCENTRACION NACIONAL NUMERO 1827 LA CONCEPCION	278	1	7	220	159	213	0	0	0	0	54	220
EDO. MIRANDA	MP. ACEVEDO	PQ. AREVALO GONZALEZ	ESCUELA UNITARIA NACIONAL NUMERO 1734 LAS BRISAS DE BURGUILLOS	295	1	3	185	125	182	0	0	0	0	57	185
EDO. MIRANDA	MP. ACEVEDO	PQ. AREVALO GONZALEZ	CONCENTRACION NACIONAL NUMERO 77 MARCELO	569	1	8	426	353	418	0	2	0	0	63	426
EDO. MIRANDA	MP. ACEVEDO	PQ. AREVALO GONZALEZ	ESCUELA  BOLIVARIANA. NACIONAL  VALLE DE URAPE (NUCLEO ENDOGENO RURAL  096)	81	1	4	67	29	63	0	1	0	0	33	67
EDO. MIRANDA	MP. ACEVEDO	PQ. AREVALO GONZALEZ	ESCUELA BOLIVARIANA ESTADAL CONCENTRACION CAÑO NEGRO (NUCLEO ENDOGENO RURAL 010)	100	1	2	89	79	87	0	1	0	0	7	89
EDO. MIRANDA	MP. ACEVEDO	PQ. AREVALO GONZALEZ	UNIDAD EDUCATIVA BOLIVARIANA PEDRO JOSE RODRIGUEZ	1365	3	28	1050	735	1022	0	4	0	0	283	1050
EDO. MIRANDA	MP. ACEVEDO	PQ. AREVALO GONZALEZ	UNIDAD EDUCATIVA CREACION EL CLAVO	213	1	3	140	112	137	0	0	0	0	25	140
EDO. MIRANDA	MP. ACEVEDO	PQ. AREVALO GONZALEZ	ESCUELA GRADUADA MERECURE REMOLINO	732	2	21	569	466	548	1	3	2	0	76	569
EDO. MIRANDA	MP. ACEVEDO	PQ. AREVALO GONZALEZ	CONCENTRACION  ESTADAL SIN NUMERO POTRERO RUBINO	155	1	4	114	53	110	0	0	2	0	55	114
EDO. MIRANDA	MP. ACEVEDO	PQ. AREVALO GONZALEZ	UNIDAD EDUCATIVA CABANO CARPIO	405	1	9	295	200	286	0	2	0	0	84	295
EDO. MIRANDA	MP. ACEVEDO	PQ. PANAQUIRE	CONCENTRACION ESTATAL NUMERO  23	213	1	1	143	92	142	1	2	0	0	47	143
EDO. MIRANDA	MP. ACEVEDO	PQ. PANAQUIRE	ESCUELA UNITARIA NACIONAL NUMERO  575	281	1	7	246	181	239	0	1	0	0	57	246
EDO. MIRANDA	MP. ACEVEDO	PQ. PANAQUIRE	UNIDAD EDUCATIVA NACIONAL BOLIVARIANA JOSE MARIA VARGAS	548	1	11	453	395	442	0	0	0	0	47	453
EDO. MIRANDA	MP. ACEVEDO	PQ. PANAQUIRE	UNIDAD EDUCATIVA LICEO BOLIVARIANO PANAQUIRE	298	1	1	245	204	244	0	2	0	0	38	245
EDO. MIRANDA	MP. ACEVEDO	PQ. PANAQUIRE	ESCUELA BASICA ESTADAL  CONCENTRADA EL SAPO BAMBU NUCLEO ESTUDIANTIL  RURAL 010	86	1	0	77	72	77	0	0	0	0	5	77
EDO. MIRANDA	MP. ACEVEDO	PQ. PANAQUIRE	CONCENTRACION ESTADAL NUMERO 3	169	1	1	114	95	113	0	0	0	0	18	114
EDO. MIRANDA	MP. ACEVEDO	PQ. PANAQUIRE	ESCUELA BASICA CREACION LA BALZA	557	1	20	447	333	427	0	1	0	0	93	447
EDO. MIRANDA	MP. ACEVEDO	PQ. PANAQUIRE	GRUPO ESCOLAR NACIONAL JOSE NICOMEDES MARRERO	2016	4	62	1551	849	1489	0	6	2	0	632	1551
EDO. MIRANDA	MP. ACEVEDO	PQ. PANAQUIRE	ESCUELA BASICA ESTADAL CONCENTRACION URBA NUCLEO ESCOLAR RURAL 010	118	1	2	100	81	98	0	0	0	0	17	100
EDO. MIRANDA	MP. ACEVEDO	PQ. PANAQUIRE	CONCENTRACION ESTADAL BOLIVARIANA MANGO DE OCOITA	343	1	4	274	247	270	0	1	1	0	21	274
EDO. MIRANDA	MP. ACEVEDO	PQ. PANAQUIRE	CONCENTRACION ESTATAL NUMERO 16	198	1	3	134	100	131	0	0	0	1	30	134
EDO. MIRANDA	MP. ACEVEDO	PQ. ARAGUITA	CONCENTRACION ESTADAL SIN NUMERO CUPATA	355	1	11	277	241	266	0	0	0	0	25	277
EDO. MIRANDA	MP. ACEVEDO	PQ. ARAGUITA	UNIDAD EDUCATIVA LA FILA	782	2	23	609	497	586	0	1	1	0	87	609
EDO. MIRANDA	MP. ACEVEDO	PQ. ARAGUITA	ESCUELA BASICA CONCENTRACION EL SOCORRO EL PEINE	150	1	7	133	105	126	0	2	0	0	19	133
EDO. MIRANDA	MP. ACEVEDO	PQ. ARAGUITA	UNIDAD EDUCATIVA JULIAN OJEDA	2051	4	34	1537	1045	1503	0	7	1	0	450	1537
EDO. MIRANDA	MP. ACEVEDO	PQ. ARAGUITA	ESCUELA BASICA ESTADAL CONCENTRACION EL LATON NUCLEO ENDOGENO RURAL 09	251	1	3	211	162	208	0	1	0	0	45	211
EDO. MIRANDA	MP. ACEVEDO	PQ. ARAGUITA	CONCENTRACION ESTATAL NUMERO 26 EL PEÑON	709	2	2	516	384	514	0	1	0	0	129	516
EDO. MIRANDA	MP. ACEVEDO	PQ. ARAGUITA	CONCENTRACION ESTADAL NUMERO 18 EL SOCORRO	598	1	10	405	307	395	1	1	1	0	85	405
EDO. MIRANDA	MP. ACEVEDO	PQ. MARIZAPA	ESCUELA ESTADAL GRADUADA DOCTOR ARNALDO AROCHA VARGAS	3511	6	150	2834	1762	2684	0	15	1	1	905	2834
EDO. MIRANDA	MP. ACEVEDO	PQ. MARIZAPA	CONCENTRACION ESTADAL SIN LOS COCOS	614	2	14	527	466	513	0	4	1	0	42	527
EDO. MIRANDA	MP. ACEVEDO	PQ. MARIZAPA	UNIDAD EDUCATIVA ARGELIA LAYA	732	2	24	601	395	577	1	1	0	1	179	601
EDO. MIRANDA	MP. ACEVEDO	PQ. MARIZAPA	ESCUELA BASICA ESTADAL CONCENTRADA  SIN NUMERO CUPO	792	2	11	674	557	663	0	2	0	0	104	674
EDO. MIRANDA	MP. ACEVEDO	PQ. CAUCAGUA	COLEGIO LA ENCARNACION	2110	4	35	1725	697	1690	1	11	1	0	980	1725
EDO. MIRANDA	MP. ACEVEDO	PQ. CAUCAGUA	ESCUELA BOLIVARIANA LA COTARA	966	2	13	837	664	824	0	9	1	2	148	837
EDO. MIRANDA	MP. ACEVEDO	PQ. CAUCAGUA	ESCUELA NACIONAL JOSE MARIA CARREÑO MENDOZA	495	1	11	403	303	392	0	2	0	0	87	403
EDO. MIRANDA	MP. ACEVEDO	PQ. CAUCAGUA	ESCUELA  BOLIVARIANA NACIONAL EL MARQUEZ	489	1	8	416	260	408	0	2	1	1	144	416
EDO. MIRANDA	MP. ACEVEDO	PQ. CAUCAGUA	CONCENTRACION ESTATAL NUMERO 25	1153	2	13	824	591	811	1	7	1	0	211	824
EDO. MIRANDA	MP. ACEVEDO	PQ. CAUCAGUA	UNIDAD EDUCATIVA ROSCIO	4792	9	105	3528	1786	3423	1	23	5	2	1606	3528
EDO. MIRANDA	MP. ACEVEDO	PQ. CAUCAGUA	ESCUELA BASICA ESTADAL CONCENTRADA LA CALIFORNIA NUCLEO ESCOLAR RURAL 011	169	1	8	138	104	130	0	1	0	0	25	138
EDO. MIRANDA	MP. ACEVEDO	PQ. CAUCAGUA	CONCENTRACION ESTATAL NUMERO 27 LOS CERRITOS	845	2	27	614	416	587	1	6	0	4	160	614
EDO. MIRANDA	MP. ACEVEDO	PQ. CAUCAGUA	CONCENTRACION ESTADAL NUMERO 4 CHUSPITA	1191	3	14	911	572	897	0	3	0	0	322	911
EDO. MIRANDA	MP. ACEVEDO	PQ. CAUCAGUA	ESCUELA BASICA ESTADAL CONCENTRADA LA BOCA NUCLEO ESCOLAR RURAL  013	232	1	4	206	193	202	0	0	0	0	9	206
EDO. MIRANDA	MP. ACEVEDO	PQ. CAUCAGUA	CONCENTRADA ESTADAL SIN NUMERO AGUA FRIA	436	1	12	303	249	291	0	2	0	0	40	303
EDO. MIRANDA	MP. ACEVEDO	PQ. CAUCAGUA	ESCUELA BASICA ESCOLAR  CONCENTRADA  SAN RAFAEL  NUCLEO ESCOLAR RURAL  011	261	1	5	235	201	230	0	1	1	0	27	235
EDO. MIRANDA	MP. ACEVEDO	PQ. CAUCAGUA	ESCUELA UNITARIA ESTADAL NUMERO 11	1043	2	30	828	578	798	0	4	0	0	216	828
EDO. MIRANDA	MP. ACEVEDO	PQ. CAUCAGUA	ESCUELA ESTADAL UNITARIA NUMERO 2316 MERCURE CENTRO	461	1	11	346	282	335	2	0	1	0	50	346
EDO. MIRANDA	MP. ACEVEDO	PQ. CAUCAGUA	UNIDAD EDUCATIVA RICARDA TOVAR	1039	2	16	836	704	820	0	2	0	0	114	836
EDO. MIRANDA	MP. ACEVEDO	PQ. CAUCAGUA	UNIDAD EDUCATIVA ALTAGRACIA	978	2	21	739	568	718	0	7	1	0	142	739
EDO. MIRANDA	MP. ACEVEDO	PQ. CAUCAGUA	UNIDAD EDUCATIVA MARIA ENRIQUETA SARRATUD	323	1	5	246	140	241	0	0	0	0	101	246
EDO. MIRANDA	MP. ACEVEDO	PQ. CAUCAGUA	UNIDAD EDUCATIVA BOLIVARIANA PANTOJA	1600	3	34	1261	753	1227	0	2	0	4	468	1261
EDO. MIRANDA	MP. ACEVEDO	PQ. CAUCAGUA	UNIDAD EDUCATIVA CAUCAGUA	466	1	9	334	211	325	0	0	0	1	113	334
EDO. MIRANDA	MP. ACEVEDO	PQ. RIBAS	CONCENTRACION ESTADAL SIN NUMERO EL PILAR	264	1	4	231	181	227	0	0	0	2	44	231
EDO. MIRANDA	MP. ACEVEDO	PQ. RIBAS	ESCUELA NUEVA ESPERANZA LOS ROSALES	175	1	0	116	103	116	0	0	0	0	13	116
EDO. MIRANDA	MP. ACEVEDO	PQ. RIBAS	CASA COMUNAL LA PUERTA	105	1	2	92	65	90	0	0	0	0	25	92
EDO. MIRANDA	MP. ACEVEDO	PQ. RIBAS	CASA DE LA CULTURA DE TAPIPA EL PUEBLO	100	1	2	82	45	80	0	0	0	0	35	82
EDO. MIRANDA	MP. ACEVEDO	PQ. RIBAS	ESCUELA BOLIVARIANA SIN NUMERO TAGUAY	255	1	1	188	156	187	1	1	0	0	29	188
EDO. MIRANDA	MP. ACEVEDO	PQ. RIBAS	ESCUELA BASICA ESTADAL CASUPITO	47	1	3	42	37	39	0	0	0	0	2	42
EDO. MIRANDA	MP. ACEVEDO	PQ. RIBAS	UNIDAD EDUCATIVA TAPIPA GRANDE	640	2	11	486	402	475	0	4	0	0	69	486
EDO. MIRANDA	MP. ACEVEDO	PQ. RIBAS	CONCENTRACION ESTADAL NUMERO 22 SANTA ANA	147	1	6	107	90	101	0	1	0	0	10	107
EDO. MIRANDA	MP. ACEVEDO	PQ. RIBAS	ESCUELA ESTADAL DEL CASERIO MACANILLA	481	1	7	318	259	311	0	0	0	0	52	318
EDO. MIRANDA	MP. ACEVEDO	PQ. RIBAS	CONCENTRADA ESTADAL NUMERO 24 EL JOVITO	31	1	1	18	14	17	0	0	0	0	3	18
EDO. MIRANDA	MP. ACEVEDO	PQ. RIBAS	ESCUELA BASICA ESTADAL CONCENTRADA  SAN JORGE NUCLEO ESCOLAR RURAL 013	93	1	0	79	43	79	0	1	0	1	34	79
EDO. MIRANDA	MP. ACEVEDO	PQ. RIBAS	ESCUELA BASICA CONCENTRACION LA MARINERA	633	2	5	426	364	421	0	0	1	0	56	426
EDO. MIRANDA	MP. ACEVEDO	PQ. RIBAS	ESCUELA BASICA ESTADAL  CONCENTRADA EL MILANO NUCLEO ESCOLAR RURAL 013	191	1	5	163	137	158	0	1	0	0	20	163
EDO. MIRANDA	MP. ACEVEDO	PQ. RIBAS	GRUPO ESCOLAR MARTIN HERNANDEZ BLANCO	1057	2	12	816	422	804	0	2	0	0	380	816
EDO. MIRANDA	MP. ACEVEDO	PQ. RIBAS	ESCUELA DEL CASERIO CAÑO NEGRO	521	1	3	418	255	415	0	3	0	0	157	418
EDO. MIRANDA	MP. ACEVEDO	PQ. RIBAS	CONCENTRACION ESTADAL NUMERO 24	279	1	1	155	137	154	0	0	1	0	16	155
EDO. MIRANDA	MP. ACEVEDO	PQ. RIBAS	ESCUELA UNITARIA ESTATAL NUMERO 16	204	1	4	146	117	142	0	0	0	0	25	146
EDO. MIRANDA	MP. ACEVEDO	PQ. RIBAS	ESCUELA UNITARIA ESTADAL SIN NUMERO	180	1	1	109	91	108	0	0	0	0	17	109
EDO. MIRANDA	MP. ACEVEDO	PQ. EL CAFE	CENTRO ESTADAL  SIN NUMERO FILA PEÑORAL	91	1	0	67	59	67	0	0	0	0	8	67
EDO. MIRANDA	MP. ACEVEDO	PQ. EL CAFE	UNIDAD EDUCATIVA ROSA HENRRIQUEZ DE BANDRES	1368	3	14	1034	704	1020	0	9	2	0	305	1034
EDO. MIRANDA	MP. ACEVEDO	PQ. EL CAFE	GRUPO ESCOLAR NARVARTE	1410	3	18	1084	755	1066	0	4	0	0	307	1084
EDO. MIRANDA	MP. ACEVEDO	PQ. EL CAFE	ESCUELA BOLIVARIANA QUEBRADA FOFA	539	1	11	392	314	381	0	0	0	0	67	392
EDO. MIRANDA	MP. ACEVEDO	PQ. EL CAFE	CONCENTRACION ESTADAL S N TOTUMITO	76	1	2	65	63	63	0	0	0	0	0	65
EDO. MIRANDA	MP. ACEVEDO	PQ. EL CAFE	ESCUELA CASERIO DE MACANILLA	360	1	9	264	204	255	0	1	0	0	50	264
EDO. MIRANDA	MP. ACEVEDO	PQ. EL CAFE	ESCUELA BASICA ESCOLAR  CONCENTRADA  ARAMINA EL LUCERO SEDE NUCLEO ESCOLAR RURAL  014	140	1	2	123	101	121	0	0	0	0	20	123
EDO. MIRANDA	MP. ACEVEDO	PQ. CAPAYA	CASA DE LA CULTURA	1884	4	72	1423	769	1351	0	5	1	0	576	1423
EDO. MIRANDA	MP. ACEVEDO	PQ. CAPAYA	UNIDAD EDUCATIVA ESCOLAR CARLOS EDUARDO RENGIFO	458	1	6	411	306	405	0	2	0	0	97	411
EDO. MIRANDA	MP. ACEVEDO	PQ. CAPAYA	CONCENTRACION ESTATAL NUMERO 8 LAS MOROCHAS	470	1	8	371	267	363	0	2	0	1	93	371
EDO. MIRANDA	MP. ACEVEDO	PQ. CAPAYA	ESCUELA BASICA ESTADAL CONCENTRADA  5 DE JULIO SEDE NUCLEO ESCOLAR REGIONAL  012	221	1	4	187	157	183	0	0	1	0	25	187
EDO. MIRANDA	MP. ACEVEDO	PQ. CAPAYA	CASA DE LOS ABUELOS FELIX EDMUNDO RONDON	763	2	25	531	353	506	0	2	1	0	150	531
EDO. MIRANDA	MP. ACEVEDO	PQ. CAPAYA	CONCENTRADA ESTADAL SIN NUMERO LA MARTURETERA	337	1	2	293	239	291	0	1	0	0	51	293
EDO. MIRANDA	MP. ACEVEDO	PQ. CAPAYA	CONCENTRACION ESTADAL  GUATIRITO	118	1	0	104	55	104	0	0	0	0	49	104
EDO. MIRANDA	MP. ACEVEDO	PQ. CAPAYA	UNIDAD EDUCATIVA CAPAYA	412	1	7	325	219	318	0	3	0	0	96	325
EDO. MIRANDA	MP. ACEVEDO	PQ. CAPAYA	CONCENTRACION NACIONAL NUMERO  68	826	2	22	650	416	628	0	2	1	1	208	650
EDO. MIRANDA	MP. ACEVEDO	PQ. CAPAYA	CONCENTRACION ESTADAL SIN NUMERO	222	1	5	164	123	159	0	3	0	0	33	164
EDO. MIRANDA	MP. ACEVEDO	PQ. CAPAYA	ESCUELA UNITARIA ESTATAL NUMERO 8	170	1	0	0	0	0	0	0	0	0	0	0
EDO. MIRANDA	MP. ACEVEDO	PQ. CAPAYA	ESCUELA BASICA ESTADAL  ARAMINA LA COROÑA NUCLE ESCOLAR RURAL  012	207	1	6	180	129	174	0	0	0	0	45	180
EDO. MIRANDA	MP. ACEVEDO	PQ. CAPAYA	CONCENTRACION NACIONAL SIN NUMERO	591	1	16	444	333	428	0	1	1	0	93	444
EDO. MIRANDA	MP. ACEVEDO	PQ. CAPAYA	UNIDAD  BASASICA  LA CARAMERA	1098	2	37	840	472	803	0	2	0	2	327	840
EDO. MIRANDA	MP. ACEVEDO	PQ. CAPAYA	ESCUELA BASICA ESTADAL AGUA AMARILLA  NUCLEO ESCOLAR RURAL 012	73	1	5	55	44	50	0	0	0	0	6	55
EDO. MIRANDA	CE. GUAICAIPURO	PQ. SAN PEDRO	CONCENTRACION RURAL BOLIVARIANA GARABATO	705	2	12	564	261	552	0	3	1	2	285	564
EDO. MIRANDA	CE. GUAICAIPURO	PQ. SAN PEDRO	UNIDAD EDUCATIVA JUAN DE DIOS GUANCHEZ	3266	6	70	2731	1209	2661	1	14	2	0	1435	2731
EDO. MIRANDA	CE. GUAICAIPURO	PQ. SAN PEDRO	UNIDAD EDUCATIVA NACIONAL BOLIVARIANA SAN PEDRO DE LOS ALTOS	2650	5	66	2176	1058	2110	1	6	2	1	1042	2176
EDO. MIRANDA	CE. GUAICAIPURO	PQ. SAN PEDRO	UNIDAD EDUCATIVA ESTADAL URQUIA	938	2	12	706	387	694	0	6	0	2	299	706
EDO. MIRANDA	CE. GUAICAIPURO	PQ. EL JARILLO	UNIDAD EDUCATIVA ESTADAL EL JARILLO	2320	4	61	1744	814	1683	2	6	0	1	860	1744
EDO. MIRANDA	CE. GUAICAIPURO	PQ. LOS TEQUES	CENTRO EDUCATIVO INTEGRAL CLARITA DE ALAYON	890	2	25	785	562	760	0	2	0	0	196	785
EDO. MIRANDA	CE. GUAICAIPURO	PQ. LOS TEQUES	UNIDAD EDUCATIVA ESTADAL OBDULIA DE ARRIOJAS	3170	6	68	2663	1720	2595	1	22	4	0	848	2663
EDO. MIRANDA	CE. GUAICAIPURO	PQ. LOS TEQUES	ESCUELA DE GUARDIAS NACIONALES CORONEL MARTIN BASTIDAS TORRES	2154	4	45	1425	1070	1380	1	3	0	1	305	1425
EDO. MIRANDA	CE. GUAICAIPURO	PQ. LOS TEQUES	UNIDAD EDUCATIVA NACIONAL BOLIVARIANA VICENTE SALIAS	1169	2	8	969	345	961	1	3	4	0	608	969
EDO. MIRANDA	CE. GUAICAIPURO	PQ. LOS TEQUES	UNIDAD EDUCATIVA ESTADAL TALLER GENERAL RAFAEL URDANETA	3106	6	54	2556	1160	2502	1	11	0	3	1327	2556
EDO. MIRANDA	CE. GUAICAIPURO	PQ. LOS TEQUES	UNIDAD EDUCATIVA ESTADAL BOLIVARIANA CAÑAOTE	391	1	8	346	292	338	0	0	0	0	46	346
EDO. MIRANDA	CE. GUAICAIPURO	PQ. LOS TEQUES	UNIDAD EDUCATIVA NACIONAL GUAICAIPURO	2914	5	45	2353	990	2308	1	7	0	1	1309	2353
EDO. MIRANDA	CE. GUAICAIPURO	PQ. LOS TEQUES	UNIDAD EDUCATIVA ESTADAL MONSEÑOR ARIAS BLANCO	3358	6	34	2778	1502	2744	3	15	0	2	1222	2778
EDO. MIRANDA	CE. GUAICAIPURO	PQ. LOS TEQUES	UNIDAD EDUCATIVA NACIONAL LUIS CORREA	4376	8	35	3686	1683	3651	0	15	1	6	1946	3686
EDO. MIRANDA	CE. GUAICAIPURO	PQ. LOS TEQUES	UNIDAD EDUCATIVA MANUEL DIAZ RODRIGUEZ	1110	2	13	951	423	938	0	2	0	2	511	951
EDO. MIRANDA	CE. GUAICAIPURO	PQ. LOS TEQUES	UNIDAD EDUCATIVA ESTADAL JUAN BAUTISTA ARISMENDI	2078	4	26	1824	910	1798	0	5	1	1	881	1824
EDO. MIRANDA	CE. GUAICAIPURO	PQ. LOS TEQUES	COLEGIO UNIVERSITARIO DE LOS TEQUES CECILIO ACOSTA	6024	11	112	4938	2200	4826	2	19	3	3	2599	4938
EDO. MIRANDA	CE. GUAICAIPURO	PQ. LOS TEQUES	INSTITUTO UNIVERSITARIO TECNICO DE ADMINISTRACION IUTA	2652	5	59	2283	971	2224	0	6	0	4	1243	2283
EDO. MIRANDA	CE. GUAICAIPURO	PQ. LOS TEQUES	TERMINAL DE PASAJEROS DE LOS TEQUES	1412	3	25	1160	636	1135	0	4	1	1	493	1160
EDO. MIRANDA	CE. GUAICAIPURO	PQ. LOS TEQUES	UNIDAD EDUCATIVA ESTADAL CRUZ DEL VALLE RODRIGUEZ	3580	7	51	2910	1880	2859	1	10	0	0	968	2910
EDO. MIRANDA	CE. GUAICAIPURO	PQ. LOS TEQUES	UNIDAD EDUCATIVA COLEGIO SAGRADA FAMILIA	1993	4	28	1707	666	1679	0	3	1	1	1008	1707
EDO. MIRANDA	CE. GUAICAIPURO	PQ. LOS TEQUES	UNIDAD EDUCATIVA ESTADAL BUENOS AIRES	521	1	6	482	321	476	0	0	1	1	153	482
EDO. MIRANDA	CE. GUAICAIPURO	PQ. LOS TEQUES	CICLO BASICO COMUN JULIO ROSALES	2385	5	32	1928	899	1896	0	6	1	2	988	1928
EDO. MIRANDA	CE. GUAICAIPURO	PQ. LOS TEQUES	UNIDAD EDUCATIVA ESTADAL ROMULO GALLEGOS	1496	3	24	1257	808	1233	2	4	3	0	416	1257
EDO. MIRANDA	CE. GUAICAIPURO	PQ. LOS TEQUES	UNIDAD EDUCATIVA ESTADAL TOMAS RAFAEL JIMENEZ	5071	9	105	4204	2021	4099	3	19	1	2	2053	4204
EDO. MIRANDA	CE. GUAICAIPURO	PQ. LOS TEQUES	CENTRO DE EDUCACION INICIAL NEGRA HIPOLITA	1932	4	22	1676	796	1654	1	8	1	0	848	1676
EDO. MIRANDA	CE. GUAICAIPURO	PQ. LOS TEQUES	CENTRO NACIONAL DE PROCESADOS MILITARES	521	1	5	272	157	267	0	2	1	0	107	272
EDO. MIRANDA	CE. GUAICAIPURO	PQ. LOS TEQUES	COLEGIO AMBROSIO PLAZA	2849	5	24	2409	700	2385	1	7	0	1	1676	2409
EDO. MIRANDA	CE. GUAICAIPURO	PQ. LOS TEQUES	LICEO SAN JOSE	1070	2	14	926	373	912	2	2	0	2	533	926
EDO. MIRANDA	CE. GUAICAIPURO	PQ. LOS TEQUES	UNIDAD EDUCATIVA NACIONAL BOLIVARIANA REPUBLICA DEL PARAGUAY	2759	5	26	2104	704	2078	0	3	1	1	1369	2104
EDO. MIRANDA	CE. GUAICAIPURO	PQ. LOS TEQUES	ESCUELA ESTADAL JOSE ANTONIO  RODRIGUEZ LOPEZ	3467	6	43	2906	1104	2863	0	13	1	1	1744	2906
EDO. MIRANDA	CE. GUAICAIPURO	PQ. LOS TEQUES	COLEGIO ILUSTRE AMERICANO	2355	4	32	2051	548	2019	3	4	0	0	1464	2051
EDO. MIRANDA	CE. GUAICAIPURO	PQ. LOS TEQUES	UNIVERSIDAD NACIONAL EXPERIMENTAL SIMON RODRIGUEZ	366	1	4	332	252	328	0	1	0	0	75	332
EDO. MIRANDA	CE. GUAICAIPURO	PQ. LOS TEQUES	LANEX	494	1	12	479	445	467	0	3	0	0	19	479
EDO. MIRANDA	CE. GUAICAIPURO	PQ. LOS TEQUES	AMBULATORIO DOCTOR ANGEL LARRALDE	1438	3	20	1217	592	1197	2	4	0	2	597	1217
EDO. MIRANDA	CE. GUAICAIPURO	PQ. LOS TEQUES	INSTITUTO NACIONAL DE ORIENTACION FEMENINA INOF	501	1	6	371	195	365	0	1	0	0	169	371
EDO. MIRANDA	CE. GUAICAIPURO	PQ. LOS TEQUES	UNIDAD EDUCATIVA ESTADAL RAMO VERDE	1735	3	41	1472	831	1431	0	15	2	2	581	1472
EDO. MIRANDA	CE. GUAICAIPURO	PQ. LOS TEQUES	UNIDAD EDUCATIVA NACIONAL CARMEN ROSALES GOMEZ	3966	7	69	3089	2053	3020	2	22	2	2	939	3089
EDO. MIRANDA	CE. GUAICAIPURO	PQ. LOS TEQUES	ESCUELA NACIONAL BOLIVARIANA EL VIGIA	3310	6	39	2837	1111	2798	0	20	1	3	1663	2837
EDO. MIRANDA	CE. GUAICAIPURO	PQ. LOS TEQUES	UNIDAD EDUCATIVA PRIVADA BELLA VISTA	457	1	3	411	216	408	0	2	0	0	190	411
EDO. MIRANDA	CE. GUAICAIPURO	PQ. LOS TEQUES	UNIADAD EDUCATIVA NACIONAL GUARENAS	2784	5	42	2262	1007	2220	1	12	0	1	1199	2262
EDO. MIRANDA	CE. GUAICAIPURO	PQ. LOS TEQUES	UNIDAD EDUCATIVA NACIONAL MANUEL CLEMENTE URBANEJA	4146	8	49	3391	1598	3342	3	11	1	4	1725	3391
EDO. MIRANDA	CE. GUAICAIPURO	PQ. LOS TEQUES	COLEGIO NUESTRA SEÑORA DEL CARMEN	161	1	1	142	65	141	0	1	0	0	75	142
EDO. MIRANDA	CE. GUAICAIPURO	PQ. LOS TEQUES	CASA DE LA CULTURA DEL PASO ALI LANDAETA	1526	3	23	1319	631	1296	2	7	0	2	654	1319
EDO. MIRANDA	CE. GUAICAIPURO	PQ. LOS TEQUES	UNIDAD EDUCATIVA ESTADAL OCUMARE DEL TUY	2174	4	21	1786	1165	1765	0	11	3	2	584	1786
EDO. MIRANDA	CE. GUAICAIPURO	PQ. LOS TEQUES	UNIDAD EDUCATIVA INSTITUTO PRIVADO BOYACA	1927	4	20	1652	420	1632	0	3	2	2	1205	1652
EDO. MIRANDA	CE. GUAICAIPURO	PQ. LOS TEQUES	UNIDAD EDUCATIVA NACIONAL DOCTOR SIMON BARRETO RAMOS	2567	5	70	2058	1321	1988	2	11	1	3	650	2058
EDO. MIRANDA	CE. GUAICAIPURO	PQ. LOS TEQUES	ATENEO LOS TEQUES ANTIGUA QUINTA SAN JOSE	2525	5	30	2076	936	2046	0	5	2	0	1103	2076
EDO. MIRANDA	CE. GUAICAIPURO	PQ. LOS TEQUES	INSTITUTO NACIONAL DE CAPACITACION Y EDUCACION SOCIALISTA	821	2	21	712	388	691	0	3	0	0	300	712
EDO. MIRANDA	CE. GUAICAIPURO	PQ. LOS TEQUES	UNIDAD EDUCATIVA COLEGIO JESUS DE NAZARET	518	1	4	489	122	485	0	1	0	1	361	489
EDO. MIRANDA	CE. GUAICAIPURO	PQ. LOS TEQUES	INTERNADO JUDICIAL DE LOS TEQUES	237	1	2	87	53	85	0	0	0	0	32	87
EDO. MIRANDA	CE. GUAICAIPURO	PQ. LOS TEQUES	UNIDAD EDUCATIVA  JOSE GREGORIO HERNANDEZ	2051	4	39	1731	1106	1692	1	4	1	4	576	1731
EDO. MIRANDA	CE. GUAICAIPURO	PQ. LOS TEQUES	ESCUELA NACIONAL TACATA	2212	4	47	1832	1018	1785	0	6	1	3	757	1832
EDO. MIRANDA	CE. GUAICAIPURO	PQ. LOS TEQUES	CENTRO DE EDUCACION INICIAL GABRIELA MISTRAL	1526	3	31	1315	742	1284	0	7	0	0	535	1315
EDO. MIRANDA	CE. GUAICAIPURO	PQ. LOS TEQUES	UNIDAD EDUCATIVA NACIONAL LICEO FRANCISCO DE MIRANDA	3235	6	51	2797	1078	2746	0	7	4	2	1655	2797
EDO. MIRANDA	CE. GUAICAIPURO	PQ. LOS TEQUES	UNIDAD EDUCATIVA ESTADAL EL NACIONAL	3301	6	53	2646	1963	2593	0	22	2	1	605	2646
EDO. MIRANDA	CE. GUAICAIPURO	PQ. LOS TEQUES	ESCUELA TECNICA COMERCIAL DOCTOR JESUS MUÑOZ TEBAR	226	1	4	197	86	193	0	0	0	0	107	197
EDO. MIRANDA	CE. GUAICAIPURO	PQ. LOS TEQUES	UNIDAD EDUCATIVA EL ENCANTO	2228	4	32	1928	833	1896	1	10	0	3	1049	1928
EDO. MIRANDA	CE. GUAICAIPURO	PQ. LOS TEQUES	UNIDAD EDUCATIVA  ESTADAL ANITA ESPINAL	2691	5	38	2321	864	2283	0	9	2	3	1405	2321
EDO. MIRANDA	CE. GUAICAIPURO	PQ. LOS TEQUES	CONCENTRACION RURAL BOLIVARIANA COLINA DEL ANGEL	889	2	22	742	482	720	1	4	2	0	231	742
EDO. MIRANDA	CE. GUAICAIPURO	PQ. LOS TEQUES	COLEGIO SAGRADO CORAZON DE JESUS	1207	3	25	1018	388	993	0	6	1	2	596	1018
EDO. MIRANDA	CE. GUAICAIPURO	PQ. LOS TEQUES	UNIDAD EDUCATIVA SAGRADO CORAZON DE JESUS II	194	1	2	173	99	171	0	1	1	0	70	173
EDO. MIRANDA	CE. GUAICAIPURO	PQ. LOS TEQUES	UNIDAD EDUCATIVA ANDRES ELOY BLANCO	1359	3	19	1101	829	1082	1	4	0	1	247	1101
EDO. MIRANDA	CE. GUAICAIPURO	PQ. LOS TEQUES	UNIDAD EDUCATIVA NACIONAL JESUS MARIA SIFONTES	2840	5	46	2207	649	2161	3	3	1	2	1503	2207
EDO. MIRANDA	CE. GUAICAIPURO	PQ. LOS TEQUES	UNIDAD EDUCATIVA ESATADAL DOCTOR FRANCISCO ESPEJO	3549	7	62	2999	1292	2937	0	7	0	3	1635	2999
EDO. MIRANDA	CE. GUAICAIPURO	PQ. LOS TEQUES	UNIDAD EDUCATIVA MARIA TERESA DE NEZER	407	1	8	378	147	370	0	0	0	0	223	378
EDO. MIRANDA	CE. GUAICAIPURO	PQ. LOS TEQUES	UNIDAD EDUCATIVA ESTADAL NICANOR BOLET PERAZA	980	2	27	829	544	802	0	3	0	0	255	829
EDO. MIRANDA	CE. GUAICAIPURO	PQ. LOS TEQUES	UNIDAD ESTADAL EDUCATIVA CECILIO ACOSTA 1	4091	8	81	3261	1672	3180	2	8	3	5	1490	3261
EDO. MIRANDA	CE. GUAICAIPURO	PQ. LOS TEQUES	CENTRO EDUCACION INICIAL NACIONAL BOLIVARIANA FILOMENA DE CORONEL	171	1	1	158	76	157	0	1	0	0	80	158
EDO. MIRANDA	CE. GUAICAIPURO	PQ. LOS TEQUES	UNIDAD EDUCATIVA ESTADAL JOSE MANUEL SISO MARTINEZ	2332	4	46	1871	1356	1825	1	4	3	0	461	1871
EDO. MIRANDA	CE. GUAICAIPURO	PQ. LOS TEQUES	UNIDAD EDUCATIVA INSTITUTO VICTEGUI	609	2	6	567	174	561	0	2	0	1	384	567
EDO. MIRANDA	CE. GUAICAIPURO	PQ. LOS TEQUES	COLEGIO NUESTRA SEÑORA DE FATIMA	2287	4	20	1964	1022	1944	0	9	1	3	909	1964
EDO. MIRANDA	CE. GUAICAIPURO	PQ. LOS TEQUES	UNIDAD EDUCATIVA NACIONAL PRESBITERO MANUEL CAÑIZALES	1446	3	40	1263	556	1223	0	8	0	1	658	1263
EDO. MIRANDA	CE. GUAICAIPURO	PQ. LOS TEQUES	UNIDAD EDUCATIVA ESTATAL BOLIVARIANA ESTADO SUCRE	1628	3	46	1317	820	1271	1	6	2	0	442	1317
EDO. MIRANDA	CE. GUAICAIPURO	PQ. LOS TEQUES	SEDE ADMINISTRATIVA DEL COLEGIO UNIVERSITARIO DE LOS TEQUES CECILIO ACOSTA	1822	4	14	1508	393	1494	0	6	0	2	1093	1508
EDO. MIRANDA	CE. GUAICAIPURO	PQ. LOS TEQUES	ESCUELA TECNICA INDUSTRIAL ROQUE PINTO	2741	5	49	2297	949	2248	2	11	0	6	1280	2297
EDO. MIRANDA	CE. GUAICAIPURO	PQ. LOS TEQUES	UNIDAD EDUCATIVA ESTADAL LUISA CACERES DE ARISMENDI	3143	6	31	2411	1689	2380	2	13	4	3	669	2411
EDO. MIRANDA	CE. GUAICAIPURO	PQ. LOS TEQUES	GRUPO ESCOLAR SIMON BOLIVAR	3725	7	61	3160	1683	3099	0	16	0	2	1398	3160
EDO. MIRANDA	CE. GUAICAIPURO	PQ. LOS TEQUES	UNIDAD EDUCATIVA COLEGIO PARROQUIAL SAN FELIPE NERY	1458	3	20	1373	494	1353	1	6	2	2	848	1373
EDO. MIRANDA	CE. GUAICAIPURO	PQ. ALTAGRACIA DE LA M	CONCENTRACION NACIONAL BOLIVARIANA LOS AMARILLOS	375	1	7	283	157	276	1	2	0	0	116	283
EDO. MIRANDA	CE. GUAICAIPURO	PQ. ALTAGRACIA DE LA M	CONCENTRACION BOLIVARIANA SAN DANIEL	456	1	22	357	186	335	0	1	0	0	148	357
EDO. MIRANDA	CE. GUAICAIPURO	PQ. ALTAGRACIA DE LA M	CONCENTRACION BOLIVARIANA EL CASCAJO	226	1	4	158	77	154	0	0	1	0	76	158
EDO. MIRANDA	CE. GUAICAIPURO	PQ. ALTAGRACIA DE LA M	UNIDAD EDUCATIVA ESTADAL EVARISTO GONZALEZ PALMA	1552	3	41	1219	761	1178	0	8	1	0	408	1219
EDO. MIRANDA	CE. GUAICAIPURO	PQ. TACATA	UNIDAD EDUCATIVA NACIONAL CALAZAN HERRERA	3028	6	44	2507	1653	2463	0	10	2	3	795	2507
EDO. MIRANDA	CE. GUAICAIPURO	PQ. CECILIO ACOSTA	UNIDAD EDUCATIVA NACIONAL RURAL NUESTRA SEÑORA DEL CARMEN	560	1	6	444	342	438	0	1	0	0	95	444
EDO. MIRANDA	CE. GUAICAIPURO	PQ. CECILIO ACOSTA	COLEGIO CECILIO ACOSTA DOS	2899	5	38	2362	657	2324	0	3	1	0	1663	2362
EDO. MIRANDA	CE. GUAICAIPURO	PQ. CECILIO ACOSTA	UNIDAD EDUCATIVA BOLIVARIAN RURAL EL NARANJAL	1289	3	14	1028	642	1014	1	1	1	3	366	1028
EDO. MIRANDA	CE. GUAICAIPURO	PQ. CECILIO ACOSTA	UNIDAD EDUCATIVA AGUA FRIA	935	2	18	784	583	766	0	7	0	1	175	784
EDO. MIRANDA	CE. GUAICAIPURO	PQ. CECILIO ACOSTA	GRUPO ESCOLAR SAN DIEGO DE ALCALA	3828	7	44	2982	1243	2938	0	13	3	1	1678	2982
EDO. MIRANDA	CE. GUAICAIPURO	PQ. CECILIO ACOSTA	CONCENTRACION SIN NUMERO GUAREGUARE NUCLEO ESCOLAR RURAL 05	822	2	20	627	360	607	0	7	0	1	239	627
EDO. MIRANDA	CE. GUAICAIPURO	PQ. CECILIO ACOSTA	ESCUELA MUNICIPAL RURAL AQUILES NAZOA	1133	2	7	934	572	927	0	4	1	0	350	934
EDO. MIRANDA	CE. GUAICAIPURO	PQ. CECILIO ACOSTA	MODULO BARRIO ADENTRO LOS OCUMITOS	229	1	6	213	186	207	0	0	0	0	21	213
EDO. MIRANDA	CE. GUAICAIPURO	PQ. PARACOTOS	CENTRO DE EDUCACION INICIAL ZOILA DE RINCON	288	1	4	257	182	253	0	1	0	0	70	257
EDO. MIRANDA	CE. GUAICAIPURO	PQ. PARACOTOS	CONCENTRACION ESTADAL RURAL SATUQUE	128	1	1	121	108	120	0	0	1	0	11	121
EDO. MIRANDA	CE. GUAICAIPURO	PQ. PARACOTOS	CASA DE LA CULTURA	826	2	23	721	517	698	0	1	1	0	179	721
EDO. MIRANDA	CE. GUAICAIPURO	PQ. PARACOTOS	ESCUELA BASICA ESTADAL CONCENTRADA EL HATO	160	1	5	145	92	140	0	1	0	0	47	145
EDO. MIRANDA	CE. GUAICAIPURO	PQ. PARACOTOS	UNIDAD EDUCATIVA ESTADAL BOLIVARIANA PALO NEGRO	728	2	8	552	353	544	0	3	1	0	187	552
EDO. MIRANDA	CE. GUAICAIPURO	PQ. PARACOTOS	ESCUELA ESTADAL ALEJANDRINA DE LUGO	1869	4	37	1542	838	1505	0	3	0	1	663	1542
EDO. MIRANDA	CE. GUAICAIPURO	PQ. PARACOTOS	GRUPO ESCOLAR PARACOTOS	3292	6	58	2612	1402	2554	0	8	5	1	1138	2612
EDO. MIRANDA	CE. GUAICAIPURO	PQ. PARACOTOS	UNIDAD EDUCATIVA NACIONAL BOLIVARIANA JOSE FELIX RIBAS	784	2	19	651	493	632	0	1	1	0	137	651
EDO. MIRANDA	CE. GUAICAIPURO	PQ. PARACOTOS	CONCENTRACION ESCOLAR NUMERO 38	407	1	5	314	142	309	0	2	1	2	162	314
EDO. MIRANDA	MP. PAEZ	PQ. RIO CHICO	CONCENTRACIÓN NACIONAL SIN NÚMERO	1172	2	13	987	748	974	0	4	1	0	221	987
EDO. MIRANDA	MP. PAEZ	PQ. RIO CHICO	CONCENTRACION  ESCOLAR NACIONAL NUMERO 79 NUCLEO NUMERO 18	1302	3	42	1082	678	1040	1	6	1	0	354	1082
EDO. MIRANDA	MP. PAEZ	PQ. RIO CHICO	CENTRO DE EDUCACIÓN INICIAL JOSÉ ANTONIO PÁEZ	1244	3	36	1009	499	973	0	2	1	0	471	1009
EDO. MIRANDA	MP. PAEZ	PQ. RIO CHICO	ESCUELA ESTADAL UNITARIA NUMERO 130	548	1	4	449	304	445	0	2	0	0	139	449
EDO. MIRANDA	MP. PAEZ	PQ. RIO CHICO	COLEGIO SAN PABLO DE LA CRUZ	828	2	29	695	343	666	0	1	0	0	322	695
EDO. MIRANDA	MP. PAEZ	PQ. RIO CHICO	CONCENTRACION ESCOLAR NUMERO 74	581	1	6	458	399	452	0	1	1	0	51	458
EDO. MIRANDA	MP. PAEZ	PQ. RIO CHICO	ESCUELA BÁSICA ESTADAL LOS CERROS	597	1	21	445	287	424	0	2	0	0	135	445
EDO. MIRANDA	MP. PAEZ	PQ. RIO CHICO	GRUPO ESCOLAR RAFAEL AREVALO GONZALEZ	2604	5	46	2057	967	2011	0	9	0	1	1034	2057
EDO. MIRANDA	MP. PAEZ	PQ. RIO CHICO	ESCUELA ESTADAL ANDRES BELLO	1304	3	44	1024	659	980	1	5	0	0	315	1024
EDO. MIRANDA	MP. PAEZ	PQ. RIO CHICO	CENTRO DE EDUCACION INICIAL LA VIRGINIA	484	1	12	406	253	394	0	0	0	0	141	406
EDO. MIRANDA	MP. PAEZ	PQ. RIO CHICO	UNIDAD EDUCATIVA 13 DE JUNIO	2279	4	61	1822	878	1761	2	2	1	1	877	1822
EDO. MIRANDA	MP. PAEZ	PQ. RIO CHICO	CONCENTRACION ESTADAL NUMERO 73	1021	2	14	842	564	828	0	3	0	0	261	842
EDO. MIRANDA	MP. PAEZ	PQ. EL GUAPO	CONCENTRACION NACIONAL NUMERO 31 CASERIO EL ROSARIO	577	1	4	447	369	443	0	3	0	0	71	447
EDO. MIRANDA	MP. PAEZ	PQ. EL GUAPO	UNIDAD EDUCATIVA AMELIA FERRER	909	2	12	735	550	723	0	3	0	1	169	735
EDO. MIRANDA	MP. PAEZ	PQ. EL GUAPO	ESCUELA RURAL UNITARIA	529	1	14	393	296	379	0	1	0	0	82	393
EDO. MIRANDA	MP. PAEZ	PQ. EL GUAPO	CONCENTRACIÓN ESTADAL BATATAL	187	1	3	122	83	119	0	1	0	0	35	122
EDO. MIRANDA	MP. PAEZ	PQ. EL GUAPO	CONCENTRACION ESTADADAL SIN NUMERO EL NISPERO	213	1	2	186	151	184	0	0	0	0	33	186
EDO. MIRANDA	MP. PAEZ	PQ. EL GUAPO	ESCUELA BOLIVARIANA FELIPE NERI	2405	5	41	1866	1256	1825	0	5	1	1	562	1866
EDO. MIRANDA	MP. PAEZ	PQ. EL GUAPO	ESCUELA UNITARIA NUMERO 76	279	1	1	229	191	228	0	1	0	0	36	229
EDO. MIRANDA	MP. PAEZ	PQ. EL GUAPO	CONCENTRACION ESTADAL BOLIVARIANA 128	149	1	2	142	112	140	0	0	1	0	27	142
EDO. MIRANDA	MP. PAEZ	PQ. EL GUAPO	CONCENTRACION ESTADAL BOLIVARIANA LOS MEDANOS	158	1	1	141	131	140	0	0	1	0	8	141
EDO. MIRANDA	MP. PAEZ	PQ. SN FERNANDO DEL GUAPO	GRUPO ESCOLAR NACIONAL PADRE SALDIVAR	1848	4	51	1453	921	1402	1	12	1	0	467	1453
EDO. MIRANDA	MP. PAEZ	PQ. SN FERNANDO DEL GUAPO	CONCENTRACION NACIONAL  NUMERO65 EL CRISTO	484	1	6	384	281	378	0	2	0	0	95	384
EDO. MIRANDA	MP. PAEZ	PQ.TACARIGUA DE LA LAGUNA	LICEO BOLIVARIANO ESTADAL DANILO ANDERSON	404	1	4	349	217	345	0	0	0	0	128	349
EDO. MIRANDA	MP. PAEZ	PQ.TACARIGUA DE LA LAGUNA	ESCUELA CONCENTRADA ESTADAL SIN NUMERO	1118	2	32	940	620	908	0	8	0	2	278	940
EDO. MIRANDA	MP. PAEZ	PQ.TACARIGUA DE LA LAGUNA	ESCUELA ESTADAL GRADUADA JUAN FRANCISCO DE LEON	1702	3	27	1376	622	1349	0	4	1	0	722	1376
EDO. MIRANDA	MP. PAEZ	PQ. PAPARO	CONCENTRACION NACIONAL NUMERO 24	1029	2	17	866	532	849	0	5	0	0	312	866
EDO. BARINAS	CE. BARINAS	PQ. SAN SILVESTRE	UNIDAD  BASICA  ALEJO FORTIQUE	1908	4	35	1469	947	1434	1	8	0	1	477	1469
EDO. BARINAS	CE. BARINAS	PQ. SAN SILVESTRE	ESCUELA ESTADAL CONCENTRADA  183 LA LEGUA	757	2	9	637	395	628	0	4	0	0	229	637
EDO. BARINAS	CE. BARINAS	PQ. SAN SILVESTRE	ESCUELA BASICA ESTADAL CONCENTRADA VAINILLA. NER 315	360	1	10	292	194	282	0	3	0	0	85	292
EDO. BARINAS	CE. BARINAS	PQ. SAN SILVESTRE	ESCUELA NACIONAL CONCENTRADA NUCLEO ESCOLAR RURAL 315 EL FANTASMA	234	1	4	202	186	198	0	1	0	0	11	202
EDO. BARINAS	CE. BARINAS	PQ. SAN SILVESTRE	INFOCENTRO SAN SILVESTRE DE TOTUMAL	446	1	3	374	272	371	0	4	1	0	94	374
EDO. BARINAS	CE. BARINAS	PQ. SAN SILVESTRE	ESCUELA ESTADAL CONCENTRADA MORROCOY 749	483	1	8	384	210	376	0	0	0	0	166	384
EDO. BARINAS	CE. BARINAS	PQ. SAN SILVESTRE	ESCUELA ESTADAL CONCENTRADA  LA CASCABEL	642	2	6	540	376	534	0	3	0	0	155	540
EDO. BARINAS	CE. BARINAS	PQ. SAN SILVESTRE	ESCUELA BASICA NACIONAL CONCENTRADA PUNTO FIJO	215	1	1	184	157	183	0	2	0	0	24	184
EDO. BARINAS	CE. BARINAS	PQ. SAN SILVESTRE	ESCUELA BASICA CONCENTRADA LAS MERCEDES	142	1	3	130	107	127	0	1	0	0	19	130
EDO. BARINAS	CE. BARINAS	PQ. SAN SILVESTRE	ESCUELA NACIONAL CONCENTRADA SIN NUMERO HATO VAINILLA	295	1	16	236	186	220	0	3	0	0	31	236
EDO. BARINAS	CE. BARINAS	PQ. RAMON I MENDEZ	ESCUELA BOLIVARIANA JUAN PABLO II	3189	6	61	2443	1714	2382	1	15	1	2	649	2443
EDO. BARINAS	CE. BARINAS	PQ. RAMON I MENDEZ	CENTRO DE EDUCACION INICIAL HIJOS DE LA PATRIA	328	1	6	298	234	292	0	4	0	0	54	298
EDO. BARINAS	CE. BARINAS	PQ. RAMON I MENDEZ	JARDIN DE INFANCIA BOLIVARIANO	992	2	16	834	365	818	0	1	0	1	451	834
EDO. BARINAS	CE. BARINAS	PQ. RAMON I MENDEZ	CENTRO DE EDUCACION INICIAL  NIÑO VENEZOLANO	3909	7	77	3407	1708	3330	1	13	1	0	1607	3407
EDO. BARINAS	CE. BARINAS	PQ. RAMON I MENDEZ	CENTRO DE EDUCACIÓN  INICIAL SIMONCITO FLORENTINO	459	1	12	395	289	383	0	4	0	0	90	395
EDO. BARINAS	CE. BARINAS	PQ. RAMON I MENDEZ	UNIDAD  BASICA HERMINIO LEON COLMENARES	4379	8	81	3720	1719	3639	1	8	1	0	1910	3720
EDO. BARINAS	CE. BARINAS	PQ. RAMON I MENDEZ	CENTRO DE EDUCACION INICIAL MI JARDIN	2595	5	34	2004	1401	1970	0	18	0	0	551	2004
EDO. BARINAS	CE. BARINAS	PQ. RAMON I MENDEZ	ESCUELA BASICA PEDRO PEREZ DELGADO MAISANTA	202	1	4	184	142	180	0	2	0	0	36	184
EDO. BARINAS	CE. BARINAS	PQ. RAMON I MENDEZ	ESCUELA BASICA BOLIVARIANA VIRGEN MARIA	3251	6	127	2630	1702	2503	1	16	0	0	784	2630
EDO. BARINAS	CE. BARINAS	PQ. RAMON I MENDEZ	ESCUELA BASICA JOSE FELIX RIBAS	81	1	4	63	51	59	0	0	1	0	7	63
EDO. BARINAS	CE. BARINAS	PQ. RAMON I MENDEZ	ESCUELA TECNICA COMERCIAL ROBINSONIANA JOSE LEONARDO CHIRINOS	448	1	24	384	275	360	0	3	1	1	80	384
EDO. BARINAS	CE. BARINAS	PQ. RAMON I MENDEZ	ESCUELA BASICA JERUSALEN	252	1	10	199	165	189	0	2	0	0	22	199
EDO. BARINAS	CE. BARINAS	PQ. RAMON I MENDEZ	LICEO NACIONAL BOLIVARIANO TRINA DE SEGOVIA	1259	3	31	993	704	962	0	6	0	0	252	993
EDO. BARINAS	CE. BARINAS	PQ. RAMON I MENDEZ	LICEO BOLIVARIANO LIBERTADOR	2762	5	57	2458	1344	2401	0	7	1	0	1049	2458
EDO. BARINAS	CE. BARINAS	PQ. RAMON I MENDEZ	UNIDAD  EDUCATIVA PADRE FELIPE  SALVADOR GILIJ	3828	7	104	3205	1948	3101	0	18	1	0	1134	3205
EDO. BARINAS	CE. BARINAS	PQ. RAMON I MENDEZ	ESCUELA  BASICA JOSEFINA ESTE DE LAMAS	2770	5	36	2121	1304	2085	1	13	2	0	765	2121
EDO. BARINAS	CE. BARINAS	PQ. RAMON I MENDEZ	PRE ESCOLAR DON ANDRES BELLO	1167	2	17	957	738	940	0	11	0	0	191	957
EDO. BARINAS	CE. BARINAS	PQ. RAMON I MENDEZ	CENTRO DE EDUCACION INICIAL MI FUTURO	597	1	10	505	395	495	0	3	0	0	97	505
EDO. BARINAS	CE. BARINAS	PQ. RAMON I MENDEZ	ESCUELA BASICA CORRALITOS II	859	2	14	734	619	720	0	3	0	0	98	734
EDO. BARINAS	CE. BARINAS	PQ. RAMON I MENDEZ	PRE ESCOLAR PRADO DEL ESTE	1556	3	29	1355	541	1326	0	10	5	1	769	1355
EDO. BARINAS	CE. BARINAS	PQ. RAMON I MENDEZ	MODULO DE SERVICIOS COROCITO	348	1	10	315	184	305	1	3	0	0	117	315
EDO. BARINAS	CE. BARINAS	PQ. RAMON I MENDEZ	LICEO NACIONAL BOLIVARIANO GENERAL EN JEFE JOSE FELIX RIBAS	1658	3	33	1361	881	1328	1	7	3	0	436	1361
EDO. BARINAS	CE. BARINAS	PQ. CORAZON DE JESUS	ESCUELA BASICA ANTONIO JOSE  DE SUCRE	2415	5	42	1986	1293	1944	1	8	1	0	641	1986
EDO. BARINAS	CE. BARINAS	PQ. CORAZON DE JESUS	CENTRO DE EDUCACION INICIAL PUNTA GORDA	285	1	4	232	161	228	0	0	0	1	66	232
EDO. BARINAS	CE. BARINAS	PQ. CORAZON DE JESUS	UNIDAD EDUCATIVA DOCTOR JOSE OCTAVIO ENRRIQUEZ	626	2	15	569	399	554	0	6	1	1	147	569
EDO. BARINAS	CE. BARINAS	PQ. CORAZON DE JESUS	UNIDAD EDUCATIVA ESTADAL BACHILLER JOSE RAFAEL BRICEÑO ALTUVE	3265	6	70	2546	1609	2476	1	9	2	1	854	2546
EDO. BARINAS	CE. BARINAS	PQ. CORAZON DE JESUS	CENTRO DE EDUCACION INICIAL BOLIVARIANO ALTAMIRA	108	1	2	93	65	91	0	0	0	0	26	93
EDO. BARINAS	CE. BARINAS	PQ. CORAZON DE JESUS	ESCUELA BASICA MENCA DE LEONI	2163	4	37	1826	915	1789	2	10	1	1	860	1826
EDO. BARINAS	CE. BARINAS	PQ. CORAZON DE JESUS	ESCUELA INTERNADO JUDICIAL CONCENTRADA  21	1212	3	19	650	579	631	1	2	0	0	49	650
EDO. BARINAS	CE. BARINAS	PQ. CORAZON DE JESUS	ESCUELA BASICA BOLIVARIANA LA CONCORDIA	2834	5	44	2278	1083	2234	2	13	2	0	1134	2278
EDO. BARINAS	CE. BARINAS	PQ. CORAZON DE JESUS	ESCUELA BASICA HERLINDA DE VALERO	3515	7	82	2794	1917	2712	0	20	1	0	774	2794
EDO. BARINAS	CE. BARINAS	PQ. CORAZON DE JESUS	UNIDAD EDUCATIVA PRIVADA SUB OFICIAL TEREZA DE LA ASUNCION FE Y ALEGRIA	368	1	6	334	226	328	0	1	1	0	100	334
EDO. BARINAS	CE. BARINAS	PQ. CORAZON DE JESUS	CENTRO DE EDUCACION INICIAL  VARYNA	315	1	5	272	154	267	0	0	0	0	113	272
EDO. BARINAS	CE. BARINAS	PQ. CORAZON DE JESUS	UNIDAD EDUCATIVA ESTADAL JOSÉ RAFAEL MENDOZA RUBIO	666	2	8	583	442	575	0	3	0	0	130	583
EDO. BARINAS	CE. BARINAS	PQ. CORAZON DE JESUS	CENTRO EDUCATIVO INICIAL BOLIVARIANO MISIA JACINTA DE CRESPO	315	1	6	271	193	265	0	3	0	1	68	271
EDO. BARINAS	CE. BARINAS	PQ. CORAZON DE JESUS	JARDIN DE INFANCIA FRANCISCO RIVAS	1348	3	17	1163	643	1146	0	6	1	0	496	1163
EDO. BARINAS	CE. BARINAS	PQ. CORAZON DE JESUS	UNIDAD EDUCATIVA RAMON REINOSO NUÑEZ	2121	4	34	1773	934	1739	1	18	0	2	784	1773
EDO. BARINAS	CE. BARINAS	PQ. CORAZON DE JESUS	GRUPO ESCOLAR FRANCISCO RIVAS	3108	6	28	2528	1292	2500	5	14	0	3	1186	2528
EDO. BARINAS	CE. BARINAS	PQ. CORAZON DE JESUS	UNIDA BASICA LA INMACULADA FE Y ALEGRIA	3746	7	57	3180	1401	3123	0	15	2	2	1703	3180
EDO. BARINAS	CE. BARINAS	PQ. CORAZON DE JESUS	AMBULATORIO CARLOS MARQUEZ	1048	2	14	837	570	823	1	7	1	0	244	837
EDO. BARINAS	CE. BARINAS	PQ. CORAZON DE JESUS	ESCUELA TECNICA ASISTENCIAL VENEZUELA	1540	3	38	1233	820	1195	1	9	2	0	363	1233
EDO. BARINAS	CE. BARINAS	PQ. CORAZON DE JESUS	ESCUELA BOLIVARIANA MANUELITA SAENZ	971	2	33	860	467	827	0	2	0	1	357	860
EDO. BARINAS	CE. BARINAS	PQ. CORAZON DE JESUS	ESCUELA BASICA MERCEDES DE JESUS MOLINA	99	1	4	89	62	85	0	0	0	0	23	89
EDO. BARINAS	CE. BARINAS	PQ. CORAZON DE JESUS	CICLO BASICO RAFAEL MEDINA JIMENEZ	126	1	2	108	63	106	0	0	0	0	43	108
EDO. BARINAS	CE. BARINAS	PQ. CORAZON DE JESUS	CENTRO DE EDUCACIÓN INICIAL  BOLIVARIANO NEGRO PRIMERO	651	2	9	583	398	574	0	4	0	0	172	583
EDO. BARINAS	CE. BARINAS	PQ. CORAZON DE JESUS	UNIDAD EDUCATIVA ESTADAL 27 DE JUNIO	619	2	14	558	415	544	0	3	0	0	126	558
EDO. BARINAS	CE. BARINAS	PQ. CORAZON DE JESUS	UNIDAD EDUCATIVA  BOLIVARIANO SIMON  AGUSTIN JIMENEZ	3617	7	42	3088	1341	3046	2	18	0	3	1682	3088
EDO. BARINAS	CE. BARINAS	PQ. EL CARMEN	ESCUELA BASICA MARIA LA RIVA SALAS	5175	9	94	4345	1843	4251	1	25	4	1	2377	4345
EDO. BARINAS	CE. BARINAS	PQ. EL CARMEN	JARDIN  DE INFANCIA DON ROMULO GALLEGOS	3347	6	44	2972	1438	2928	0	14	0	2	1474	2972
EDO. BARINAS	CE. BARINAS	PQ. EL CARMEN	GIMNASIO CUBIERTO CIUDAD DE BARINAS	2346	4	33	1888	1138	1855	0	5	0	2	710	1888
EDO. BARINAS	CE. BARINAS	PQ. EL CARMEN	ESCUELA BASICA JUAN ESCALONA	2984	6	28	2549	780	2521	0	13	0	1	1727	2549
EDO. BARINAS	CE. BARINAS	PQ. EL CARMEN	ESCUELA BASICA EZEQUIEL ZAMORA	3351	6	57	2648	1337	2591	3	13	0	0	1238	2648
EDO. BARINAS	CE. BARINAS	PQ. EL CARMEN	INCE CONSTRUCCION	2293	4	41	1858	871	1817	0	11	0	0	935	1858
EDO. BARINAS	CE. BARINAS	PQ. EL CARMEN	PRE ESCOLAR JARDIN DE INFANCIA MARIA LARRIVA SALAS	2247	4	27	1970	908	1943	1	5	0	1	1028	1970
EDO. BARINAS	CE. BARINAS	PQ. EL CARMEN	ESCUELA BASICA  NACIONAL  EL MOLINO	1452	3	18	1301	810	1283	0	7	0	0	466	1301
EDO. BARINAS	CE. BARINAS	PQ. EL CARMEN	ESCUELA  TECNICA  INDUSTRAL  EZEQUIEL ZAMORA	1554	3	46	1253	626	1207	1	5	0	0	575	1253
EDO. BARINAS	CE. BARINAS	PQ. EL CARMEN	GRUPO ESCOLAR CARLOS SOUBLETTE	4027	7	84	3428	1536	3344	0	17	1	0	1790	3428
EDO. BARINAS	CE. BARINAS	PQ. EL CARMEN	ESCUELA BASICA NACIONAL 24 DE JUNIO	3651	7	66	3016	1052	2950	0	13	1	2	1882	3016
EDO. BARINAS	CE. BARINAS	PQ. EL CARMEN	ESCUELA BASICA DON MARIANO PICON  SALAS	4311	8	97	3503	1616	3406	2	16	3	1	1768	3503
EDO. BARINAS	CE. BARINAS	PQ. ALTO BARINAS	ESCUELA BASICA BOLIVARIANA LAS PALMAS	1843	4	23	1606	1031	1583	0	13	0	0	539	1606
EDO. BARINAS	CE. BARINAS	PQ. ALTO BARINAS	LICEO NACIONAL BOLIVARIANO LAS COLINAS DEL LLANO	1502	3	31	1340	772	1309	0	2	1	0	534	1340
EDO. BARINAS	CE. BARINAS	PQ. ALTO BARINAS	ESCUELA BASICA MI JARDIN II	718	2	16	553	396	537	0	5	0	0	136	553
EDO. BARINAS	CE. BARINAS	PQ. ALTO BARINAS	UNIDA BASICA EDUCATIVA  BILINGUE NUESTRA  SEÑORA DE FATIMA	2374	5	34	2167	614	2133	0	10	4	0	1505	2167
EDO. BARINAS	CE. BARINAS	PQ. ALTO BARINAS	UNIDAD  EDUCATIVA  BASICA  ALTO BARINAS SUR	4304	8	39	3723	606	3684	1	11	1	1	3064	3723
EDO. BARINAS	CE. BARINAS	PQ. ALTO BARINAS	CENTRO SOCIAL CIUDAD TAVACARE	976	2	26	895	773	869	0	6	0	2	88	895
EDO. BARINAS	CE. BARINAS	PQ. ALTO BARINAS	UNIDAD EDUCATIVA ANDRES ELOY BLANCO	2835	5	50	2501	952	2451	0	11	2	2	1484	2501
EDO. BARINAS	CE. BARINAS	PQ. ALTO BARINAS	ESCUELA BASICA BOLIVARIANA CIUDAD VARYNA	3348	6	64	2990	1676	2926	0	15	0	1	1234	2990
EDO. BARINAS	CE. BARINAS	PQ. ALTO BARINAS	ESCUELA BASICA LA ROSALEDA	2382	5	46	2048	1316	2002	0	12	1	0	673	2048
EDO. BARINAS	CE. BARINAS	PQ. ALTO BARINAS	TALLER DE EDUCACION  LABORAL ALTO BARINAS	3484	6	34	3184	890	3150	0	6	3	3	2248	3184
EDO. BARINAS	CE. BARINAS	PQ. ALTO BARINAS	ESCUELA BOLIVARIANA PAGUEICITOO	349	1	10	281	215	271	1	2	0	0	53	281
EDO. BARINAS	CE. BARINAS	PQ. ALTO BARINAS	UNIDAD EDUCATIVA ALTO BARINAS NORTE.LA EXCELENCIA.	1688	3	13	1502	564	1489	0	6	0	1	918	1502
EDO. BARINAS	CE. BARINAS	PQ. ALTO BARINAS	ESCUELA BASICA MI JARDIN III	587	1	11	476	363	465	0	3	0	0	99	476
EDO. BARINAS	CE. BARINAS	PQ. ALTO BARINAS	ESCUELA BASICA 15 DE ENERO	727	2	17	595	391	578	0	1	0	0	186	595
EDO. BARINAS	CE. BARINAS	PQ. ALTO BARINAS	ESCUELA BASICA BOLIVARIANA PEDRO BRICEÑO MENDEZ	1327	3	22	1183	779	1161	1	6	0	1	374	1183
EDO. BARINAS	CE. BARINAS	PQ. ALTO BARINAS	ESCUELA BASICA TRINA BRICENO DE SEGOVIA	2225	4	46	1655	1103	1609	0	9	2	1	494	1655
EDO. BARINAS	CE. BARINAS	PQ. ALTO BARINAS	UNIDAD  EDUCATIVA  SIMON BOLIVAR C.A	3286	6	34	2959	846	2925	0	3	2	2	2072	2959
EDO. BARINAS	CE. BARINAS	PQ. JUAN A RODRIGUEZ D	ESCUELA BASICA RAFAEL MONTENEGRO	2201	4	62	1771	1024	1709	0	3	1	0	681	1771
EDO. BARINAS	CE. BARINAS	PQ. JUAN A RODRIGUEZ D	UNIDAD EDUCATIVA BOLIVARIANA LA ERIKA	379	1	16	295	193	279	0	2	1	0	83	295
EDO. BARINAS	CE. BARINAS	PQ. MANUEL P FAJARDO	ESCUELA BASICA UNITARIA  VALLE HONDO NER 317	104	1	3	79	39	76	0	0	0	0	37	79
EDO. BARINAS	CE. BARINAS	PQ. MANUEL P FAJARDO	ESCUELA BASICA ESTATAL VIRGINIA DE CONTRERAS	4585	9	115	3683	2015	3568	0	11	5	0	1537	3683
EDO. BARINAS	CE. BARINAS	PQ. MANUEL P FAJARDO	CENTRO DE EDUCACION INICIAL BOLIVARIANO LAS DELICIAS	272	1	8	241	167	233	0	2	0	0	64	241
EDO. BARINAS	CE. BARINAS	PQ. MANUEL P FAJARDO	ESCUELA BOLIVARIANA LA ECHEVERRIA	191	1	0	150	78	150	0	0	0	0	72	150
EDO. BARINAS	CE. BARINAS	PQ. MANUEL P FAJARDO	ESCUELA BASICA BOLIVARIANA LA CARAMUCA. EL PUENTE. NUCLEO ESCOLAR RURAL 147	462	1	2	395	319	393	0	0	0	0	74	395
EDO. BARINAS	CE. BARINAS	PQ. TORUNOS	UNIDAD EDUCATIVA BOLIVARIANA CARONI BAJO	386	1	8	341	243	333	0	1	0	0	89	341
EDO. BARINAS	CE. BARINAS	PQ. TORUNOS	UNIDAD BASICA TORUNOS	2468	5	54	2058	1231	2004	0	3	0	0	770	2058
EDO. BARINAS	CE. BARINAS	PQ. TORUNOS	ESCUELA BASICA ESTADAL CONCENTRADA CARONI ALTO
EDO. BARINAS	CE. BARINAS	PQ. BARINAS	CASA DE LA CULTURA NAPOLEON SEBASTIAN ARTEAGA	1058	2	20	836	390	816	1	7	1	0	417	836
EDO. BARINAS	CE. BARINAS	PQ. BARINAS	BIBLIOTECA ANDRES ELOY BLANCO	999	2	13	757	252	744	0	4	2	0	486	757
EDO. BARINAS	CE. BARINAS	PQ. BARINAS	UNIDAD EDUCATIVA MARQUES DEL PUMAR	231	1	2	182	77	180	0	1	0	0	102	182
EDO. BARINAS	CE. BARINAS	PQ. BARINAS	GRUPO ESCOLAR ESTADO GUARICO	2996	6	32	2465	870	2433	1	12	0	1	1549	2465
EDO. BARINAS	CE. BARINAS	PQ. BARINAS	CICLO  DIVERSIFICADO DANIEL FLORENCIO  OLEARY	2679	5	42	2000	755	1958	0	11	1	1	1190	2000
EDO. BARINAS	CE. BARINAS	PQ. BARINAS	ESCUELA ARTES PLASTICAS CRISTOBAL ROJAS	954	2	12	731	253	719	0	4	1	0	461	731
EDO. BARINAS	CE. BARINAS	PQ. BARINAS	ESCUELA BASICA PASCUAL IIGNASIO VILLASMIL	1783	4	38	1438	645	1400	0	6	0	1	748	1438
EDO. BARINAS	CE. BARINAS	PQ. BARINAS	ESCUELA BASICA RAMON IGNASIO  MENDEZ	1670	3	36	1360	583	1324	0	5	0	0	736	1360
EDO. BARINAS	CE. BARINAS	PQ. DOMINGA ORTIZ P	ESCUELA BASICA PALMITAS DE CAMIRI	514	1	14	390	191	376	0	3	0	0	182	390
EDO. BARINAS	CE. BARINAS	PQ. DOMINGA ORTIZ P	ESCUELA BASICA 10 DE DICIEMBRE	2112	4	46	1620	1095	1574	0	4	1	0	474	1620
EDO. BARINAS	CE. BARINAS	PQ. DOMINGA ORTIZ P	ESCUELA ESTADAL BOLIVARIANA MIGUEL TOBIAS QUINONES	728	2	11	594	373	583	0	2	0	0	208	594
EDO. BARINAS	CE. BARINAS	PQ. DOMINGA ORTIZ P	ESCUELA BOLIVARIANA CESAR MORA	1325	3	31	1061	614	1030	0	4	0	0	412	1061
EDO. BARINAS	CE. BARINAS	PQ. DOMINGA ORTIZ P	ESCUELA BASICA ESTADAL CONCENTRADA CORRALES PALMITAS  NUCLEO ESCOLAR RURAL 147   A	252	1	6	210	124	204	0	0	0	0	80	210
EDO. BARINAS	CE. BARINAS	PQ. DOMINGA ORTIZ P	ESCUELA BASICA CONCENTRADA LA MULITA	59	1	1	48	36	47	0	0	0	0	11	48
EDO. BARINAS	CE. BARINAS	PQ. DOMINGA ORTIZ P	ESCUELA BASICA CONCENTRADA CASITAS DE CAMIRI I	86	1	4	83	33	79	0	1	0	0	45	83
EDO. BARINAS	CE. BARINAS	PQ. SANTA LUCIA	ESCUELA BOLIVARIANA LA OTENERA NUCLEO ESCOLAR RURAL 017	241	1	9	202	110	193	0	0	0	0	83	202
EDO. BARINAS	CE. BARINAS	PQ. SANTA LUCIA	ESCUELA NACIONAL CONCENTRADA CHAPARRAL NUCLEO ESCOLAR RURAL 017	385	1	3	300	227	297	0	3	0	0	67	300
EDO. BARINAS	CE. BARINAS	PQ. SANTA LUCIA	ESCUELA BASICA SANTA LUCIA	2996	6	75	2143	1193	2068	0	13	2	0	860	2143
EDO. BARINAS	CE. BARINAS	PQ. SANTA LUCIA	ESCUELA  ESTADAL  CONCENTRADA COROZAL NUCLEO ESCOLAR RURAL 017	257	1	9	213	144	204	0	3	0	0	57	213
EDO. BARINAS	CE. BARINAS	PQ. ROMULO BETANCOURT	ESCUELA BASICA LOURDES RIVAS  DE TORRES	3786	7	80	3040	1890	2960	1	14	2	0	1053	3040
EDO. BARINAS	CE. BARINAS	PQ. ROMULO BETANCOURT	CICLO DIVERSIFICADO  MANUEL PALACIO  FAJARDO	3399	6	70	2798	1534	2728	0	21	2	2	1169	2798
EDO. BARINAS	CE. BARINAS	PQ. ROMULO BETANCOURT	CENTRO DE EDUCACION INICIAL  25 DE MAYO	1083	2	22	909	493	887	0	6	0	1	387	909
EDO. BARINAS	CE. BARINAS	PQ. ROMULO BETANCOURT	CENTRO DE EDUCACION INICIAL BOLIVARIANO DE BARINAS	307	1	1	291	150	290	0	2	0	0	138	291
EDO. BARINAS	CE. BARINAS	PQ. ROMULO BETANCOURT	ESCUELA BASICA ESTADAL ANGELA MENDOZA  DE SANCHEZ	2480	5	49	2022	1470	1973	0	9	2	0	492	2022
EDO. BARINAS	CE. BARINAS	PQ. ROMULO BETANCOURT	ESCUELA BASICA DON  LINO JIMENEZ	3304	6	42	2638	1546	2596	0	19	1	2	1028	2638
EDO. BARINAS	CE. BARINAS	PQ. ROMULO BETANCOURT	GRUPO ESCOLAR  RAFAEL IGNACIO MENDOZA	2908	5	24	2400	1180	2376	0	13	1	2	1180	2400
EDO. BARINAS	CE. BARINAS	PQ. ROMULO BETANCOURT	ESCUELA BASICA CIUDAD BARINAS	3448	6	58	2759	1482	2701	1	17	1	0	1200	2759
EDO. BARINAS	CE. BARINAS	PQ. ROMULO BETANCOURT	ESCUELA ESTADAL CONCENTRADA EL POZON	1920	4	38	1549	1002	1511	0	12	0	0	497	1549
EDO. BARINAS	CE. BARINAS	PQ. ROMULO BETANCOURT	INSTITUTO DE EDUCACION ESPECIAL LOS LLANOS	1108	2	7	944	498	937	0	4	0	1	434	944
EDO. BARINAS	CE. BARINAS	PQ. ROMULO BETANCOURT	ESCUELA BASICA ESTADAL SANTIAGO MARIÑO	453	1	4	396	292	392	0	1	0	1	98	396
EDO. BARINAS	CE. BARINAS	PQ. ROMULO BETANCOURT	ESCUELA BASICA JUAN ANDRES VARELA	3602	7	43	3093	1095	3050	0	18	2	3	1932	3093
EDO. BARINAS	CE. BARINAS	PQ. ROMULO BETANCOURT	INSTITUTO DE EDUCACION ESPECIAL BARINAS	979	2	11	866	295	855	0	5	0	0	555	866
EDO. BARINAS	CE. BARINAS	PQ. ROMULO BETANCOURT	LICEO BOLIVARIANO GUANIPA	535	1	5	438	331	433	0	3	0	1	98	438
EDO. BARINAS	CE. BARINAS	PQ. ALFREDO A LARRIVA	UNIDAD EDUCATIVA DOMINGA ORTIZ DE PAEZ	3719	7	67	2917	1547	2850	0	11	2	1	1289	2917
EDO. BARINAS	CE. BARINAS	PQ. ALFREDO A LARRIVA	UNIDAD EDUCATIVA IRMIS CADENAS DE HERNANDEZ	718	2	6	636	467	630	0	2	1	0	160	636
EDO. BARINAS	CE. BARINAS	PQ. ALFREDO A LARRIVA	ESCUELA BASICA BOLIVARIANA LA PARANGULA NUCLEO ESCOLAR RURAL  045	329	1	6	303	243	297	0	2	0	0	52	303
EDO. BARINAS	CE. BARINAS	PQ. ALFREDO A LARRIVA	ESCUELA ESTADAL CONCENTRADA SANTA ELENA	97	1	0	89	65	89	0	2	0	0	22	89
EDO. BARINAS	CE. BARINAS	PQ. ALFREDO A LARRIVA	ESCUELA BASICA ESTADAL CONCENTRADA LA COLONIA DEL CURAY	391	1	3	322	215	319	0	0	0	0	104	322
EDO. BARINAS	CE. BARINAS	PQ. SANTA INES	ESCUELA BASICA ESTADAL CONCENTRADA BOLIVARIANA RIO SECO NER 403	172	1	1	146	96	145	0	1	0	0	48	146
EDO. BARINAS	CE. BARINAS	PQ. SANTA INES	ESCUELA BOLIVARIANA ADONAY PARRA JIMENEZ	2145	4	31	1736	1166	1705	0	6	0	0	533	1736
EDO. BARINAS	MP. CRUZ PAREDES	PQ. BARRANCAS	ESCUELA ESTADAL CONCENTRADA TORO ARRIBA	369	1	8	225	173	217	0	0	0	0	44	225
EDO. BARINAS	MP. CRUZ PAREDES	PQ. BARRANCAS	ESCUELA  ETANISLAO CARVAJAL	964	2	9	821	637	812	0	4	0	0	171	821
EDO. BARINAS	MP. CRUZ PAREDES	PQ. BARRANCAS	UNIDAD  EDUCATIVA NACIONAL  LUIS LORETO PERALTA	1273	3	17	1061	761	1044	1	7	0	0	275	1061
EDO. BARINAS	MP. CRUZ PAREDES	PQ. BARRANCAS	ESCUELA BOLIVARIANA  CONCENTRADA  LAS GUAYABITAS	923	2	21	760	540	739	0	3	0	0	196	760
EDO. BARINAS	MP. CRUZ PAREDES	PQ. BARRANCAS	ESCUELA BASICA CONCENTRADA BOLIVARIANA LOS MANGOS	569	1	4	458	375	454	0	1	0	0	78	458
EDO. BARINAS	MP. CRUZ PAREDES	PQ. BARRANCAS	ESCUELA BASICA GENERAL FRANCISCO DE MIRANDA	603	2	14	509	373	495	0	4	0	0	118	509
EDO. BARINAS	MP. CRUZ PAREDES	PQ. BARRANCAS	CENTRO DE EDUCACIÓN  INICIAL NACIONAL BOLIVARIANO CRUZ PAREDES	418	1	2	345	245	343	0	1	0	0	97	345
EDO. BARINAS	MP. CRUZ PAREDES	PQ. BARRANCAS	UNIDAD EDUCATIVA GUILLERMO TELL VILLEGAS PULIDO	1945	4	36	1643	1205	1607	0	15	0	0	387	1643
EDO. BARINAS	MP. CRUZ PAREDES	PQ. BARRANCAS	ESCUELA BASICA ESTADAL BOLIVARIANA TORO ABAJO	59	1	0	50	48	50	0	0	0	0	2	50
EDO. BARINAS	MP. CRUZ PAREDES	PQ. BARRANCAS	ESCUELA BASICA BOLIVARIANA MAESTRO DIONICIO SOLIS	601	2	11	460	368	449	0	1	0	0	80	460
EDO. BARINAS	MP. CRUZ PAREDES	PQ. BARRANCAS	ESCUELA BOLIVARIANA LICENCIADO WILLIAM ARRIZAGA	143	1	2	126	90	124	0	1	0	0	33	126
EDO. BARINAS	MP. CRUZ PAREDES	PQ. BARRANCAS	ESCUELA ESTADAL CONCENTRADA SOCO III	125	1	1	115	107	114	0	0	0	0	7	115
EDO. BARINAS	MP. CRUZ PAREDES	PQ. BARRANCAS	CASA DE LA CULTURA NEMECIO PALACIO  LOZANO	1905	4	29	1569	1032	1540	1	10	1	0	496	1569
EDO. BARINAS	MP. CRUZ PAREDES	PQ. BARRANCAS	ESCUELA BASICA ESTADAL CONCENTRADA LA MAPORITA NUCLEO ESCOLAR RURAL 015	215	1	3	179	155	176	0	0	0	0	21	179
EDO. BARINAS	MP. CRUZ PAREDES	PQ. BARRANCAS	UNIDAD EDUCATIVA LAS TINAJAS NUCLEO ESCOLAR RURAL 16	161	1	0	145	133	145	0	0	0	0	12	145
EDO. BARINAS	MP. CRUZ PAREDES	PQ. BARRANCAS	ESCUELA BASICA ESTADAL UNITARIA EL TIGRE	54	1	0	51	45	51	0	0	0	0	6	51
EDO. BARINAS	MP. CRUZ PAREDES	PQ. BARRANCAS	GRUPO ESCOLAR NACIONAL CRUZ PAREDES	2966	6	36	2274	1481	2238	0	14	2	1	740	2274
EDO. BARINAS	MP. CRUZ PAREDES	PQ. BARRANCAS	ESCUELA ESTADAL CONCENTRADA 12 DE MARZO	996	2	32	860	712	828	0	6	1	0	109	860
EDO. BARINAS	MP. CRUZ PAREDES	PQ. BARRANCAS	ESCUELA ESTADAL  CONCENTRADA SOCO II	301	1	4	227	179	223	0	0	0	0	44	227
EDO. BARINAS	MP. CRUZ PAREDES	PQ. EL SOCORRO	UNIDAD EDUCATIVA  LAS MARAVILLAS	221	1	1	177	108	176	0	3	0	0	65	177
EDO. BARINAS	MP. CRUZ PAREDES	PQ. EL SOCORRO	ESCUELA BASICA ESTADAL CONCENTRADA BOLIVARIANA CALDERITAS II	297	1	4	227	143	223	0	3	0	0	77	227
EDO. BARINAS	MP. CRUZ PAREDES	PQ. EL SOCORRO	ESCUELA BASICA ESTADAL CONCENTRADA LA ARENOSA	79	1	1	75	42	74	0	1	0	0	31	75
EDO. BARINAS	MP. CRUZ PAREDES	PQ. EL SOCORRO	ESCUELA BASICA BOLIVARIANA EL PURGATORIO	300	1	1	238	177	237	0	0	1	0	59	238
EDO. BARINAS	MP. CRUZ PAREDES	PQ. EL SOCORRO	ESCUELA BASICA BOLIVARIANA LOIDA VASQUEZ DE CASTILLO	968	2	17	800	538	783	0	3	1	0	241	800
EDO. BARINAS	MP. CRUZ PAREDES	PQ. EL SOCORRO	ESCUELA BASICA  CONCENTRADA BOLIVARIANA  EL PESCADO	475	1	10	388	270	378	0	1	0	0	107	388
EDO. BARINAS	MP. CRUZ PAREDES	PQ. EL SOCORRO	ESCUELA BASICA CONCENTRADA EL CHARAL	443	1	17	350	210	333	0	5	1	0	117	350
EDO. BARINAS	MP. CRUZ PAREDES	PQ. EL SOCORRO	ESCUELA BASICA NACIONAL CONCENTRADA BOLIVARIANA LA DANTA	56	1	3	43	21	40	0	0	0	0	19	43
EDO. BARINAS	MP. CRUZ PAREDES	PQ. EL SOCORRO	ESCUELA BASICA ESTADAL CONCENTRADA CALDERITAS I	77	1	1	71	35	70	0	1	0	0	34	71
EDO. BARINAS	MP. CRUZ PAREDES	PQ. MASPARRITO	ESCUELA BASICA ESTADAL CONCENTRADA  POZO VERDE NUCLEO ESCOLAR RURAL NUMERO 015	116	1	0	94	58	94	0	0	0	0	36	94
EDO. BARINAS	MP. CRUZ PAREDES	PQ. MASPARRITO	ESCUELA ESTADAL CONCENTRADA MASPARRITO	273	1	3	177	153	174	1	1	0	0	19	177
EDO. BARINAS	MP. CRUZ PAREDES	PQ. MASPARRITO	ESCUELA ESTADAL UNITARIA LAS AGUITAS	74	1	0	29	17	29	0	0	0	0	12	29
EDO. BARINAS	MP. PEDRAZA	PQ. JOSE FELIX RIBAS	ESCUELA BOLIVARIANA ESCAGUEY ARRIBA	122	1	2	101	62	99	0	0	0	0	37	101
EDO. BARINAS	MP. PEDRAZA	PQ. JOSE FELIX RIBAS	ESCUELA BOLIVARIANA EL SILENCIO I	287	1	8	218	166	210	0	2	0	0	42	218
EDO. BARINAS	MP. PEDRAZA	PQ. JOSE FELIX RIBAS	ESCUELA BASICA ESTATAL BOLIVARIANA EL QUEBRADON	115	1	6	106	36	100	0	3	0	0	61	106
EDO. BARINAS	MP. PEDRAZA	PQ. JOSE FELIX RIBAS	ESCUELA BOLIVARIANA NACIONAL CONCENTRADA SIN NUMERO EL MESERO	275	1	2	237	218	235	0	0	0	0	17	237
EDO. BARINAS	MP. PEDRAZA	PQ. JOSE FELIX RIBAS	ESCUELA BASICA RURAL  ALTO LA AGUADA NUMERO 561	59	1	2	39	15	37	0	0	0	0	22	39
EDO. BARINAS	MP. PEDRAZA	PQ. JOSE FELIX RIBAS	UNIDAD EDUCATIVA ENRIQUE  CASTRO	2548	5	56	1964	1129	1908	1	3	0	0	775	1964
EDO. BARINAS	MP. PEDRAZA	PQ. JOSE FELIX RIBAS	UNIDAD EDUCATIVA LAS PALMAS NUMERO 561	590	1	3	434	240	431	0	0	0	0	191	434
EDO. BARINAS	MP. PEDRAZA	PQ. JOSE FELIX RIBAS	ESCUELA BASICA CONCENTRADA  BOLIVARIANA EL ALGARROBO	448	1	4	353	253	349	0	1	0	1	94	353
EDO. BARINAS	MP. PEDRAZA	PQ. JOSE FELIX RIBAS	ESCUELA BASICA CONCENTRADA  BOLIVARIANA ANIME NUMERO 561	538	1	6	404	253	398	1	2	0	0	142	404
EDO. BARINAS	MP. PEDRAZA	PQ. JOSE FELIX RIBAS	ESCUELA OFICIAL CONVINADA 4017	133	1	3	122	101	119	0	1	1	0	16	122
EDO. BARINAS	MP. PEDRAZA	PQ. JOSE FELIX RIBAS	ESCUELA BOLIVARIANA LA ARENOSITA NUCLEO ESTADAL RURAL  NUMERO 510	81	1	2	75	46	73	0	1	0	0	26	75
EDO. BARINAS	MP. PEDRAZA	PQ. JOSE FELIX RIBAS	ESCUELA BASICA NACIONAL UNITARIA SANTA MARIA DE CANAGUA	67	1	1	63	55	62	0	0	0	0	7	63
EDO. BARINAS	MP. PEDRAZA	PQ. JOSE FELIX RIBAS	ESCUELA BASICA NACIONAL UNITARIA  LOS COLONITOS NUCLEO ESCOLAR RURAL  561	231	1	3	207	196	204	0	1	0	0	7	207
EDO. BARINAS	MP. PEDRAZA	PQ. IGNACIO BRICE#O	ESCUELA BASICA AURA DE MARQUEZ	2101	4	24	1508	700	1484	0	3	0	0	781	1508
EDO. BARINAS	MP. PEDRAZA	PQ. IGNACIO BRICE#O	ESCUELA BASICA UNITARIA  BOCA DE TORTUGA	94	1	5	66	21	61	0	2	0	0	38	66
EDO. BARINAS	MP. PEDRAZA	PQ. IGNACIO BRICE#O	ESCUELA ESTADAL UNITARIA LOS MANGOS Nº 019	221	1	1	116	29	115	0	1	0	0	85	116
EDO. BARINAS	MP. PEDRAZA	PQ. IGNACIO BRICE#O	ESCUELA HATO VIEJO	270	1	3	217	167	214	0	1	1	0	45	217
EDO. BARINAS	MP. PEDRAZA	PQ. CIUDAD BOLIVIA	ESCUELA 5 DE JULIO	848	2	19	689	482	670	0	2	0	0	186	689
EDO. BARINAS	MP. PEDRAZA	PQ. CIUDAD BOLIVIA	ESCUELA ESTADAL CONCENTRADA  MATARRALA  Nº 592	606	2	15	445	153	430	0	2	1	0	274	445
EDO. BARINAS	MP. PEDRAZA	PQ. CIUDAD BOLIVIA	ESCUELA BASICA JOSE FRANCISCO JIMENEZ	4171	8	79	3306	1428	3227	1	12	5	0	1781	3306
EDO. BARINAS	MP. PEDRAZA	PQ. CIUDAD BOLIVIA	ESCUELA BASICA EUGENIA DE RODRIGUEZ	869	2	17	705	432	688	0	3	0	0	253	705
EDO. BARINAS	MP. PEDRAZA	PQ. CIUDAD BOLIVIA	ESCUELA BASICA ESTADAL EMILCE  DE CONTRERAS	999	2	29	794	436	765	0	2	0	0	327	794
EDO. BARINAS	MP. PEDRAZA	PQ. CIUDAD BOLIVIA	ESCUELA BASICA SEBASTIAN ARAUJO	3947	7	49	3144	1303	3095	0	16	2	0	1774	3144
EDO. BARINAS	MP. PEDRAZA	PQ. CIUDAD BOLIVIA	ESCUELA BASICA ANA DE ROMERO	1537	3	30	1207	615	1177	0	2	4	0	556	1207
EDO. BARINAS	MP. PEDRAZA	PQ. CIUDAD BOLIVIA	CASA DE LA CULTURA	1539	3	29	1172	523	1143	0	4	1	0	615	1172
EDO. BARINAS	MP. PEDRAZA	PQ. CIUDAD BOLIVIA	ESCUELA NACIONAL CONCENTRADA LA FLORESTA	516	1	2	417	289	415	0	3	0	0	123	417
EDO. BARINAS	MP. PEDRAZA	PQ. CIUDAD BOLIVIA	ESCUELA ESTADAL CONCENTRADA CHUPONAL I	829	2	11	678	404	667	0	3	1	0	259	678
EDO. BARINAS	MP. PEDRAZA	PQ. CIUDAD BOLIVIA	UNIDAD EDUCATIVA  BICENTENARIA NATALICIO  DEL LIBERTADOR	1015	2	17	808	458	791	0	6	1	0	326	808
EDO. BARINAS	MP. PEDRAZA	PQ. CIUDAD BOLIVIA	ESCUELA UNITARIA LA CEIBITA	773	2	8	673	632	665	0	1	2	0	30	673
EDO. BARINAS	MP. PEDRAZA	PQ. CIUDAD BOLIVIA	ESCUELA BASICA UNITARIA  SAN FRANCISCO DE CANAGUA	188	1	3	125	57	122	0	1	0	0	64	125
EDO. BARINAS	MP. PEDRAZA	PQ. CIUDAD BOLIVIA	ESCUELA BASICA CONCENTRADA  BOCA DE ANARO NUMERO 001	433	1	7	264	156	257	0	2	0	0	99	264
EDO. BARINAS	MP. PEDRAZA	PQ. CIUDAD BOLIVIA	ESCUELA BASICA UNITARIA  SANTA MARIA DE PEDRAZA	331	1	0	270	180	270	0	1	0	0	89	270
EDO. BARINAS	MP. PEDRAZA	PQ. CIUDAD BOLIVIA	ESCUELA UNITARIA  ESTADAL SIN NUMERO MATA DE LEON	242	1	1	167	75	166	0	1	0	0	90	167
EDO. BARINAS	MP. PEDRAZA	PQ. CIUDAD BOLIVIA	ESCUELA BASICA FELIX ERNESTO OSUNA	1376	3	41	1043	532	1002	0	5	1	0	464	1043
EDO. BARINAS	MP. PEDRAZA	PQ. CIUDAD BOLIVIA	ESCUELA BASICA CONCENTRADA  SAN ISIDRO NUMERO 185	262	1	3	171	98	168	0	2	0	0	68	171
EDO. BARINAS	MP. PEDRAZA	PQ. CIUDAD BOLIVIA	PREESCOLAR BOLIVARIANO LOS PAPAGALLOS	1417	3	23	1159	508	1136	0	4	0	1	623	1159
EDO. BARINAS	MP. PEDRAZA	PQ. CIUDAD BOLIVIA	ESCUELA ESTADAL CONCENTRADA  SAN ANTONIO	364	1	8	286	123	278	1	1	0	0	153	286
EDO. BARINAS	MP. PEDRAZA	PQ. CIUDAD BOLIVIA	ESCUELA BOLIVARIANA EL SILENCIO	1698	3	17	1334	651	1317	0	5	1	0	660	1334
EDO. BARINAS	MP. PEDRAZA	PQ. CIUDAD BOLIVIA	ESCUELA BASICA CONCENTRADA    EL POLVERO
EDO. BARINAS	MP. PEDRAZA	PQ. CIUDAD BOLIVIA	PREESCOLAR JOSE FRANCISCO JIMENEZ	982	2	14	798	356	784	0	5	0	0	423	798
EDO. BARINAS	MP. PEDRAZA	PQ. CIUDAD BOLIVIA	ESCUELA BASICA CONCENTRADA  EL TESORO NUMERO 185	385	1	13	322	173	309	0	2	0	0	134	322
EDO. BARINAS	MP. PEDRAZA	PQ. CIUDAD BOLIVIA	ESCUELA BASICA CIUDAD BOLIVIA	1004	2	28	813	503	785	0	1	0	0	281	813
EDO. BARINAS	MP. PEDRAZA	PQ. CIUDAD BOLIVIA	ESCUELA BASICA CONCENTRADA BOLIVARIANA LAS PEÑITAS	649	2	7	522	269	515	0	0	0	0	246	522
EDO. BARINAS	MP. PEDRAZA	PQ. CIUDAD BOLIVIA	ESCUELA ESTADAL CONCENTRADA  BOLIVARIANA  PALMA SOLA	1004	2	11	778	410	767	0	2	0	0	355	778
EDO. BARINAS	MP. PEDRAZA	PQ. CIUDAD BOLIVIA	ESCUELA BASICA ROMULO GALLEGOS	1254	3	19	1039	633	1020	0	2	0	0	385	1039
EDO. BARINAS	MP. PEDRAZA	PQ. PAEZ	ESCUELA BASICA CONCENTRADA POTREROS DE LA VIRGEN I	189	1	4	154	68	150	0	5	0	0	77	154
EDO. BARINAS	MP. PEDRAZA	PQ. PAEZ	ESCUELA ESTADAL UNITARIA  SIN  NUMERO SANTA ROSALIA	116	1	4	74	38	70	0	0	1	0	31	74
EDO. BARINAS	MP. PEDRAZA	PQ. PAEZ	ESCUELA LOS GUIRES	268	1	2	223	129	221	0	1	1	0	90	223
EDO. BARINAS	MP. PEDRAZA	PQ. PAEZ	UNIDAD EDUCATIVA SAN RAFAEL DE CANAGUA	3512	6	73	2549	1553	2476	0	23	4	0	896	2549
EDO. BARINAS	MP. PEDRAZA	PQ. PAEZ	ESCUELA ESTADAL CONCENTRADA  SALOME Nº 592	200	1	4	142	25	138	0	0	0	0	113	142
EDO. BARINAS	MP. PEDRAZA	PQ. PAEZ	ESCUELA LAS MALVINAS 060304 185 R2	348	1	10	254	180	244	0	1	0	0	63	254
EDO. BARINAS	MP. PEDRAZA	PQ. PAEZ	ESCUELA NACIONAL CONCENTRADA LA TIGRA II	188	1	6	135	107	129	0	0	0	0	22	135
EDO. BARINAS	MP. ROJAS	PQ. DOLORES	ESCUELA BASICA AGUA LARGA	695	2	15	557	376	542	0	5	0	0	161	557
EDO. BARINAS	MP. ROJAS	PQ. DOLORES	ESCUELA BOLIVARIANA MAPORAL NER 261	33	1	2	27	17	25	0	0	0	0	8	27
EDO. BARINAS	MP. ROJAS	PQ. DOLORES	ESCUELA ESTADAL CONCENTRADA 4 Y 20	861	2	11	673	474	662	0	0	0	0	188	673
EDO. BARINAS	MP. ROJAS	PQ. DOLORES	GRUPO ESCOLAR RAMON ESCOBAR	2917	5	47	2176	1316	2129	0	17	2	0	794	2176
EDO. BARINAS	MP. ROJAS	PQ. DOLORES	ESCUELA ESTADAL CONCENTRADA NUMERO 206	450	1	11	348	215	337	0	1	2	0	119	348
EDO. BARINAS	MP. ROJAS	PQ. DOLORES	ESCUELA ESTADAL NUMERO 334	304	1	3	226	185	223	0	0	0	0	38	226
EDO. BARINAS	MP. ROJAS	PQ. PALACIO FAJARDO	ESCUELA MIXTA  NACIONAL FLORA MARGARITA  PONCE	2188	4	30	1724	1425	1694	0	7	0	0	262	1724
EDO. BARINAS	MP. ROJAS	PQ. PALACIO FAJARDO	ESCUELA ESTADAL CONCENTRADA NUMERO 422 119 222 NUCLEO ESCOLAR RURAL 81	536	1	7	427	388	420	0	0	1	0	31	427
EDO. BARINAS	MP. ROJAS	PQ. PALACIO FAJARDO	ESCUELA TECNICA  AGRICOLA  ALFREDO  LARRIVA	1239	3	14	982	778	968	1	5	0	0	184	982
EDO. BARINAS	MP. ROJAS	PQ. PALACIO FAJARDO	ESCUELA BOLIVARIANA EL CALDERO	308	1	5	273	242	268	0	0	1	0	25	273
EDO. BARINAS	MP. ROJAS	PQ. PALACIO FAJARDO	ESCUELA BASICA  ENRIQUETA ARVELO  LARRIVA	2053	4	15	1580	1243	1565	0	10	1	0	311	1580
EDO. BARINAS	MP. ROJAS	PQ. PALACIO FAJARDO	ESCUELA BASICA CONCENTRADA PATO LOPERA	339	1	1	272	190	271	0	0	0	0	81	272
EDO. BARINAS	MP. ROJAS	PQ. LIBERTAD	ESCUELA ESTADAL UNITARIA SIN NUMERO	457	1	5	355	269	350	0	5	0	0	76	355
EDO. BARINAS	MP. ROJAS	PQ. LIBERTAD	ESCUELA ESTADAL NUMERO 534	270	1	3	211	150	208	0	1	0	1	56	211
EDO. BARINAS	MP. ROJAS	PQ. LIBERTAD	UNIDAD EDUCATIVA ENRIQUE IGNACIO GUTIERREZ	2621	5	52	2077	1429	2025	1	13	0	0	582	2077
EDO. BARINAS	MP. ROJAS	PQ. LIBERTAD	ESCUELA ESTADAL CONCENTRADA EL POLVERO	136	1	1	109	97	108	0	2	0	0	9	109
EDO. BARINAS	MP. ROJAS	PQ. LIBERTAD	ESCUELA ESTADAL CONCENTRADA NUCLEO ESTADAL RURAL 19	320	1	9	266	211	257	0	0	0	0	46	266
EDO. BARINAS	MP. ROJAS	PQ. LIBERTAD	ESCUELA ESTATAL BOLIVARIANA GENERAL PEDRO MANUEL ROJAS	335	1	1	304	245	303	0	3	0	0	55	304
EDO. BARINAS	MP. ROJAS	PQ. LIBERTAD	ESCUELA BASICA LUIS UGUETO	3567	7	63	2776	1675	2713	0	22	0	0	1016	2776
EDO. BARINAS	MP. ROJAS	PQ. LIBERTAD	ESCUELA ESTADAL CONCENTRADA MASPARRITO	183	1	9	161	122	152	0	1	0	0	29	161
EDO. BARINAS	MP. ROJAS	PQ. SANTA ROSA	ESCUELA ESTADAL CONCENTRADA NUMERO 100	193	1	2	146	90	144	0	0	1	0	53	146
EDO. BARINAS	MP. ROJAS	PQ. SANTA ROSA	ESCUELA BASICA MANUEL HEREDIA ALAS	1537	3	33	1220	899	1187	1	6	0	1	280	1220
EDO. BARINAS	MP. ROJAS	PQ. SANTA ROSA	ESCUELA ESTADAL CONCENTRADA 122 Y SIN NUMERO	198	1	4	163	123	159	0	0	0	0	36	163
EDO. BARINAS	MP. ROJAS	PQ. SANTA ROSA	ESCUELA BASICA CONCENTRADA LAS TEJAS	149	1	1	129	103	128	0	1	1	0	23	129
EDO. BARINAS	MP. ROJAS	PQ. SANTA ROSA	ESCUELA ESTADAL EL MAMON	262	1	3	250	191	247	0	3	0	0	53	250
EDO. BARINAS	MP. ROJAS	PQ. SANTA ROSA	ESCUELA BASICA NACIONAL COROCITO SABANA	163	1	3	128	103	125	0	0	0	0	22	128
EDO. BARINAS	MP. ROJAS	PQ. SANTA ROSA	ESCUELA BASICA  NICOLAS ANTONIO PULIDO	2222	4	24	1704	1100	1680	0	11	1	0	568	1704
EDO. BARINAS	MP. ROJAS	PQ. SANTA ROSA	ESCUELA ESTADAL CONCENTRADA 121 124 171 123	510	1	2	398	311	396	1	2	0	0	82	398
EDO. BARINAS	MP. ROJAS	PQ. SANTA ROSA	ESCUELA BASICA VEGON ARRIBA NUCLEO ESCOLAR RURAL NUMERO 019	518	1	3	411	345	408	0	1	0	0	62	411
EDO. BARINAS	MP. ROJAS	PQ. SANTA ROSA	ESCUELA ESTADAL NUMERO 154	249	1	3	180	133	177	0	0	1	0	43	180
EDO. BARINAS	MP. ROJAS	PQ. SANTA ROSA	ESCUELA NACIONAL CONCENTRADA NUMERO 3638	456	1	5	370	296	365	0	3	0	0	66	370
EDO. BARINAS	MP. ROJAS	PQ. SANTA ROSA	ESCUELA ESTADAL CONCENTRADA 59 60	275	1	4	218	173	214	0	2	0	0	39	218
EDO. BARINAS	MP. ARISMENDI	PQ. SAN ANTONIO	ESCUELA BASICA CONCENTRADA EL PASO DE SAN ANTONIO	610	2	7	402	252	395	0	5	0	1	137	402
EDO. BARINAS	MP. ARISMENDI	PQ. SAN ANTONIO	ESCUELA BASICA EL PALMAR NUCLEO ESCOLAR RURAL  A	983	2	8	715	535	707	0	0	0	1	171	715
EDO. BARINAS	MP. ARISMENDI	PQ. SAN ANTONIO	ESCUELA BASICA ESTADAL  SAN ANTONIO LAS FLORES NUCLEO ESCOLAR RURAL 03	1004	2	26	720	427	694	0	7	0	0	260	720
EDO. BARINAS	MP. ARISMENDI	PQ. SAN ANTONIO	ESCUELA BASICA CONCENTRADA HATO VIEJO NUCLEO ESCOLAR RURAL 03	289	1	4	213	87	209	0	1	0	0	121	213
EDO. BARINAS	MP. ARISMENDI	PQ. SAN ANTONIO	ESCUELA BASICA ROSA HERMINIA GONZALEZ	217	1	1	135	104	134	0	0	0	0	30	135
EDO. BARINAS	MP. ARISMENDI	PQ. ARISMENDI	ESCUELA ESTADAL CONCENTRADA SAN VICENTE NUCLEO ESCOLAR RURAL 04	156	1	1	109	84	108	0	1	0	0	23	109
EDO. BARINAS	MP. ARISMENDI	PQ. ARISMENDI	ESCUELA  ESTADAL UNITARIA  TOTUMAL NUCLEO ESCOLAR RURAL NUMERO 04	130	1	2	103	87	101	0	1	0	0	13	103
EDO. BARINAS	MP. ARISMENDI	PQ. ARISMENDI	ESCUELA ESTADAL UNITARIA CHORROCO EL MEDIO NUCLEO ESCOLAR RURAL 04 A
EDO. BARINAS	MP. ARISMENDI	PQ. ARISMENDI	ESCUELA NACIONAL CONCENTRADA EL COROZO NUCLEO ESCOLAR 620 A	90	1	5	74	36	69	0	0	0	0	33	74
EDO. BARINAS	MP. ARISMENDI	PQ. ARISMENDI	ESCUELA ESTADAL CONCENTRADA LAS UÑAS NUCLEO ESCOLAR RURAL NUMERO 04   B	364	1	2	220	172	218	0	0	0	0	46	220
EDO. BARINAS	MP. ARISMENDI	PQ. ARISMENDI	ESCUELA ESTADAL UNITARIA FLOR AMARILLO NUCLEO ESCOLAR RURAL NUMERO 04	140	1	1	64	42	63	0	0	0	0	21	64
EDO. BARINAS	MP. ARISMENDI	PQ. ARISMENDI	ESCUELA ESTADAL CONCENTRADA CAÑO VIEJO NUCLEO ESCOLAR RURAL NUMERO 04	361	1	1	252	223	251	0	12	0	0	16	252
EDO. BARINAS	MP. ARISMENDI	PQ. ARISMENDI	ESCUELA ESTADAL CONCENTRADA MATA DE GUASIMO NUCLEO ESCOLAR RURAL 04 B
EDO. BARINAS	MP. ARISMENDI	PQ. ARISMENDI	ESCUELA ESTADAL UNITARIA LOZADA NUCLEO ESCOLAR RURAL 423 C	158	1	4	103	77	99	0	0	0	0	22	103
EDO. BARINAS	MP. ARISMENDI	PQ. ARISMENDI	ESCUELA ESTADAL UNITARIA LA CALENTURA	55	1	1	52	44	51	0	0	0	0	7	52
EDO. BARINAS	MP. ARISMENDI	PQ. ARISMENDI	ESCUELA ESTADAL CONCENTRADA JOSE ANTONIO PAEZ	463	1	12	338	262	326	0	1	0	0	63	338
EDO. BARINAS	MP. ARISMENDI	PQ. ARISMENDI	ESCUELA BASICA CONCENTRADA LA MADRINA	433	1	5	327	211	322	0	2	1	0	108	327
EDO. BARINAS	MP. ARISMENDI	PQ. ARISMENDI	ESCUELA ESTADAL CONCENTRADA LA AGUADITA NUCLEO ESCOLAR RURAL 04	115	1	1	63	46	62	0	0	0	0	16	63
EDO. BARINAS	MP. ARISMENDI	PQ. ARISMENDI	ESCUELA ESTADAL UNITARIA LA RAYITA NUCLEO ESCOLAR RURAL NUMERO 04	118	1	1	79	72	78	0	1	0	0	5	79
EDO. BARINAS	MP. ARISMENDI	PQ. ARISMENDI	ESCUELA BASICA ANDRES ELOY BLANCO	235	1	7	186	146	179	0	1	0	0	32	186
EDO. BARINAS	MP. ARISMENDI	PQ. ARISMENDI	ESCUELA ESTADAL UNITARIA PALMARITO NUCLEO ESCOLAR RURAL NUMERO 04	147	1	0	74	70	74	0	0	0	0	4	74
EDO. BARINAS	MP. ARISMENDI	PQ. ARISMENDI	ESCUELA ESTADAL RAFAEL MARIA ROJAS BARCO	505	1	5	367	264	362	0	1	2	0	95	367
EDO. BARINAS	MP. ARISMENDI	PQ. ARISMENDI	ESCUELA TECNICA AGROPECUARIA	1811	4	42	1338	888	1296	2	6	2	0	398	1338
EDO. BARINAS	MP. ARISMENDI	PQ. ARISMENDI	ESCUELA BASICA LA UNION	1136	2	16	794	470	778	0	5	1	0	302	794
EDO. BARINAS	MP. ARISMENDI	PQ. ARISMENDI	ESCUELA NACIONAL CONCENTRADA VIRGILIO TOSTA	84	1	5	62	46	57	0	1	0	0	10	62
EDO. BARINAS	MP. ARISMENDI	PQ. GUADARRAMA	ESCUELA ESTADAL UNITARIA SANTO DOMINGO NUCLEO ESCOLAR RURAL 11	87	1	2	70	63	68	0	0	0	0	5	70
EDO. BARINAS	MP. ARISMENDI	PQ. GUADARRAMA	ESCUELA ESTADAL UNITARIA TIZNADO NUCLEO ESCOLAR RURAL 11	59	1	1	40	37	39	0	0	0	0	2	40
EDO. BARINAS	MP. ARISMENDI	PQ. GUADARRAMA	UNIDAD EDUCATIVA NACIONAL BOLIVARIANA MARCELO RAMIREZ	832	2	16	643	464	627	0	3	0	0	160	643
EDO. BARINAS	MP. ARISMENDI	PQ. GUADARRAMA	ESCUELA ESTADAL Nº 121	101	1	0	67	54	67	0	0	0	0	13	67
EDO. BARINAS	MP. ARISMENDI	PQ. GUADARRAMA	ESCUELA ESTADAL UNITARIA  LA MUERTA NUCLEO ESCOLAR RURAL 11	115	1	3	74	56	71	0	2	0	0	13	74
EDO. BARINAS	MP. ARISMENDI	PQ. GUADARRAMA	ESCUELA ESTADAL CONCENTRADA IGUEZ NUCLEO ESCOLAR RURAL NUMERO 11	280	1	3	217	175	214	0	0	1	0	38	217
EDO. BARINAS	MP. ARISMENDI	PQ. GUADARRAMA	ESCUELA ESTADAL UNITARIA LA MAYITA NUCLEO ESCOLAR RURAL 11	86	1	1	67	61	66	0	1	0	0	4	67
EDO. BARINAS	MP. ARISMENDI	PQ. GUADARRAMA	ESCUELA ESTADAL EL GADIN NUCLEO ESCOLAR #11	101	1	1	63	52	62	0	1	0	0	9	63
EDO. BARINAS	MP. ARISMENDI	PQ. LA UNION	ESCUELA BASICA ESTADAL UNITARIA PARAPARAL NUCLEO ESCOLAR RURAL 10	168	1	1	114	46	113	0	0	0	0	67	114
EDO. BARINAS	MP. ARISMENDI	PQ. LA UNION	ESCUELA BASICA CONCENTRADA BOLIVARIANA SAN JAIME NER 10 A	419	1	1	237	162	236	0	1	0	0	73	237
EDO. BARINAS	MP. ARISMENDI	PQ. LA UNION	ESCUELA BASICA ESTADAL  UNITARIA LOS ARRECIFES  NUCLEO ESCOLAR RURAL 10	67	1	2	55	30	53	0	0	0	0	23	55
EDO. BARINAS	MP. ARISMENDI	PQ. LA UNION	ESCUELA BASICA NACIONAL 3429 NUCLEO NACIONAL RURAL 093	237	1	2	136	87	134	0	3	0	0	44	136
EDO. BARINAS	MP. ARISMENDI	PQ. LA UNION	ESCUELA BASICA UNITARIA EL POLVO NUCLEO ESCOLAR RURAL 10B	224	1	8	166	133	158	1	0	0	0	24	166
EDO. BARINAS	MP. ARISMENDI	PQ. LA UNION	ESCUELA BASICA CONCENTRADA SAN PABLO VIVERO	571	1	4	406	290	402	0	1	0	0	111	406
EDO. BARINAS	MP. ARISMENDI	PQ. LA UNION	ESCUELA PRIMARIA YARURO	1534	3	23	1086	777	1063	1	4	1	0	280	1086
EDO. BARINAS	MP. ARISMENDI	PQ. LA UNION	ESCUELA BASICA CONCENTRADA LAS VENTANAS NUCLEO ESCOLAR RURAL 10 A	517	1	2	338	173	336	0	0	1	0	162	338
EDO. BARINAS	MP. ARISMENDI	PQ. LA UNION	ESCUELA BASICA UNITARIA  EL GUASIMO	561	1	6	335	232	329	0	0	0	0	97	335
EDO. BARINAS	MP. ARISMENDI	PQ. LA UNION	ESCUELA BASICA ESTADAL UNITARIA LOS ACEITES NUCLEO ESCOLAR RURAL 10 A	79	1	0	54	48	54	0	0	0	0	6	54
EDO. BARINAS	MP. ARISMENDI	PQ. LA UNION	ESCUELA BASICA CONCENTRADA FRANQUERO NUCLEO ESCOLAR RURAL 010 B	552	1	3	347	280	344	0	0	0	0	64	347
EDO. BARINAS	MP. ARISMENDI	PQ. LA UNION	ESCUELA ESTADAL UNITARIA JABILLAL  NUCLEO ESCOLAR RURAL  10	259	1	1	130	101	129	0	0	0	0	28	130
EDO. BARINAS	MP. ALBERTO ARVELO T	PQ. RODRIGUEZ DOMINGUEZ	ESCUELA BOLIVARIANA CAÑO E GUACA	156	1	1	148	138	147	0	0	0	0	9	148
EDO. BARINAS	MP. ALBERTO ARVELO T	PQ. RODRIGUEZ DOMINGUEZ	ESCUELA BASICA  BOLIVARIANA BERNARDINO MOSQUERA	1857	4	17	1490	1101	1473	0	8	2	0	362	1490
EDO. BARINAS	MP. ALBERTO ARVELO T	PQ. RODRIGUEZ DOMINGUEZ	UNIDAD BASICA NACIONAL BOLIVARIANA FRANCISCA DE REIMI	1142	2	18	963	804	945	0	4	0	0	137	963
EDO. BARINAS	MP. ALBERTO ARVELO T	PQ. RODRIGUEZ DOMINGUEZ	ESCUELA BASICA LLANO ALTO NUCLEO ESCOLAR RURAL 573	338	1	5	309	295	304	1	1	0	0	7	309
EDO. BARINAS	MP. ALBERTO ARVELO T	PQ. RODRIGUEZ DOMINGUEZ	ESCUELA BASICA LAS PALMAS	161	1	5	146	138	141	0	1	1	0	1	146
EDO. BARINAS	MP. ALBERTO ARVELO T	PQ. RODRIGUEZ DOMINGUEZ	ESCUELA NACIONAL GRADUADA OBISPOS	1172	2	19	966	763	947	0	3	0	0	181	966
EDO. BARINAS	MP. ALBERTO ARVELO T	PQ. RODRIGUEZ DOMINGUEZ	ESCUELA ESTADAL CONCENTRADA LAS VIRTUDES	130	1	1	101	83	100	0	1	1	0	15	101
EDO. BARINAS	MP. ALBERTO ARVELO T	PQ. RODRIGUEZ DOMINGUEZ	LICEO BOLIVARIANO VEGUITA	560	1	5	516	425	511	0	2	0	0	84	516
EDO. BARINAS	MP. ALBERTO ARVELO T	PQ. RODRIGUEZ DOMINGUEZ	ESCUELA BASICA LA REPRESA	174	1	2	136	128	134	0	2	0	0	4	136
EDO. BARINAS	MP. ALBERTO ARVELO T	PQ. SABANETA	ESCUELA ESTADAL BOLIVARIANA REGINO ANTONIO SALAS LA ISLA	286	1	3	256	239	253	0	1	0	0	13	256
EDO. BARINAS	MP. ALBERTO ARVELO T	PQ. SABANETA	ESCUELA BASICA CURITO ABAJO	348	1	11	318	296	307	0	0	0	0	11	318
EDO. BARINAS	MP. ALBERTO ARVELO T	PQ. SABANETA	ESCUELA BASICA  BOLIVARIANA LA RAYITA	732	2	9	617	536	608	0	2	0	1	69	617
EDO. BARINAS	MP. ALBERTO ARVELO T	PQ. SABANETA	ESCUELA BASICA BOLIVARIANA PUEBLO NUEVO	654	2	13	542	416	529	0	2	0	0	111	542
EDO. BARINAS	MP. ALBERTO ARVELO T	PQ. SABANETA	ESCUELA ESTADAL CONCENTRADA 01 02 004 NUCLEO ESCOLAR RURAL 573	1271	3	47	1036	801	989	0	3	0	1	184	1036
EDO. BARINAS	MP. ALBERTO ARVELO T	PQ. SABANETA	ESCUELA BASICA BOLIVARIANA EL REMOLINO	511	1	3	410	346	407	0	0	2	1	58	410
EDO. BARINAS	MP. ALBERTO ARVELO T	PQ. SABANETA	ESCUELA BASICA GUAFALES TUBERIA LAGUNA MASPARRO	171	1	3	161	138	158	0	0	0	0	20	161
EDO. BARINAS	MP. ALBERTO ARVELO T	PQ. SABANETA	ESCUELA BASICA ESTADAL  CONCENTRADA POBLADO IV	391	1	9	364	332	355	0	1	0	1	21	364
EDO. BARINAS	MP. ALBERTO ARVELO T	PQ. SABANETA	ESCUELA BASICA BOLIVARIANA  ZOILA  MELEAN DE ALVARADO	1124	2	24	919	669	895	0	5	0	0	221	919
EDO. BARINAS	MP. ALBERTO ARVELO T	PQ. SABANETA	UNIDAD EDUCATIVA SABANETA	2367	4	46	1931	1383	1885	0	10	0	0	492	1931
EDO. BARINAS	MP. ALBERTO ARVELO T	PQ. SABANETA	ESCUELA BASICA JULIAN PINO	3180	6	39	2391	1664	2352	0	13	0	2	673	2391
EDO. BARINAS	MP. ALBERTO ARVELO T	PQ. SABANETA	ESCUELA PRIMARIA BOLIVARIANA FLOR AMARILLO	306	1	4	255	207	251	0	2	0	0	42	255
EDO. BARINAS	MP. ALBERTO ARVELO T	PQ. SABANETA	ESCUELA BASICA ELIAS CORDERO UZCATEGUI	2303	4	63	1922	1509	1859	0	9	0	0	341	1922
EDO. BARINAS	MP. ALBERTO ARVELO T	PQ. SABANETA	PREESCOLAR JULIAN PINO	1512	3	26	1334	948	1308	0	11	0	0	349	1334
EDO. BARINAS	MP. ALBERTO ARVELO T	PQ. SABANETA	ESCUELA BASICA BOLIVARIANA SANTA RITA	580	1	7	491	432	484	0	4	0	0	48	491
EDO. BARINAS	MP. ALBERTO ARVELO T	PQ. SABANETA	ESCUELA BASICA BOLIVARIANA MASPARRO GUAFITAS	526	1	4	410	372	406	0	1	0	0	33	410
EDO. BARINAS	MP. ALBERTO ARVELO T	PQ. SABANETA	ESCUELA BASICA BOLIVARIANA SAN HIPOLITO 01 02 013	1629	3	18	1313	1184	1295	0	3	0	0	108	1313
EDO. BARINAS	MP. ALBERTO ARVELO T	PQ. SABANETA	ESCUELA BASICA BOLIVARIANA FLOR AMARILLO	790	2	20	657	546	637	1	3	0	0	87	657
EDO. BARINAS	MP. ALBERTO ARVELO T	PQ. SABANETA	UNIVERSIDAD NACIONAL EXPERIMENTAL DE LAS FUERZAS ARMADAS (UNEFA)	1273	3	36	1081	913	1045	0	5	1	0	126	1081
EDO. BARINAS	MP. ALBERTO ARVELO T	PQ. SABANETA	UNIDAD EDUCATIVA NACIONAL NICOLAS ANTONIO PULIDO	505	1	7	469	413	462	0	3	0	0	46	469
EDO. BARINAS	MP. ALBERTO ARVELO T	PQ. SABANETA	ESCUELA BASICA LOS GUAFALES	486	1	1	395	349	394	0	1	0	0	44	395
EDO. BARINAS	MP. ALBERTO ARVELO T	PQ. SABANETA	CENTRO EDUCACION INICIAL BACHILLER ELIAS CORDERO UZCATEGUI	442	1	6	407	332	401	0	2	0	0	67	407
EDO. BARINAS	MP. ANDRES E. BLANCO	PQ. EL CANTON	LICEO BOLIVARIANO CORRALITOS DE CAPARO	263	1	6	219	178	213	0	8	0	0	27	219
EDO. BARINAS	MP. ANDRES E. BLANCO	PQ. EL CANTON	UNIDAD EDUCATIVA BOLIVARIANA GENERAL  PEDRO BRICEÑO MENDEZ	2562	5	20	1912	974	1892	0	3	0	0	915	1912
EDO. BARINAS	MP. ANDRES E. BLANCO	PQ. EL CANTON	LICEO NACIONAL BOLIVARIANO CAÑO CHIGUIRE	599	1	9	455	305	446	0	3	0	0	138	455
EDO. BARINAS	MP. ANDRES E. BLANCO	PQ. EL CANTON	ESCUELA BASICA CONCENTRADA FUNDO BRAVO	689	2	14	543	383	529	0	3	0	0	143	543
EDO. BARINAS	MP. ANDRES E. BLANCO	PQ. EL CANTON	ESCUELA ESTADAL UNITARIA  LIMONCITO	281	1	1	198	154	197	0	0	1	0	42	198
EDO. BARINAS	MP. ANDRES E. BLANCO	PQ. EL CANTON	ESCUELA ESTADAL UNITARIA  EL GUAYABO Nº 233	245	1	1	196	109	195	0	0	0	0	86	196
EDO. BARINAS	MP. ANDRES E. BLANCO	PQ. EL CANTON	UNIDAD EDUCATIVA NACIONAL EL CANTON	1012	2	15	879	556	864	1	0	0	2	305	879
EDO. BARINAS	MP. ANDRES E. BLANCO	PQ. PUERTO VIVAS	ESCUELA ESTADAL UNITARIA CAÑO DE DANTA	274	1	3	231	153	228	0	0	0	0	75	231
EDO. BARINAS	MP. ANDRES E. BLANCO	PQ. PUERTO VIVAS	ESCUELA  BASICA CONCENTRADA TRES ESQUINAS	543	1	17	401	218	384	0	0	0	0	166	401
EDO. BARINAS	MP. ANDRES E. BLANCO	PQ. PUERTO VIVAS	ESCUELA BOLIVARIANA MATEO SEXAGESIMO HOSTOS	1049	2	16	745	518	729	0	3	0	1	207	745
EDO. BARINAS	MP. ANDRES E. BLANCO	PQ. PUERTO VIVAS	ESCUELA ESTADAL GUAQUITA	279	1	2	243	192	241	0	1	0	0	48	243
EDO. BARINAS	MP. ANDRES E. BLANCO	PQ. PUERTO VIVAS	ESCUELA BASICA EL GUAMAL	189	1	8	149	103	141	0	2	0	0	36	149
EDO. BARINAS	MP. ANDRES E. BLANCO	PQ. PUERTO VIVAS	ESCUELA NACIONAL BOLIVARIANA  PLAYA DE CEDRO	340	1	4	310	143	306	0	1	0	0	162	310
EDO. BARINAS	MP. ANDRES E. BLANCO	PQ. PUERTO VIVAS	ESCUELA ESTADAL CONCENTRADA TOPOCHALES	134	1	3	112	95	109	0	3	0	0	11	112
EDO. BARINAS	MP. ANDRES E. BLANCO	PQ. SANTA CRUZ DE GUACAS	ESCUELA BASICA SIMON BOLIVAR	2286	4	32	1717	915	1685	0	11	1	0	758	1717
EDO. BARINAS	MP. ANDRES E. BLANCO	PQ. SANTA CRUZ DE GUACAS	ESCUELA BASICA CONCENTRADA INDUMA	393	1	6	312	148	306	0	6	0	0	152	312
EDO. BARINAS	MP. ANDRES E. BLANCO	PQ. SANTA CRUZ DE GUACAS	ESCUELA BASICA CONCENTRADA LA CEIBITA	441	1	8	349	250	341	0	5	0	0	86	349
EDO. BARINAS	MP. ANDRES E. BLANCO	PQ. SANTA CRUZ DE GUACAS	ESCUELA ESTADAL UNITARIA SANTA RITA	80	1	0	63	59	63	0	0	0	0	4	63
EDO. BARINAS	MP. ANDRES E. BLANCO	PQ. SANTA CRUZ DE GUACAS	ESCUELA BASICA CONCENTRADA BOLIVARIANA LA PIEDRITA	182	1	2	120	74	118	0	2	0	0	42	120
EDO. BARINAS	MP. A JOSE DE SUCRE	PQ. ANDRES BELLO	UNIDAD  EDUCATIVA CAÑO DE OSO	539	1	10	444	242	434	0	2	1	0	189	444
EDO. BARINAS	MP. A JOSE DE SUCRE	PQ. ANDRES BELLO	UNIDAD  EDUCATIVA  ANTONIO RAMON  CARDENAS	3359	6	61	2618	1376	2557	2	11	1	0	1167	2618
EDO. BARINAS	MP. A JOSE DE SUCRE	PQ. ANDRES BELLO	ESCUELA CONCENTRADA  CAÑO GRANDE	228	1	1	194	147	193	0	1	0	0	45	194
EDO. BARINAS	MP. A JOSE DE SUCRE	PQ. ANDRES BELLO	UNIDAD EDUCATIVA BOLIVARIANA JUAN JOSE LANDAETA	127	1	3	108	74	105	0	0	0	0	31	108
EDO. BARINAS	MP. A JOSE DE SUCRE	PQ. TICOPORO	PREESCOLAR BOLIVARIANO ALBERTO ARVELO  TORREALBA	5047	9	105	3622	1688	3517	1	17	2	1	1808	3622
EDO. BARINAS	MP. A JOSE DE SUCRE	PQ. TICOPORO	ESCUELA BASICA LAS MARGARITAS	212	1	5	172	103	167	0	1	0	0	63	172
EDO. BARINAS	MP. A JOSE DE SUCRE	PQ. TICOPORO	ESCUELA NACIONAL LA LLOVIZNA NUCLEO ESCOLAR RURAL  612	1215	3	14	1014	607	1000	0	12	2	0	379	1014
EDO. BARINAS	MP. A JOSE DE SUCRE	PQ. TICOPORO	ESCUELA BASICA LINDOLFO MARTINEZ	3583	7	45	2868	1423	2823	1	14	2	1	1382	2868
EDO. BARINAS	MP. A JOSE DE SUCRE	PQ. TICOPORO	ESCUELA BASICA EL LIBERTADOR	1000	2	26	825	581	799	1	4	1	0	212	825
EDO. BARINAS	MP. A JOSE DE SUCRE	PQ. TICOPORO	ESCUELA BOLIVARIANA SABANA DE LA MURUCUTY	2654	5	48	2136	1327	2088	0	8	1	0	752	2136
EDO. BARINAS	MP. A JOSE DE SUCRE	PQ. TICOPORO	ESCUELA BASICA ORLANDO GARCIA	1125	2	28	879	482	851	0	3	1	0	365	879
EDO. BARINAS	MP. A JOSE DE SUCRE	PQ. TICOPORO	ESCUELA BOLIVARIANA LA CULTURA	109	1	4	74	52	70	0	1	0	0	17	74
EDO. BARINAS	MP. A JOSE DE SUCRE	PQ. TICOPORO	COMEDOR POPULAR	3467	7	51	2756	1242	2705	0	15	3	1	1444	2756
EDO. BARINAS	MP. A JOSE DE SUCRE	PQ. TICOPORO	UNIDAD EDUCATIVA COROZAL	2571	5	51	2114	1132	2063	0	8	1	0	922	2114
EDO. BARINAS	MP. A JOSE DE SUCRE	PQ. TICOPORO	LICEO BOLIVARIANO SOCOPO	1490	3	31	1259	609	1228	0	6	0	0	613	1259
EDO. BARINAS	MP. A JOSE DE SUCRE	PQ. TICOPORO	ESCUELA BASICA BOLIVARIANA  CONCHABAMBA	2370	4	42	1794	930	1752	1	7	0	0	814	1794
EDO. BARINAS	MP. A JOSE DE SUCRE	PQ. TICOPORO	PREESCOLAR BOLIVARIANO LAS AMERICAS	2785	5	47	2280	1108	2233	2	14	1	1	1107	2280
EDO. BARINAS	MP. A JOSE DE SUCRE	PQ. TICOPORO	ESCUELA  BASICA BOLIVARIANA SANTA BARBARA BENDITA	1245	3	29	1006	731	977	0	7	3	0	236	1006
EDO. BARINAS	MP. A JOSE DE SUCRE	PQ. TICOPORO	ESCUELA BASICA ALBERTO ARVELO  TORREALBA	5210	10	83	4125	1949	4042	1	19	2	2	2069	4125
EDO. BARINAS	MP. A JOSE DE SUCRE	PQ. TICOPORO	ESCUELA AEROPUERTO	566	1	15	462	221	447	0	2	0	0	224	462
EDO. BARINAS	MP. A JOSE DE SUCRE	PQ. TICOPORO	ESCUELA BASICA LA ORQUIDEA	95	1	2	76	54	74	0	1	0	0	19	76
EDO. BARINAS	MP. A JOSE DE SUCRE	PQ. TICOPORO	ESCUELA BASICA BOLIVARIANA   LUIS AGUSTIN DALO	2193	4	33	1728	932	1695	0	6	1	0	756	1728
EDO. BARINAS	MP. A JOSE DE SUCRE	PQ. NICOLAS PULIDO	ESCUELA LA CAPILLA NUCLEO ESCOLAR RURAL 018 A	274	1	2	222	184	220	0	0	0	0	36	222
EDO. BARINAS	MP. A JOSE DE SUCRE	PQ. NICOLAS PULIDO	ESCUELA BASICA RUFO ANTONIO  MONTILLA	1904	4	39	1460	937	1421	0	7	1	0	476	1460
EDO. BARINAS	MP. A JOSE DE SUCRE	PQ. NICOLAS PULIDO	ESCUELA BASICA BOLIVARIANA  MIGUEL ANGEL GUILLEN	2537	5	39	1942	1103	1903	1	16	1	0	782	1942
EDO. BARINAS	MP. A JOSE DE SUCRE	PQ. NICOLAS PULIDO	ESCUELA NACIONAL BOLIVARIANA TOPOCHALES DE MACAGUAL	128	1	1	111	85	110	0	0	0	0	25	111
EDO. BARINAS	MP. A JOSE DE SUCRE	PQ. NICOLAS PULIDO	ESCUELA LA PRIMAVERA	416	1	1	352	302	351	1	0	0	0	48	352
EDO. BARINAS	MP. SOSA	PQ. SANTA CATALINA	GRUPO ESCOLAR AGUSTIN ISTURIZ	547	1	5	363	287	358	0	4	0	0	67	363
EDO. BARINAS	MP. SOSA	PQ. SANTA CATALINA	ESCUELA ESTADAL CONCENTRADA	224	1	4	152	72	148	0	0	0	0	76	152
EDO. BARINAS	MP. SOSA	PQ. SANTA CATALINA	ESCUELA ESTADAL NUMERO 629	78	1	1	47	25	46	0	0	0	0	21	47
EDO. BARINAS	MP. SOSA	PQ. SANTA CATALINA	ESCUELA UNITARIA NUMERO 160	467	1	4	286	167	282	0	2	0	0	113	286
EDO. BARINAS	MP. SOSA	PQ. EL REGALO	ESCUELA BASICA CAÑADAS DE SANTA CRUZ	577	1	4	431	348	427	0	4	0	0	75	431
EDO. BARINAS	MP. SOSA	PQ. EL REGALO	ESCUELA ESTADAL CONCENTRADA LOS ARAGUATOS	247	1	2	224	148	222	0	1	0	0	73	224
EDO. BARINAS	MP. SOSA	PQ. EL REGALO	ESCUELA CONCENTRADA 503. EL CLAVO	651	2	4	566	483	562	0	2	0	0	77	566
EDO. BARINAS	MP. SOSA	PQ. EL REGALO	ESCUELA ESTADAL CONCENTRADA	1676	3	16	1412	689	1396	0	6	2	0	699	1412
EDO. BARINAS	MP. SOSA	PQ. EL REGALO	ESCUELA CONCENTRADA CACHICAMO LA ERIKA	955	2	25	785	488	760	0	3	0	0	269	785
EDO. BARINAS	MP. SOSA	PQ. PUERTO DE NUTRIAS	ESCUELA ESTADAL NUMERO 504	210	1	0	156	133	156	0	0	0	0	23	156
EDO. BARINAS	MP. SOSA	PQ. PUERTO DE NUTRIAS	UNIDAD EDUCATIVA BOLIVARIANA  RODRIGUEZ DOMINGUEZ	1879	4	30	1331	893	1301	0	5	1	1	401	1331
EDO. BARINAS	MP. SOSA	PQ. CIUDAD DE NUTRIAS	ESCUELA BOLIVARIANA  LIMONCITO	562	1	4	454	403	450	0	0	0	0	47	454
EDO. BARINAS	MP. SOSA	PQ. CIUDAD DE NUTRIAS	ESCUELA BASICA CHAPARRITO	819	2	7	690	461	683	0	6	0	0	216	690
EDO. BARINAS	MP. SOSA	PQ. CIUDAD DE NUTRIAS	ESCUELA BASICA ESTADAL CONCETRADA LOS CANALES	179	1	1	151	126	150	0	1	0	0	23	151
EDO. BARINAS	MP. SOSA	PQ. CIUDAD DE NUTRIAS	ESCUELA ESTADAL SIN NUMERO, CHORROSCO EL MEDIO
EDO. BARINAS	MP. SOSA	PQ. CIUDAD DE NUTRIAS	ESCUELA BASICA NACIONAL  CONCENTRADA CHORROSCO IV, NER 423	164	1	4	139	121	135	0	0	0	0	14	139
EDO. BARINAS	MP. SOSA	PQ. CIUDAD DE NUTRIAS	UNIDAD BASICA SOSA	2281	4	47	1764	887	1717	0	7	0	1	822	1764
EDO. BARINAS	MP. SOSA	PQ. CIUDAD DE NUTRIAS	ESCUELA BOLIVARIANA CAÑAVERALES	792	2	15	648	383	633	0	2	0	0	248	648
EDO. BARINAS	MP. SOSA	PQ. CIUDAD DE NUTRIAS	ESCUELA MIXTA  EL CUCHARO	1018	2	23	821	467	798	0	7	1	0	323	821
EDO. BARINAS	MP. SOSA	PQ. CIUDAD DE NUTRIAS	ESCUELA NACIONAL NUMERO 3971	1174	2	13	925	631	912	0	3	0	0	278	925
EDO. BARINAS	MP. SOSA	PQ. CIUDAD DE NUTRIAS	UNIDAD EDUCATIVA DESARROLLO ENDOGENO	1260	3	23	961	598	938	0	6	0	0	334	961
EDO. BARINAS	MP. SOSA	PQ. CIUDAD DE NUTRIAS	ESCUELA BASICA CHORROCO ARRIBA (NER 423)	107	1	1	82	73	81	0	0	0	0	8	82
EDO. BARINAS	MP. SOSA	PQ. CIUDAD DE NUTRIAS	ESCUELA BASICA EL BONGO NUCLEO ESCOLAR RURAL 020	181	1	7	161	116	154	0	1	0	0	37	161
EDO. BARINAS	MP. BOLIVAR	PQ. ALTAMIRA	ESCUELA BASICA ESTADAL CONCENTRADA EL CELOSO NUCLEO ESCOLAR RURAL 610	147	1	4	118	68	114	0	1	0	0	45	118
EDO. BARINAS	MP. BOLIVAR	PQ. ALTAMIRA	ESCUELA ESTADAL NUMERO  284	211	1	2	171	147	169	1	0	1	0	20	171
EDO. BARINAS	MP. BOLIVAR	PQ. ALTAMIRA	ESCUELA BOLIVARIANA  LA SOLEDAD NUCLEO ESCOLAR RURAL  610	579	1	4	486	362	482	0	5	0	0	115	486
EDO. BARINAS	MP. BOLIVAR	PQ. ALTAMIRA	ESCUELA BASICA NACIONAL UNITARIA CHIQUIMBUY NUCLEO ESCOLAR RURAL 610	111	1	0	77	74	77	0	0	0	0	3	77
EDO. BARINAS	MP. BOLIVAR	PQ. ALTAMIRA	ESCUELA BOLIVARIANA EL PALMAR	369	1	9	312	238	303	0	1	0	0	64	312
EDO. BARINAS	MP. BOLIVAR	PQ. ALTAMIRA	ESCUELA BOLIVARIANA ALFREDO ARVELO	568	1	8	453	223	445	0	1	0	1	220	453
EDO. BARINAS	MP. BOLIVAR	PQ. ALTAMIRA	LICEO BOLIVARIANO 30 DE JUNIO	299	1	3	271	184	268	0	3	0	0	81	271
EDO. BARINAS	MP. BOLIVAR	PQ. ALTAMIRA	ESCUELA BASICA UNITARIA  MAPORAL	86	1	2	63	46	61	0	0	0	0	15	63
EDO. BARINAS	MP. BOLIVAR	PQ. ALTAMIRA	ESCUELA BASICA ESTADAL CONCENTRADA SAN MIGUEL	159	1	2	127	80	125	0	0	0	0	45	127
EDO. BARINAS	MP. BOLIVAR	PQ. BARINITAS	ESCUELA BASICA ESTADAL CONCENTRADA LA MUCUSAVICHE	252	1	2	187	124	185	0	1	1	0	59	187
EDO. BARINAS	MP. BOLIVAR	PQ. BARINITAS	UNIDAD EDUCATIVA ANTONIETA MORENO DE ALBORNOZ	607	2	7	511	243	504	0	6	0	0	255	511
EDO. BARINAS	MP. BOLIVAR	PQ. BARINITAS	ESCUELA BASICA ORINOCO	3217	6	38	2651	1462	2613	1	15	1	0	1134	2651
EDO. BARINAS	MP. BOLIVAR	PQ. BARINITAS	ESCUELA BASICA NACIONAL ADOLFO MORENO	2190	4	32	1814	1197	1782	0	9	1	1	574	1814
EDO. BARINAS	MP. BOLIVAR	PQ. BARINITAS	ESCUELA ESTADAL 312 166 NUMERO 213	276	1	2	239	210	237	0	0	0	1	26	239
EDO. BARINAS	MP. BOLIVAR	PQ. BARINITAS	UNIDAD EDUCATIVA  JOSE VICENTE UNDA	4299	8	76	3610	1659	3534	1	18	1	1	1854	3610
EDO. BARINAS	MP. BOLIVAR	PQ. BARINITAS	ESCUELA BOLIVARIANA BARINITAS	3100	6	66	2524	1194	2458	0	11	1	1	1251	2524
EDO. BARINAS	MP. BOLIVAR	PQ. BARINITAS	ESCUELA BOLIVARIANA TERRAZAS DE SANTO DOMINGO	1538	3	28	1330	927	1302	0	7	1	0	367	1330
EDO. BARINAS	MP. BOLIVAR	PQ. BARINITAS	ESCUELA BASICA MOROMOY	895	2	12	787	458	775	0	6	1	2	308	787
EDO. BARINAS	MP. BOLIVAR	PQ. BARINITAS	ESCUELA BASICA UNITARIA NACIONAL LOS PANCHES	105	1	0	91	79	91	0	1	0	0	11	91
EDO. BARINAS	MP. BOLIVAR	PQ. BARINITAS	UNIDAD EDUCATIVA  NELLY VALERO	1576	3	25	1254	858	1229	1	3	0	0	367	1254
EDO. BARINAS	MP. BOLIVAR	PQ. BARINITAS	UNIDAD EDUCATIVA MILITAR OFICIAL GENERAL JOSÉ ANTONIO PAEZ	1358	3	22	923	613	901	0	6	1	0	281	923
EDO. BARINAS	MP. BOLIVAR	PQ. BARINITAS	UNIDAD EDUCATIVA NACIONAL SIMON BOLIVAR	999	2	13	854	505	841	0	1	1	0	334	854
EDO. BARINAS	MP. BOLIVAR	PQ. BARINITAS	ESCUELA BASICA JOSE RAMON TRASPUESTO	3705	7	81	3044	1718	2963	2	13	1	1	1228	3044
EDO. BARINAS	MP. BOLIVAR	PQ. BARINITAS	ATENEO POPULAR DE BARINITAS	2254	4	37	1867	880	1830	0	5	0	1	944	1867
EDO. BARINAS	MP. BOLIVAR	PQ. BARINITAS	LICEO BOLIVARIANO  CANDIDO  MEZA	1890	4	34	1626	842	1592	0	11	0	0	739	1626
EDO. BARINAS	MP. BOLIVAR	PQ. BARINITAS	ESCUELA ESTADAL CONCENTRADA NUMERO 290	403	1	10	349	290	339	0	1	0	0	48	349
EDO. BARINAS	MP. BOLIVAR	PQ. CALDERAS	ESCUELA BOLIVARIANA ESTADAL CONCENTRADA VILLA DE COROMOTO NUCLEO ESCOLAR RURAL  018	98	1	3	67	42	64	0	0	0	0	22	67
EDO. BARINAS	MP. BOLIVAR	PQ. CALDERAS	ESCUELA BASICA NACIONAL CONCENTRADA  LAS TUNAS NUCLEO ESCOLAR RURAL 509	122	1	2	73	52	71	0	0	0	0	19	73
EDO. BARINAS	MP. BOLIVAR	PQ. CALDERAS	CASA DE LA CULTURA DON AVELINO MORENO	246	1	6	221	121	215	0	0	0	0	94	221
EDO. BARINAS	MP. BOLIVAR	PQ. CALDERAS	CENTRO MOVIL	74	1	1	63	44	62	0	1	0	0	17	63
EDO. BARINAS	MP. BOLIVAR	PQ. CALDERAS	LICEO JACINTO MORA SANCHEZ	211	1	3	189	128	186	0	2	0	0	56	189
EDO. BARINAS	MP. BOLIVAR	PQ. CALDERAS	ESCUELA ESTADAL CONCENTRADA PRADO DE MARIA .NUCLEO ESCOLAR RURAL 018	88	1	2	74	51	72	0	0	0	0	21	74
EDO. BARINAS	MP. BOLIVAR	PQ. CALDERAS	ESCUELA BASICA MIGUEL GUERRERO	1032	2	12	802	442	790	0	4	0	0	344	802
EDO. BARINAS	MP. BOLIVAR	PQ. CALDERAS	ESCUELA ESTADAL CONCENTRADA LA HONDA NUCLEO ESCOLAR RURAL 187	222	1	0	177	122	177	0	1	0	0	54	177
EDO. BARINAS	MP. BOLIVAR	PQ. CALDERAS	ESCUELA BASICA ESTADAL CONCENTRADA 41 200 PALMARITO	94	1	0	57	40	57	0	0	0	0	17	57
EDO. BARINAS	MP. BOLIVAR	PQ. CALDERAS	ESCUELA BOLIVARIANA EL CEDRO NUCLEO ESCOLAR RURAL 018	355	1	3	288	234	285	0	1	0	0	50	288
EDO. BARINAS	MP. BOLIVAR	PQ. CALDERAS	ESCUELA ESTADAL CONCENTRADA PUNTA BRAVA NUCLEO ESCOLAR RURAL  018	234	1	2	180	133	178	0	0	0	0	45	180
EDO. BARINAS	MP. BOLIVAR	PQ. CALDERAS	ESCUELA BASICA NACIONAL CONCENTRADA BOLIVARIANA VEGA DEL MOLINO	186	1	1	144	122	143	0	1	0	0	20	144
EDO. BARINAS	MP. BOLIVAR	PQ. CALDERAS	ESCUELA BOLIVARIANA ORLANDO ARAUJO	392	1	4	323	198	319	0	0	0	0	121	323
EDO. BARINAS	MP. BOLIVAR	PQ. CALDERAS	ESCUELA ESTADAL UNITARIA LA AGUADITA NUCLEO ESCOLAR RURAL 018	172	1	4	132	98	128	1	0	0	0	29	132
EDO. BARINAS	MP. BOLIVAR	PQ. CALDERAS	ESCUELA BASICA NACIONAL CONCENTRADA BOLIVARIANA LA LAGUNA NER 509	410	1	2	321	255	319	0	1	0	0	63	321
EDO. BARINAS	MP. BOLIVAR	PQ. CALDERAS	ESCUELA BOLIVARIANA LOS NARANJOS	251	1	3	183	132	180	0	1	1	0	46	183
EDO. BARINAS	MP. BOLIVAR	PQ. CALDERAS	ESCUELA ESTADAL UNITARIA SAN LUIS NUCLEO ESCOLAR RURAL 187	94	1	2	73	42	71	0	3	0	0	26	73
EDO. BARINAS	MP. BOLIVAR	PQ. CALDERAS	ESCUELA ESTADAL CONCENTRADA LA BELLACA NUCLEO ESCOLAR RURAL 187	180	1	1	146	102	145	0	0	1	0	42	146
EDO. BARINAS	MP. BOLIVAR	PQ. CALDERAS	ESCUELA ESTADAL CONCENTRADA LA SABANA NUCLEO ESTADAL RURAL018	179	1	2	120	77	118	0	1	0	0	40	120
EDO. BARINAS	MP. EZEQUIEL ZAMORA	PQ. PEDRO BRICE#O MENDEZ	ESCUELA BASICA BOLIVARIANA QUIU	426	1	9	341	118	332	0	2	0	0	212	341
EDO. BARINAS	MP. EZEQUIEL ZAMORA	PQ. PEDRO BRICE#O MENDEZ	ESCUELA BASICA ESTATAL BOLIVARIANA CANDELARIA DE CABRITAS	2243	4	44	1764	869	1720	0	8	2	1	840	1764
EDO. BARINAS	MP. EZEQUIEL ZAMORA	PQ. PEDRO BRICE#O MENDEZ	ESCUELA BOLIVARIANA PARCELAS ABAJO	803	2	22	632	272	610	0	2	0	0	336	632
EDO. BARINAS	MP. EZEQUIEL ZAMORA	PQ. PEDRO BRICE#O MENDEZ	ESCUELA BASICA ESTADAL  RIO ARRIBA	245	1	3	196	105	193	0	0	0	0	88	196
EDO. BARINAS	MP. EZEQUIEL ZAMORA	PQ. SANTA BARBARA	UNIDAD EDUCATIVA PRIVADO COLEGIO CORAZON DE MARIA	3871	7	66	3151	1585	3085	0	13	1	0	1486	3151
EDO. BARINAS	MP. EZEQUIEL ZAMORA	PQ. SANTA BARBARA	ESCUELA BASICA NACIONAL LA IDEA	233	1	2	168	89	166	0	0	0	0	77	168
EDO. BARINAS	MP. EZEQUIEL ZAMORA	PQ. SANTA BARBARA	ESCUELA BOLIVARIANA JOSE FELIX RIBAS	1041	2	12	835	510	823	0	3	1	0	309	835
EDO. BARINAS	MP. EZEQUIEL ZAMORA	PQ. SANTA BARBARA	ESCUELA BOLIVARIANA SAN ANTONIO DE PAJEN
EDO. BARINAS	MP. EZEQUIEL ZAMORA	PQ. SANTA BARBARA	LICEO BOLIVARIANO ELIAS ARAQUE MULLER	3233	6	54	2615	1472	2561	1	12	2	0	1074	2615
EDO. BARINAS	MP. EZEQUIEL ZAMORA	PQ. SANTA BARBARA	ESCUELA BASICA ESTADAL UNITARIA SAN SEBASTIAN NUCLEO ESCOLAR RURAL 17	139	1	1	98	50	97	0	1	0	0	46	98
EDO. BARINAS	MP. EZEQUIEL ZAMORA	PQ. SANTA BARBARA	ESCUELA BOLIVARIANA  BARRANCONES ARRIBA	563	1	6	466	302	460	0	2	0	0	156	466
EDO. BARINAS	MP. EZEQUIEL ZAMORA	PQ. SANTA BARBARA	ESCUELA UNITARIA PAIVA	303	1	9	238	111	229	0	1	0	0	117	238
EDO. BARINAS	MP. EZEQUIEL ZAMORA	PQ. SANTA BARBARA	ESCUELA BASICA UNITARIA PAIVITA	163	1	4	135	62	131	0	5	0	0	64	135
EDO. BARINAS	MP. EZEQUIEL ZAMORA	PQ. SANTA BARBARA	CASA DE LA CULTURA JESUS DANIEL QUINTERO	2697	5	47	2078	1039	2031	0	7	3	0	982	2078
EDO. BARINAS	MP. EZEQUIEL ZAMORA	PQ. SANTA BARBARA	LICEO NACIONAL BOLIVARIANO CARLOS DEL POZO Y SUCRE	3432	6	63	2757	1190	2694	0	17	4	0	1483	2757
EDO. BARINAS	MP. EZEQUIEL ZAMORA	PQ. SANTA BARBARA	ESCUELA BASICA ESTADAL CONCENTRADA SURIPA ARRIBA	210	1	2	168	66	166	0	0	0	0	100	168
EDO. BARINAS	MP. EZEQUIEL ZAMORA	PQ. SANTA BARBARA	ESCUELA BASICA NACIONAL CONCENTRADA BELLA VISTA	127	1	0	87	60	87	0	0	0	0	27	87
EDO. BARINAS	MP. EZEQUIEL ZAMORA	PQ. SANTA BARBARA	GRUPO ESCOLAR MARQUEZ DEL PUMAR	3423	6	62	2682	1201	2620	0	10	2	1	1406	2682
EDO. BARINAS	MP. EZEQUIEL ZAMORA	PQ. SANTA BARBARA	ESCUELA BASICA ESTADAL CONCENTRADA CACHICAMO	205	1	6	164	121	158	0	0	1	0	36	164
EDO. BARINAS	MP. EZEQUIEL ZAMORA	PQ. SANTA BARBARA	ESCUELA  BASICA  NACIONAL CONCENTRADA LA QUEVEDA	720	2	14	619	281	605	1	1	0	0	322	619
EDO. BARINAS	MP. EZEQUIEL ZAMORA	PQ. SANTA BARBARA	ESCUELA BASICA NACIONAL CONCENTRADA EL CAMBUR	317	1	2	245	141	243	0	2	0	0	100	245
EDO. BARINAS	MP. EZEQUIEL ZAMORA	PQ. SANTA BARBARA	ESCUELA BOLIVARIANA EL YAURE	783	2	17	615	369	598	0	9	0	0	220	615
EDO. BARINAS	MP. EZEQUIEL ZAMORA	PQ. SANTA BARBARA	ESCUELA BASICA NACIONAL UNITARIA  CERRO AZUL	135	1	1	77	49	76	0	1	0	0	26	77
EDO. BARINAS	MP. EZEQUIEL ZAMORA	PQ. SANTA BARBARA	ESCUELA BOLIVARIANA SAN ANTONIO ABAJO	372	1	7	283	127	276	1	0	0	0	148	283
EDO. BARINAS	MP. EZEQUIEL ZAMORA	PQ. SANTA BARBARA	ESCUELA BASICA ESTADAL UNITARIA EL HORNO	285	1	3	214	111	211	0	4	0	0	96	214
EDO. BARINAS	MP. EZEQUIEL ZAMORA	PQ. SANTA BARBARA	ESCUELA BASICA ESTADAL UNITARIA CAÑANDON ZULIA	417	1	5	310	216	305	0	2	0	0	87	310
EDO. BARINAS	MP. EZEQUIEL ZAMORA	PQ. SANTA BARBARA	ESCUELA ESTADAL PASO POTRERO	103	1	1	72	28	71	0	0	0	0	43	72
EDO. BARINAS	MP. EZEQUIEL ZAMORA	PQ. SANTA BARBARA	ESCUELA BASICA NACIONAL CONCENTRADA  EL PIÑALITO	141	1	2	102	60	100	0	0	0	0	40	102
EDO. BARINAS	MP. EZEQUIEL ZAMORA	PQ. SANTA BARBARA	ESCUELA BASICA ESTADAL PADRE NOGUERA	1314	3	19	1091	616	1072	0	7	2	0	447	1091
EDO. BARINAS	MP. EZEQUIEL ZAMORA	PQ. SANTA BARBARA	ESCUELA BASICA NACIONAL BOLIVARIANA JOSÉ MAGIN MOLINA	1284	3	33	1054	611	1021	0	3	0	0	407	1054
EDO. BARINAS	MP. EZEQUIEL ZAMORA	PQ. RAMON IGNACIO MENDEZ	ESCUELA BASICA ESTADAL DANIEL NAVEA	2597	5	44	2042	1015	1998	1	4	0	1	977	2042
EDO. BARINAS	MP. EZEQUIEL ZAMORA	PQ.JOSE IGNACIO DEL PUMAR	ESCUELA BASICA NACIONAL CONCENTRADA EL JOBO	329	1	10	260	109	250	0	1	0	0	140	260
EDO. BARINAS	MP. EZEQUIEL ZAMORA	PQ.JOSE IGNACIO DEL PUMAR	ESCUELA BASICA LA CURVA	197	1	6	167	118	161	0	1	0	0	42	167
EDO. BARINAS	MP. EZEQUIEL ZAMORA	PQ.JOSE IGNACIO DEL PUMAR	ESCUELA BASICA NACIONAL UNITARIA CURITO ARRIBA	121	1	1	68	36	67	0	0	0	0	31	68
EDO. BARINAS	MP. EZEQUIEL ZAMORA	PQ.JOSE IGNACIO DEL PUMAR	UNIDAD  EDUCATIVA  JOSE IGNACIO DEL PUMAR	1974	4	46	1469	731	1423	0	3	1	1	687	1469
EDO. BARINAS	MP. OBISPOS	PQ. LOS GUASIMITOS	ESCUELA BASICA PEDRO ELIAS GUTIERREZ	3848	7	69	3041	1778	2972	1	21	2	2	1168	3041
EDO. BARINAS	MP. OBISPOS	PQ. LOS GUASIMITOS	ESCUELA BASICA ELBA ROSA ACEVEDO	976	2	13	815	555	802	0	5	0	1	241	815
EDO. BARINAS	MP. OBISPOS	PQ. LOS GUASIMITOS	ESCUELA BOLIVARIANA LOS COMPATRIOTAS	344	1	7	290	213	283	0	4	0	0	66	290
EDO. BARINAS	MP. OBISPOS	PQ. LOS GUASIMITOS	ESCUELA BASICA ESTADAL CONCENTRADA BOLIVARIANA OLMEDILLO	294	1	6	264	218	258	0	1	0	0	39	264
EDO. BARINAS	MP. OBISPOS	PQ. LOS GUASIMITOS	ESCUELA ESTADAL CONCENTRADA  SABANA DE LOS NEGROS	483	1	9	369	215	360	0	1	0	0	144	369
EDO. BARINAS	MP. OBISPOS	PQ. OBISPOS	ESCUELA  BASICA MANUEL PALACIOS	3222	6	42	2516	1446	2474	0	19	1	0	1008	2516
EDO. BARINAS	MP. OBISPOS	PQ. OBISPOS	ESCUELA BASICA NACIONAL CONCENTRADA LOS NARANJOS NUCLEO ESCOLAR RURAL NUMERO 608	345	1	6	277	224	271	0	3	0	0	44	277
EDO. BARINAS	MP. OBISPOS	PQ. OBISPOS	ESCUELA BASICA MASPARRO SAN LUIS NUCLEO ESCOLAR RURAL NUMERO 608	150	1	1	112	104	111	0	0	0	0	7	112
EDO. BARINAS	MP. OBISPOS	PQ. OBISPOS	ESCUELA BASICA JULIA ROSA  CASTILLO	2372	5	49	1939	1136	1890	0	15	3	0	736	1939
EDO. BARINAS	MP. OBISPOS	PQ. OBISPOS	ESCUELA BASICA ESTADAL CONCENTRADA PARAPARO	243	1	4	189	115	185	0	1	0	0	69	189
EDO. BARINAS	MP. OBISPOS	PQ. OBISPOS	ESCUELA BASICA MASPARRO EL CAMBUR NUCLEO ESCOLAR RURAL 608
EDO. BARINAS	MP. OBISPOS	PQ. OBISPOS	ESCUELA BASICA ESTADAL JULIA DE MARRERO	734	2	12	562	407	550	0	3	0	1	139	562
EDO. BARINAS	MP. OBISPOS	PQ. OBISPOS	ESCUELA BASICA ARMADILLO NUCLEO ESTADAL RURAL 608	519	1	6	437	305	431	0	4	0	0	122	437
EDO. BARINAS	MP. OBISPOS	PQ. OBISPOS	ESCUELA BASICA BOLIVARIANA VILLA NUEVA NUCLEO ESCOLAR RURAL 066	250	1	3	230	124	227	0	3	0	0	100	230
EDO. BARINAS	MP. OBISPOS	PQ. OBISPOS	ESCUELA TECNICA AGROPECUARIA MANUEL PALACIO	327	1	3	274	238	271	0	5	0	0	28	274
EDO. BARINAS	MP. OBISPOS	PQ. OBISPOS	ESCUELA ESTADAL CONCENTRADA SAN JOSE OBRERO NUMERO 118	815	2	18	712	504	694	0	6	1	0	183	712
EDO. BARINAS	MP. OBISPOS	PQ. OBISPOS	CENTRO DE EDUCACION INICIAL BOLIVARIANO MANUEL PALACIO	807	2	19	655	442	636	0	3	0	0	191	655
EDO. BARINAS	MP. OBISPOS	PQ. OBISPOS	ESCUELA BASICA ESTADAL CONCENTRADA CAIMITAL EJE 6	528	1	1	427	275	426	0	1	0	0	150	427
EDO. BARINAS	MP. OBISPOS	PQ. OBISPOS	ESCUELA BASICA BOLIVARIANA LA MATHIERA	841	2	12	700	538	688	0	5	2	0	143	700
EDO. BARINAS	MP. OBISPOS	PQ. EL REAL	ESCUELA BASICA ESTADAL CONCENTRADA GUAMITO NUCLEO ESTADAL RURAL 13	435	1	6	391	353	385	0	1	0	0	31	391
EDO. BARINAS	MP. OBISPOS	PQ. EL REAL	UNIDAD EDUCATIVA EL REAL	1826	4	19	1524	1160	1505	1	7	1	0	336	1524
EDO. BARINAS	MP. OBISPOS	PQ. LA LUZ	ESCUELA BASICA ESTADAL CONCENTRADA SAN LORENZO
EDO. BARINAS	MP. OBISPOS	PQ. LA LUZ	ESCUELA BASICA ESTADAL UNITARIA CAPA MAPURITAL	225	1	1	195	182	194	0	0	1	0	11	195
EDO. BARINAS	MP. OBISPOS	PQ. LA LUZ	ESCUELA ESTADAL CONCENTRADA CURITO I	264	1	0	226	216	226	0	1	0	0	9	226
EDO. BARINAS	MP. OBISPOS	PQ. LA LUZ	ESCUELA BASICA BOLIVARIANA EL HURTADO	348	1	2	273	219	271	0	1	2	0	49	273
EDO. BARINAS	MP. OBISPOS	PQ. LA LUZ	ESCUELA BASICA CONCENTRADA LA PALMA REAL	433	1	5	345	275	340	0	3	0	0	62	345
EDO. BARINAS	MP. OBISPOS	PQ. LA LUZ	ESCUELA BASICA ESTADAL CONCENTRADA COMPAÑIA ABAJO	194	1	2	167	127	165	0	0	0	0	38	167
EDO. BARINAS	MP. OBISPOS	PQ. LA LUZ	ESCUELA BASICA ESTADAL CONCENTRADA EL TAMBOR	578	1	9	454	349	445	0	2	0	0	94	454
EDO. BARINAS	MP. OBISPOS	PQ. LA LUZ	ESCUELA BASICA ESTADAL CONCENTRADA EL ROBLECITO
EDO. BARINAS	MP. OBISPOS	PQ. LA LUZ	ESCUELA BASICA GENERAL NICOLAS SILVA	1852	4	29	1499	835	1470	1	15	1	1	617	1499
EDO. BARINAS	MP. OBISPOS	PQ. LA LUZ	ESCUELA BASICA POTRERITO	157	1	1	140	132	139	0	0	0	0	7	140
EDO. BARINAS	MP. OBISPOS	PQ. LA LUZ	CENTRO MOVIL MATA LINDA	131	1	0	115	114	115	0	0	0	0	1	115
EDO. BARINAS	MP. OBISPOS	PQ. LA LUZ	ESCUELA BASICA BOLIVARIANA LA PIEDRA	275	1	0	232	187	232	0	4	0	0	41	232
EDO. COJEDES	MP. GIRARDOT	PQ. EL BAUL	ESCUELA  PRIMARIA   BOLIVARIANA  NICOLAS DE CASTRO	2898	5	57	2325	1367	2268	0	10	1	2	888	2325
EDO. COJEDES	MP. GIRARDOT	PQ. EL BAUL	LICEO BOLIVARIANO HIGINIO MORALES	2805	5	51	2315	1440	2264	1	19	1	2	801	2315
EDO. COJEDES	MP. GIRARDOT	PQ. EL BAUL	CENTRO DE EDUCACION INICIAL QUEBRADA DE AGUA	186	1	2	169	160	167	0	0	0	0	7	169
EDO. COJEDES	MP. GIRARDOT	PQ. EL BAUL	ESCUELA  ESTADAL  LA NUÑERA	620	2	14	456	341	442	0	3	1	0	97	456
EDO. COJEDES	MP. GIRARDOT	PQ. EL BAUL	ESCUELA MUNICIPAL UNITARIA NUMERO  2	244	1	3	152	135	149	0	2	0	0	12	152
EDO. COJEDES	MP. GIRARDOT	PQ. EL BAUL	ESCUELA ESTADAL UNITARIA NUMERO 75	512	1	3	379	316	376	0	0	0	0	60	379
EDO. COJEDES	MP. GIRARDOT	PQ. EL BAUL	ESCUELA  ESTADAL NUMERO 241 ZANJA DE LIRA	242	1	2	184	151	182	0	0	0	0	31	184
EDO. COJEDES	MP. GIRARDOT	PQ. SUCRE	ESCUELA BOLIVARIANA LA PALMITA	357	1	3	308	256	305	0	0	0	0	49	308
EDO. COJEDES	MP. GIRARDOT	PQ. SUCRE	ESCUELA  ESTADAL  FRANCISCO VILLANUEVA	825	2	8	658	450	650	0	8	2	0	190	658
EDO. COJEDES	MP. GIRARDOT	PQ. SUCRE	ESCUELA  BASICA CONCONCENTRADA  SIN NUMERO NUCLEO 400	381	1	2	283	242	281	0	4	0	0	35	283
EDO. COJEDES	MP. GIRARDOT	PQ. SUCRE	ESCUELA  BASICA  CONCENTRADA  CHIVERRY	142	1	2	108	84	106	0	0	0	0	22	108
EDO. COJEDES	MP. TINACO	PQ. GRL/JEFE JOSE L SILVA	ESCUELA  ESTADAL  CONCENTRADA NUMERO 96 103	437	1	12	363	287	351	0	1	1	0	62	363
EDO. COJEDES	MP. TINACO	PQ. GRL/JEFE JOSE L SILVA	ESCUELA  BASICA BOLIVARIANA  JOSE LAURENCIO SILVA	3458	6	59	2794	1242	2735	1	18	1	1	1472	2794
EDO. COJEDES	MP. TINACO	PQ. GRL/JEFE JOSE L SILVA	ESCUELA PRIMARIA LA CRUZ	94	1	0	89	71	89	0	0	0	0	18	89
EDO. COJEDES	MP. TINACO	PQ. GRL/JEFE JOSE L SILVA	CENTRO DE EDUCACION EL MIJAGUA	395	1	7	353	312	346	0	3	1	0	30	353
EDO. COJEDES	MP. TINACO	PQ. GRL/JEFE JOSE L SILVA	ESCUELA PRIMARIA CAMORUCO	390	1	12	356	258	344	1	1	0	0	84	356
EDO. COJEDES	MP. TINACO	PQ. GRL/JEFE JOSE L SILVA	ESCUELA BASICA UNITARIA EL SOCORRO	59	1	3	55	43	52	0	0	0	0	9	55
EDO. COJEDES	MP. TINACO	PQ. GRL/JEFE JOSE L SILVA	ESCUELA  BASICA RURAL ORUPE	861	2	14	677	494	663	0	6	1	0	162	677
EDO. COJEDES	MP. TINACO	PQ. GRL/JEFE JOSE L SILVA	JARDIN DE INFANCIA BOLIVARIANO TINACO	591	1	11	495	303	484	0	0	0	0	181	495
EDO. COJEDES	MP. TINACO	PQ. GRL/JEFE JOSE L SILVA	CENTRO DE EDUCACION INICIAL ESTEFANA GONZALEZ	318	1	9	283	230	274	0	2	0	0	42	283
EDO. COJEDES	MP. TINACO	PQ. GRL/JEFE JOSE L SILVA	ESCUELA BASICA JOSE CARRILLO MORENO	415	1	7	378	253	371	0	0	0	0	118	378
EDO. COJEDES	MP. TINACO	PQ. GRL/JEFE JOSE L SILVA	ESCUELA  BASICA BOLIVARINA  PEDRO DUARTE	1347	3	17	1101	742	1084	0	8	0	1	333	1101
EDO. COJEDES	MP. TINACO	PQ. GRL/JEFE JOSE L SILVA	ESCUELA  BASICA BOLIVARIANA  JOSE MARIA VARGAS	1014	2	20	819	582	799	0	2	0	0	215	819
EDO. COJEDES	MP. TINACO	PQ. GRL/JEFE JOSE L SILVA	ESCUELA  BASICA  AURA DE TERAN	1393	3	28	1096	755	1068	0	5	1	0	307	1096
EDO. COJEDES	MP. TINACO	PQ. GRL/JEFE JOSE L SILVA	UNIDAD  EDUCATIVA  DE EDUCACIÒN  ESPECIAL TINACO	1420	3	25	1188	652	1163	0	9	1	0	501	1188
EDO. COJEDES	MP. TINACO	PQ. GRL/JEFE JOSE L SILVA	CENTRO DE EDUCACION INICIAL COLINAS DE SAN LORENZO TINACO	451	1	13	371	303	358	0	2	0	0	53	371
EDO. COJEDES	MP. TINACO	PQ. GRL/JEFE JOSE L SILVA	ESCUELA  ESTADAL CONCENTRADA  NUMERO  151 236 LAS TEJAS	343	1	7	271	186	264	0	3	0	0	75	271
EDO. COJEDES	MP. TINACO	PQ. GRL/JEFE JOSE L SILVA	ESCUELA  BASICA  FRANCISCO MARIA ARIAS	3396	6	70	2725	1710	2655	0	6	2	2	935	2725
EDO. COJEDES	MP. TINACO	PQ. GRL/JEFE JOSE L SILVA	ESCUELA BASICA GUANMONTEY	262	1	5	239	227	234	0	0	0	0	7	239
EDO. COJEDES	MP. TINACO	PQ. GRL/JEFE JOSE L SILVA	LICEO TECNICO ROBINSONIANO  SIXTO SOSA	1859	4	32	1542	933	1510	0	13	0	0	564	1542
EDO. COJEDES	MP. TINACO	PQ. GRL/JEFE JOSE L SILVA	ESCUELA PRIMARIA UNITARIA CHAPARRAL	108	1	2	105	89	103	0	0	0	0	14	105
EDO. COJEDES	MP. TINACO	PQ. GRL/JEFE JOSE L SILVA	ESCUELA ESTADAL LA VILLEGUERA	252	1	7	223	187	216	0	0	0	0	29	223
EDO. COJEDES	MP. TINACO	PQ. GRL/JEFE JOSE L SILVA	ESCUELA  BASICA BOLIVARIANA CREACIÒN  TINACO	2118	4	65	1763	1169	1698	0	13	1	2	513	1763
EDO. COJEDES	MP. TINACO	PQ. GRL/JEFE JOSE L SILVA	ESCUELA  BASICA  CARLOS QUINTERO ALEGRIA	2128	4	46	1702	1176	1656	0	12	4	0	464	1702
EDO. COJEDES	CE. EZEQUIEL ZAMORA	PQ. MANUEL MANRIQUE	ESCUELA UNITARIA NUMERO 101	499	1	10	397	293	387	0	1	1	0	92	397
EDO. COJEDES	CE. EZEQUIEL ZAMORA	PQ. MANUEL MANRIQUE	GRUPO ESCOLAR COAHERI	2111	4	46	1750	992	1704	0	10	1	1	700	1750
EDO. COJEDES	CE. EZEQUIEL ZAMORA	PQ. MANUEL MANRIQUE	ESCUELA ESTADAL CONCENTRADA MACANILLA	232	1	3	178	126	175	1	1	0	0	47	178
EDO. COJEDES	CE. EZEQUIEL ZAMORA	PQ. MANUEL MANRIQUE	ESCUELA CONCENTRADA CARIAQUITO	181	1	2	170	127	168	0	0	0	1	40	170
EDO. COJEDES	CE. EZEQUIEL ZAMORA	PQ. JUAN ANGEL BRAVO	ESCUELA  ESTADAL PARAGUITO	139	1	6	95	58	89	0	1	0	0	30	95
EDO. COJEDES	CE. EZEQUIEL ZAMORA	PQ. JUAN ANGEL BRAVO	ESCUELA BOLIVARIANA CAMPO ALEGRE	126	1	0	116	93	116	0	0	0	0	23	116
EDO. COJEDES	CE. EZEQUIEL ZAMORA	PQ. JUAN ANGEL BRAVO	ESCUELA CONCENTRADA ESCOLAR LA SIERRA	533	1	4	425	286	421	0	3	0	0	132	425
EDO. COJEDES	CE. EZEQUIEL ZAMORA	PQ. JUAN ANGEL BRAVO	ESCUELA ESTADAL UNITARIA LA FLORIDA	96	1	1	76	59	75	0	0	0	0	16	76
EDO. COJEDES	CE. EZEQUIEL ZAMORA	PQ. JUAN ANGEL BRAVO	ESCUELA ESTADAL UNITARIA  NUCLEO 322	79	1	1	72	65	71	0	0	0	0	6	72
EDO. COJEDES	CE. EZEQUIEL ZAMORA	PQ. JUAN ANGEL BRAVO	ESCUELA ESTADAL LAS TUCURAGUAS 114	170	1	2	129	76	127	0	2	0	0	49	129
EDO. COJEDES	CE. EZEQUIEL ZAMORA	PQ. SAN CARLOS DE AUSTRIA	ESCUELA ESTADAL UNITARIA TIO AGUSTIN	177	1	3	78	71	75	0	0	0	0	4	78
EDO. COJEDES	CE. EZEQUIEL ZAMORA	PQ. SAN CARLOS DE AUSTRIA	CENTRO DE EDUCACION INICIAL BOLIVARIANO ALEJANDRO FEBRES	340	1	7	305	235	298	0	1	0	1	61	305
EDO. COJEDES	CE. EZEQUIEL ZAMORA	PQ. SAN CARLOS DE AUSTRIA	ESCUELA BASICA BOLIVARIANA ANDRES ELOY BLANCO	2719	5	57	2217	1357	2160	1	17	6	0	779	2217
EDO. COJEDES	CE. EZEQUIEL ZAMORA	PQ. SAN CARLOS DE AUSTRIA	ESCUELA BASICA RAMON ANTONIO VILLEGAS	802	2	13	682	507	669	1	3	1	0	157	682
EDO. COJEDES	CE. EZEQUIEL ZAMORA	PQ. SAN CARLOS DE AUSTRIA	ESCUELA ESTADAL UNITARIA NUMERO 102	246	1	5	213	199	208	0	1	0	0	8	213
EDO. COJEDES	CE. EZEQUIEL ZAMORA	PQ. SAN CARLOS DE AUSTRIA	CENTRO DE EDUCACIÒN INICIAL EL PAUJIL	895	2	17	741	331	724	1	2	0	1	389	741
EDO. COJEDES	CE. EZEQUIEL ZAMORA	PQ. SAN CARLOS DE AUSTRIA	ESCUELA BASICA MARITZA MENA DE PEREZ	522	1	14	459	272	445	0	2	0	0	171	459
EDO. COJEDES	CE. EZEQUIEL ZAMORA	PQ. SAN CARLOS DE AUSTRIA	CENTRO DE EDUCACION INICIAL SIMONCITO LA MEDINERA	369	1	8	337	225	329	0	1	0	0	103	337
EDO. COJEDES	CE. EZEQUIEL ZAMORA	PQ. SAN CARLOS DE AUSTRIA	ESCUELA BASICA EMILIO GERONIMO GOMEZ	1412	3	14	1156	919	1142	0	8	2	0	213	1156
EDO. COJEDES	CE. EZEQUIEL ZAMORA	PQ. SAN CARLOS DE AUSTRIA	CENTRO DE EDUCACION INICIAL BOLIVARIANO LYA IMBER DE CORONIL	78	1	4	71	48	67	0	1	0	0	18	71
EDO. COJEDES	CE. EZEQUIEL ZAMORA	PQ. SAN CARLOS DE AUSTRIA	ESCUELA  BASICA BOLIVARIANA CARLOS VILORIO	3916	7	45	3233	1286	3188	0	33	1	4	1864	3233
EDO. COJEDES	CE. EZEQUIEL ZAMORA	PQ. SAN CARLOS DE AUSTRIA	ESCUELA  GRADUADA  MARIA CLEMENCIA DE GUERRA	1126	2	28	938	597	910	2	3	0	1	307	938
EDO. COJEDES	CE. EZEQUIEL ZAMORA	PQ. SAN CARLOS DE AUSTRIA	ESCUELA  BASICA ALEJANDRO FEBRES	2482	5	74	1915	1097	1841	1	10	1	0	732	1915
EDO. COJEDES	CE. EZEQUIEL ZAMORA	PQ. SAN CARLOS DE AUSTRIA	ESCUELA BASICA  LA BLANQUERA	2455	5	26	2053	913	2027	1	18	1	1	1093	2053
EDO. COJEDES	CE. EZEQUIEL ZAMORA	PQ. SAN CARLOS DE AUSTRIA	ESCUELA CONCENTRADA LA PALMA	515	1	11	437	282	426	1	3	0	0	140	437
EDO. COJEDES	CE. EZEQUIEL ZAMORA	PQ. SAN CARLOS DE AUSTRIA	CENTRO DE EDUCACION INICIAL BOLIVARIANO LUISA CACERES DE ARISMENDI	245	1	2	208	164	206	0	1	0	0	41	208
EDO. COJEDES	CE. EZEQUIEL ZAMORA	PQ. SAN CARLOS DE AUSTRIA	ESCUELA ESTADAL EL PENITENTE	142	1	4	116	94	112	0	1	0	0	17	116
EDO. COJEDES	CE. EZEQUIEL ZAMORA	PQ. SAN CARLOS DE AUSTRIA	CENTRO DE EDUCACION INICIAL SAN RAMON	718	2	6	636	461	630	0	5	0	0	164	636
EDO. COJEDES	CE. EZEQUIEL ZAMORA	PQ. SAN CARLOS DE AUSTRIA	UNIDAD GERIATRICA AGUSTIN CAPO BIANCO SANCHEZ	688	2	8	594	394	586	0	2	1	0	189	594
EDO. COJEDES	CE. EZEQUIEL ZAMORA	PQ. SAN CARLOS DE AUSTRIA	CENTRO DE EDUCACION INICIAL EL RETAZO	524	1	13	442	333	429	0	4	0	0	92	442
EDO. COJEDES	CE. EZEQUIEL ZAMORA	PQ. SAN CARLOS DE AUSTRIA	CENTRO DE EDUCACION INICIAL ESTADAL EZEQUIEL ZAMORA	359	1	9	323	261	314	0	2	0	0	51	323
EDO. COJEDES	CE. EZEQUIEL ZAMORA	PQ. SAN CARLOS DE AUSTRIA	ESCUELA GRANJA ANIBAL DOMINICI	374	1	8	329	145	321	0	4	0	0	172	329
EDO. COJEDES	CE. EZEQUIEL ZAMORA	PQ. SAN CARLOS DE AUSTRIA	ESCUELA TECNICA AGROPECUARIA  E INDUSTRIAL ROBINSONIANA Y ZAMORANA SIMON RODRIGUEZ	115	1	5	98	78	93	0	0	0	0	15	98
EDO. COJEDES	CE. EZEQUIEL ZAMORA	PQ. SAN CARLOS DE AUSTRIA	LICEO ELOY GUILLERMO GONZALEZ	2287	4	34	1959	783	1925	0	11	0	0	1131	1959
EDO. COJEDES	CE. EZEQUIEL ZAMORA	PQ. SAN CARLOS DE AUSTRIA	ESCUELA  BASICA  JULIO ESCALONA	1866	4	42	1486	930	1444	0	16	0	1	497	1486
EDO. COJEDES	CE. EZEQUIEL ZAMORA	PQ. SAN CARLOS DE AUSTRIA	ESCUELA BASICA BOLIVARIANA IGINIO MORALES	2487	5	28	2076	766	2048	3	9	0	2	1268	2076
EDO. COJEDES	CE. EZEQUIEL ZAMORA	PQ. SAN CARLOS DE AUSTRIA	ESCUELA  BASICA  ELEAZAR ALMARAT	2068	4	33	1777	674	1744	0	8	0	0	1062	1777
EDO. COJEDES	CE. EZEQUIEL ZAMORA	PQ. SAN CARLOS DE AUSTRIA	CENTRO DE EDUCACION INICIAL FUNDACODULLEZ	294	1	3	260	187	257	0	1	0	0	69	260
EDO. COJEDES	CE. EZEQUIEL ZAMORA	PQ. SAN CARLOS DE AUSTRIA	ESCUELA BASICA BOLIVARIANA DOCTOR JOSE GREGORIO HERNANDEZ	334	1	4	284	253	280	0	1	0	0	26	284
EDO. COJEDES	CE. EZEQUIEL ZAMORA	PQ. SAN CARLOS DE AUSTRIA	ESCUELA ESTADAL CONCENTRADA VALLE HONDO	516	1	11	435	293	424	0	1	0	0	130	435
EDO. COJEDES	CE. EZEQUIEL ZAMORA	PQ. SAN CARLOS DE AUSTRIA	ESCUELA BASICA MONSEÑOR FRANCISCO MIGUEL SEIJAS	2975	6	65	2413	1458	2348	1	17	0	1	871	2413
EDO. COJEDES	CE. EZEQUIEL ZAMORA	PQ. SAN CARLOS DE AUSTRIA	LICEO CREACION LIMONCITO	1826	4	50	1579	749	1529	1	8	0	1	770	1579
EDO. COJEDES	CE. EZEQUIEL ZAMORA	PQ. SAN CARLOS DE AUSTRIA	ESCUELA BASICA BOLIVARIANA LA MAPORA	1091	2	17	914	671	897	1	4	0	2	219	914
EDO. COJEDES	CE. EZEQUIEL ZAMORA	PQ. SAN CARLOS DE AUSTRIA	ESCUELA BASICA OCTAVIO PAEZ	599	1	13	506	356	493	0	4	0	0	133	506
EDO. COJEDES	CE. EZEQUIEL ZAMORA	PQ. SAN CARLOS DE AUSTRIA	ESCUELA PRIMARIA BOLIVARIANA MANGO REDONDO	436	1	12	378	277	366	1	1	0	0	87	378
EDO. COJEDES	CE. EZEQUIEL ZAMORA	PQ. SAN CARLOS DE AUSTRIA	ESCUELA BASICA PUERTO ESCONDIDO	170	1	5	155	112	150	0	2	1	0	35	155
EDO. COJEDES	CE. EZEQUIEL ZAMORA	PQ. SAN CARLOS DE AUSTRIA	ESCUELA BASICA EL RETAZO	340	1	2	275	223	273	0	4	0	1	45	275
EDO. COJEDES	CE. EZEQUIEL ZAMORA	PQ. SAN CARLOS DE AUSTRIA	ESCUELA PRIMARIA NACIONAL BOLIVARIANA 24 DE JULIO DE 1783 NATALICIO DEL LIBERTADOR	997	2	22	927	686	905	0	9	0	0	210	927
EDO. COJEDES	CE. EZEQUIEL ZAMORA	PQ. SAN CARLOS DE AUSTRIA	CENTRO DE EDUCACION INICIAL BOLIVARIANO MONSEÑOR PADILLA	458	1	7	399	263	392	0	6	0	0	123	399
EDO. COJEDES	CE. EZEQUIEL ZAMORA	PQ. SAN CARLOS DE AUSTRIA	UNIDAD SANITARIA CANDIDO DIAZ CARBALLO	964	2	18	800	335	782	0	5	1	0	441	800
EDO. COJEDES	CE. EZEQUIEL ZAMORA	PQ. SAN CARLOS DE AUSTRIA	LICEO NACIONAL BOLIVARIANO 24 DE JULIO DE 1783	1022	2	21	941	727	920	0	4	0	0	189	941
EDO. COJEDES	CE. EZEQUIEL ZAMORA	PQ. SAN CARLOS DE AUSTRIA	ESCUELA BASICA NACIONAL BOLIVARIANA ROMULO GALLEGOS	2356	4	79	1965	1122	1886	0	16	0	0	748	1965
EDO. COJEDES	CE. EZEQUIEL ZAMORA	PQ. SAN CARLOS DE AUSTRIA	ESCUELA BASICA NACIONAL BOLIVARIANA GENERAL FRANCISCO DE MIRANDA	603	2	8	537	398	529	0	3	0	0	128	537
EDO. COJEDES	CE. EZEQUIEL ZAMORA	PQ. SAN CARLOS DE AUSTRIA	ESCUELA  BOLIVARIANA EL BANCO DE MAPURITE	381	1	4	320	232	316	0	0	0	0	84	320
EDO. COJEDES	CE. EZEQUIEL ZAMORA	PQ. SAN CARLOS DE AUSTRIA	ESCUELA CONCENTRADA SOLANO	424	1	8	343	249	335	0	2	1	1	82	343
EDO. COJEDES	CE. EZEQUIEL ZAMORA	PQ. SAN CARLOS DE AUSTRIA	ESCUELA  BASICA  CREACION SAN CARLOS	3409	6	57	2867	1494	2810	2	25	0	1	1288	2867
EDO. COJEDES	CE. EZEQUIEL ZAMORA	PQ. SAN CARLOS DE AUSTRIA	ESCUELA BOLIVARIANA MAPUEY	1269	3	32	1056	692	1024	1	4	0	0	327	1056
EDO. COJEDES	CE. EZEQUIEL ZAMORA	PQ. SAN CARLOS DE AUSTRIA	ESCUELA  BASICA  MARIA  DE  ALBORNOZ	2806	5	44	2235	1301	2191	0	18	0	2	870	2235
EDO. COJEDES	CE. EZEQUIEL ZAMORA	PQ. SAN CARLOS DE AUSTRIA	UNIDAD EDUCATIVA PRIVADA MIGUEL PALAO RICO	1144	2	27	973	394	946	1	7	0	0	544	973
EDO. COJEDES	CE. EZEQUIEL ZAMORA	PQ. SAN CARLOS DE AUSTRIA	ESCUELA BASICA SANTA ROSA	161	1	3	148	133	145	3	2	0	0	7	148
EDO. COJEDES	CE. EZEQUIEL ZAMORA	PQ. SAN CARLOS DE AUSTRIA	ESCUELA BASICA BOLIVARIANA CARLOS TOVAR	2145	4	44	1827	914	1783	1	17	0	0	851	1827
EDO. COJEDES	CE. EZEQUIEL ZAMORA	PQ. SAN CARLOS DE AUSTRIA	CENTRO DE EDUCACION INICIAL NACIONAL BOLIVARIANO FUNDA BARRIO	696	2	9	615	499	606	0	4	0	0	103	615
EDO. COJEDES	CE. EZEQUIEL ZAMORA	PQ. SAN CARLOS DE AUSTRIA	CENTRO DE EDUCACION INICIAL BOLIVARIANO SAN ANTONIO DE PADUA	232	1	7	212	160	205	0	2	0	0	43	212
EDO. COJEDES	CE. EZEQUIEL ZAMORA	PQ. SAN CARLOS DE AUSTRIA	ESCUELA BOLIVARIANA MANPOSTAL	153	1	1	135	123	134	0	1	0	0	10	135
EDO. COJEDES	CE. EZEQUIEL ZAMORA	PQ. SAN CARLOS DE AUSTRIA	LICEO BOLIVARIANO RAUL LEONI	837	2	17	751	477	734	0	4	1	0	252	751
EDO. COJEDES	CE. EZEQUIEL ZAMORA	PQ. SAN CARLOS DE AUSTRIA	ESCUELA BASICA BOLIVARIANA ANGEL MARIA GARRIDO	1965	4	45	1641	914	1596	3	13	0	1	665	1641
EDO. COJEDES	CE. EZEQUIEL ZAMORA	PQ. SAN CARLOS DE AUSTRIA	ESCUELA  BASICA  ELOY GUILLERMO  GONZALEZ	3047	6	88	2489	1103	2401	2	20	2	3	1271	2489
EDO. COJEDES	CE. EZEQUIEL ZAMORA	PQ. SAN CARLOS DE AUSTRIA	LICEO BOLIVARIANO EZEQUIEL ZAMORA	506	1	18	457	304	439	0	3	0	0	132	457
EDO. COJEDES	CE. EZEQUIEL ZAMORA	PQ. SAN CARLOS DE AUSTRIA	CENTRO DE EDUCACIÓN INICIAL NACIONAL RAYITO DE SOL	429	1	8	368	272	360	0	2	0	0	86	368
EDO. COJEDES	CE. EZEQUIEL ZAMORA	PQ. SAN CARLOS DE AUSTRIA	ESCUELA ESTADAL CONCENTRADA PALMERO	689	2	14	562	389	548	0	3	1	0	155	562
EDO. COJEDES	MP. RICAURTE	PQ. LIBERTAD DE COJEDES	JARDIN DE INFANCIA BOLIVARIANO LA CHEPERA	246	1	5	205	168	200	0	1	0	0	31	205
EDO. COJEDES	MP. RICAURTE	PQ. LIBERTAD DE COJEDES	ESCUELA BASICA SABANA LARGA	299	1	2	279	219	277	0	5	0	0	53	279
EDO. COJEDES	MP. RICAURTE	PQ. LIBERTAD DE COJEDES	ESCUELA  BASICA  EL MUERTICO	509	1	6	423	376	417	0	2	0	0	39	423
EDO. COJEDES	MP. RICAURTE	PQ. LIBERTAD DE COJEDES	ESCUELA ESTADAL UNITARIA NUMERO 155	420	1	7	322	221	315	0	2	0	0	92	322
EDO. COJEDES	MP. RICAURTE	PQ. LIBERTAD DE COJEDES	ESCUELA  BASICA  CANTA RANA	808	2	20	677	570	657	1	2	1	0	83	677
EDO. COJEDES	MP. RICAURTE	PQ. LIBERTAD DE COJEDES	ESCUELA ESTADAL ZOILA EMPERATRIZ GUTIERREZ	1299	3	11	1017	774	1006	0	9	0	0	223	1017
EDO. COJEDES	MP. RICAURTE	PQ. LIBERTAD DE COJEDES	ESCUELA  BASICA  MIGUEL PALAO RICO	1950	4	31	1577	1215	1546	0	11	0	1	319	1577
EDO. COJEDES	MP. RICAURTE	PQ. LIBERTAD DE COJEDES	ESCUELA  ESTADAL NUMERO  256	287	1	5	218	163	213	0	0	0	0	50	218
EDO. COJEDES	MP. RICAURTE	PQ. LIBERTAD DE COJEDES	ESCUELA  CONCENTRADA  MIXTA GENAREÑO	437	1	4	349	265	345	0	0	1	1	78	349
EDO. COJEDES	MP. RICAURTE	PQ. LIBERTAD DE COJEDES	ESCUELA CONCENTRADA NUMERO  15 35 89 156	1063	2	27	876	632	849	0	7	0	0	210	876
EDO. COJEDES	MP. RICAURTE	PQ. LIBERTAD DE COJEDES	CICLO BASICO COMUN, FERNANDO FIGUEREDO	1546	3	40	1313	1014	1273	0	5	0	0	254	1313
EDO. COJEDES	MP. RICAURTE	PQ. EL AMPARO	CONCENTRACION ESCOLAR EL AMPARO	1049	2	16	781	620	765	0	6	2	0	137	781
EDO. COJEDES	MP. RICAURTE	PQ. EL AMPARO	C.E.I. LUIS RAMON MATUTE	389	1	3	347	307	344	1	2	0	0	34	347
EDO. COJEDES	MP. ROMULO GALLEGOS	PQ. ROMULO GALLEGOS	JARDIN DE INFANCIA 24 DE JUNIO	675	2	8	547	458	539	0	3	1	0	77	547
EDO. COJEDES	MP. ROMULO GALLEGOS	PQ. ROMULO GALLEGOS	UNIDAD EDUCATIVA ALEJANDRO FEBRES	569	1	13	517	399	504	0	3	1	0	101	517
EDO. COJEDES	MP. ROMULO GALLEGOS	PQ. ROMULO GALLEGOS	ESCUELA  BASICA LA BLANCA	1280	3	23	1046	764	1023	0	6	0	0	253	1046
EDO. COJEDES	MP. ROMULO GALLEGOS	PQ. ROMULO GALLEGOS	CENTRO DE EDUCACION INICIAL NACIONAL BOLIVARIANO MATA ABDON	575	1	12	505	352	493	0	3	1	0	137	505
EDO. COJEDES	MP. ROMULO GALLEGOS	PQ. ROMULO GALLEGOS	ESCUELA  BASICA  JUAN ANGEL BRAVO	2294	4	45	1855	1045	1810	1	23	2	0	739	1855
EDO. COJEDES	MP. ROMULO GALLEGOS	PQ. ROMULO GALLEGOS	ESCUELA BASICA BOLIVARIANA LAS MARGARITAS	697	2	17	597	519	580	0	4	0	0	57	597
EDO. COJEDES	MP. ROMULO GALLEGOS	PQ. ROMULO GALLEGOS	CENTRO DE EDUCACION INICIAL NACIONAL BOLIVARIANO ESTEFANA GONZALEZ	216	1	1	190	126	189	0	1	0	0	62	190
EDO. COJEDES	MP. ROMULO GALLEGOS	PQ. ROMULO GALLEGOS	ESCUELA  BOLIVARIANA  RURAL LA VIGIA	1002	2	29	762	526	733	0	8	0	0	199	762
EDO. COJEDES	MP. ROMULO GALLEGOS	PQ. ROMULO GALLEGOS	CENTRO DE EDUCACION INICIAL SAN MIGUEL	316	1	2	280	200	278	0	0	0	1	77	280
EDO. COJEDES	MP. ROMULO GALLEGOS	PQ. ROMULO GALLEGOS	ESCUELA  BASICA  NACIONAL  ESTEFANA GONZALEZ	2241	4	41	1796	1002	1755	1	14	1	0	737	1796
EDO. COJEDES	MP. ROMULO GALLEGOS	PQ. ROMULO GALLEGOS	LICEO BOLIVARIANO CREACION JUAN ANGEL BRAVO	889	2	19	717	486	698	0	3	0	0	209	717
EDO. COJEDES	MP. ROMULO GALLEGOS	PQ. ROMULO GALLEGOS	ESCUELA PRIMARIA RURAL EL CHARCOTE	516	1	6	447	427	441	0	0	0	0	14	447
EDO. COJEDES	MP. ROMULO GALLEGOS	PQ. ROMULO GALLEGOS	ESCUELA  BASICA BOLIVARIANA ELBA MANZANO DE SANCHEZ. EL ESPINAL	2127	4	60	1649	1008	1589	0	19	0	0	562	1649
EDO. COJEDES	MP. PAO S J BAUTISTA	PQ. EL PAO	CONCENTRACION ESCOLAR PAPELON	176	1	5	124	81	119	0	1	0	0	37	124
EDO. COJEDES	MP. PAO S J BAUTISTA	PQ. EL PAO	ESCUELA BASICA ESTADAL CONCENTRADA  MACUAYA	164	1	2	137	120	135	0	0	0	0	15	137
EDO. COJEDES	MP. PAO S J BAUTISTA	PQ. EL PAO	ESCUELA BASICA ESTADAL UNITARIA SIN NUMERO VALLECITO	75	1	3	71	53	68	0	0	0	0	15	71
EDO. COJEDES	MP. PAO S J BAUTISTA	PQ. EL PAO	ESCUELA BASICA CONCENTRADA LIMONCITO	125	1	2	121	113	119	0	1	0	0	5	121
EDO. COJEDES	MP. PAO S J BAUTISTA	PQ. EL PAO	ESCUELA  CONCENTRADA NUMERO  39 146	212	1	6	170	106	164	0	1	0	0	57	170
EDO. COJEDES	MP. PAO S J BAUTISTA	PQ. EL PAO	ESCUELA  BASICA  ADELA MATA DE MORENO	841	2	15	707	507	692	1	9	0	0	175	707
EDO. COJEDES	MP. PAO S J BAUTISTA	PQ. EL PAO	ESCUELA  ESTADAL  NUMERO  28 SIN NUMERO	470	1	17	368	277	351	0	2	1	0	71	368
EDO. COJEDES	MP. PAO S J BAUTISTA	PQ. EL PAO	ESCUELA BASICA ESTADAL CONCENTRADA LA ARENITA	169	1	2	147	116	145	0	0	0	1	28	147
EDO. COJEDES	MP. PAO S J BAUTISTA	PQ. EL PAO	CENTRO DE EDUCACION INICIAL BOLIVARIANO JOSE ANTONIO APONTE	236	1	6	220	167	214	1	1	0	0	45	220
EDO. COJEDES	MP. PAO S J BAUTISTA	PQ. EL PAO	ESCUELA  ESTADAL  NUMERO  26	226	1	2	155	122	153	0	1	1	0	29	155
EDO. COJEDES	MP. PAO S J BAUTISTA	PQ. EL PAO	ESCUELA BASICA CONCENTRADA EL PUEBLITO	534	1	6	476	425	470	0	5	0	0	40	476
EDO. COJEDES	MP. PAO S J BAUTISTA	PQ. EL PAO	ESCUELA BASICA CONCENTRADA MATA OSCURA	111	1	5	102	89	97	0	2	0	0	6	102
EDO. COJEDES	MP. PAO S J BAUTISTA	PQ. EL PAO	ESCUELA  ESTADAL  PLAYITA	286	1	2	198	166	196	2	0	0	0	28	198
EDO. COJEDES	MP. PAO S J BAUTISTA	PQ. EL PAO	ESCUELA  BASICA  BOLIVARIANA JOSE ANTONIO APONTE	1894	4	56	1557	950	1501	0	10	1	1	539	1557
EDO. COJEDES	MP. PAO S J BAUTISTA	PQ. EL PAO	UNIDAD EDUCATIVA TECNICA  JUDAS TADEO PIÑANGO	1603	3	47	1295	879	1248	0	8	0	0	361	1295
EDO. COJEDES	MP. PAO S J BAUTISTA	PQ. EL PAO	ESCUELA NACIONAL BOLIVARIANA EZEQUIEL ZAMORA	82	1	1	73	68	72	0	0	0	0	4	73
EDO. COJEDES	MP. PAO S J BAUTISTA	PQ. EL PAO	ESCUELA BASICA CAMPO ALEGRE	144	1	10	136	126	126	0	0	0	0	0	136
EDO. COJEDES	MP. PAO S J BAUTISTA	PQ. EL PAO	ESCUELA BASICA BAQUIRA	113	1	2	106	81	104	0	0	0	0	23	106
EDO. COJEDES	MP. PAO S J BAUTISTA	PQ. EL PAO	ESCUELA BASICA ESTADAL CONCENTRADA EL TORO	69	1	3	61	48	58	0	0	0	0	10	61
EDO. COJEDES	MP. PAO S J BAUTISTA	PQ. EL PAO	ESCUELA BASICA CORCOVADO	108	1	3	95	71	92	0	1	0	0	20	95
EDO. COJEDES	MP. PAO S J BAUTISTA	PQ. EL PAO	ESCUELA BASICA LOS MATA PALOS	219	1	7	201	173	194	0	2	1	0	18	201
EDO. COJEDES	MP. PAO S J BAUTISTA	PQ. EL PAO	ESCUELA ESTADAL UNITARIA NUMERO 135	209	1	2	168	146	166	0	0	0	0	20	168
EDO. COJEDES	MP. PAO S J BAUTISTA	PQ. EL PAO	ESCUELA  ESTADAL  CONCENTRADA NUMERO  91	374	1	9	274	201	265	1	0	0	0	63	274
EDO. COJEDES	MP. PAO S J BAUTISTA	PQ. EL PAO	ESCUELA ESTADAL UNITARIA NUMERO 12 GARRIDO	100	1	1	95	93	94	0	1	0	0	0	95
EDO. COJEDES	MP. PAO S J BAUTISTA	PQ. EL PAO	ESCUELA ESTADAL UNITARIA NUMERO  128	208	1	3	123	94	120	0	1	0	0	25	123
EDO. COJEDES	MP. PAO S J BAUTISTA	PQ. EL PAO	ESCUELA  BASICA  ESTADAL  UNITARIA NUMERO  265	300	1	3	250	227	247	0	1	0	0	19	250
EDO. COJEDES	MP. PAO S J BAUTISTA	PQ. EL PAO	ESCUELA  ESTADAL  UNITARIA NUMERO  149	244	1	5	193	149	188	0	3	0	0	36	193
EDO. COJEDES	MP. PAO S J BAUTISTA	PQ. EL PAO	ESCUELA  ESTADAL  CONCENTRADA SIN NUMERO	242	1	6	184	131	178	0	0	0	0	47	184
EDO. COJEDES	MP. PAO S J BAUTISTA	PQ. EL PAO	ESCUELA  ESTADAL NUMERO  31	374	1	5	304	248	299	0	3	1	0	47	304
EDO. COJEDES	MP. PAO S J BAUTISTA	PQ. EL PAO	ESCUELA UNITARIA LAS GARZAS	181	1	2	142	117	140	0	0	0	0	23	142
EDO. COJEDES	MP. PAO S J BAUTISTA	PQ. EL PAO	ESCUELA BASICA BOLIVARIANA SAN ANTONIO DE MONAGAS	457	1	7	379	362	372	0	0	0	0	10	379
EDO. COJEDES	MP. PAO S J BAUTISTA	PQ. EL PAO	ESCUELA CONCENTRADA LA CRUZ	202	1	2	177	143	175	1	0	0	0	31	177
EDO. COJEDES	MP. PAO S J BAUTISTA	PQ. EL PAO	ESCUELA  BASICA  ESTADAL  UNITARIA SIN NUMERO	200	1	3	162	144	159	0	0	0	0	15	162
EDO. COJEDES	MP. PAO S J BAUTISTA	PQ. EL PAO	ESCUELA  ESTADAL  CONCENTRADA ROLANDO VASQUEZ	858	2	10	682	568	672	1	6	0	0	97	682
EDO. COJEDES	MP. PAO S J BAUTISTA	PQ. EL PAO	ESCUELA BASICA ESTADAL CONCENTRADA LA YAGUITA	256	1	3	202	163	199	0	0	0	0	36	202
EDO. COJEDES	MP. PAO S J BAUTISTA	PQ. EL PAO	ESCUELA  ESTADAL NUMERO  73	377	1	9	304	278	295	1	1	1	1	13	304
EDO. COJEDES	MP. LIMA BLANCO	PQ. MACAPO	ESCUELA NACIONAL UNITARIA NUMERO 3647 EL BANCO	599	1	12	499	378	487	0	1	0	0	108	499
EDO. COJEDES	MP. LIMA BLANCO	PQ. MACAPO	ESCUELA BÁSICA BOLIVARIANA MANAURE	2292	4	37	1939	1249	1902	0	2	0	1	650	1939
EDO. COJEDES	MP. LIMA BLANCO	PQ. MACAPO	ESCUELA BASICA  MONAGAS	1047	2	28	872	576	844	0	3	0	1	264	872
EDO. COJEDES	MP. LIMA BLANCO	PQ. MACAPO	JARDIN DE INFANCIA MANAURE	487	1	6	421	287	415	0	4	0	0	124	421
EDO. COJEDES	MP. LIMA BLANCO	PQ. MACAPO	ESCUELA BASICA  DAVID MENESSINI	1091	2	18	908	482	890	0	5	0	0	403	908
EDO. COJEDES	MP. LIMA BLANCO	PQ. LA AGUADITA	ESCUELA  ESTADAL COCENTRADA NUMERO 20252 LAS PALMAS	288	1	6	243	181	237	0	0	0	0	56	243
EDO. COJEDES	MP. LIMA BLANCO	PQ. LA AGUADITA	CENTRO DE EDUCACION INICIAL BOLIVARIANO LA AGUADITA	137	1	0	122	101	122	0	1	0	0	20	122
EDO. COJEDES	MP. LIMA BLANCO	PQ. LA AGUADITA	ESCUELA ESTADAL CONCENTRADA NUMERO 80251 LAS PALMAS	593	1	5	465	355	460	0	2	1	0	102	465
EDO. COJEDES	MP. LIMA BLANCO	PQ. LA AGUADITA	ESCUELA  BASICA  MONSEÑOR  SIXTO SOSA	1906	4	52	1587	1077	1535	1	7	2	0	448	1587
EDO. COJEDES	MP. LIMA BLANCO	PQ. LA AGUADITA	UNIDAD EDUCATIVA JULIETA SANCHEZ	211	1	7	185	126	178	0	1	0	0	51	185
EDO. COJEDES	MP. ANZOATEGUI	PQ. JUAN DE MATA SUAREZ	ESCUELA PRIMARIA BASICA ESTADAL DR LUIS BELTRAN PRIETO FIGUEROA	1005	2	31	847	609	816	0	5	0	0	202	847
EDO. COJEDES	MP. ANZOATEGUI	PQ. JUAN DE MATA SUAREZ	ESCUELA PRIMARIA BASICA ESTADAL CARMELINA DE GARCIA	904	2	22	796	606	774	1	5	0	0	162	796
EDO. COJEDES	MP. ANZOATEGUI	PQ. JUAN DE MATA SUAREZ	ESCUELA PRIMARIA BOLIVARIANA NACIONAL MAURICIO PEREZ LAZO	3026	6	93	2431	1344	2338	0	15	0	1	978	2431
EDO. COJEDES	MP. ANZOATEGUI	PQ. JUAN DE MATA SUAREZ	ESCUELA PRIMARIA BASICA CONCENTRADA ESTADAL PUENTE ONOTO	632	2	9	524	397	515	0	1	0	0	117	524
EDO. COJEDES	MP. ANZOATEGUI	PQ. JUAN DE MATA SUAREZ	ESCUELA PRIMARIA  BASICA  CONCENTRADA ESTADAL LA AROITA	766	2	29	622	448	593	0	1	0	0	144	622
EDO. COJEDES	MP. ANZOATEGUI	PQ. JUAN DE MATA SUAREZ	CENTRO DE EDUCACION INICIAL BOLIVARIANO MAURICIO PEREZ LAZO	360	1	6	311	177	305	0	2	0	1	125	311
EDO. COJEDES	MP. ANZOATEGUI	PQ. JUAN DE MATA SUAREZ	ESCUELA PRIMARIA BASICA CONCENTRADA ESTADAL  RIO CLARO	340	1	1	270	262	269	0	0	0	0	7	270
EDO. COJEDES	MP. ANZOATEGUI	PQ. JUAN DE MATA SUAREZ	ESCUELA PRIMARIA BASICA CONCENTRADA  ESTADAL BUENOS AIRES	188	1	1	138	84	137	0	2	0	0	51	138
EDO. COJEDES	MP. ANZOATEGUI	PQ. COJEDES	ESCUELA PRIMARIA BASICA CONCENTRADA ESTADAL  EL ESTERO	426	1	7	341	255	334	0	2	0	0	77	341
EDO. COJEDES	MP. ANZOATEGUI	PQ. COJEDES	ESCUELA PRIMARIA CONCENTRADA ESTADAL CASA DE TEJA	120	1	3	113	98	110	0	1	0	0	11	113
EDO. COJEDES	MP. ANZOATEGUI	PQ. COJEDES	ESCUELA PRIMARIA BASICA CONCENTRADA ESTADAL MATA OSCURA	365	1	11	307	244	296	0	3	0	1	48	307
EDO. COJEDES	MP. ANZOATEGUI	PQ. COJEDES	CENTRO DE EDUCACION INICIAL LOS MANGOS	321	1	0	273	214	273	1	0	0	0	58	273
EDO. COJEDES	MP. ANZOATEGUI	PQ. COJEDES	ESCUELA PRIMARIA BASICA CONCENTRADA ESTADAL LA CHORRERA	386	1	1	342	291	341	0	0	0	0	50	342
EDO. COJEDES	MP. ANZOATEGUI	PQ. COJEDES	CENTRO DE EDUCACION INICIAL FRAY PEDRO ALCALA	405	1	10	366	284	356	0	1	0	0	71	366
EDO. COJEDES	MP. ANZOATEGUI	PQ. COJEDES	ESCUELA PRIMARIA  BOLIVARIANA NACIONAL AGUSTIN RAFAEL ANDRADES	2063	4	47	1705	1093	1658	0	3	0	0	562	1705
EDO. COJEDES	MP. ANZOATEGUI	PQ. COJEDES	ESCUELA PRIMARIA BASICA CONCENTRADA ESTADAL RETAJAO	526	1	11	409	331	398	0	3	0	0	64	409
EDO. COJEDES	MP. TINAQUILLO	PQ. TINAQUILLO	ESCUELA  BASICA  ANATOLIO VIVAS SALAMANCA	3584	7	56	2904	1732	2848	0	15	0	2	1099	2904
EDO. COJEDES	MP. TINAQUILLO	PQ. TINAQUILLO	CENTRO DE EDUCACION INICIAL ESTADAL LIGIA CADENA DE ALVARADO	324	1	3	286	212	283	0	1	0	0	70	286
EDO. COJEDES	MP. TINAQUILLO	PQ. TINAQUILLO	ESCUELA  BASICA  ORTENCIA DE GARMENDIA	1415	3	51	1158	627	1107	0	6	0	0	474	1158
EDO. COJEDES	MP. TINAQUILLO	PQ. TINAQUILLO	ESCUELA  UNITARIA  COMPLETA NUMERO  44 120	191	1	9	123	86	114	0	0	0	0	28	123
EDO. COJEDES	MP. TINAQUILLO	PQ. TINAQUILLO	CENTRO DE EDUCACION INICIAL BOLIVARIANO LA FLORESTA	398	1	6	364	302	358	0	1	0	0	55	364
EDO. COJEDES	MP. TINAQUILLO	PQ. TINAQUILLO	CENTRO DE EDUCACION INICIAL NACIONAL GUAYABITO	363	1	6	320	205	314	0	2	0	0	107	320
EDO. COJEDES	MP. TINAQUILLO	PQ. TINAQUILLO	CENTRO DE EDUCACION INICIAL NACIONAL TEOSTISTE DE GALLEGOS	526	1	15	446	357	431	0	0	0	1	73	446
EDO. COJEDES	MP. TINAQUILLO	PQ. TINAQUILLO	LICEO BOLIVARIANO PRESBITERO MANUEL AROCHA	358	1	9	311	194	302	0	1	0	0	107	311
EDO. COJEDES	MP. TINAQUILLO	PQ. TINAQUILLO	ESCUELA  BASICA  PREBISTERO LUIS MARIA  SUCRE	1693	3	58	1448	710	1390	1	4	0	1	674	1448
EDO. COJEDES	MP. TINAQUILLO	PQ. TINAQUILLO	ESCUELA BASICA BOLIVARIANA LOS CAPACHITOS	565	1	2	475	374	473	1	3	0	1	94	475
EDO. COJEDES	MP. TINAQUILLO	PQ. TINAQUILLO	CICLO DIVERSIFICADO JOSE LAURENCIO SILVA	344	1	3	307	151	304	0	1	0	0	152	307
EDO. COJEDES	MP. TINAQUILLO	PQ. TINAQUILLO	CENTRO DE EDUCACION INICIAL NACIONAL LOS PINOS	261	1	6	248	199	242	0	2	0	0	41	248
EDO. COJEDES	MP. TINAQUILLO	PQ. TINAQUILLO	CENTRO DE EDUCACION INICIAL BOLIVARIANO LAS GRANJITAS	909	2	20	744	608	724	0	3	0	0	113	744
EDO. COJEDES	MP. TINAQUILLO	PQ. TINAQUILLO	CENTRO DE EDUCACIÒN INICIAL BOLIVARINA  03 MAYO	571	1	15	511	438	496	0	2	0	0	56	511
EDO. COJEDES	MP. TINAQUILLO	PQ. TINAQUILLO	ESCUELA  BASICA JESUS MARTIN LEON	4315	8	79	3397	2331	3318	3	22	3	1	958	3397
EDO. COJEDES	MP. TINAQUILLO	PQ. TINAQUILLO	ESCUELA BASICA BOLIVARIANA LOS MONOS	269	1	12	232	202	220	0	2	0	0	16	232
EDO. COJEDES	MP. TINAQUILLO	PQ. TINAQUILLO	ESCUELA  BASICA  LIGIA CADENA  DE ALVARADO	2756	5	55	2192	1414	2137	3	10	1	1	708	2192
EDO. COJEDES	MP. TINAQUILLO	PQ. TINAQUILLO	ESCUELA  BASICA ELOY JOSE ORTEGA PEREZ	2553	5	97	2102	1443	2005	0	14	1	0	547	2102
EDO. COJEDES	MP. TINAQUILLO	PQ. TINAQUILLO	ESCUELA  BASICA BALMIRA VILLEGAS	3506	6	60	2882	1400	2822	0	15	0	0	1407	2882
EDO. COJEDES	MP. TINAQUILLO	PQ. TINAQUILLO	ESCUELA BASICA ANTONIO JOSE DE SUCRE	2801	5	45	2204	1426	2159	1	12	3	3	714	2204
EDO. COJEDES	MP. TINAQUILLO	PQ. TINAQUILLO	CENTRO DE EDUCACION INICIAL BUENA VISTA	236	1	6	211	173	205	0	0	0	0	32	211
EDO. COJEDES	MP. TINAQUILLO	PQ. TINAQUILLO	ESCUELA  BASICA  FRANCISCO JOSE SANDOVAL	711	2	21	577	337	556	0	3	0	0	216	577
EDO. COJEDES	MP. TINAQUILLO	PQ. TINAQUILLO	CENTRO DE EDUCACION INICIAL NACIONAL BOLIVARIANO ANDRES BELLO	52	1	2	43	16	41	0	0	0	0	25	43
EDO. COJEDES	MP. TINAQUILLO	PQ. TINAQUILLO	CENTRO DE EDUCACION INICIAL NACIONAL BALMIRA VILLEGAS	580	1	11	502	338	491	0	1	0	0	152	502
EDO. COJEDES	MP. TINAQUILLO	PQ. TINAQUILLO	ESCUELA  BASICA  ANGEL MARIA LIZAUZABA	930	2	7	775	603	768	0	2	0	0	163	775
EDO. COJEDES	MP. TINAQUILLO	PQ. TINAQUILLO	CENTRO DE EDUCACION INICIAL NACIONAL BOLIVARIANO LOS CARIÑOSITOS	347	1	2	310	212	308	0	4	0	0	92	310
EDO. COJEDES	MP. TINAQUILLO	PQ. TINAQUILLO	ESCUELA PRIMARIA CERRO GORDO	160	1	9	132	101	123	0	1	0	0	21	132
EDO. COJEDES	MP. TINAQUILLO	PQ. TINAQUILLO	ESCUELA BASICA CONCENTRADA  NUMERO 206 NER  50	397	1	6	323	279	317	1	0	0	0	37	323
EDO. COJEDES	MP. TINAQUILLO	PQ. TINAQUILLO	ESCUELA BASICA ELOY JACINTO DIAZ OCHOA	1142	2	24	979	750	955	1	5	0	0	199	979
EDO. COJEDES	MP. TINAQUILLO	PQ. TINAQUILLO	CENTRO DE EDUCACION INICIAL BOLIVARIANA EL BAJIO	228	1	1	206	186	205	0	1	0	0	18	206
EDO. COJEDES	MP. TINAQUILLO	PQ. TINAQUILLO	ESCUELA  ESTADAL  CONCENTRADA  NUMERO  134	384	1	9	327	202	318	0	7	1	0	108	327
EDO. COJEDES	MP. TINAQUILLO	PQ. TINAQUILLO	ESCUELA  BASICA  JOSE FRANCISCO AROCHA	2022	4	50	1669	1097	1619	0	9	0	1	512	1669
EDO. COJEDES	MP. TINAQUILLO	PQ. TINAQUILLO	CENTRO UNIFICADO ANZOATEGUI	2508	5	33	2106	834	2073	0	13	0	0	1226	2106
EDO. COJEDES	MP. TINAQUILLO	PQ. TINAQUILLO	ESCUELA  BASICA UNITARIA NUMERO 61 249	995	2	22	813	491	791	0	4	1	2	293	813
EDO. COJEDES	MP. TINAQUILLO	PQ. TINAQUILLO	UNIVERSIDAD NACIONAL EXPERIMENTAL POLITECNICA DE LA FUERZA ARMADA. NUCLEO COJEDES	837	2	23	746	446	723	0	5	0	0	272	746
EDO. COJEDES	MP. TINAQUILLO	PQ. TINAQUILLO	ESCUELA BASICA  EDUARDO NOGUERA	3697	7	87	2943	2171	2856	1	18	3	0	663	2943
EDO. COJEDES	MP. TINAQUILLO	PQ. TINAQUILLO	CENTRO DE EDUCACION INICIAL KARACHE	150	1	3	134	106	131	0	0	0	0	25	134
EDO. COJEDES	MP. TINAQUILLO	PQ. TINAQUILLO	ESCUELA  BASICA NUMERO  90	757	2	15	603	432	588	0	6	0	0	150	603
EDO. COJEDES	MP. TINAQUILLO	PQ. TINAQUILLO	CENTRO DE EDUCACION INICIAL NACIONAL BOLIVARIANO CAJA DE AGUA 2	277	1	6	253	170	247	0	2	0	0	75	253
EDO. COJEDES	MP. TINAQUILLO	PQ. TINAQUILLO	ESCUELA  ESTADAL CONCENTRADA  NUMERO 168 TAMANACO	381	1	5	312	210	307	0	1	0	0	96	312
EDO. COJEDES	MP. TINAQUILLO	PQ. TINAQUILLO	UNIDAD EDUCATIVA NACIONAL BATALLA DE TAGUANES	449	1	15	373	274	358	0	3	0	0	81	373
EDO. COJEDES	MP. TINAQUILLO	PQ. TINAQUILLO	PRE ESCOLAR   JUAN IGNACIO MENDEZ	2336	4	56	1836	1380	1780	1	8	0	1	390	1836
EDO. COJEDES	MP. TINAQUILLO	PQ. TINAQUILLO	ESCUELA BASICA SIMON RODRIGUEZ	409	1	8	360	296	352	1	4	1	0	50	360
EDO. COJEDES	MP. TINAQUILLO	PQ. TINAQUILLO	CENTRO DE EDUCACION INICIAL BOLIVARIANO BATALLA DE TAGUANES	315	1	4	263	181	259	0	4	0	0	74	263
EDO. COJEDES	MP. TINAQUILLO	PQ. TINAQUILLO	ESCUELA CONCENTRADA SIN NUMERO CHIRGUITA	333	1	14	296	238	282	0	0	0	0	44	296
EDO. COJEDES	MP. TINAQUILLO	PQ. TINAQUILLO	ESCUELA  BOLIVARIANA JOSE ANTONIO  ANZOATEGUI	4276	8	49	3595	1336	3546	1	16	0	2	2191	3595
EDO. COJEDES	MP. TINAQUILLO	PQ. TINAQUILLO	ESCUELA  ESTADAL  CONCENTRADA  NUMERO  154	324	1	8	250	157	242	0	1	2	0	82	250
EDO. COJEDES	MP. TINAQUILLO	PQ. TINAQUILLO	PRE ESCOLAR LOS PICOS E' PLATA	2600	5	66	2063	1278	1997	1	13	2	1	702	2063
EDO. COJEDES	MP. TINAQUILLO	PQ. TINAQUILLO	ESCUELA BASICA NACIONAL BOLIVARIANA JUAN IGNACIO MENDEZ	639	2	11	559	464	548	0	2	0	0	82	559
EDO. COJEDES	MP. TINAQUILLO	PQ. TINAQUILLO	ESCUELA PRIMARIA RURAL LOS LEONCITOS	209	1	7	172	140	165	0	0	0	1	24	172
EDO. COJEDES	MP. TINAQUILLO	PQ. TINAQUILLO	CENTRO DE EDUCACION INICIAL MARIA DE LA CONCEPCION PALACIOS Y BLANCO	321	1	12	296	215	284	0	2	1	0	66	296
EDO. COJEDES	MP. TINAQUILLO	PQ. TINAQUILLO	UNIDAD EDUCATIVA SIMON BOLIVAR	1565	3	29	1246	876	1217	2	14	0	0	325	1246
EDO. COJEDES	MP. TINAQUILLO	PQ. TINAQUILLO	ESCUELA  BASICA  CRISTINA DE BOCANEY	3005	6	100	2361	1576	2261	4	11	3	2	665	2361
EDO. COJEDES	MP. TINAQUILLO	PQ. TINAQUILLO	CENTRO DE EDUCACION INICIAL ESTADAL LOS PEGONES	158	1	6	139	113	133	1	0	0	0	19	139
EDO. COJEDES	MP. TINAQUILLO	PQ. TINAQUILLO	UNIDAD EDUCATIVA  MONSEÑOR FRANCISCO MIGUEL SEIJAS	1499	3	27	1296	550	1269	0	5	0	2	712	1296
EDO. COJEDES	MP. TINAQUILLO	PQ. TINAQUILLO	CENTRO DE EDUCACION INICIAL AUTONOMA TINAQUILLO	96	1	1	78	36	77	0	0	0	0	41	78
EDO.NVA.ESPARTA	MP.VILLALBA(I.COCHE)	PQ. VICENTE FUENTES	UNIDAD EDUCATIVA ESTADAL FELIPA NERI DE NARVÁEZ	1061	2	10	883	507	873	0	5	2	0	359	883
EDO.NVA.ESPARTA	MP.VILLALBA(I.COCHE)	PQ. VICENTE FUENTES	UNIDAD EDUCATIVA BOLIVARIANA VICTOR MANUEL SALAZAR	1040	2	17	896	440	879	0	1	0	0	438	896
EDO.NVA.ESPARTA	MP.VILLALBA(I.COCHE)	PQ. VICENTE FUENTES	UNIDAD EDUCATIVA ESTADAL MERITA MARÍN	1072	2	13	921	529	908	0	1	2	0	376	921
EDO.NVA.ESPARTA	MP.VILLALBA(I.COCHE)	CM. SAN PEDRO DE COCHE	UNIDAD EDUCATIVA LICEO BOLIVARIANO NAPOLEÓN NARVÁEZ	1890	4	22	1490	860	1468	0	8	5	1	594	1490
EDO.NVA.ESPARTA	MP.VILLALBA(I.COCHE)	CM. SAN PEDRO DE COCHE	ESCUELA BÁSICA BOLIVARIANA DOCTOR AGUSTÍN RAFAEL HERNÁNDEZ	2169	4	35	1745	910	1710	0	7	5	0	788	1745
EDO.NVA.ESPARTA	CE. ARISMENDI	CM. LA ASUNCION	UNIDAD EDUCATIVA ESPECIAL BOLIVARIANA LUISA CÁCERES DE ARISMENDI	237	1	0	203	72	203	0	0	0	0	131	203
EDO.NVA.ESPARTA	CE. ARISMENDI	CM. LA ASUNCION	UNIDAD EDUCATIVA ESTADAL DOCTOR ANDRES ELOY BLANCO	2203	4	35	1826	783	1791	0	5	0	1	1002	1826
EDO.NVA.ESPARTA	CE. ARISMENDI	CM. LA ASUNCION	UNIDAD EDUCATIVA PROFESOR JOSE INOCENTE ALFARO	1713	3	30	1385	571	1355	0	5	0	1	778	1385
EDO.NVA.ESPARTA	CE. ARISMENDI	CM. LA ASUNCION	UNIDAD EDUCATIVA ESTADAL PROFESOR JULIO VILLARROEL	2380	5	26	1973	646	1947	0	5	1	1	1294	1973
EDO.NVA.ESPARTA	CE. ARISMENDI	CM. LA ASUNCION	CENTRO DE EDUCACION INICIAL LA ASUNCION	1089	2	7	920	325	913	0	1	0	1	586	920
EDO.NVA.ESPARTA	CE. ARISMENDI	CM. LA ASUNCION	UNIDAD EDUCATIVA NACIONAL BOLIVARIANA FRANCISCO ESTEBAN GOMEZ	3453	6	47	2850	1044	2803	0	13	2	0	1744	2850
EDO.NVA.ESPARTA	CE. ARISMENDI	CM. LA ASUNCION	UNIDAD EDUCATIVA RAMONA CARABALLO GUZMAN	1811	4	46	1574	723	1528	0	5	1	0	799	1574
EDO.NVA.ESPARTA	CE. ARISMENDI	CM. LA ASUNCION	UNIDAD EDUCATIVA BOLIVARIANA LUISA CACERES DE ARISMENDI	2436	5	40	2029	779	1989	0	7	1	2	1200	2029
EDO.NVA.ESPARTA	CE. ARISMENDI	CM. LA ASUNCION	INSTITUTO DE EDUCACION ESPECIAL BOLIVARIANO NUEVA ESPARTA	294	1	2	263	131	261	0	0	0	1	129	263
EDO.NVA.ESPARTA	CE. ARISMENDI	CM. LA ASUNCION	UNIDAD EDUCATIVA ESTADAL ENCARNACION RODRIGUEZ DE ROJAS	766	2	12	589	354	577	1	2	0	1	219	589
EDO.NVA.ESPARTA	CE. ARISMENDI	CM. LA ASUNCION	UNIDAD EDUCATIVA LICEO BOLIVARIANO DOCTOR FRANCISCO ANTONIO RISQUEZ	1077	2	15	905	317	890	1	2	1	0	569	905
EDO.NVA.ESPARTA	CE. ARISMENDI	CM. LA ASUNCION	UNIVERSIDAD NACIONAL ABIERTA	757	2	9	688	268	679	1	1	0	1	408	688
EDO.NVA.ESPARTA	CE. ARISMENDI	CM. LA ASUNCION	UNIDAD EDUCATIVA ESTADAL JUAN CANCIO RODRIGUEZ	2072	4	25	1737	826	1712	0	12	0	1	873	1737
EDO.NVA.ESPARTA	MP. MANEIRO	PQ. AGUIRRE	UNIDAD EDUCATIVA INSTITUTO SURAMERICANO LIBRE APRENDIZAJE (ISLA)	2085	4	10	1648	228	1638	0	5	0	0	1405	1648
EDO.NVA.ESPARTA	MP. MANEIRO	PQ. AGUIRRE	UNIDAD EDUCATIVA COLEGIO MADRE GUADALUPE	3281	6	15	2632	391	2617	0	5	0	1	2220	2632
EDO.NVA.ESPARTA	MP. MANEIRO	PQ. AGUIRRE	UNIDAD EDUCATIVA NACIONAL BOLIVARIANA VICTOR CEDENO	3016	6	26	2428	797	2402	0	3	0	0	1602	2428
EDO.NVA.ESPARTA	MP. MANEIRO	PQ. AGUIRRE	CASA DE LA CULTURA JUAN FERMIN MILLAN	2733	5	26	2270	791	2244	0	7	0	1	1445	2270
EDO.NVA.ESPARTA	MP. MANEIRO	PQ. AGUIRRE	UNIDAD EDUCATIVA ESTADAL PROFESOR  JESUS MANUEL SUBERO	1717	3	9	1349	425	1340	1	3	0	1	910	1349
EDO.NVA.ESPARTA	MP. MANEIRO	PQ. AGUIRRE	UNIDAD EDUCATIVA INSTITUTO MARIA AUXILIADORA II	1105	2	6	1011	159	1005	0	3	0	0	843	1011
EDO.NVA.ESPARTA	MP. MANEIRO	PQ. AGUIRRE	UNIDAD EDUCATIVA EL ANGEL	1397	3	11	1216	122	1205	0	6	1	0	1076	1216
EDO.NVA.ESPARTA	MP. MANEIRO	PQ. AGUIRRE	UNIDAD EDUCATIVA LICEO BOLIVARIANO JOSE AUGUSTO DE LEON	1965	4	22	1561	505	1539	0	3	0	0	1031	1561
EDO.NVA.ESPARTA	MP. MANEIRO	PQ. AGUIRRE	UNIDAD EDUCATIVA INSTITUTO MARIA AUXILIADORA I	257	1	3	233	59	230	0	0	0	0	171	233
EDO.NVA.ESPARTA	MP. MANEIRO	PQ. AGUIRRE	UNIDAD EDUCATIVA INSTITUTO EDUCACIONAL RENACER	656	2	10	595	162	585	0	2	0	0	421	595
EDO.NVA.ESPARTA	MP. MANEIRO	PQ. AGUIRRE	SEDE BANDA SHOW ESCUELA MARIA SINFOROZA REYES	365	1	10	329	112	319	0	0	0	0	207	329
EDO.NVA.ESPARTA	MP. MANEIRO	CM. PAMPATAR	UNIDAD EDUCATIVA ESTADAL LUISA ROSAS DE VELASQUEZ	3622	7	40	3049	1363	3009	0	3	1	1	1641	3049
EDO.NVA.ESPARTA	MP. MANEIRO	CM. PAMPATAR	UNIDAD EDUCATIVA BOLIVARIANA PETRA SUÁREZ DE PIÑERUA	650	2	17	599	230	582	0	3	0	0	349	599
EDO.NVA.ESPARTA	MP. MANEIRO	CM. PAMPATAR	FUNDACION CULTURAL ALI PRIMERA	720	2	17	622	385	605	0	0	0	0	220	622
EDO.NVA.ESPARTA	MP. MANEIRO	CM. PAMPATAR	BIBLIOTECA ROSAURA ROSA ACOSTA	1248	3	14	962	307	948	0	0	0	0	641	962
EDO.NVA.ESPARTA	MP. MANEIRO	CM. PAMPATAR	CASA DE LA CULTURA MANUEL PLACIDO MANEIRO	533	1	6	451	121	445	0	2	0	0	322	451
EDO.NVA.ESPARTA	MP. MANEIRO	CM. PAMPATAR	UNIDAD EDUCATIVA CRISTO DEL BUEN VIAJE	2291	4	32	1858	625	1826	0	5	0	2	1194	1858
EDO.NVA.ESPARTA	MP. MANEIRO	CM. PAMPATAR	UNIDAD EDUCATIVA NACIONAL BOLIVARIANA JOSE JOAQUIN DE OLMEDO	2947	6	26	2346	792	2320	0	6	0	2	1520	2346
EDO.NVA.ESPARTA	MP. MANEIRO	CM. PAMPATAR	UNIDAD EDUCATIVA JOSE CONCEPCION SALCEDO AVILA	1166	2	23	924	432	901	0	3	0	1	465	924
EDO.NVA.ESPARTA	MP. MANEIRO	CM. PAMPATAR	UNIDAD EDUCATIVA CASTA JOSEFINA SALAZAR DE LOPEZ	1843	4	14	1521	799	1507	0	5	0	0	703	1521
EDO.NVA.ESPARTA	MP. MANEIRO	CM. PAMPATAR	CENTRO DE EDUCACION INICIAL PROFESOR BERNARDO ACOSTA	889	2	13	718	361	705	0	2	0	0	342	718
EDO.NVA.ESPARTA	MP. GOMEZ	PQ. MATASIETE	UNIDAD EDUCATIVA NACIONAL BOLIVARIANA JUAN BAUTISTA ARISMENDI	2727	5	25	2264	1110	2239	0	15	0	0	1114	2264
EDO.NVA.ESPARTA	MP. GOMEZ	PQ. MATASIETE	UNIDAD EDUCATIVA NACIONAL BOLIVARIANA CONCENTRADA EL SALADO	263	1	4	241	150	237	0	1	0	0	86	241
EDO.NVA.ESPARTA	MP. GOMEZ	PQ. MATASIETE	UNIDAD EDUCATIVA CONCENTRADA NUMERO 24	378	1	7	333	225	326	0	1	0	0	100	333
EDO.NVA.ESPARTA	MP. GOMEZ	PQ. MATASIETE	CENTRO DE EDUCACION INICIAL SIMONCITO ARCELIA MORENO DE GONZALEZ	379	1	5	310	198	305	0	1	0	0	106	310
EDO.NVA.ESPARTA	MP. GOMEZ	PQ. GUEVARA	UNIDAD EDUCATIVA BOLIVARIANA NAPOLEON NARVAEZ	1915	4	16	1609	738	1593	0	7	0	0	848	1609
EDO.NVA.ESPARTA	MP. GOMEZ	PQ. GUEVARA	UNIDAD EDUCATIVA CRUZ MILLAN GARCIA	2067	4	29	1692	890	1663	0	10	1	0	762	1692
EDO.NVA.ESPARTA	MP. GOMEZ	CM. SANTA ANA	BIBLIOTECA PUBLICA JUSTA MATA GAMBOA	794	2	6	637	373	631	0	2	0	0	256	637
EDO.NVA.ESPARTA	MP. GOMEZ	CM. SANTA ANA	CENTRO DE EDUCACION INICIAL VALERIANO LAREZ	453	1	7	364	244	357	0	0	0	0	113	364
EDO.NVA.ESPARTA	MP. GOMEZ	CM. SANTA ANA	UNIDAD EDUCATIVA LICEO BOLIVARIANO RICARDO MARQUEZ MORENO	536	1	2	461	282	459	0	4	0	0	173	461
EDO.NVA.ESPARTA	MP. GOMEZ	CM. SANTA ANA	CENTRO DE EDUCACION INICIAL SIMONCITO MAESTRO JESUS MANUEL MARIN	2695	5	27	2259	1354	2232	0	7	0	1	870	2259
EDO.NVA.ESPARTA	MP. GOMEZ	CM. SANTA ANA	UNIDAD EDUCATIVA BOLIVARIANA MATASIETE	3086	6	29	2542	1275	2513	0	15	0	2	1221	2542
EDO.NVA.ESPARTA	MP. GOMEZ	CM. SANTA ANA	ESCUELA PRIMARIA BOLIVARIANA BACHILLER JUAN JOSE FERNANDEZ	444	1	9	393	243	384	0	2	0	0	139	393
EDO.NVA.ESPARTA	MP. GOMEZ	CM. SANTA ANA	CENTRO CULTURAL EL MORO	454	1	3	346	216	343	0	0	0	0	127	346
EDO.NVA.ESPARTA	MP. GOMEZ	CM. SANTA ANA	CENTRO DE EDUCACION INICIAL CONSUELO DE NATERA	471	1	10	409	318	399	0	3	0	1	77	409
EDO.NVA.ESPARTA	MP. GOMEZ	CM. SANTA ANA	UNIDAD EDUCATIVA JOSE RAMON LOPEZ VELASQUEZ	1042	2	9	864	566	855	0	4	1	0	284	864
EDO.NVA.ESPARTA	MP. GOMEZ	PQ. BOLIVAR	UNIDAD EDUCATIVA NACIONAL BOLIVARIANA APOLINAR FIGUEROA CORONADO	1705	3	14	1474	799	1460	0	11	1	0	649	1474
EDO.NVA.ESPARTA	MP. GOMEZ	PQ. SUCRE	UNIDAD EDUCATIVA BOLIVARIANA JOSE CORTES DE MADARIAGA	2703	5	38	2144	1052	2106	0	12	0	0	1042	2144
EDO.NVA.ESPARTA	MP. GOMEZ	PQ. SUCRE	CENTRO DE EDUCACION INICIAL SOL Y ARENA	691	2	6	535	321	529	0	4	0	0	204	535
EDO.NVA.ESPARTA	MP. GOMEZ	PQ. SUCRE	CENTRO DE EDUCACION INICIAL SIMONCITO MAESTRA MARIA GERTRUDIS GONZALEZ	808	2	8	689	432	681	0	4	0	0	245	689
EDO.NVA.ESPARTA	MP. GOMEZ	PQ. SUCRE	UNIDAD EDUCATIVA ESTADAL NUESTRA SEÑORA DE ALTAGRACIA	2337	4	36	1870	875	1834	0	9	0	1	949	1870
EDO.NVA.ESPARTA	MP. GOMEZ	PQ. SUCRE	CENTRO DE EDUCACION INICIAL BRISAS DE ALTAGRACIA	508	1	5	386	327	381	0	2	0	0	52	386
EDO.NVA.ESPARTA	MP. GARCIA	CM. VALLE ESP SANTO	UNIDAD EDUCATIVA MONSEÑOR EDUARDO VÁSQUEZ	3352	6	66	2636	1303	2570	0	14	0	2	1251	2636
EDO.NVA.ESPARTA	MP. GARCIA	CM. VALLE ESP SANTO	UNIDAD EDUCATIVA COLEGIO AMERICO VESPUCIO	2952	6	43	2367	961	2324	1	8	2	0	1352	2367
EDO.NVA.ESPARTA	MP. GARCIA	CM. VALLE ESP SANTO	CASA DE LA CULTURA VALLE DE LA MARGARITA	565	1	12	471	198	459	0	1	0	1	259	471
EDO.NVA.ESPARTA	MP. GARCIA	CM. VALLE ESP SANTO	UNIDAD EDUCATIVA INSTITUTO DIOCESANO EL VALLE DEL ESPÍRITU SANTO	1183	2	10	1007	357	997	0	3	0	1	636	1007
EDO.NVA.ESPARTA	MP. GARCIA	PQ. FRANCISCO FAJARDO	MISION BARRIO ADENTRO L URBANIZACION PEDRO LUIS BRICENO	443	1	3	370	310	367	0	2	0	0	55	370
EDO.NVA.ESPARTA	MP. GARCIA	PQ. FRANCISCO FAJARDO	ESCUELA BÁSICA VILLA ROSA	3372	6	73	2731	1379	2658	0	17	1	1	1260	2731
EDO.NVA.ESPARTA	MP. GARCIA	PQ. FRANCISCO FAJARDO	CENTRO DE EDUCACIÓN INICIAL LUISA CÁCERES DE ARISMENDI	2087	4	47	1718	941	1671	0	11	0	0	719	1718
EDO.NVA.ESPARTA	MP. GARCIA	PQ. FRANCISCO FAJARDO	UNIDAD EDUCATIVA LICEO BOLIVARIANO MAESTRA ARGELIA LAYA	1052	2	18	836	549	818	0	6	0	1	262	836
EDO.NVA.ESPARTA	MP. GARCIA	PQ. FRANCISCO FAJARDO	UNIDAD EDUCATIVA SANTIAGO MARIÑO	997	2	11	809	342	798	0	3	0	1	452	809
EDO.NVA.ESPARTA	MP. GARCIA	PQ. FRANCISCO FAJARDO	MISION BARRIO ADENTRO I LA CAPILLA	513	1	11	450	334	439	0	2	0	0	103	450
EDO.NVA.ESPARTA	MP. GARCIA	PQ. FRANCISCO FAJARDO	UNIDAD EDUCATIVA MARIA MONTESSORI	1239	3	12	1057	607	1045	0	2	0	0	436	1057
EDO.NVA.ESPARTA	MP. GARCIA	PQ. FRANCISCO FAJARDO	CENTRO DE EDUCACION INICIAL SANTIAGO MARINO	2307	4	24	1952	902	1928	0	7	0	0	1019	1952
EDO.NVA.ESPARTA	MP. GARCIA	PQ. FRANCISCO FAJARDO	CENTRO DE EDUCACIÓN INICIAL SIMONCITO SIMÓN BOLÍVAR	924	2	17	768	403	751	0	1	0	0	347	768
EDO.NVA.ESPARTA	MP. GARCIA	PQ. FRANCISCO FAJARDO	CENTRO PENITENCIARIO REGIÓN INSULAR	1163	2	2	550	462	548	0	4	1	1	80	550
EDO.NVA.ESPARTA	MP. GARCIA	PQ. FRANCISCO FAJARDO	ESCUELA BASICA LICEO BOLIVARIANO PRESBISTERO MANUEL MONTANER SALAZAR	2371	5	41	1957	986	1916	0	11	1	0	918	1957
EDO.NVA.ESPARTA	MP. GARCIA	PQ. FRANCISCO FAJARDO	CENTRO DE EDUCACIÓN INICIAL SIMONCITO LUISA CHENG DE MARÍN	1723	3	27	1480	806	1453	0	8	2	0	637	1480
EDO.NVA.ESPARTA	MP. GARCIA	PQ. FRANCISCO FAJARDO	UNIDAD EDUCATIVA ESTADAL MARIA ELVIRA DE FIGUEROA	3193	6	58	2501	1517	2443	0	16	1	1	908	2501
EDO.NVA.ESPARTA	MP. GARCIA	PQ. FRANCISCO FAJARDO	CENTRO DE EDUCACION INICIAL SIMONCITO CONCEPCION MARIÑO	1543	3	25	1290	974	1265	0	5	0	1	285	1290
EDO.NVA.ESPARTA	MP. GARCIA	PQ. FRANCISCO FAJARDO	CENTRO DE EDUCACIÓN INICIAL SIMONCITO SAN ANTONIO	2081	4	53	1646	1095	1593	0	15	0	1	482	1646
EDO.NVA.ESPARTA	MP. GARCIA	PQ. FRANCISCO FAJARDO	UNIDAD EDUCATIVA INSTITUTO EDUCACIONAL ABC	445	1	8	366	180	358	0	3	0	0	175	366
EDO.NVA.ESPARTA	MP. GARCIA	PQ. FRANCISCO FAJARDO	CASA INTEGRAL DE PEDRO LUIS BRICENO	97	1	3	75	51	72	0	0	0	0	21	75
EDO.NVA.ESPARTA	MP. GARCIA	PQ. FRANCISCO FAJARDO	UNIDAD EDUCATIVA LUISA MERCEDES HERNANDEZ DE CARRILLO	2339	4	40	1940	841	1900	1	10	0	2	1046	1940
EDO.NVA.ESPARTA	MP. GARCIA	PQ. FRANCISCO FAJARDO	UNIDAD EDUCATIVA BOLIVARIANA MANUELA SAENZ	621	2	12	551	351	539	0	3	0	0	185	551
EDO.NVA.ESPARTA	MP. GARCIA	PQ. FRANCISCO FAJARDO	CENTRO DE EDUCACION INICIAL SIMONCITO GUAIQUERI	487	1	7	394	236	387	0	1	0	0	150	394
EDO.NVA.ESPARTA	MP. GARCIA	PQ. FRANCISCO FAJARDO	CENTRO DE EDUCACION INICIAL  MARIA ELVIRA DE FIGUEROA	976	2	19	771	511	752	0	4	0	0	237	771
EDO.NVA.ESPARTA	MP. MARCANO	CM. JUAN GRIEGO	UNIDAD EDUCATIVA ESTADAL RURAL CONCENTRADA NUMERO 50	607	2	8	505	281	497	0	1	1	0	214	505
EDO.NVA.ESPARTA	MP. MARCANO	CM. JUAN GRIEGO	CENTRO DE EDUCACION INICIAL LA SABANETA	587	1	5	477	346	472	0	4	0	1	121	477
EDO.NVA.ESPARTA	MP. MARCANO	CM. JUAN GRIEGO	ESCUELA BASICA ESTADAL ANTONIA MATILDE MATA	2193	4	31	1861	1099	1830	1	12	0	0	718	1861
EDO.NVA.ESPARTA	MP. MARCANO	CM. JUAN GRIEGO	CENTRO DE EDUCACION INICIAL DOÑANA	1932	4	33	1591	967	1558	0	7	2	0	582	1591
EDO.NVA.ESPARTA	MP. MARCANO	CM. JUAN GRIEGO	SIMONCITO COMUNITARIO LOS TUCANES	297	1	7	243	185	236	0	0	0	0	51	243
EDO.NVA.ESPARTA	MP. MARCANO	CM. JUAN GRIEGO	UNIDAD EDUCATIVA SAN JUDAS TADEO	1203	3	11	959	467	948	1	5	3	0	472	959
EDO.NVA.ESPARTA	MP. MARCANO	CM. JUAN GRIEGO	UNIDAD EDUCATIVA LICEO BOLIVARIANO JUAN DE CASTELLANOS	418	1	5	347	173	342	0	1	0	0	168	347
EDO.NVA.ESPARTA	MP. MARCANO	CM. JUAN GRIEGO	CENTRO DE EDUCACION INICIAL BAHIA DEL SOL	402	1	4	358	252	354	0	0	0	0	102	358
EDO.NVA.ESPARTA	MP. MARCANO	CM. JUAN GRIEGO	UNIDAD EDUCATIVA PRESBITERO MANUEL MONTANER SALAZAR	1768	3	25	1451	718	1426	0	14	0	0	694	1451
EDO.NVA.ESPARTA	MP. MARCANO	CM. JUAN GRIEGO	UNIDAD EDUCATIVA FRANCISCO SALAZAR SABINO	1503	3	21	1208	598	1187	1	8	0	0	580	1208
EDO.NVA.ESPARTA	MP. MARCANO	CM. JUAN GRIEGO	CENTRO DE EDUCACION INTEGRAL INICIAL JUAN GRIEGO	1106	2	17	910	537	893	0	5	1	0	350	910
EDO.NVA.ESPARTA	MP. MARCANO	CM. JUAN GRIEGO	UNIDAD EDUCATIVA LICEO BOLIVARIANO ANTONIO DIAZ	2748	5	27	2164	1039	2137	1	6	1	1	1089	2164
EDO.NVA.ESPARTA	MP. MARCANO	PQ. ADRIAN	UNIDAD EDUCATIVA NACIONAL BOLIVARIANA RAFAEL VALERY MAZA	2304	4	40	1894	917	1854	0	15	1	0	921	1894
EDO.NVA.ESPARTA	MP. MARCANO	PQ. ADRIAN	UNIDAD EDUCATIVA ESTADAL LOURDES RODRIGUEZ	1222	3	16	1015	649	999	0	4	1	0	345	1015
EDO.NVA.ESPARTA	MP. MARCANO	PQ. ADRIAN	CENTRO DE EDUCACION INICIAL LOS MILLANES	884	2	13	719	458	706	0	4	0	0	244	719
EDO.NVA.ESPARTA	MP. MARCANO	PQ. ADRIAN	CENTRO DE EDUCACION INICIAL DOCTOR FRANCISCO ANTONIO RISQUEZ	656	2	4	566	342	562	0	4	0	0	216	566
EDO.NVA.ESPARTA	MP. MARCANO	PQ. ADRIAN	CENTRO DE EDUCACION INICIAL SIMONCITO VICUÑA	302	1	0	262	193	262	0	2	0	0	67	262
EDO.NVA.ESPARTA	MP. MARCANO	PQ. ADRIAN	UNIDAD EDUCATIVA ESTADAL JUANA MENDEZ PENOTH	1605	3	24	1306	730	1282	0	9	1	0	542	1306
EDO.NVA.ESPARTA	MP. MARCANO	PQ. ADRIAN	SEDE DE LA CASA COMUNAL DE CHORO CHORO	533	1	15	447	279	432	0	3	1	0	149	447
EDO.NVA.ESPARTA	MP. MARCANO	PQ. ADRIAN	UNIDAD EDUCATIVA DOCTOR FRANCISCO ANTONIO RISQUEZ	3031	6	47	2516	1455	2469	0	12	1	2	999	2516
EDO.NVA.ESPARTA	MP. DIAZ	PQ. ZABALA	CENTRO DE EDUCACION INICIAL ESTADAL LAS CASAS	873	2	18	735	566	717	0	3	0	0	148	735
EDO.NVA.ESPARTA	MP. DIAZ	PQ. ZABALA	UNIDAD EDUCATIVA ESTADAL MARIA ROSARIO LAREZ	1031	2	30	853	523	823	0	1	0	0	299	853
EDO.NVA.ESPARTA	MP. DIAZ	PQ. ZABALA	UNIDAD EDUCATIVA LICEO BOLIVARIANO LA GUARDIA	1576	3	43	1235	705	1192	0	2	1	1	483	1235
EDO.NVA.ESPARTA	MP. DIAZ	PQ. ZABALA	UNIDAD EDUCATIVA NACIONAL BOLIVARIANA MIGUEL SUNIAGA	2776	5	61	2174	1127	2113	0	14	1	2	969	2174
EDO.NVA.ESPARTA	MP. DIAZ	PQ. ZABALA	UNIDAD EDUCATIVA PROFESOR  ASCANIO J. VELASQUEZ	2447	5	45	1910	1210	1865	2	9	1	1	642	1910
EDO.NVA.ESPARTA	MP. DIAZ	PQ. ZABALA	CENTRO DE EDUCACION INICIAL BRISAS DEL VALLE	904	2	21	754	611	733	0	6	0	0	116	754
EDO.NVA.ESPARTA	MP. DIAZ	PQ. ZABALA	MODULO DE BARRIO ADENTRO BARRIO UNION	838	2	22	690	563	668	1	4	0	0	100	690
EDO.NVA.ESPARTA	MP. DIAZ	PQ. ZABALA	CENTRO DE EDUCACION INICIAL MIGUEL SUNIAGA	2072	4	46	1635	891	1589	1	7	0	1	689	1635
EDO.NVA.ESPARTA	MP. DIAZ	CM. SAN JUAN BAUTISTA	UNIDAD EDUCATIVA SIMON JOSE ARISMENDI	818	2	14	673	353	659	0	1	0	0	305	673
EDO.NVA.ESPARTA	MP. DIAZ	CM. SAN JUAN BAUTISTA	UNIDAD EDUCATIVA CESAREA DIAZ DE HERRERA	1310	3	22	1123	489	1101	0	4	1	0	607	1123
EDO.NVA.ESPARTA	MP. DIAZ	CM. SAN JUAN BAUTISTA	CENTRO DE EDUCACIÓN INICIAL PRESBITERO MONSEÑOR JOSÉ ANTONIO CÓNSTENLA GARRIDO	458	1	10	410	268	400	0	1	0	0	131	410
EDO.NVA.ESPARTA	MP. DIAZ	CM. SAN JUAN BAUTISTA	UNIDAD EDUCATIVA LICEO BOLIVARIANO GASPAR MARCANO	1141	2	23	996	390	973	0	4	0	0	579	996
EDO.NVA.ESPARTA	MP. DIAZ	CM. SAN JUAN BAUTISTA	UNIDAD EDUCATIVA ESCOLAR FELICIANO HERNANDEZ	2234	4	56	1789	917	1733	0	12	0	0	804	1789
EDO.NVA.ESPARTA	MP. DIAZ	CM. SAN JUAN BAUTISTA	UNIDAD EDUCATIVA DOÑA EMILIA DE VELASQUEZ	1369	3	29	1174	452	1145	0	4	0	0	689	1174
EDO.NVA.ESPARTA	MP. DIAZ	CM. SAN JUAN BAUTISTA	ESCUELA BASICA BOLIVARIANA FRANCISCO BOADAS DIAZ	1886	4	38	1666	851	1628	1	3	0	1	772	1666
EDO.NVA.ESPARTA	MP. DIAZ	CM. SAN JUAN BAUTISTA	CENTRO DE EDUCACION INICIAL YNES MERCEDES SALAZAR DE RONDON	1180	2	24	975	645	951	0	5	0	1	300	975
EDO.NVA.ESPARTA	MP. DIAZ	CM. SAN JUAN BAUTISTA	UNIDAD EDUCATIVA LICEO BOLIVARIANO FRANCISCO FAJARDO	2493	5	34	2031	903	1997	0	12	0	2	1080	2031
EDO.NVA.ESPARTA	MP. DIAZ	CM. SAN JUAN BAUTISTA	UNIDAD EDUCATIVA CONCENTRADA NUMERO 69	260	1	8	209	114	201	0	0	0	1	86	209
EDO.NVA.ESPARTA	MP. DIAZ	CM. SAN JUAN BAUTISTA	CENTRO DE EDUCACION INICIAL CERROMAR	1367	3	36	1182	768	1146	0	5	0	0	373	1182
EDO.NVA.ESPARTA	MP. DIAZ	CM. SAN JUAN BAUTISTA	CENTRO DE EDUCACION INICIAL MARIA GUEVARA	1998	4	67	1726	1107	1659	2	9	0	0	541	1726
EDO.NVA.ESPARTA	MP. DIAZ	CM. SAN JUAN BAUTISTA	UNIDAD EDUCATIVA ESTADAL JOAQUINA VELASQUEZ DE ROMERO	2092	4	47	1752	997	1705	1	7	0	1	699	1752
EDO.NVA.ESPARTA	MP. DIAZ	CM. SAN JUAN BAUTISTA	UNIDAD EDUCATIVA ESTADAL ANIBAL LAREZ	3314	6	68	2700	1531	2632	1	19	1	0	1080	2700
EDO.NVA.ESPARTA	MP. DIAZ	CM. SAN JUAN BAUTISTA	UNIDAD EDUCATIVA ESTHELA ZABALA DE SOTO	1051	2	33	869	489	836	0	2	0	1	344	869
EDO.NVA.ESPARTA	MP. DIAZ	CM. SAN JUAN BAUTISTA	UNIDAD EDUCATIVA ESTADAL MARIA AUXILIADORA ZABALA DE MILLAN	1196	3	17	1042	512	1025	0	5	0	1	507	1042
EDO.NVA.ESPARTA	MP. DIAZ	CM. SAN JUAN BAUTISTA	UNIDAD EDUCATIVA JUANA SALAZAR DE MORENO	684	2	20	584	304	564	0	2	0	0	258	584
EDO.NVA.ESPARTA	MP. DIAZ	CM. SAN JUAN BAUTISTA	CENTRO DE EDUCACION INICIAL LA LAGUNITA	1937	4	57	1588	962	1531	0	6	0	0	563	1588
EDO.NVA.ESPARTA	MP. DIAZ	CM. SAN JUAN BAUTISTA	UNIDAD EDUCATIVA ESTADAL PROFESOR OVIDIO VALERIO	929	2	30	791	564	761	0	5	0	0	192	791
EDO.NVA.ESPARTA	MP. TUBORES	CM. PUNTA DE PIEDRAS	CENTRO DE EDUCACION INICIAL LOS MARINERITOS	418	1	16	346	217	330	0	1	0	0	112	346
EDO.NVA.ESPARTA	MP. TUBORES	CM. PUNTA DE PIEDRAS	ESCUELA BASICA ESTADAL JOSE PRESENTACION ESPINOZA REYES	514	1	8	407	188	399	0	2	0	0	209	407
EDO.NVA.ESPARTA	MP. TUBORES	CM. PUNTA DE PIEDRAS	UNIDAD EDUCATIVA JOSEFINA ORTIZ	1527	3	21	1279	753	1258	0	8	0	0	497	1279
EDO.NVA.ESPARTA	MP. TUBORES	CM. PUNTA DE PIEDRAS	ESCUELA BASICA ALBINA RODRIGUEZ DE MARCANO	1126	2	10	929	469	919	1	2	0	0	447	929
EDO.NVA.ESPARTA	MP. TUBORES	CM. PUNTA DE PIEDRAS	UNIDAD EDUCATIVA BOLIVARIANA MAESTRA TRINA GUERRA DE GUERRA	1780	3	45	1476	1059	1431	0	6	1	0	365	1476
EDO.NVA.ESPARTA	MP. TUBORES	CM. PUNTA DE PIEDRAS	UNIDAD EDUCATIVA ESTADAL CONCENTRADA NUMERO 53 LA RESTINGA	105	1	2	86	41	84	0	0	0	0	43	86
EDO.NVA.ESPARTA	MP. TUBORES	CM. PUNTA DE PIEDRAS	UNIDAD EDUCATIVA LICEO BOLIVARIANO TUBORES	2191	4	37	1707	986	1670	0	8	0	0	676	1707
EDO.NVA.ESPARTA	MP. TUBORES	CM. PUNTA DE PIEDRAS	UNIDAD EDUCATIVA ESTADAL DOROTEO DIAZ SALAZAR	836	2	18	651	385	633	0	2	1	0	245	651
EDO.NVA.ESPARTA	MP. TUBORES	CM. PUNTA DE PIEDRAS	UNIDAD EDUCATIVA ESTADAL SALUSTIANO SALAZAR MARIN	916	2	12	770	442	758	0	2	0	0	314	770
EDO.NVA.ESPARTA	MP. TUBORES	CM. PUNTA DE PIEDRAS	INSTITUTO EDUCACIÓN ESPECIAL LAS HERNÁNDEZ	1095	2	8	855	469	847	0	6	1	0	371	855
EDO.NVA.ESPARTA	MP. TUBORES	CM. PUNTA DE PIEDRAS	SIMONCITO NUMERO 25 LA REDOMA, LAS HERNANDEZ	188	1	2	170	92	168	0	0	0	0	76	170
EDO.NVA.ESPARTA	MP. TUBORES	CM. PUNTA DE PIEDRAS	STADIUM JOSE JESUS GOMEZ IBARRA	166	1	3	158	116	155	0	0	0	0	39	158
EDO.NVA.ESPARTA	MP. TUBORES	CM. PUNTA DE PIEDRAS	UNIDAD EDUCATIVA COLEGIO SAN SIMÓN APÓSTOL (ADULTO)	546	1	5	463	297	458	0	1	1	0	159	463
EDO.NVA.ESPARTA	MP. TUBORES	CM. PUNTA DE PIEDRAS	CENTRO DE EDUCACION INICIAL SIMONCITO GUAYACAN DEL NORTE
EDO.NVA.ESPARTA	MP. TUBORES	CM. PUNTA DE PIEDRAS	UNIDAD EDUCATIVA LICEO BOLIVARIANO LAS HERNÁNDEZ	1792	4	29	1470	746	1441	0	6	0	1	688	1470
EDO.NVA.ESPARTA	MP. TUBORES	CM. PUNTA DE PIEDRAS	CENTRO DE EDUCACIÓN INICIAL TIO CONEJO	1690	3	26	1390	689	1364	1	5	0	0	669	1390
EDO.NVA.ESPARTA	MP. TUBORES	CM. PUNTA DE PIEDRAS	UNIDAD EDUCATIVA ESTADAL JUAN RAMÓN AGUILERA	1088	2	8	839	346	831	0	2	1	0	482	839
EDO.NVA.ESPARTA	MP. TUBORES	CM. PUNTA DE PIEDRAS	UNIDAD EDUCATIVA ESTADAL DON SIMON RODRIGUEZ	880	2	12	720	345	708	0	3	0	1	359	720
EDO.NVA.ESPARTA	MP. TUBORES	PQ. LOS BARALES	UNIDAD EDUCATIVA ESTADAL CONCENTRADA NUMERO 59	593	1	7	463	293	456	0	2	0	0	161	463
EDO.NVA.ESPARTA	MP. TUBORES	PQ. LOS BARALES	CASA COMUNAL EL HATICO	206	1	4	181	122	177	0	3	0	0	52	181
EDO.NVA.ESPARTA	MP. TUBORES	PQ. LOS BARALES	UNIDAD EDUCATIVA ESTADAL JESÚS RAMÓN GAMBOA	781	2	8	626	412	618	0	3	0	0	203	626
EDO.NVA.ESPARTA	MP. TUBORES	PQ. LOS BARALES	UNIDAD EDUCATIVA JOSÉ VICENTE MARCANO	2285	4	31	1829	1057	1798	0	7	1	0	733	1829
EDO.NVA.ESPARTA	MP. TUBORES	PQ. LOS BARALES	UNIDAD EDUCATIVA ESTADAL BACHILLER CRUZ JOSE MARVAL	1340	3	33	1095	654	1062	0	2	0	1	405	1095
EDO.NVA.ESPARTA	MP. TUBORES	PQ. LOS BARALES	UNIDAD EDUCATIVA CONCENTRADA NUMERO 25	453	1	3	369	224	366	0	2	0	0	140	369
EDO.NVA.ESPARTA	MP. TUBORES	PQ. LOS BARALES	CENTRO EDUCACION INICIAL NUESTRA SEÑORA DE LAS MERCEDES	309	1	6	253	188	247	0	0	0	0	59	253
EDO.NVA.ESPARTA	MP.PENIN. DE MACANAO	PQ. SAN FRANCISCO	ESCUELA BASICA DOCTOR FRANCISCO ANTONIO GARCIA	2713	5	16	1751	1090	1735	0	5	1	1	638	1751
EDO.NVA.ESPARTA	MP.PENIN. DE MACANAO	PQ. SAN FRANCISCO	UNIDAD EDUCATIVA JESUS EUFRACIO VALERIO MARIN	87	1	1	79	56	78	0	0	0	0	22	79
EDO.NVA.ESPARTA	MP.PENIN. DE MACANAO	PQ. SAN FRANCISCO	ESCUELA BASICA ANTONIO JOSE DE SUCRE	1665	3	20	1261	781	1241	0	4	2	0	454	1261
EDO.NVA.ESPARTA	MP.PENIN. DE MACANAO	PQ. SAN FRANCISCO	CENTRO DE EDUCACION INICIAL ANA MARIA CAMPOS	1153	2	12	792	496	780	0	4	1	0	279	792
EDO.NVA.ESPARTA	MP.PENIN. DE MACANAO	PQ. SAN FRANCISCO	INFOCENTRO EL HORCON	121	1	4	109	91	105	0	0	0	0	14	109
EDO.NVA.ESPARTA	MP.PENIN. DE MACANAO	PQ. SAN FRANCISCO	CANCHA DE USOS MULTIPLES EL MANANTIAL	153	1	1	126	92	125	0	1	0	0	32	126
EDO.NVA.ESPARTA	MP.PENIN. DE MACANAO	PQ. SAN FRANCISCO	UNIDAD EDUCATIVA ESTADAL FRANCISCO ROJAS GAMBOA	757	2	12	600	337	588	0	1	0	0	250	600
EDO.NVA.ESPARTA	MP.PENIN. DE MACANAO	PQ. SAN FRANCISCO	CASA COMUNAL PESCADOR EL TUNAL	119	1	3	106	67	103	0	0	0	0	36	106
EDO.NVA.ESPARTA	MP.PENIN. DE MACANAO	PQ. SAN FRANCISCO	INFOCENTRO LA LAGUNA	115	1	2	95	68	93	0	2	0	1	22	95
EDO.NVA.ESPARTA	MP.PENIN. DE MACANAO	PQ. SAN FRANCISCO	UNIDAD EDUCATIVA ESTADAL DOCTOR JOSE MARIA VARGAS	1290	3	17	1105	568	1088	0	2	0	1	517	1105
EDO.NVA.ESPARTA	MP.PENIN. DE MACANAO	PQ. SAN FRANCISCO	UNIDAD EDUCATIVA CONCENTRADA PUNTA ARENAS	115	1	1	92	63	91	0	0	0	0	28	92
EDO.NVA.ESPARTA	MP.PENIN. DE MACANAO	PQ. SAN FRANCISCO	CENTRO DE EDUCACION INICIAL DOCTOR HORACIO NELSON GARCIA MARIN	796	2	10	567	361	557	0	3	0	0	193	567
EDO.NVA.ESPARTA	MP.PENIN. DE MACANAO	PQ. SAN FRANCISCO	UNIDAD EDUCATIVA LICEO BOLIVARIANO BOCA DE POZO	703	2	3	481	338	478	0	3	0	1	136	481
EDO.NVA.ESPARTA	MP.PENIN. DE MACANAO	CM. BOCA DEL RIO	CENTRO DE EDUCACION INICIAL EMILIA MARIA MATA VASQUEZ	498	1	2	418	290	416	0	2	0	0	124	418
EDO.NVA.ESPARTA	MP.PENIN. DE MACANAO	CM. BOCA DEL RIO	ESCUELA BASICA SIMON BOLIVAR	1209	3	7	939	511	932	1	5	0	0	415	939
EDO.NVA.ESPARTA	MP.PENIN. DE MACANAO	CM. BOCA DEL RIO	UNIDAD EDUCATIVA LICEO BOLIVARIANO LUIS CASTRO	2716	5	30	2141	1034	2111	0	11	0	1	1065	2141
EDO.NVA.ESPARTA	MP.PENIN. DE MACANAO	CM. BOCA DEL RIO	ESCUELA BASICA MONSENOR NICOLAS EUGENIO NAVARRO	2830	5	28	2286	1146	2258	0	12	0	2	1098	2286
EDO.NVA.ESPARTA	MP.PENIN. DE MACANAO	CM. BOCA DEL RIO	BIBLIOTECA PUBLICA DOCTOR RIGOBERTO MARIN	356	1	7	287	165	280	0	1	0	0	114	287
EDO.NVA.ESPARTA	MP. MARI#O	CM. PORLAMAR	CENTRO DE EDUCACION INICIAL MAESTRA BELEN SAN JUAN	403	1	9	339	231	330	0	3	0	0	96	339
EDO.NVA.ESPARTA	MP. MARI#O	CM. PORLAMAR	UNIDAD EDUCATIVA SAN MARTÍN DE PORRES	1000	2	11	847	371	836	0	4	0	0	461	847
EDO.NVA.ESPARTA	MP. MARI#O	CM. PORLAMAR	CASA DE LA CULTURA PUEBLO DE LA MAR RAMON VASQUEZ BRITO	2446	5	40	1975	782	1935	0	2	3	1	1147	1975
EDO.NVA.ESPARTA	MP. MARI#O	CM. PORLAMAR	UNIDAD EDUCATIVA JOSÉ JESÚS GARCÍA RODRÍGUEZ	2168	4	52	1708	1049	1656	2	5	1	0	599	1708
EDO.NVA.ESPARTA	MP. MARI#O	CM. PORLAMAR	UNIDAD EDUCATIVA NACIONAL BOLIVARIANA CACIQUE CHARAIMA	3087	6	49	2479	1217	2430	0	5	0	0	1208	2479
EDO.NVA.ESPARTA	MP. MARI#O	CM. PORLAMAR	CENTRO DE EDUCACIÓN INICIAL BACHILLER JOSÉ JOAQUÍN DE LEÓN	2615	5	33	2020	1153	1987	0	12	1	1	820	2020
EDO.NVA.ESPARTA	MP. MARI#O	CM. PORLAMAR	CENTRO DE FORMACION SOCIALISTA INCES TURISMO GUARAGUAO	1864	4	22	1421	634	1399	0	6	0	1	758	1421
EDO.NVA.ESPARTA	MP. MARI#O	CM. PORLAMAR	UNIDAD EDUCATIVA NACIONAL BOLIVARIANA PETRONILA MATA	223	1	1	175	146	174	0	0	0	0	28	175
EDO.NVA.ESPARTA	MP. MARI#O	CM. PORLAMAR	UNIDAD EDUCATIVA DON ROMULO GALLEGOS	413	1	19	327	147	308	0	2	0	0	159	327
EDO.NVA.ESPARTA	MP. MARI#O	CM. PORLAMAR	UNIDAD EDUCATIVA INSTITUTO EDUCACIONAL SIMON BOLIVAR	2138	4	30	1672	842	1642	0	13	2	0	785	1672
EDO.NVA.ESPARTA	MP. MARI#O	CM. PORLAMAR	CENTRO DE EDUCACION INICIAL SIMONCITO ANDRES BELLO	301	1	4	232	127	228	1	0	0	0	100	232
EDO.NVA.ESPARTA	MP. MARI#O	CM. PORLAMAR	UNIDAD EDUCATIVA NACIONAL BOLIVARIANA MANEIRO	2383	5	48	1788	839	1740	0	5	0	1	895	1788
EDO.NVA.ESPARTA	MP. MARI#O	CM. PORLAMAR	UNIDAD EDUCATIVA DOÑA MENCA DE LEONI	2919	5	71	2286	1414	2215	0	3	0	1	797	2286
EDO.NVA.ESPARTA	MP. MARI#O	CM. PORLAMAR	UNIDAD EDUCATIVA BACHILLER SANTIAGO SALAZAR FERMIN	2786	5	24	2096	787	2072	0	11	0	1	1273	2096
EDO.NVA.ESPARTA	MP. MARI#O	CM. PORLAMAR	INCE MAR	1417	3	18	1096	683	1078	0	5	1	0	389	1096
EDO.NVA.ESPARTA	MP. MARI#O	CM. PORLAMAR	UNIDAD EDUCATIVA SAN NICOLAS	1298	3	11	979	366	968	1	3	1	0	597	979
EDO.NVA.ESPARTA	MP. MARI#O	CM. PORLAMAR	UNIDAD EDUCATIVA DOCTOR RAÚL LEONI	2121	4	41	1670	1000	1629	2	6	1	0	620	1670
EDO.NVA.ESPARTA	MP. MARI#O	CM. PORLAMAR	ESCUELA BASICA ESTADO ZULIA	3026	6	41	2250	1027	2209	0	6	1	1	1174	2250
EDO.NVA.ESPARTA	MP. MARI#O	CM. PORLAMAR	UNIDAD EDUCATIVA EDUCACIONAL PORLAMAR	725	2	9	630	133	621	0	2	0	0	486	630
EDO.NVA.ESPARTA	MP. MARI#O	CM. PORLAMAR	UNIDAD EDUCATIVA CANDIDO SÁNCHEZ	2701	5	55	2162	1177	2107	1	9	1	1	918	2162
EDO.NVA.ESPARTA	MP. MARI#O	CM. PORLAMAR	UNIDAD EDUCATIVA DOCTOR LEONARDO RUIZ PINEDA	2623	5	49	2089	1195	2040	1	23	2	0	819	2089
EDO.NVA.ESPARTA	MP. MARI#O	CM. PORLAMAR	UNIDAD EDUCATIVA DOCTOR ARTURO USLAR PIETRI	1718	3	43	1308	620	1265	0	2	0	0	643	1308
EDO.NVA.ESPARTA	MP. MARI#O	CM. PORLAMAR	UNIDAD EDUCATIVA SAN JOSÉ	1768	4	28	1386	624	1358	0	5	0	2	727	1386
EDO.NVA.ESPARTA	MP. MARI#O	CM. PORLAMAR	UNIDAD EDUCATIVA INDEPENDENCIA	1865	4	17	1429	548	1412	0	6	0	0	858	1429
EDO.NVA.ESPARTA	MP. MARI#O	CM. PORLAMAR	UNIDAD EDUCATIVA ANTONIO MARIA MARTÍNEZ	2645	5	47	2084	984	2037	0	15	1	0	1037	2084
EDO.NVA.ESPARTA	MP. MARI#O	CM. PORLAMAR	CASA INTEGRAL DEL CONSEJO COMUNAL CAMPOMAR, MANZANA II	182	1	5	164	126	159	0	0	0	0	33	164
EDO.NVA.ESPARTA	MP. MARI#O	CM. PORLAMAR	UNIDAD EDUCATIVA EL PIACHE	938	2	12	801	551	789	0	1	0	0	237	801
EDO.NVA.ESPARTA	MP. MARI#O	CM. PORLAMAR	ESCUELA NACIONAL BOLIVARIANA BACHILLER JOSÉ JOAQUÍN DE LEÓN	798	2	11	623	428	612	0	2	0	1	181	623
EDO.NVA.ESPARTA	MP. MARI#O	CM. PORLAMAR	UNIDAD EDUCATIVA MUNICIPAL MAESTRO GREGORIO ROMERO	1990	4	20	1597	357	1577	0	4	0	0	1216	1597
EDO.NVA.ESPARTA	MP. MARI#O	CM. PORLAMAR	LICEO BOLIVARIANO NUEVA ESPARTA	2352	4	15	1717	753	1702	1	9	1	0	938	1717
EDO.NVA.ESPARTA	MP. MARI#O	CM. PORLAMAR	UNIDAD EDUCATIVA RAFAEL SALAZAR BRITO	2917	5	45	2380	1209	2335	0	19	0	1	1106	2380
EDO.NVA.ESPARTA	MP. MARI#O	CM. PORLAMAR	UNIDAD EDUCATIVA INSTITUTO VIRGEN DEL VALLE (ADULTO)	2550	5	28	1972	625	1944	0	9	0	0	1310	1972
EDO.NVA.ESPARTA	MP. MARI#O	CM. PORLAMAR	CENTRO DE EDUCACION INICIAL CANDIDO SÁNCHEZ	677	2	22	535	316	513	0	2	0	0	195	535
EDO.NVA.ESPARTA	MP. MARI#O	CM. PORLAMAR	UNIDAD EDUCATIVA INSTITUTO EDUCATIVO NUEVA ESPARTA	529	1	6	421	256	415	0	0	0	1	158	421
EDO.NVA.ESPARTA	MP. MARI#O	CM. PORLAMAR	UNIDAD EDUCATIVA INSTITUTO EDUCATIVO ARCOIRIS	3171	6	23	2504	455	2481	0	8	0	1	2017	2504
EDO.NVA.ESPARTA	MP. MARI#O	CM. PORLAMAR	UNIDAD EDUCATIVA LICEO BOLIVARIANO LUISA CÁCERES DE ARISMENDI	3103	6	56	2457	1477	2401	0	14	1	1	908	2457
EDO.NVA.ESPARTA	MP. MARI#O	CM. PORLAMAR	UNIDAD EDUCATIVA NUESTRA SEÑORA DE COROMOTO	1767	3	10	1418	381	1408	0	4	0	0	1023	1418
EDO.NVA.ESPARTA	MP. MARI#O	CM. PORLAMAR	CENTRO DE EDUCACIÓN INICIAL SIMONCITO AZUL Y VIENTO	1171	2	15	962	438	947	0	9	0	0	500	962
EDO.NVA.ESPARTA	MP. MARI#O	CM. PORLAMAR	ESCUELA BASICA MUNICIPAL BACHILLER ELEUTERIO ROSARIO CAMPOS	1704	3	36	1367	586	1331	0	8	0	0	737	1367
EDO.NVA.ESPARTA	MP. MARI#O	CM. PORLAMAR	CENTRO DE EDUCACIÓN INICIAL SIMONCITO VIRGEN DEL VALLE	1426	3	28	1109	629	1081	0	5	1	1	445	1109
EDO.NVA.ESPARTA	MP.ANTOLIN DEL CAMPO	CM.LA PLAZA DE PARAGUACHI	UNIDAD EDUCATIVA ESTADAL AMADA FERMIN DE HERNANDEZ	1316	3	10	1100	572	1090	0	5	0	1	512	1100
EDO.NVA.ESPARTA	MP.ANTOLIN DEL CAMPO	CM.LA PLAZA DE PARAGUACHI	ESCUELA BASICA DON ANDRES BELLO	2392	5	39	2035	1221	1996	0	10	0	0	765	2035
EDO.NVA.ESPARTA	MP.ANTOLIN DEL CAMPO	CM.LA PLAZA DE PARAGUACHI	CENTRO DE EDUCACION INICIAL DOCTOR LUIS ORTEGA	737	2	18	589	325	571	0	1	0	0	245	589
EDO.NVA.ESPARTA	MP.ANTOLIN DEL CAMPO	CM.LA PLAZA DE PARAGUACHI	CENTRO DE EDUCACION INICIAL ANTOLIN DEL CAMPO	631	2	6	545	288	539	1	0	0	0	250	545
EDO.NVA.ESPARTA	MP.ANTOLIN DEL CAMPO	CM.LA PLAZA DE PARAGUACHI	UNIDAD EDUCATIVA DOCTOR CAYETANO GARCIA SALAZAR	2153	4	23	1837	1047	1814	2	7	0	1	757	1837
EDO.NVA.ESPARTA	MP.ANTOLIN DEL CAMPO	CM.LA PLAZA DE PARAGUACHI	CANCHA MULTIPLE JOSE GREGORIO AGUILERA	417	1	10	351	223	341	0	0	0	0	118	351
EDO.NVA.ESPARTA	MP.ANTOLIN DEL CAMPO	CM.LA PLAZA DE PARAGUACHI	UNIDAD EDUCATIVA ESTADAL RURAL NUMERO 21	796	2	7	669	252	662	0	2	0	0	408	669
EDO.NVA.ESPARTA	MP.ANTOLIN DEL CAMPO	CM.LA PLAZA DE PARAGUACHI	UNIDAD EDUCATIVA NACIONAL CRUZ MILLAN GARCIA	1550	3	15	1335	609	1320	0	10	0	2	699	1335
EDO.NVA.ESPARTA	MP.ANTOLIN DEL CAMPO	CM.LA PLAZA DE PARAGUACHI	UNIDAD EDUCATIVA BOLIVARIANA ANTOLIN DEL CAMPO	2221	4	19	1806	784	1787	0	12	0	1	990	1806
EDO.NVA.ESPARTA	MP.ANTOLIN DEL CAMPO	CM.LA PLAZA DE PARAGUACHI	UNIDAD EDUCATIVA RURAL NUMERO 29	964	2	15	823	375	808	0	9	0	2	422	823
EDO.NVA.ESPARTA	MP.ANTOLIN DEL CAMPO	CM.LA PLAZA DE PARAGUACHI	UNIDAD EDUCATIVA ESTADAL ELVIRA JOSEFINA DE RODRIGUEZ	1424	3	14	1166	558	1152	0	5	0	1	588	1166
EDO.NVA.ESPARTA	MP.ANTOLIN DEL CAMPO	CM.LA PLAZA DE PARAGUACHI	UNIDAD EDUCATIVA BOLIVARIANA DOCTOR LUIS ORTEGA	2522	5	30	2094	1042	2064	0	9	1	0	1012	2094
EDO.NVA.ESPARTA	MP.ANTOLIN DEL CAMPO	CM.LA PLAZA DE PARAGUACHI	UNIDAD EDUCATIVA ESTADAL  JOSE RAFAEL MARCANO GIL	958	2	23	817	458	794	0	5	0	0	331	817
EDO.NVA.ESPARTA	MP.ANTOLIN DEL CAMPO	CM.LA PLAZA DE PARAGUACHI	UNIDAD EDUCATIVA BOLIVARIANA BACHILLER LUIS NAVARRO RIVAS	1492	3	15	1298	484	1283	0	4	0	0	795	1298
EDO.NVA.ESPARTA	MP.ANTOLIN DEL CAMPO	CM.LA PLAZA DE PARAGUACHI	CENTRO DE EDUCACION INICIAL PARAGUACHI	433	1	6	352	185	346	0	1	0	0	160	352
EDO. TACHIRA	MP. INDEPENDENCIA	PQ. ROMAN CARDENAS	ESCUELA BOLIVARIANA PERIBECA	1508	3	28	1307	498	1279	0	3	0	1	777	1307
EDO. TACHIRA	MP. INDEPENDENCIA	PQ. ROMAN CARDENAS	ESCUELA BOLIVARIANA EL TOPON	559	1	7	461	301	454	0	4	1	0	148	461
EDO. TACHIRA	MP. INDEPENDENCIA	CM. CAPACHO NUEVO	CENTRO DE EDUCACIÓN INICIAL SIMONCITO ELOINA BONILLA	211	1	3	193	109	190	0	1	0	0	80	193
EDO. TACHIRA	MP. INDEPENDENCIA	CM. CAPACHO NUEVO	CENTRO DE EDUCACION INICIAL TARABAY	1505	3	33	1273	453	1240	0	6	0	0	781	1273
EDO. TACHIRA	MP. INDEPENDENCIA	CM. CAPACHO NUEVO	ESCUELA BOLIVARIANA PARAMO DE LA LAJA	742	2	21	650	303	629	0	3	0	0	323	650
EDO. TACHIRA	MP. INDEPENDENCIA	CM. CAPACHO NUEVO	LICEO BOLIVARIANO ROMAN CARDENAS	2261	4	43	1901	619	1858	0	12	1	1	1225	1901
EDO. TACHIRA	MP. INDEPENDENCIA	CM. CAPACHO NUEVO	ESCUELA BOLIVARIANA LA LAJA	1098	2	22	952	446	930	0	2	0	1	481	952
EDO. TACHIRA	MP. INDEPENDENCIA	CM. CAPACHO NUEVO	ESCUELA BOLIVARIANA PRESBITERO JUVENAL CARRERO	571	1	4	485	266	481	0	1	0	0	214	485
EDO. TACHIRA	MP. INDEPENDENCIA	CM. CAPACHO NUEVO	ESCUELA BOLIVARIANA ESTADO MIRANDA	2864	5	49	2361	871	2312	1	9	1	2	1428	2361
EDO. TACHIRA	MP. INDEPENDENCIA	CM. CAPACHO NUEVO	UNIDAD EDUCATIVA ESTADAL PADRE CONTRERAS	1861	4	28	1579	720	1551	1	7	0	0	823	1579
EDO. TACHIRA	MP. INDEPENDENCIA	CM. CAPACHO NUEVO	ESCUELA DE LABORES NOCTURNA INDEPENDENCIA	220	1	4	171	98	167	0	0	0	0	69	171
EDO. TACHIRA	MP. INDEPENDENCIA	CM. CAPACHO NUEVO	UNIDAD EDUCATIVA MUNICIPAL BOLIVARIANA CAMPO C	762	2	10	671	343	661	0	3	0	0	315	671
EDO. TACHIRA	MP. INDEPENDENCIA	CM. CAPACHO NUEVO	UNIDAD EDUCATIVA MONSEÑOR EDMUNDO VIVAS	1126	2	18	1032	573	1014	0	8	0	0	433	1032
EDO. TACHIRA	MP. INDEPENDENCIA	CM. CAPACHO NUEVO	ESCUELA BOLIVARIANA CERRO DE LA LAGUNA	511	1	11	400	275	389	0	2	0	0	112	400
EDO. TACHIRA	MP. INDEPENDENCIA	CM. CAPACHO NUEVO	LICEO RURAL BOLIVARIANO NO CONSOLIDADO PIE DE CUESTA	1392	3	22	1122	402	1100	0	7	1	0	690	1122
EDO. TACHIRA	MP. INDEPENDENCIA	CM. CAPACHO NUEVO	UNIDAD EDUCATIVA BOLIVARIANA PIE DE CUESTA	909	2	14	748	255	734	0	3	0	0	476	748
EDO. TACHIRA	MP. INDEPENDENCIA	PQ. JUAN GERMAN ROSCIO	CASA COMUNAL DEL VALLE	868	2	18	765	417	747	0	3	0	0	327	765
EDO. TACHIRA	MP. INDEPENDENCIA	PQ. JUAN GERMAN ROSCIO	ESCUELA BOLIVARIANA TRES ESQUINAS	1524	3	26	1336	732	1310	1	14	0	0	563	1336
EDO. TACHIRA	MP. INDEPENDENCIA	PQ. JUAN GERMAN ROSCIO	ESCUELA DE LABORES EL VALLE	456	1	14	410	161	396	0	1	0	0	234	410
EDO. TACHIRA	MP. INDEPENDENCIA	PQ. JUAN GERMAN ROSCIO	UNIDAD EDUCATIVA COLEGIO PARROQUIAL BETANIA	438	1	6	377	173	371	0	1	0	1	196	377
EDO. TACHIRA	MP. INDEPENDENCIA	PQ. JUAN GERMAN ROSCIO	UNIDAD EDUCATIVA ESTADAL JUAN GERMAN ROSCIO	2904	5	62	2410	1045	2348	2	13	0	0	1288	2410
EDO. TACHIRA	MP. SAN JUDAS TADEO	CM. UMUQUENA	UNIDAD EDUCATIVA DOCTOR RAMON FERNANDEZ VELARDI	2020	4	28	1654	839	1626	0	10	1	1	775	1654
EDO. TACHIRA	MP. SAN JUDAS TADEO	CM. UMUQUENA	UNIDAD EDUCATIVA NACIONAL DON MAXIMILIANO PEREZ	1000	2	19	748	538	729	0	3	0	0	188	748
EDO. TACHIRA	MP. SAN JUDAS TADEO	CM. UMUQUENA	ESCUELA ESTADAL  ALDEA MATA DE GUINEO CONCENTRADA  NUMERO 77	259	1	7	198	123	191	0	0	0	0	68	198
EDO. TACHIRA	MP. SAN JUDAS TADEO	CM. UMUQUENA	ESCUELA NACIONAL SIN NUMERO LA VEGA NUCLEO ESCOLAR RURAL 357	399	1	5	322	184	317	0	1	0	0	132	322
EDO. TACHIRA	MP. SAN JUDAS TADEO	CM. UMUQUENA	NUCLEO ESCOLAR RURAL NUMERO 357 ESTADAL UNITARIA 35	277	1	7	213	127	206	0	1	0	0	78	213
EDO. TACHIRA	MP. SAN JUDAS TADEO	CM. UMUQUENA	ESCUELA BOLIVARIANA DON PAULINO PEREZ	818	2	17	693	446	676	0	5	1	0	224	693
EDO. TACHIRA	MP. SAN JUDAS TADEO	CM. UMUQUENA	UNIDAD EDUCATIVA NACIONAL DON POMPILIO DUQUE	469	1	10	373	272	363	0	3	0	0	88	373
EDO. TACHIRA	MP. SAN JUDAS TADEO	CM. UMUQUENA	UNIDAD EDUCATIVA NACIONAL UMUQUENA	1381	3	39	1154	665	1115	0	1	0	0	449	1154
EDO. TACHIRA	MP. SAN JUDAS TADEO	CM. UMUQUENA	ESCUELA EL PARAISO NER 357	198	1	7	168	138	161	0	0	0	0	23	168
EDO. TACHIRA	CE. SAN CRISTOBAL	PQ. SN JUAN BAUTISTA	ESCUELA BASICA RURAL LA PROVIDENCIA	3109	6	64	2456	910	2392	0	9	0	0	1473	2456
EDO. TACHIRA	CE. SAN CRISTOBAL	PQ. SN JUAN BAUTISTA	ESCUELA MUNICIPAL LUISA CACERES DE ARISMENDI	2663	5	21	2331	448	2310	0	4	0	1	1857	2331
EDO. TACHIRA	CE. SAN CRISTOBAL	PQ. SN JUAN BAUTISTA	UNIDAD EDUCATIVA COLEGIO LA VILLA DE LOS NIÑOS	3250	6	38	2826	634	2788	0	9	0	3	2142	2826
EDO. TACHIRA	CE. SAN CRISTOBAL	PQ. SN JUAN BAUTISTA	INSTITUTO UNIVERSITARIO JUAN PABLO PEREZ ALFONZO	1967	4	17	1581	407	1564	0	10	0	2	1145	1581
EDO. TACHIRA	CE. SAN CRISTOBAL	PQ. SN JUAN BAUTISTA	UNIDAD EDUCATIVA ESTADAL ALICIA CHACÓN DE SANCHEZ	1198	2	14	1071	499	1057	0	3	0	1	554	1071
EDO. TACHIRA	CE. SAN CRISTOBAL	PQ. SN JUAN BAUTISTA	ESCUELA ESTADAL PERPETUO SOCORRO	2799	5	34	2235	864	2201	0	5	0	1	1331	2235
EDO. TACHIRA	CE. SAN CRISTOBAL	PQ. SN JUAN BAUTISTA	ESCUELA BOLIVARIANA LOS ANDES	4200	8	71	3502	1451	3431	1	8	1	0	1970	3502
EDO. TACHIRA	CE. SAN CRISTOBAL	PQ. SN JUAN BAUTISTA	ESCUELA BOLIVARIANA BUSTAMANTE	4875	9	71	4021	1337	3950	1	15	1	3	2593	4021
EDO. TACHIRA	CE. SAN CRISTOBAL	PQ. SN JUAN BAUTISTA	ESCUELA BASICA ESTADAL MARISCAL SUCRE	1866	4	22	1621	462	1599	0	9	2	0	1126	1621
EDO. TACHIRA	CE. SAN CRISTOBAL	PQ. SN JUAN BAUTISTA	LICEO NACIONAL RAMON JOSE VELAZQUEZ	3601	7	29	3070	550	3041	1	7	0	0	2483	3070
EDO. TACHIRA	CE. SAN CRISTOBAL	PQ. SN JUAN BAUTISTA	CENTRO DE EDUCACION INICIAL SIMONCITO VIRGILIO PINZON	2246	4	32	2029	420	1997	0	8	0	0	1569	2029
EDO. TACHIRA	CE. SAN CRISTOBAL	PQ. SN JUAN BAUTISTA	UNIDAD EDUCATIVA LAGUNILLAS DE ZORCA	1266	3	27	1096	606	1069	0	5	0	0	458	1096
EDO. TACHIRA	CE. SAN CRISTOBAL	PQ. SN JUAN BAUTISTA	ESCUELA BOLIVARIANA EL MIRADOR	1136	2	24	988	512	964	0	5	0	0	447	988
EDO. TACHIRA	CE. SAN CRISTOBAL	PQ. SN JUAN BAUTISTA	UNIDAD EDUCATIVA BOLIVARIANA DE TALENTO DEPORTIVO TACHIRENSE	2329	5	42	1955	635	1913	0	3	0	3	1272	1955
EDO. TACHIRA	CE. SAN CRISTOBAL	PQ. SN JUAN BAUTISTA	CICLO DIVERSIFICADO ELEAZAR LOPEZ CONTRERAS	1967	4	22	1612	278	1590	0	3	0	0	1309	1612
EDO. TACHIRA	CE. SAN CRISTOBAL	PQ. SN JUAN BAUTISTA	UNIDAD EDUCATIVA COLEGIO DOCTOR. JOSE MARIA VARGAS	2292	4	27	1881	515	1854	0	5	2	1	1331	1881
EDO. TACHIRA	CE. SAN CRISTOBAL	PQ. SN JUAN BAUTISTA	UNIDAD EDUCATIVA ESTADAL BOLIVARIANA  ANA DOLORES FERNADEZ	4305	8	45	3775	958	3730	0	9	0	3	2760	3775
EDO. TACHIRA	CE. SAN CRISTOBAL	PQ. SN JUAN BAUTISTA	CENTRO MOVIL POSADA BOLIVARIANA	797	2	8	729	393	721	0	4	0	0	324	729
EDO. TACHIRA	CE. SAN CRISTOBAL	PQ. SN JUAN BAUTISTA	LICEO BOLIVARIANO FRANCISCO ALVARADO	2478	5	23	2090	316	2067	0	5	0	0	1746	2090
EDO. TACHIRA	CE. SAN CRISTOBAL	PQ. SN JUAN BAUTISTA	UNIDAD EDUCATIVA COLEGIO PRIVADO SANTISIMO SALVADOR	3182	6	30	2767	525	2737	0	2	1	1	2208	2767
EDO. TACHIRA	CE. SAN CRISTOBAL	PQ. SN JUAN BAUTISTA	ESCUELA NACIONAL BOLIVARIANA MACHIRI	1848	4	37	1613	605	1576	1	8	1	0	961	1613
EDO. TACHIRA	CE. SAN CRISTOBAL	PQ. SN JUAN BAUTISTA	UNIDAD EDUCATIVA ESTADAL BOLIVARIANA FRANCISCO DE MIRANDA	1709	3	14	1509	457	1495	0	6	2	1	1029	1509
EDO. TACHIRA	CE. SAN CRISTOBAL	PQ. SN JUAN BAUTISTA	UNIDAD EDUCATIVA ESTADAL BOLIVARIANA REPUBLICA DEL ECUADOR	1799	4	25	1461	506	1436	0	6	0	2	922	1461
EDO. TACHIRA	CE. SAN CRISTOBAL	PQ. SN JUAN BAUTISTA	ESCUELA BOLIVARIANA SIMON BOLIVAR	3496	6	30	2972	802	2942	0	6	0	0	2134	2972
EDO. TACHIRA	CE. SAN CRISTOBAL	PQ. SN JUAN BAUTISTA	UNIDAD EDUCATIVA COLEGIO METROPOLITANO	563	1	7	497	151	490	0	1	0	0	338	497
EDO. TACHIRA	CE. SAN CRISTOBAL	PQ. SN JUAN BAUTISTA	ESCUELA BOLIVARIANA TECNICA DE COMERCIO ALBERTO ADRIANI	2306	4	24	2022	332	1998	0	4	2	2	1658	2022
EDO. TACHIRA	CE. SAN CRISTOBAL	PQ. SN JUAN BAUTISTA	ESCUELA BOLIVARIANA VIRGILIO PINZON	3122	6	64	2674	639	2610	1	9	1	2	1958	2674
EDO. TACHIRA	CE. SAN CRISTOBAL	PQ. SAN SEBASTIAN	UNIDAD EDUCATIVA COLEGIO PARROQUIAL MONSEÑOR SAN MIGUEL	1552	3	18	1237	408	1219	0	9	0	0	802	1237
EDO. TACHIRA	CE. SAN CRISTOBAL	PQ. SAN SEBASTIAN	ESCUELA ESTADAL GRADUADA DOCTORA BLANCA LOPEZ DE SANCHEZ	3036	6	41	2504	1270	2463	0	7	0	0	1186	2504
EDO. TACHIRA	CE. SAN CRISTOBAL	PQ. SAN SEBASTIAN	ESCUELA BASICA MIXTA TONONO  450 50	530	1	14	422	185	408	0	5	0	0	218	422
EDO. TACHIRA	CE. SAN CRISTOBAL	PQ. SAN SEBASTIAN	UNIDAD EDUCATIVA ESTADAL SALIAS Y LANDAETA	1537	3	18	1226	540	1208	1	10	0	0	657	1226
EDO. TACHIRA	CE. SAN CRISTOBAL	PQ. SAN SEBASTIAN	UNIDAD ESTADAL  224 650 65	991	2	27	855	508	828	1	2	0	1	316	855
EDO. TACHIRA	CE. SAN CRISTOBAL	PQ. SAN SEBASTIAN	ESCUELA NACIONAL UNITARIA NUMERO 776	177	1	4	128	71	124	0	1	1	0	51	128
EDO. TACHIRA	CE. SAN CRISTOBAL	PQ. SAN SEBASTIAN	LICEO GONZALO MENDEZ	1227	3	18	1027	416	1009	1	4	0	1	587	1027
EDO. TACHIRA	CE. SAN CRISTOBAL	PQ. SAN SEBASTIAN	ESCUELA BASICA MUNICIPAL REGINA DE VELAZQUEZ	891	2	16	737	224	721	0	3	1	0	493	737
EDO. TACHIRA	CE. SAN CRISTOBAL	PQ. SAN SEBASTIAN	EDIFICIO NACIONAL	2018	4	41	1585	626	1544	1	4	2	1	910	1585
EDO. TACHIRA	CE. SAN CRISTOBAL	PQ. SAN SEBASTIAN	CENTRO MOVIL CASA COMUNAL CAMPO ALEGRE	148	1	4	127	85	123	0	1	0	0	37	127
EDO. TACHIRA	CE. SAN CRISTOBAL	PQ. SAN SEBASTIAN	ESCUELA ESTADAL CONCENTRADA  104  ANDRES ELOY BLANCO	936	2	23	789	352	766	0	5	1	0	408	789
EDO. TACHIRA	CE. SAN CRISTOBAL	PQ. PEDRO MARIA MORANTES	GERIATRICO PADRE LIZARDO	1575	3	11	1383	192	1372	0	3	0	1	1176	1383
EDO. TACHIRA	CE. SAN CRISTOBAL	PQ. PEDRO MARIA MORANTES	LICEO BOLIVARIANO JESUS MARIA PELLIN	2474	5	22	2206	455	2184	1	11	0	1	1716	2206
EDO. TACHIRA	CE. SAN CRISTOBAL	PQ. PEDRO MARIA MORANTES	ESCUELA BOLIVARIANA JUAN ANTONIO ROMAN VALECILLOS	4093	7	43	3517	800	3474	1	6	0	1	2666	3517
EDO. TACHIRA	CE. SAN CRISTOBAL	PQ. PEDRO MARIA MORANTES	UNIDAD EDUCATIVA ESTADAL VICTOR MORENO OROZCO	2620	5	24	2232	486	2208	0	5	1	0	1716	2232
EDO. TACHIRA	CE. SAN CRISTOBAL	PQ. PEDRO MARIA MORANTES	UNIDAD EDUCATIVA COLEGIO DON BOSCO	392	1	3	360	77	357	0	1	0	0	279	360
EDO. TACHIRA	CE. SAN CRISTOBAL	PQ. PEDRO MARIA MORANTES	CENTRO DE EDUCACION INICIAL SIMONCITO JUAN ANTONIO ROMAN VALECILLOS	1919	4	19	1618	365	1599	0	7	0	1	1226	1618
EDO. TACHIRA	CE. SAN CRISTOBAL	PQ. PEDRO MARIA MORANTES	CASA DE LOS NIÑOS LOS PIRINEOS	1405	3	11	1171	237	1160	0	0	0	0	923	1171
EDO. TACHIRA	CE. SAN CRISTOBAL	PQ. PEDRO MARIA MORANTES	ESCUELA TECNICA ROBINSONIANA DE CIENCIAS Y ARTES JUAN ANTONIO ROMAN VALECILLOS	4363	8	24	3736	698	3712	1	5	0	2	3006	3736
EDO. TACHIRA	CE. SAN CRISTOBAL	PQ. PEDRO MARIA MORANTES	LICEO BOLIVARIANO SIMÓN BOLÍVAR	3422	6	56	2861	989	2805	0	10	1	3	1802	2861
EDO. TACHIRA	CE. SAN CRISTOBAL	PQ. PEDRO MARIA MORANTES	ESCUELA ESTADAL INTEGRAL BOLIVARIANA CECILIO ACOSTA	1086	2	22	920	313	898	0	1	1	0	583	920
EDO. TACHIRA	CE. SAN CRISTOBAL	PQ. PEDRO MARIA MORANTES	INSTITUTO UNIVERSITARIO DE LA FRONTERA	686	2	7	593	207	586	0	0	1	0	378	593
EDO. TACHIRA	CE. SAN CRISTOBAL	PQ. PEDRO MARIA MORANTES	CENTRO DE EDUCACION INICIAL SIMONCITO BOLIVARIANO MARISCAL DE AYACUCHO	573	1	4	534	173	530	0	1	0	0	356	534
EDO. TACHIRA	CE. SAN CRISTOBAL	PQ. PEDRO MARIA MORANTES	UNIDAD EDUCATIVA DOCTOR ARISTIDES GARBIRAS	3465	6	26	2942	593	2916	1	8	2	2	2310	2942
EDO. TACHIRA	CE. SAN CRISTOBAL	PQ. PEDRO MARIA MORANTES	UNIDAD EDUCATIVA MUNICIPAL SIMÓN RODRIGUEZ	259	1	2	232	74	230	0	1	0	0	155	232
EDO. TACHIRA	CE. SAN CRISTOBAL	PQ. PEDRO MARIA MORANTES	UNIDAD EDUCATIVA INSTITUTO MARÍA MONTESORI	396	1	8	359	87	351	0	0	0	1	263	359
EDO. TACHIRA	CE. SAN CRISTOBAL	PQ. PEDRO MARIA MORANTES	ESCUELA BASICA TACHIRA	1857	4	7	1579	201	1572	0	2	0	0	1369	1579
EDO. TACHIRA	CE. SAN CRISTOBAL	PQ. PEDRO MARIA MORANTES	CENTRO DE EDUCACION INICIAL ANDRES BELLO	379	1	3	343	106	340	0	3	0	1	230	343
EDO. TACHIRA	CE. SAN CRISTOBAL	PQ. PEDRO MARIA MORANTES	UNIDAD EDUCATIVA MONSEÑOR SAN MIGUEL	3891	7	26	3341	644	3315	0	8	0	2	2661	3341
EDO. TACHIRA	CE. SAN CRISTOBAL	PQ. PEDRO MARIA MORANTES	UNIDAD EDUCATIVA COLEGIO CRISTO REY	130	1	1	118	32	117	0	1	0	0	84	118
EDO. TACHIRA	CE. SAN CRISTOBAL	PQ. PEDRO MARIA MORANTES	ESCUELA BOLIVARIANA CARLOS RANGEL LAMUS	3086	6	39	2429	575	2390	0	5	1	2	1807	2429
EDO. TACHIRA	CE. SAN CRISTOBAL	PQ. PEDRO MARIA MORANTES	ESCUELA BOLIVARIANA PEDRO MARIA MORANTES	3052	6	34	2423	661	2389	0	5	0	1	1722	2423
EDO. TACHIRA	CE. SAN CRISTOBAL	PQ. PEDRO MARIA MORANTES	GRUPO ESCOLAR PABLO EMILIO GAMBOA PEÑALOZA	3627	7	31	3032	657	3001	0	6	0	1	2337	3032
EDO. TACHIRA	CE. SAN CRISTOBAL	PQ. PEDRO MARIA MORANTES	UNIDAD EDUCATIVA PARROQUIAL COLEGIO COROMOTO	1703	3	13	1397	325	1384	0	5	0	1	1053	1397
EDO. TACHIRA	CE. SAN CRISTOBAL	PQ. PEDRO MARIA MORANTES	UNIVESIDAD PEDAGOGICA EXPERIMENTAL LIBERTADOR	608	2	8	556	184	548	0	0	0	0	364	556
EDO. TACHIRA	CE. SAN CRISTOBAL	PQ. PEDRO MARIA MORANTES	UNIDAD EDUCATIVA COLEGIO CERVANTES	1361	3	14	1171	237	1157	0	6	0	1	913	1171
EDO. TACHIRA	CE. SAN CRISTOBAL	PQ. PEDRO MARIA MORANTES	ESCUELA BOLIVARIANA ANTONIO ROMAN SILVA	1754	3	11	1424	298	1413	0	4	0	0	1111	1424
EDO. TACHIRA	CE. SAN CRISTOBAL	PQ. LA CONCORDIA	ESCUELA ESTADAL UNITARIA  199	266	1	9	209	143	200	0	0	1	0	56	209
EDO. TACHIRA	CE. SAN CRISTOBAL	PQ. LA CONCORDIA	JARDIN DE INFANCIA JOSEFINA MOLINA DE DUQUE	2064	4	31	1729	723	1698	0	5	1	1	968	1729
EDO. TACHIRA	CE. SAN CRISTOBAL	PQ. LA CONCORDIA	ESCUELA LICEO BOLIVARIANO EMILIO CONSTANTINO GUERRERO	1718	3	40	1359	434	1319	1	2	0	0	882	1359
EDO. TACHIRA	CE. SAN CRISTOBAL	PQ. LA CONCORDIA	UNIDAD EDUCATIVA ESTADAL LUIS RAMIREZ CHACON	949	2	11	810	371	799	1	3	1	0	423	810
EDO. TACHIRA	CE. SAN CRISTOBAL	PQ. LA CONCORDIA	UNIDAD EDUCATIVA DOCTOR. DANIEL FIGUEROA	556	1	4	469	263	465	0	0	0	0	202	469
EDO. TACHIRA	CE. SAN CRISTOBAL	PQ. LA CONCORDIA	ESCUELA BOLIVARIANA RITA ELISA MEDINA DE USECHE	412	1	7	368	160	361	0	1	0	0	200	368
EDO. TACHIRA	CE. SAN CRISTOBAL	PQ. LA CONCORDIA	UNIDAD EDUCATIVA ESTADAL BOLIVARIANA RAMON BUENAHORA	4138	8	46	3529	1103	3483	1	9	2	3	2365	3529
EDO. TACHIRA	CE. SAN CRISTOBAL	PQ. LA CONCORDIA	GRUPO ESCOLAR CRISTOBAL MENDOZA	3559	7	40	2969	1526	2929	0	17	3	0	1383	2969
EDO. TACHIRA	CE. SAN CRISTOBAL	PQ. LA CONCORDIA	UNIDAD EDUCATIVA BOLIVARIANA ALIANZA	3963	7	49	3336	1326	3287	0	9	1	2	1949	3336
EDO. TACHIRA	CE. SAN CRISTOBAL	PQ. LA CONCORDIA	UNIDAD EDUCATIVA DOCTOR VICENTE DAVILA	3738	7	62	3089	994	3027	0	17	2	0	2014	3089
EDO. TACHIRA	CE. SAN CRISTOBAL	PQ. LA CONCORDIA	ESCUELA ESTADAL CONCENTRADA GENERAL EZEQUIEL ZAMORA	409	1	4	368	195	364	0	1	0	0	168	368
EDO. TACHIRA	CE. SAN CRISTOBAL	PQ. LA CONCORDIA	ESCUELA BASICA ELBA BEATRIZ RAMIREZ DE ORTEGA	2923	5	19	2511	638	2492	0	10	0	0	1844	2511
EDO. TACHIRA	CE. SAN CRISTOBAL	PQ. LA CONCORDIA	ESCUELA ESTADAL INTEGRAL BOLIVARIANA PRESBITERO VICTOR MANUEL VALECILLOS	917	2	12	800	439	788	0	4	1	0	344	800
EDO. TACHIRA	CE. SAN CRISTOBAL	PQ. LA CONCORDIA	ESCUELA ESTADAL CONCENTRADA NUMERO 84 NUCLEO ESCOLAR RURAL	293	1	3	243	103	240	0	3	0	0	134	243
EDO. TACHIRA	CE. SAN CRISTOBAL	PQ. LA CONCORDIA	ESCUELA DE LABORES DEL ESTADO DOÑA MENCA DE LEONI	547	1	7	494	201	487	0	1	0	0	285	494
EDO. TACHIRA	CE. SAN CRISTOBAL	PQ. LA CONCORDIA	ESCUELA BASICA CORDOBA	3669	7	68	3047	1246	2979	1	11	3	2	1716	3047
EDO. TACHIRA	CE. SAN CRISTOBAL	PQ. LA CONCORDIA	LICEO NACIONAL PEDRO MARIA MORANTES	3618	7	42	3004	811	2962	1	8	1	3	2138	3004
EDO. TACHIRA	CE. SAN CRISTOBAL	PQ. LA CONCORDIA	CENTRO DE FORMACION TECNICA SOCIALISTA DOCTOR LUIS BELTRAN PRIETO FIGUEROA	3429	6	42	2869	1020	2827	1	15	3	2	1786	2869
EDO. TACHIRA	CE. SAN CRISTOBAL	PQ. LA CONCORDIA	ESCUELA BASICA NACIONAL LA CONCORDIA	3117	6	42	2345	845	2303	2	6	1	2	1447	2345
EDO. TACHIRA	CE. SAN CRISTOBAL	PQ. LA CONCORDIA	ESCUELA BASICA JUAN BAUTISTA GARCIA ROA	4339	8	56	3525	1473	3469	1	13	1	3	1978	3525
EDO. TACHIRA	CE. SAN CRISTOBAL	PQ. LA CONCORDIA	INSTITUTO UNIVERSITARIO DE TECNOLOGIA AGROINDUSTRIAL	1846	4	17	1494	519	1477	0	2	0	0	956	1494
EDO. TACHIRA	CE. SAN CRISTOBAL	PQ. LA CONCORDIA	UNIDAD EDUCATIVA ESTADAL MANUEL FELIPE RUGELES	1875	4	51	1579	785	1528	0	6	0	1	736	1579
EDO. TACHIRA	CE. SAN CRISTOBAL	PQ. LA CONCORDIA	INSTITUTO NACIONAL DE COOPERACIÓN EDUCATIVA COMERCIAL	1609	3	32	1238	512	1206	0	4	1	0	689	1238
EDO. TACHIRA	CE. SAN CRISTOBAL	PQ. LA CONCORDIA	ESCUELA BOLIVARIANA NACIONAL JOSEFINA MEDINA DE DUQUE	3388	6	81	2754	1052	2673	1	11	1	0	1608	2754
EDO. TACHIRA	CE. SAN CRISTOBAL	PQ. LA CONCORDIA	UNIDAD EDUCATIVA ESTADAL BOLIVARIANA MENCA DE LEONI	555	1	16	486	242	470	0	1	0	0	227	486
EDO. TACHIRA	CE. SAN CRISTOBAL	PQ. LA CONCORDIA	NUCLEO ESCOLAR RURAL 129	256	1	10	196	95	186	0	0	1	0	90	196
EDO. TACHIRA	CE. SAN CRISTOBAL	PQ. LA CONCORDIA	UNIDAD EDUCATIVA INSTITUTO CORAZON DE JESUS	1529	3	23	1236	498	1213	0	7	0	0	708	1236
EDO. TACHIRA	CE. SAN CRISTOBAL	PQ. LA CONCORDIA	CENTRO DE EDUCACION INICIAL SIMONCITO JUAN BAUTISTA GARCIA ROA	2562	5	36	2132	792	2096	1	10	0	0	1293	2132
EDO. TACHIRA	CE. SAN CRISTOBAL	PQ. LA CONCORDIA	INSTITUTO UNIVERSITARIO TECNOLOGICO AGROPECUARIO	1636	3	21	1314	430	1293	0	6	3	0	854	1314
EDO. TACHIRA	CE. SAN CRISTOBAL	PQ. LA CONCORDIA	UNIDAD EDUCATIVA COLEGIO PARROQUIAL JESUS OBRERO	2118	4	24	1746	699	1722	0	7	0	0	1016	1746
EDO. TACHIRA	CE. SAN CRISTOBAL	PQ. LA CONCORDIA	UNIDAD EDUCATIVA ESTADAL RAMON VIVAS GOMEZ	1583	3	15	1396	349	1381	0	2	1	0	1029	1396
EDO. TACHIRA	CE. SAN CRISTOBAL	PQ. LA CONCORDIA	GRUPO ESCOLAR DOCTOR LEONARDO RUIZ PINEDA	3881	7	48	3227	842	3179	0	8	1	0	2328	3227
EDO. TACHIRA	CE. SAN CRISTOBAL	PQ. LA CONCORDIA	ESCUELA BOLIVARIANA VILLAFAÑE	3465	6	47	3042	882	2995	0	8	0	3	2102	3042
EDO. TACHIRA	CE. SAN CRISTOBAL	PQ. LA CONCORDIA	ESCUELA BOLIVARIANA 964	194	1	0	142	69	142	0	1	0	0	72	142
EDO. TACHIRA	CE. SAN CRISTOBAL	PQ. DR. FCO. ROMERO LOBO	ESCUELA ESTADAL CONCENTRADA  61	798	2	13	650	293	637	0	1	0	0	343	650
EDO. TACHIRA	CE. SAN CRISTOBAL	PQ. DR. FCO. ROMERO LOBO	ESCUELA NACIONAL 956
EDO. TACHIRA	MP. ANTONIO ROMULO C	CM. LAS MESAS	UNIDAD EDUCATIVA NACIONAL RAMON ELIAS MONTOYA	329	1	12	281	151	269	0	1	0	0	117	281
EDO. TACHIRA	MP. ANTONIO ROMULO C	CM. LAS MESAS	ESCUELA BASICA UNITARIA Nº 7 MESITAS	51	1	0	31	18	31	0	0	0	1	12	31
EDO. TACHIRA	MP. ANTONIO ROMULO C	CM. LAS MESAS	ESCUELA BASICA CONCENTRADA 107 SIN NUMERO PIEDRA DE MOLER	394	1	14	322	178	308	0	3	0	0	127	322
EDO. TACHIRA	MP. ANTONIO ROMULO C	CM. LAS MESAS	CENTRO DE EDUCACION INICIAL SIMONCITO MESA ALTA II	434	1	10	372	215	362	0	1	0	0	146	372
EDO. TACHIRA	MP. ANTONIO ROMULO C	CM. LAS MESAS	INSTITUTO DE EDUCACION ESPECIAL LAS MESAS	733	2	21	646	399	625	0	5	0	1	220	646
EDO. TACHIRA	MP. ANTONIO ROMULO C	CM. LAS MESAS	ESCUELA CONCENTRADA MUNICIPAL  EL CONTENTO  03	422	1	3	356	240	353	0	2	0	0	111	356
EDO. TACHIRA	MP. ANTONIO ROMULO C	CM. LAS MESAS	ESCUELA BOLIVARIANA ANTONIO GUZMAN BLANCO	1122	2	18	919	562	901	0	4	0	0	335	919
EDO. TACHIRA	MP. ANTONIO ROMULO C	CM. LAS MESAS	CENTRO DE EDUCACIÓN INICIAL MESA ALTA I	498	1	12	424	274	412	1	0	0	0	137	424
EDO. TACHIRA	MP. ANTONIO ROMULO C	CM. LAS MESAS	LICEO BOLIVARIANO DOCTOR LUIS BELTRAN PRIETO FIGUEROA	1075	2	32	909	563	877	1	5	0	0	308	909
EDO. TACHIRA	MP. ANTONIO ROMULO C	CM. LAS MESAS	UNIDAD EDUCATIVA ELEAZAR LOPEZ CONTRERAS	1625	3	27	1264	761	1237	0	5	0	0	471	1264
EDO. TACHIRA	MP. ANTONIO ROMULO C	CM. LAS MESAS	CENTRO EDUCATIVO INICIAL CENTRO POBLADO	790	2	20	662	462	642	0	1	0	0	179	662
EDO. TACHIRA	MP. SUCRE	PQ. SAN PABLO	UNIDAD EDUCATIVA CONCENTRADA 28 18 29 SIN NUMERO NUCLEO ESCOLAR RURAL 525	259	1	0	210	160	210	0	1	0	0	49	210
EDO. TACHIRA	MP. SUCRE	PQ. SAN PABLO	UNIDAD EDUCATIVA BOLIVARIANA MARTHA ARISTIGUIETA	136	1	1	93	50	92	0	0	0	0	42	93
EDO. TACHIRA	MP. SUCRE	PQ. SAN PABLO	ESCUELA BASICA CONCENTRADA 7 15 NER 412 ALTAMIRA	126	1	2	98	86	96	0	0	0	0	10	98
EDO. TACHIRA	MP. SUCRE	PQ. SAN PABLO	UNIDAD BASICA CONCENTRADA 50 SIN NUMERO MUNICIPAL 21 NUCLEO ESCOLAR RURAL 525	179	1	3	149	59	146	0	0	0	0	87	149
EDO. TACHIRA	MP. SUCRE	PQ. SAN PABLO	UNIDAD EDUCATIVA CONCENTRADA NACIONAL S N ESTADAL 99 NER 525	107	1	3	90	78	87	0	0	0	0	9	90
EDO. TACHIRA	MP. SUCRE	PQ. SAN PABLO	LICEO BOLIVARIANO LICENCIADO JOSE ARCANGEL CHACON CARRERO	905	2	7	730	461	723	0	1	0	0	261	730
EDO. TACHIRA	MP. SUCRE	PQ. SAN PABLO	UNIDAD EDUCATIVA CONCENTRADA SIN NUMERO 301 NUCLEO ESCOLAR RURAL 525 EL MORAL	146	1	0	105	63	105	0	0	0	0	42	105
EDO. TACHIRA	MP. SUCRE	PQ.ELEAZAR LOPEZ CONTRERA	UNIDAD EDUCATIVA ESTADAL FELIX MARIA SALCEDO ZAMBRANO NER 580	440	1	4	361	156	357	0	0	0	0	201	361
EDO. TACHIRA	MP. SUCRE	CM. QUENIQUEA	UNIDAD EDUCATIVA CONCENTRADA 98 632 NER 525 LA COLORADA	138	1	0	110	73	110	0	1	0	0	36	110
EDO. TACHIRA	MP. SUCRE	CM. QUENIQUEA	ESCUELA BASICA CONCENTRADA BOLIVARIANA 19 NER 258 EL ALTICO	307	1	1	244	157	243	0	0	0	0	86	244
EDO. TACHIRA	MP. SUCRE	CM. QUENIQUEA	UNIDAD EDUCATIVA CONCENTRADA BOLIVARIANA 1382 NER 258	97	1	0	78	53	78	0	0	0	0	25	78
EDO. TACHIRA	MP. SUCRE	CM. QUENIQUEA	DISPENSARIO RURAL LA PEREZ	302	1	1	250	148	249	0	0	0	0	101	250
EDO. TACHIRA	MP. SUCRE	CM. QUENIQUEA	ESCUELA BASICA ESTADAL CORONEL. VICENTE CAMPO ELIAS
EDO. TACHIRA	MP. SUCRE	CM. QUENIQUEA	UNIDAD EDUCATIVA ESTADAL GENERAL ANGEL MARIA SALCEDO	393	1	9	301	214	292	0	0	0	0	78	301
EDO. TACHIRA	MP. SUCRE	CM. QUENIQUEA	ESCUELA BASICA GRAL. JUAN CRISOSTOMO FALCON	236	1	3	209	140	206	0	0	0	0	66	209
EDO. TACHIRA	MP. SUCRE	CM. QUENIQUEA	ESCUELA BASICA CONCENTRACION BOLIVARIANA 865 NER 580	95	1	1	78	30	77	0	0	0	0	47	78
EDO. TACHIRA	MP. SUCRE	CM. QUENIQUEA	UNIDAD EDUCATIVA CONCENTRADA BOLIVARIANA 860 NER 580	295	1	3	263	197	260	0	0	0	0	63	263
EDO. TACHIRA	MP. SUCRE	CM. QUENIQUEA	ESCUELA ESTADAL CONCENTRADA  91 20 NER 580 LOS BARROS	311	1	3	263	96	260	0	1	0	1	162	263
EDO. TACHIRA	MP. SUCRE	CM. QUENIQUEA	UNIDAD EDUCATIVA MONSEÑOR JUAN BAUTISTA CASTRO	1628	3	24	1326	658	1302	0	3	0	0	641	1326
EDO. TACHIRA	MP. LIBERTADOR	CM. ABEJALES	UNIDAD EDUCATIVA  MUNICIPAL CONCENTRADA Nº 01 EMETERIO OCHOA	981	2	17	865	430	848	0	5	0	0	413	865
EDO. TACHIRA	MP. LIBERTADOR	CM. ABEJALES	ESCUELA TECNICA  AGROPECUARIA ISAIAS MEDINA ANGARITA	1554	3	29	1350	594	1321	0	2	0	0	725	1350
EDO. TACHIRA	MP. LIBERTADOR	CM. ABEJALES	UNIDAD EDUCATIVA NER 003 CONCENTRADA Nº22 LA BIRMANIA	433	1	8	363	261	355	0	0	1	0	93	363
EDO. TACHIRA	MP. LIBERTADOR	CM. ABEJALES	UNIDAD EDUCATIVA NACIONAL  NELLY MARIA ZAMBRANO DE ANGULO	255	1	1	199	115	198	0	0	0	0	83	199
EDO. TACHIRA	MP. LIBERTADOR	CM. ABEJALES	ESCUELA MUNICIPAL LA POLVOROSA	144	1	2	112	45	110	0	0	0	0	65	112
EDO. TACHIRA	MP. LIBERTADOR	CM. ABEJALES	ESCUELA BOLIVARIANA SIMON BOLIVAR	800	2	17	693	390	676	0	1	0	0	285	693
EDO. TACHIRA	MP. LIBERTADOR	CM. ABEJALES	ESCUELA BASICA ESTADAL FRANCISCO DE BORJAS Y MORA	1921	4	35	1562	712	1527	0	4	0	1	810	1562
EDO. TACHIRA	MP. LIBERTADOR	PQ. DORADAS	UNIDAD EDUCATIVA NACIONAL MANUEL RAMON RANGEL	470	1	3	397	197	394	0	2	1	0	194	397
EDO. TACHIRA	MP. LIBERTADOR	PQ. DORADAS	UNIDAD EDUCATIVA BOLIVARIANA RUFINO DUQUE CONTRERAS	354	1	2	308	189	306	0	1	0	0	116	308
EDO. TACHIRA	MP. LIBERTADOR	PQ. DORADAS	UNIDAD EDUCATIVA ESTADAL PEDRO ALEJANDRO SANCHEZ	2065	4	13	1664	867	1651	2	10	2	0	770	1664
EDO. TACHIRA	MP. LIBERTADOR	PQ. SAN JOAQUIN DE NAVAY	ESCUELA BOLIVARIANA CONC S N 472 LA TALA	265	1	1	197	79	196	0	0	0	0	117	197
EDO. TACHIRA	MP. LIBERTADOR	PQ. SAN JOAQUIN DE NAVAY	ESCUELA MUNICIPAL  16 PEDERNALES	226	1	2	170	67	168	0	1	0	0	100	170
EDO. TACHIRA	MP. LIBERTADOR	PQ. SAN JOAQUIN DE NAVAY	ESCUELA ESTADAL CAMPO ALEGRE Nº 302	44	1	0	30	15	30	0	0	0	0	15	30
EDO. TACHIRA	MP. LIBERTADOR	PQ. SAN JOAQUIN DE NAVAY	ESCUELA ESTADAL  69 LA PITA	446	1	11	364	189	353	0	4	0	1	159	364
EDO. TACHIRA	MP. LIBERTADOR	PQ. SAN JOAQUIN DE NAVAY	ESCUELA BOLIVARIANA CONCENTRADA NUMERO 58 SAN JOAQUIN DE NAVAY	1168	2	18	930	432	912	0	5	1	0	474	930
EDO. TACHIRA	MP. LIBERTADOR	PQ. EMETERIO OCHOA	UNIDAD EDUCATIVA NACIONAL GENERAL CIPRIANO CASTRO	540	1	10	451	311	441	1	2	0	1	126	451
EDO. TACHIRA	MP. LIBERTADOR	PQ. EMETERIO OCHOA	ESCUELA ESTADAL CONCENTRADA Nº 55 GUAIMARAL	273	1	3	221	53	218	0	0	0	0	165	221
EDO. TACHIRA	MP. LIBERTADOR	PQ. EMETERIO OCHOA	UNIDAD EDUCATIVA PREVOCACIONAL PUERTO NUEVO	1108	2	8	936	440	928	0	1	0	2	485	936
EDO. TACHIRA	MP. LIBERTADOR	PQ. EMETERIO OCHOA	UNIDAD EDUCATIVA NACIONAL  RURAL GENERAL CIPRIANO CASTRO	991	2	10	838	397	828	1	1	0	0	429	838
EDO. TACHIRA	MP. LIBERTADOR	PQ. EMETERIO OCHOA	UNIDAD EDUCATIVA NUMERO 99 RAMON DE LA CRUZ MORENO	369	1	2	301	107	299	0	0	0	0	192	301
EDO. TACHIRA	MP. LIBERTADOR	PQ. EMETERIO OCHOA	ESCUELA ESTADAL CONCENTRADA Nº 249 6 CAMPO HERMOSO	132	1	3	120	71	117	0	0	0	0	46	120
EDO. TACHIRA	MP. PANAMERICANO	PQ. LA PALMITA	UNIDAD EDUCATIVA NACIONAL AQUILINO GUERRA NER 522	498	1	6	380	212	374	0	2	0	0	160	380
EDO. TACHIRA	MP. PANAMERICANO	PQ. LA PALMITA	ESCUELA BOLIVARIANA UNITARIA Nº 02 NER 532 GUAMAS	145	1	3	123	101	120	0	0	0	0	19	123
EDO. TACHIRA	MP. PANAMERICANO	PQ. LA PALMITA	ESCUELA BOLIVARIANA CONCENTRADA  NER 532 MESA DE LA BLANQUITA	267	1	4	219	149	215	0	3	0	0	63	219
EDO. TACHIRA	MP. PANAMERICANO	PQ. LA PALMITA	ESCUELA NACIONAL BASICA RURAL BOLIVARIANA LA PALMITA NORTE	2470	5	35	1934	1194	1899	1	12	0	1	691	1934
EDO. TACHIRA	MP. PANAMERICANO	PQ. LA PALMITA	ESCUELA BOLIVARIANA NACIONAL CONCENTRADA  NER 532 CENTRO POBLADO	155	1	2	135	78	133	0	2	0	0	53	135
EDO. TACHIRA	MP. PANAMERICANO	PQ. LA PALMITA	UNIDAD EDUCATIVA NACIONAL JUAN PABLO II, CAÑO CUCHARON   NER 532	381	1	10	265	155	255	0	2	0	0	98	265
EDO. TACHIRA	MP. PANAMERICANO	PQ. LA PALMITA	ESCUELA BOLIVARIANA CONCENTRADA 3838 S N NER 532, 23 DE ENERO	134	1	7	116	92	109	0	0	0	0	17	116
EDO. TACHIRA	MP. PANAMERICANO	CM. COLONCITO	ESCUELA BOLIVARIANA PRIMARIA COLONCITO	2097	4	45	1654	715	1609	0	8	1	0	885	1654
EDO. TACHIRA	MP. PANAMERICANO	CM. COLONCITO	UNIDAD EDUCATIVA COLEGIO CRISTOBAL COLON	563	1	15	467	276	452	0	1	0	0	175	467
EDO. TACHIRA	MP. PANAMERICANO	CM. COLONCITO	UNIDAD EDUCATIVA CONCENTRADA 45 NER 522 EL PULPITO	300	1	5	233	142	228	1	0	0	0	85	233
EDO. TACHIRA	MP. PANAMERICANO	CM. COLONCITO	UNIDAD EDUCATIVA CONCENTRADA 323 428 S N NER 522 LOS CAÑOS	207	1	7	167	121	160	0	1	0	0	38	167
EDO. TACHIRA	MP. PANAMERICANO	CM. COLONCITO	UNIDAD EDUCATIVA MONSEÑOR RAFAEL ARIAS BLANCO	3057	6	65	2493	1095	2428	1	9	0	0	1323	2493
EDO. TACHIRA	MP. PANAMERICANO	CM. COLONCITO	UNIDAD EDUCATIVA MUNICIPAL 19 DE ABRIL	1685	3	27	1309	961	1282	0	8	1	0	312	1309
EDO. TACHIRA	MP. PANAMERICANO	CM. COLONCITO	ESCUELA BOLIVARIANA NACIONAL UNITARIA  GUAIMARAL NER 522	161	1	1	133	101	132	0	0	0	0	31	133
EDO. TACHIRA	MP. PANAMERICANO	CM. COLONCITO	ESCUELA BOLIVARIANA PRIMARIA GRAL. JOSE MARIA CORDOBA	2512	5	43	2029	867	1986	0	7	1	0	1111	2029
EDO. TACHIRA	MP. PANAMERICANO	CM. COLONCITO	ESCUELA BOLIVARIANA ESTADAL SAN ISIDRO	2167	4	32	1771	910	1739	0	8	0	1	820	1771
EDO. TACHIRA	MP. PANAMERICANO	CM. COLONCITO	CENTRO DE EDUCACION INICIAL BOLIVARIANA COLONCITO	372	1	4	313	169	309	0	1	0	0	139	313
EDO. TACHIRA	MP. PANAMERICANO	CM. COLONCITO	CENTRO DE EDUCACIÓN INICIAL JOSÉ MARÍA CORDOBA	382	1	3	271	151	268	0	4	0	0	113	271
EDO. TACHIRA	MP. PANAMERICANO	CM. COLONCITO	UNIDAD EDUCATIVA COLEGIO NUESTRA SEÑORA DE LOURDES	1367	3	14	1080	400	1066	1	4	0	0	661	1080
EDO. TACHIRA	MP. SIMON RODRIGUEZ	CM. SAN SIMON	GRUPO ESCOLAR SIMON LEON	1477	3	27	1221	600	1194	0	5	1	0	588	1221
EDO. TACHIRA	MP. SIMON RODRIGUEZ	CM. SAN SIMON	ESCUELA  ESTADAL NUMERO 38 EL ALTO	447	1	5	393	140	388	0	1	1	0	246	393
EDO. TACHIRA	MP. SIMON RODRIGUEZ	CM. SAN SIMON	ESCUELA  RURAL BURUQUIA NUMERO 138 587 600	596	1	9	494	213	485	0	1	2	0	269	494
EDO. TACHIRA	MP. ANDRES BELLO	CM. CORDERO	FUNDACION MIS SUEÑOS DORADOS	728	2	15	663	290	648	0	0	0	0	358	663
EDO. TACHIRA	MP. ANDRES BELLO	CM. CORDERO	ESCUELA NACIONAL BOLIVARIANA DOCTOR VILLALOBOS	3196	6	55	2689	874	2634	0	12	4	1	1743	2689
EDO. TACHIRA	MP. ANDRES BELLO	CM. CORDERO	UNIDAD EDUCATIVA BOLIVARIANA Nº 825 1822 S N ESTADAL 306  646  NER 505	393	1	8	297	136	289	1	0	0	0	152	297
EDO. TACHIRA	MP. ANDRES BELLO	CM. CORDERO	INSTITUTO DE EDUCACION ESPECIAL BOLIVARIANO CORDERO	494	1	6	431	174	425	0	3	0	0	248	431
EDO. TACHIRA	MP. ANDRES BELLO	CM. CORDERO	UNIDAD EDUCATIVA NACIONAL CONCENTRADA 70 SIN NUMERO ESTADAL 83 133  NUCLEO ESCOLAR RURAL 505	274	1	1	252	149	251	0	0	1	0	101	252
EDO. TACHIRA	MP. ANDRES BELLO	CM. CORDERO	UNIDAD EDUCATIVA FRANCISCANO MARIA AUXILIADORA	555	1	4	517	247	513	0	0	0	2	264	517
EDO. TACHIRA	MP. ANDRES BELLO	CM. CORDERO	ESCUELA BOLIVARIANA SIMON RODRIGUEZ	1751	3	30	1493	707	1463	1	4	0	0	751	1493
EDO. TACHIRA	MP. ANDRES BELLO	CM. CORDERO	UNIDAD EDUCATIVA NACIONAL ILDEFONSO VASQUEZ BRAVO	2751	5	69	2388	789	2319	0	5	0	5	1520	2388
EDO. TACHIRA	MP. ANDRES BELLO	CM. CORDERO	UNIDAD EDUCATIVA ESTADAL JOSE LEONARDO CHIRINOS	807	2	27	667	295	640	0	0	1	0	344	667
EDO. TACHIRA	MP. ANDRES BELLO	CM. CORDERO	UNIDAD EDUCATIVA ESTADAL CONCENTRADA 106 591 594 SIN NUMERO NER 01 PAN DE AZUCAR	251	1	4	221	154	217	0	0	0	0	63	221
EDO. TACHIRA	MP. ANDRES BELLO	CM. CORDERO	ESCUELA ESTADAL ARTESANAL CORDERO	346	1	6	302	152	296	0	1	0	0	143	302
EDO. TACHIRA	MP. ANDRES BELLO	CM. CORDERO	UNIDAD EDUCATIVA MONSEÑOR ACACIO CHACON	2495	5	42	2130	694	2088	0	7	0	0	1387	2130
EDO. TACHIRA	MP. ANDRES BELLO	CM. CORDERO	UNIDAD EDUCATIVA NACIONAL CONCENTRADA EL FICAL NUCLEO ESCOLAR RURAL 505	1090	2	14	916	444	902	0	6	0	0	452	916
EDO. TACHIRA	MP. ANDRES BELLO	CM. CORDERO	UNIDAD EDUCATIVA BOLIVARIANA LICEO MAFER	1463	3	28	1183	620	1155	0	4	0	1	530	1183
EDO. TACHIRA	MP. ANDRES BELLO	CM. CORDERO	ESCUELA BASICA ESTADAL UNITARIA BOLIVARIANA 165 NER 533 EL GUAMAL	67	1	1	56	15	55	0	0	0	0	40	56
EDO. TACHIRA	MP. LIBERTAD	CM. CAPACHO VIEJO	CASA DE LA CULTURA	477	1	13	400	181	387	0	2	0	0	204	400
EDO. TACHIRA	MP. LIBERTAD	CM. CAPACHO VIEJO	UNIDAD EDUCATIVA CONCENTRADA 440 682 521 PALO GORDO NER 526	482	1	7	392	252	385	0	3	0	0	130	392
EDO. TACHIRA	MP. LIBERTAD	CM. CAPACHO VIEJO	ESCUELA BOLIVARIANA EL POBLAR	265	1	25	237	168	212	0	1	0	0	43	237
EDO. TACHIRA	MP. LIBERTAD	CM. CAPACHO VIEJO	ESCUELA BOLIVARIANA  792 SALADO NEGRO NUCLEO ESCOLAR RURAL 141	371	1	8	282	179	274	0	1	0	0	94	282
EDO. TACHIRA	MP. LIBERTAD	CM. CAPACHO VIEJO	CENTRO DE EDUCACIÓN INICIAL SIMONCITO LOS PINOS	1257	3	20	1003	506	983	1	4	1	1	470	1003
EDO. TACHIRA	MP. LIBERTAD	CM. CAPACHO VIEJO	ESCUELA BOLIVARIANA CEDRALITO	308	1	1	230	103	229	1	1	0	0	124	230
EDO. TACHIRA	MP. LIBERTAD	CM. CAPACHO VIEJO	UNIDAD EDUCATIVA COLEGIO SANTA MARIANA DE JESUS	873	2	20	753	295	733	0	4	0	0	434	753
EDO. TACHIRA	MP. LIBERTAD	CM. CAPACHO VIEJO	ESCUELA BOLIVARIANA LIBERTAD	2581	5	58	2089	1017	2031	1	7	1	1	1004	2089
EDO. TACHIRA	MP. LIBERTAD	CM. CAPACHO VIEJO	UNIDAD EDUCATIVA FUNDACION TALLER ESCUELA	1451	3	31	1231	570	1200	0	6	0	1	623	1231
EDO. TACHIRA	MP. LIBERTAD	CM. CAPACHO VIEJO	CENTRO DE EDUCACIÓN INICIAL BOLIVARIANA LIBERTAD	393	1	4	368	245	364	0	0	0	0	119	368
EDO. TACHIRA	MP. LIBERTAD	CM. CAPACHO VIEJO	ESCUELA DE LABORES NOCTURNA LIBERTAD	378	1	4	325	231	321	0	0	0	0	90	325
EDO. TACHIRA	MP. LIBERTAD	CM. CAPACHO VIEJO	UNIDAD EDUCATIVA BOLIVARIANA CONCENTRADA  LA AGUADA	194	1	5	169	97	164	0	0	0	0	67	169
EDO. TACHIRA	MP. LIBERTAD	PQ. MANUEL FELIPE RUGELES	U.E PABLO EMILIO ORTIZ	832	2	24	703	319	679	0	1	0	0	359	703
EDO. TACHIRA	MP. LIBERTAD	PQ. MANUEL FELIPE RUGELES	ESCUELA BOLIVARIANA EL TOPE	552	1	20	456	233	436	0	1	0	0	202	456
EDO. TACHIRA	MP. LIBERTAD	PQ. MANUEL FELIPE RUGELES	UNIDAD EDUCATIVA ESTADAL DOCTOR JOSE ABEL MONTILLA	1068	2	25	919	447	894	0	3	0	0	444	919
EDO. TACHIRA	MP. LIBERTAD	PQ. MANUEL FELIPE RUGELES	GRUPO ESCOLAR DOCTOR JOSE GREGORIO HERNANDEZ	1988	4	35	1669	706	1634	0	8	1	1	918	1669
EDO. TACHIRA	MP. LIBERTAD	PQ. MANUEL FELIPE RUGELES	UNIDAD EDUCATIVA CONCENTRADA S N SANTA CRUZ	253	1	1	208	142	207	0	1	0	0	64	208
EDO. TACHIRA	MP. LIBERTAD	PQ. MANUEL FELIPE RUGELES	ESCUELA BASICA ESTADAL SANTIAGO MARIÑO	437	1	14	348	225	334	0	2	0	0	107	348
EDO. TACHIRA	MP. LIBERTAD	PQ. MANUEL FELIPE RUGELES	UNIDAD EDUCATIVA VEGA DEL CEDRO	1278	3	28	1093	534	1065	1	6	0	0	524	1093
EDO. TACHIRA	MP. LIBERTAD	PQ. CIPRIANO CASTRO	UNIDAD EDUCATIVA 1504 524 CONCENTRADA LAS JUAREZ	248	1	3	195	112	192	0	0	0	0	80	195
EDO. TACHIRA	MP. LIBERTAD	PQ. CIPRIANO CASTRO	UNIDAD EDUCATIVA BOLIVARIANA CONCENTRADA 2751 767  LOMAS BAJAS	508	1	3	401	176	398	0	2	0	0	220	401
EDO. TACHIRA	MP. LIBERTAD	PQ. CIPRIANO CASTRO	UNIDAD EDUCATIVA BOLIVARIANA LOS CACAOS	434	1	7	324	204	317	0	3	0	0	110	324
EDO. TACHIRA	MP. LIBERTAD	PQ. CIPRIANO CASTRO	UNIDAD EDUCATVA FELICIANO MONTENEGRO	757	2	6	632	260	626	0	0	0	0	366	632
EDO. TACHIRA	MP. LIBERTAD	PQ. CIPRIANO CASTRO	UNIDAD EDUCATIVA BOLIVARIANA CONCENTRADA 64 LA OVEJERA NER 526	286	1	3	233	152	230	0	3	0	0	75	233
EDO. TACHIRA	MP. LIBERTAD	PQ. CIPRIANO CASTRO	UNIDAD EDUCATIVA BOLIVARIANA CONCENTRADA LLANO GRANDE	200	1	1	162	102	161	0	0	1	0	58	162
EDO. TACHIRA	MP. LIBERTAD	PQ. CIPRIANO CASTRO	NUCLEO CULTURAL COMUNITARIO PARROQUIA CIPRIANO CASTRO	164	1	2	134	89	132	0	0	0	0	43	134
EDO. TACHIRA	MP. SAMUEL MALDONADO	CM. LA TENDIDA	UNIDAD EDUCATIVA MONSEÑOR ALEJANDRO FERNANDEZ FEO	1405	3	30	1140	531	1110	0	2	0	1	576	1140
EDO. TACHIRA	MP. SAMUEL MALDONADO	CM. LA TENDIDA	ESCUELA BOLIVARIANA EL VENADO Nº 192 NER 228	273	1	10	246	138	236	0	1	0	0	97	246
EDO. TACHIRA	MP. SAMUEL MALDONADO	CM. LA TENDIDA	CENTRO DE EDUCACION INICIAL MONSEÑOR ALEJANDRO FERNADEZ FEO	949	2	9	781	404	772	0	5	0	0	363	781
EDO. TACHIRA	MP. SAMUEL MALDONADO	CM. LA TENDIDA	UNIDAD EDUCATIVA RAFAEL MARIA PARRA	920	2	11	779	375	768	0	2	0	0	391	779
EDO. TACHIRA	MP. SAMUEL MALDONADO	CM. LA TENDIDA	ESCUELA BOLIVARIANA LAS TIENDAS	859	2	34	708	435	674	0	0	0	1	238	708
EDO. TACHIRA	MP. SAMUEL MALDONADO	CM. LA TENDIDA	UNIDAD EDUCATIVA CONCENTRADA  1533 ESTADAL 74 SAN RAFAEL	594	1	9	524	266	515	0	2	0	0	247	524
EDO. TACHIRA	MP. SAMUEL MALDONADO	CM. LA TENDIDA	ESTADAL CONCENTRADA  500 25   93	196	1	9	147	77	138	0	1	0	0	60	147
EDO. TACHIRA	MP. SAMUEL MALDONADO	CM. LA TENDIDA	ESCUELA BOLIVARIANA LA MORITA
EDO. TACHIRA	MP. SAMUEL MALDONADO	CM. LA TENDIDA	UNIDAD EDUCATIVA NACIONAL ERNESTINA MORALES	427	1	11	375	262	364	0	1	0	0	101	375
EDO. TACHIRA	MP. SAMUEL MALDONADO	PQ. HERNANDEZ	ESCUELA MUICIPAL 138 LAS COCUIZAS	47	1	3	39	29	36	0	0	0	0	7	39
EDO. TACHIRA	MP. SAMUEL MALDONADO	PQ. HERNANDEZ	ESCUELA BOLIVARIANA BASICA CIUDAD DE SAN CRISTOBAL	1505	3	12	1271	694	1259	0	3	0	0	562	1271
EDO. TACHIRA	MP. SAMUEL MALDONADO	PQ. HERNANDEZ	ESCUELA BOLIVARIANA EL SALADO	266	1	9	219	149	210	0	0	0	0	61	219
EDO. TACHIRA	MP. SAMUEL MALDONADO	PQ. HERNANDEZ	ESCUELA ESTADAL UNITARIA 137 LAS LAGUNAS	63	1	2	53	24	51	0	0	0	0	27	53
EDO. TACHIRA	MP. SAMUEL MALDONADO	PQ. HERNANDEZ	ESCUELA BOLIVARIANA NACIONAL VUELTA DE SAN FERNANDO	40	1	3	34	10	31	0	0	0	0	21	34
EDO. TACHIRA	MP. SAMUEL MALDONADO	PQ. HERNANDEZ	UNIDAD EDUCATIVA DOCTOR. JUAN PABLO PEREZ ALFONZO	592	1	10	534	302	524	0	1	0	1	220	534
EDO. TACHIRA	MP. SAMUEL MALDONADO	PQ. BOCONO	UNIDAD EDUCATIVA CONCENTRADA S N 471 SEDE NER 034	1218	3	20	986	631	966	1	1	0	0	333	986
EDO. TACHIRA	MP. SAMUEL MALDONADO	PQ. BOCONO	ESCUELA ESTADAL CONCANTRADA LOS CAÑOS 659 S N LOS CAÑOS	122	1	4	87	62	83	0	0	0	0	21	87
EDO. TACHIRA	MP. SAMUEL MALDONADO	PQ. BOCONO	ESCUELA BASICA NACIONAL BOLIVARIANA 25 90 SAN MATEO	424	1	10	321	176	311	1	1	1	0	132	321
EDO. TACHIRA	MP. SAMUEL MALDONADO	PQ. BOCONO	UNIDAD EDUCATIVA JOSE TRINIDAD COLMENARES	1054	2	17	850	501	833	0	0	1	1	330	850
EDO. TACHIRA	MP. TORBES	CM. SAN JOSECITO	UNIDAD EDUCATIVA SAN JOCESITO	4612	8	123	3741	1853	3618	1	16	2	1	1745	3741
EDO. TACHIRA	MP. TORBES	CM. SAN JOSECITO	ESCUELA RAFAEL ANTONIO UZCATEGUI	3620	7	135	2873	1282	2738	0	10	0	0	1446	2873
EDO. TACHIRA	MP. TORBES	CM. SAN JOSECITO	ESCUELA BÁSICA ESTADAL JOSÉ FELIX RIBAS	1407	3	32	1202	715	1170	0	5	1	0	449	1202
EDO. TACHIRA	MP. TORBES	CM. SAN JOSECITO	CENTRO DE EDUCACIÒN INICIAL NACIONAL SIMONCITO SAN JOCESITO II	324	1	7	289	173	282	1	1	0	0	107	289
EDO. TACHIRA	MP. TORBES	CM. SAN JOSECITO	ESCUELA ESTADAL GRADUADA MARIA DEL ROSARIO MARQUEZ	3778	7	59	3073	1471	3014	1	10	1	3	1528	3073
EDO. TACHIRA	MP. TORBES	CM. SAN JOSECITO	ESCUELA LA PALMITA SUR RURAL	1092	2	27	909	489	882	1	2	0	2	388	909
EDO. TACHIRA	MP. TORBES	CM. SAN JOSECITO	UNIDAD EDUCATIVA NACIONAL BOLIVARIANA FUERTE MURACHI	387	1	16	292	207	276	0	1	0	0	68	292
EDO. TACHIRA	MP. TORBES	CM. SAN JOSECITO	ESCUELA BASICA SAN JOSECITO II	2942	5	71	2352	1164	2281	1	10	2	1	1103	2352
EDO. TACHIRA	MP. TORBES	CM. SAN JOSECITO	ESCUELA NACIONAL PALMAR NUEVO	3232	6	74	2742	1311	2668	0	8	2	0	1347	2742
EDO. TACHIRA	MP. TORBES	CM. SAN JOSECITO	UNIVERSIDAD BOLIVARIANA DE VENEZUELA ALDEA UNIVERSITARIA TORBES	1282	3	16	1108	674	1092	0	5	1	1	411	1108
EDO. TACHIRA	MP. TORBES	CM. SAN JOSECITO	ESCUELA ESTADAL GRADUADA GENERAL CARLOS SOUBLETTE	3007	6	99	2396	1218	2297	0	11	0	2	1066	2396
EDO. TACHIRA	MP. TORBES	CM. SAN JOSECITO	ESCUELA ESTADAL PALMAR VIEJO	1073	2	28	942	497	914	0	4	0	0	413	942
EDO. TACHIRA	MP. JOSE MARIA VARGA	CM. EL COBRE	ESCUELA ESTADAL 129 ALDEA MESA DE PERNIA	181	1	2	133	61	131	0	0	1	0	69	133
EDO. TACHIRA	MP. JOSE MARIA VARGA	CM. EL COBRE	UNIDAD EDUCATIVA NACIONAL BOLIVARIANA SIN NUMERO 04 LOMA DEL TRIGO NER 601	98	1	4	97	45	93	0	0	0	0	48	97
EDO. TACHIRA	MP. JOSE MARIA VARGA	CM. EL COBRE	UNIDAD EDUCATIVA ESCOLAR CONCENTRADA BOLIVARIANA 131 699 DISTRITO 4 NER 360	250	1	5	226	174	221	0	2	0	0	45	226
EDO. TACHIRA	MP. JOSE MARIA VARGA	CM. EL COBRE	LICEO NACIONAL BOLIVARIANO FERMIN LUÍS VALERO	418	1	8	375	257	367	0	2	0	0	108	375
EDO. TACHIRA	MP. JOSE MARIA VARGA	CM. EL COBRE	ESCUELA NACIONAL CONCENTRADA  3138 3164 3183	395	1	7	345	109	338	0	2	0	0	227	345
EDO. TACHIRA	MP. JOSE MARIA VARGA	CM. EL COBRE	ESCUELA NACIONAL CONCENTRADA BOLIVARIANA 1867 SIN NUMERO	592	1	3	460	221	457	0	0	1	0	235	460
EDO. TACHIRA	MP. JOSE MARIA VARGA	CM. EL COBRE	ESCUELA CONCENTRADA ESTADAL  62 (132 266 552 SIN NUMERO) NACIONAL  SAN AGUSTIN	688	2	20	541	293	521	0	4	0	0	224	541
EDO. TACHIRA	MP. JOSE MARIA VARGA	CM. EL COBRE	ESCUELA NACIONAL BOLIVARIANA  859 SIN NUMERO Y ESTADAL 134 ANGOSTURA	649	2	23	558	289	535	0	6	0	0	240	558
EDO. TACHIRA	MP. JOSE MARIA VARGA	CM. EL COBRE	ESCUELA BASICA MUNICIPAL UNITARIA 01 DISTRITO 4 NER 360	174	1	4	161	130	157	0	1	0	0	26	161
EDO. TACHIRA	MP. JOSE MARIA VARGA	CM. EL COBRE	ESCUELA ESTADAL CONCENTRADA SIN NUMERO 551 30 VALLALES	373	1	3	292	156	289	0	0	0	0	133	292
EDO. TACHIRA	MP. JOSE MARIA VARGA	CM. EL COBRE	UNIDAD EDUCATIVA CONCENTRADA 54 (9 211 256 260 SIN NUMERO)	581	1	6	504	327	498	0	1	0	0	170	504
EDO. TACHIRA	MP. JOSE MARIA VARGA	CM. EL COBRE	UNIDAD EDUCATIVA ESCOLAR CONCENTRADA BOLIVARIANA 565 SIN NUMERO NER 601	138	1	5	128	110	123	0	0	0	0	13	128
EDO. TACHIRA	MP. JOSE MARIA VARGA	CM. EL COBRE	ESCUELA BOLIVARIANA NACIONAL 936 SIN NUMERO CUCHILLA DE GUAYANA	199	1	3	180	158	177	0	0	0	0	19	180
EDO. TACHIRA	MP. JOSE MARIA VARGA	CM. EL COBRE	ESCUELA NACIONAL BOLIVARIANA MONSEÑOR ACEVEDO	2800	5	42	2322	981	2280	0	6	0	0	1293	2322
EDO. TACHIRA	MP. LOBATERA	CM. LOBATERA	UNIDAD EDUCATIVA NACIONAL JUAN BAUTISTA TREJO MORALES LLANO GRANDE	588	1	16	456	282	440	0	1	0	1	156	456
EDO. TACHIRA	MP. LOBATERA	CM. LOBATERA	ESCUELA ESTADAL CONCENTRADA NUMERO 35 EL OSO	471	1	10	378	290	368	0	2	0	0	76	378
EDO. TACHIRA	MP. LOBATERA	CM. LOBATERA	UNIDAD EDUCATIVA DOCTOR FRANCISCO JAVIER GARCIA DE HEVIA	2486	5	34	2164	837	2130	0	7	0	2	1284	2164
EDO. TACHIRA	MP. LOBATERA	CM. LOBATERA	UNIDAD CONCENTRADA SIN NUMERO 177 SIN NUMERO 799 NER 533 VOLADOR	311	1	1	272	217	271	0	1	0	0	53	272
EDO. TACHIRA	MP. LOBATERA	CM. LOBATERA	UNIDAD EDUCATIVA CONCENTRADA 95 (175 503 SIN NUMERO) NER 533	476	1	14	327	145	313	0	1	0	0	167	327
EDO. TACHIRA	MP. LOBATERA	CM. LOBATERA	UNIDAD EDUCATIVA PROFESORA DELIA VARELA DE DIAZ LAS MINAS	930	2	10	770	628	760	0	3	0	0	129	770
EDO. TACHIRA	MP. LOBATERA	CM. LOBATERA	ESCUELA BOLIVARIANA UNITARIA NUMERO 4 LA TEURA	112	1	1	92	75	91	0	0	0	0	16	92
EDO. TACHIRA	MP. LOBATERA	CM. LOBATERA	LICEO NACIONAL DON ALFONSO SUAREZ	188	1	1	170	143	169	0	2	1	0	23	170
EDO. TACHIRA	MP. LOBATERA	PQ. CONSTITUCION	ESCUELA ESTADAL CONCENTRADA NUMERO 20 LA CURIACHA	521	1	3	446	281	443	0	3	0	0	159	446
EDO. TACHIRA	MP. LOBATERA	PQ. CONSTITUCION	ESCUELA INTEGRAL BOLIVARIANA CAZADERO	917	2	29	736	486	707	0	3	0	0	218	736
EDO. TACHIRA	MP. LOBATERA	PQ. CONSTITUCION	UNIDAD EDUCATIVA BOLIVARIANA BOROTA	1241	3	14	1074	494	1060	0	6	0	0	560	1074
EDO. TACHIRA	MP. LOBATERA	PQ. CONSTITUCION	ESCUELA ESTADAL UNITARIA NUMERO 653 EL SALADITO	172	1	2	141	128	139	0	0	0	0	11	141
EDO. TACHIRA	MP. LOBATERA	PQ. CONSTITUCION	ESCUELA ESTADAL EL ORO 46 176 237 469	257	1	0	203	110	203	0	0	0	0	93	203
EDO. TACHIRA	MP. LOBATERA	PQ. CONSTITUCION	UNIDAD EDUCATIVA INTEGRAL MARIA PETRA LABRADOR DE CHACON	775	2	9	683	335	674	0	0	0	1	338	683
EDO. TACHIRA	MP. LOBATERA	PQ. CONSTITUCION	ESCUELA ESTADAL CONCENTRADA Nº 174 PALO GRANDE	190	1	1	169	113	168	0	0	0	0	55	169
EDO. TACHIRA	MP. MICHELENA	CM. MICHELENA	ESCUELA NACIONAL CONCENTRACIÒN NUMERO 1126	349	1	7	299	121	292	0	1	0	0	170	299
EDO. TACHIRA	MP. MICHELENA	CM. MICHELENA	UNIDAD EDUCATIVA NACIONAL CONCENTRADA BOLIVARIANA S N DON GREGORIO RAMON ARELLANO	168	1	1	159	95	158	0	1	0	0	62	159
EDO. TACHIRA	MP. MICHELENA	CM. MICHELENA	ESCUELA NACIONAL BOLIVARIANA NUMERO 2 EL UVITO	411	1	5	370	266	365	0	3	0	0	96	370
EDO. TACHIRA	MP. MICHELENA	CM. MICHELENA	ESCUELA RAFAEL ANTONIO ARELLANO MORA	549	1	13	505	295	492	0	2	0	0	195	505
EDO. TACHIRA	MP. MICHELENA	CM. MICHELENA	ESCUELA BOLIVARIANA PRESBITERO DOCTOR JOSE AMANDO PEREZ ARELLANO	3687	7	51	3109	1294	3058	0	14	2	2	1746	3109
EDO. TACHIRA	MP. MICHELENA	CM. MICHELENA	ESCUELA OFICAL ESTADAL NUMERO 26 LOS VEGONES	124	1	1	109	85	108	0	0	0	0	23	109
EDO. TACHIRA	MP. MICHELENA	CM. MICHELENA	ESCUELA BÁSICA SANTA RITA	859	2	14	761	479	747	0	4	0	3	261	761
EDO. TACHIRA	MP. MICHELENA	CM. MICHELENA	UNIDAD EDUCATIVA NACIONAL LOS HORNOS	477	1	8	364	226	356	1	0	1	0	128	364
EDO. TACHIRA	MP. MICHELENA	CM. MICHELENA	UNIDAD EDUCATIVA NACIONAL CONCENTRADA BOLIVARIANA 87 S N DON RUBEN RIVAS	223	1	1	166	89	165	0	0	1	0	75	166
EDO. TACHIRA	MP. MICHELENA	CM. MICHELENA	ESCUELA ESTADAL BOLIVARIANA 03 EL PEÑON	529	1	3	470	349	467	0	0	0	0	118	470
EDO. TACHIRA	MP. MICHELENA	CM. MICHELENA	ESCUELA NACIONAL UNITARIA NUMERO 762	311	1	4	238	166	234	0	2	0	0	66	238
EDO. TACHIRA	MP. MICHELENA	CM. MICHELENA	UNIDAD EDUCATIVA CONCENTRADA BOLIVARIANA NUMERO 16 LA PRADERA	1408	3	29	1178	573	1149	0	6	0	1	569	1178
EDO. TACHIRA	MP. MICHELENA	CM. MICHELENA	UNIDAD EDUCATIVA CONCENTRADA NUMERO 29 277 MUNICIPAL SIN NUMERO BOCA DE MONTE	451	1	5	346	178	341	0	3	1	0	159	346
EDO. TACHIRA	MP. MICHELENA	CM. MICHELENA	UNIDAD EDUCATIVA CAMILO PRADA	3028	6	47	2527	1029	2480	1	2	0	3	1445	2527
EDO. TACHIRA	MP. MICHELENA	CM. MICHELENA	UNIDAD EDUCATIVA ESTADAL DOCTOR JOSE ALBERTO VELANDIA	679	2	13	594	301	581	0	2	0	0	278	594
EDO. TACHIRA	MP. GUASIMOS	CM. PALMIRA	ESCUELA BOLIVARIANA EL ABEJAL	1959	4	44	1720	886	1676	0	4	0	2	784	1720
EDO. TACHIRA	MP. GUASIMOS	CM. PALMIRA	ESCUELA BOLIVARIANA LA PUENTE SIN NUMERO	398	1	8	368	167	360	0	0	0	0	193	368
EDO. TACHIRA	MP. GUASIMOS	CM. PALMIRA	LICEO BOLIVARIANO MARISCAL ANTONIO JOSE DE SUCRE	1629	3	25	1477	549	1452	2	7	2	2	890	1477
EDO. TACHIRA	MP. GUASIMOS	CM. PALMIRA	ESCUELA BOLIVARIANA EL OJITO	431	1	11	382	243	371	0	2	0	0	126	382
EDO. TACHIRA	MP. GUASIMOS	CM. PALMIRA	ESCUELA BOLIVARIANA MONSEÑOR TOMAS ANTONIO SAN MIGUEL	3231	6	86	2802	895	2716	1	6	1	1	1812	2802
EDO. TACHIRA	MP. GUASIMOS	CM. PALMIRA	UNIDAD EDUCATIVA JHON  KENNEDY	3003	6	35	2608	729	2573	2	6	1	4	1831	2608
EDO. TACHIRA	MP. GUASIMOS	CM. PALMIRA	ESCUELA BOLIVARIANA BOCA DE CANEYES	1079	2	26	965	327	939	0	5	0	1	606	965
EDO. TACHIRA	MP. GUASIMOS	CM. PALMIRA	LICEO BOLIVARIANO MONSEÑOR ANTONIO IGNACIO CAMARGO ALVAREZ.	3010	6	73	2554	786	2481	0	2	1	0	1692	2554
EDO. TACHIRA	MP. GUASIMOS	CM. PALMIRA	UNIDAD EDUCATIVA GENERAL JOSE ANTONIO PAEZ	3341	6	92	2886	1137	2794	1	10	1	0	1645	2886
EDO. TACHIRA	MP. GUASIMOS	CM. PALMIRA	SANTA FILOMENA NER 533	569	1	14	457	247	443	0	2	0	0	194	457
EDO. TACHIRA	MP. GUASIMOS	CM. PALMIRA	ESCUELA CONCENTRADA ESTADAL NUMERO 17 NUCLEO ESCOLAR RURAL 170 TOITUNA	725	2	15	614	209	599	0	3	0	0	387	614
EDO. TACHIRA	MP. GUASIMOS	CM. PALMIRA	CASA DE LAS MISIONES	462	1	12	421	204	409	0	0	1	0	204	421
EDO. TACHIRA	MP. GUASIMOS	CM. PALMIRA	CONCENTRADA NACIONAL Nº 9377 765 875 S N LA BLANCA	1092	2	28	966	558	938	0	3	0	1	376	966
EDO. TACHIRA	MP. GUASIMOS	CM. PALMIRA	UNIDAD EDUCATIVA CONCENTRADA 1192 44 NUCLEO ESCOLAR RURAL 170	1435	3	47	1267	627	1220	0	2	1	0	590	1267
EDO. TACHIRA	MP. GUASIMOS	CM. PALMIRA	COLEGIO PARROQUIAL PADRE FRIAS	2417	5	30	2084	693	2054	1	6	2	0	1352	2084
EDO. TACHIRA	MP. GUASIMOS	CM. PALMIRA	ESCUELA BOLIVARIANA PUEBLO CHIQUITO	881	2	16	793	377	777	1	5	0	1	393	793
EDO. TACHIRA	MP. GUASIMOS	CM. PALMIRA	ESCUELA ESTADAL CONCENTRADA NUMERO 15 (223 407) LA VICTORIA	1314	3	22	1173	452	1151	0	6	0	1	692	1173
EDO. TACHIRA	MP. GUASIMOS	CM. PALMIRA	UNIDAD EDUCATIVA BOLIVARIANA 257 8 S N LA ADUANA	664	2	14	602	368	588	0	2	0	0	218	602
EDO. TACHIRA	MP. URIBANTE	CM. PREGONERO	ESCUELA BOLIVARIANA Nº 19  ALDEA LAGUNA DEL SOCORRO CASERIO EL CERRITO	158	1	3	116	65	113	0	0	0	0	48	116
EDO. TACHIRA	MP. URIBANTE	CM. PREGONERO	ESCUELA ESTADAL CONCENTRADA Nº 241 S N ALDEA PARAMO DE PEREZ	182	1	1	141	90	140	0	0	1	0	49	141
EDO. TACHIRA	MP. URIBANTE	CM. PREGONERO	CASA PARROQUIAL IGLESIA EL CARMEN	359	1	8	303	156	295	0	0	0	0	139	303
EDO. TACHIRA	MP. URIBANTE	CM. PREGONERO	UNIDAD EDUCATIVA CONCENTRADA 239 45	268	1	4	205	70	201	0	1	0	0	130	205
EDO. TACHIRA	MP. URIBANTE	CM. PREGONERO	UNIDAD EDUCATIVA ESTADAL JOSE IGNACIO CARDENAS	899	2	15	753	355	738	1	1	0	1	380	753
EDO. TACHIRA	MP. URIBANTE	CM. PREGONERO	ESCUELA ESTADAL CONCENTRADA NUMERO 94 356 596 675 NUCLEO ESCOLAR RURAL 489 ALDEA SAN PEDRO CASERIO LAS MESAS	312	1	4	265	126	261	0	1	0	0	134	265
EDO. TACHIRA	MP. URIBANTE	CM. PREGONERO	ESCUELA ESTADAL 354 24 ALDEA MESONES CASERIO PLAN DE MESAS	119	1	1	89	32	88	0	2	0	0	54	89
EDO. TACHIRA	MP. URIBANTE	CM. PREGONERO	ESCUELA ESTADAL UNITARIA 439 ALDEA MESA DE PEREZ	65	1	1	42	22	41	0	0	0	0	19	42
EDO. TACHIRA	MP. URIBANTE	CM. PREGONERO	ESCUELA ESTADAL CONCENTRADA 70  190 361 588	229	1	3	187	134	184	0	0	0	0	50	187
EDO. TACHIRA	MP. URIBANTE	CM. PREGONERO	ESCUELA NACIONAL BOLIVARIANA FERMINA MEDINA DE ANDRADE ALDEA TENEGA	122	1	0	67	15	67	0	0	0	0	52	67
EDO. TACHIRA	MP. URIBANTE	CM. PREGONERO	UNIDAD EDUCATIVA NACIONAL DON ALIPIO HERNANDEZ	156	1	1	117	93	116	0	0	0	0	23	117
EDO. TACHIRA	MP. URIBANTE	CM. PREGONERO	ESCUELA NACIONAL BOLIVARIANA PLAN DE RUBIO MUNICIPAL 17 ESTADAL 351 NACIONAL SIN NUMERO	305	1	1	263	213	262	0	1	0	0	48	263
EDO. TACHIRA	MP. URIBANTE	CM. PREGONERO	ESCUELA NACIONAL BOLIVARIANA DON JOSE PIO ARELLANO ZAMBRANO PEÑAS BLANCAS CASERIO URUMAL	93	1	2	70	41	68	0	0	0	0	27	70
EDO. TACHIRA	MP. URIBANTE	CM. PREGONERO	UNIDAD EDUCATIVA COLEGIO SANTA MARIANA DE JESUS	1604	3	32	1265	452	1233	0	1	0	0	780	1265
EDO. TACHIRA	MP. URIBANTE	CM. PREGONERO	LICEO BOLIVARIANO FRANCISCO DE BORJA Y MORA	1451	3	29	1226	475	1197	0	4	0	0	718	1226
EDO. TACHIRA	MP. URIBANTE	CM. PREGONERO	ESCUELA BOLIVARIANA SANCHEZ CARRERO	471	1	3	358	182	355	0	1	0	0	172	358
EDO. TACHIRA	MP. URIBANTE	CM. PREGONERO	UNIDAD EDUCATIVA NACIONAL DOÑA NIEVES RUFINA RAMIREZ NAVAS	404	1	12	330	217	318	0	0	0	0	101	330
EDO. TACHIRA	MP. URIBANTE	CM. PREGONERO	MINISTERIO DEL PODER POPULAR PARA EL AMBIENTE AREA ADMINISTRATIVA NUMERO 06	618	2	14	528	226	514	0	2	0	0	286	528
EDO. TACHIRA	MP. URIBANTE	CM. PREGONERO	ESCUELA COMBINADA 05 12 SIN NUMERO PRE ESCOLAR ALDEA MONTAÑA ALTA	170	1	1	153	147	152	0	0	0	0	5	153
EDO. TACHIRA	MP. URIBANTE	CM. PREGONERO	ESCUELA NACIONAL BOLIVARIANA Nº 863 S N CASERIO LA CAÑABRABA	333	1	3	280	139	277	0	0	0	0	138	280
EDO. TACHIRA	MP. URIBANTE	CM. PREGONERO	ESCUELA NACIONAL CONCENTRADA Nº 861 ALDEA LOS RASTROJOS	116	1	2	92	72	90	0	0	0	0	18	92
EDO. TACHIRA	MP. URIBANTE	PQ. CARDENAS	ESCUELA BASICA BOLIVARIANA CONCENTRADA S N NER 412 ALDEA MESA FRESCA	63	1	0	52	45	52	0	0	0	0	7	52
EDO. TACHIRA	MP. URIBANTE	PQ. CARDENAS	ESCUELA BASICA BOLIVARIANA CONCENTRADA 5 8 NER 412 EL VISO	87	1	0	71	28	71	0	0	0	0	43	71
EDO. TACHIRA	MP. URIBANTE	PQ. CARDENAS	BOLIVARIANA ESCUELA BASICA CONCENTRADA SIN NUMERO NUCLEO ESCOLAR RURAL 412
EDO. TACHIRA	MP. URIBANTE	PQ. CARDENAS	UNIDAD EDUCATIVA NACIONAL  CONCENTRADA. 3130  NER 412 EL PARADERO	364	1	2	304	109	302	0	1	0	0	192	304
EDO. TACHIRA	MP. URIBANTE	PQ. CARDENAS	BOLIVARIANA ESCUELA BASICA CONCENTRADA  11 NUCLEO ESCOLAR RURAL 412	65	1	1	45	28	44	0	1	0	0	15	45
EDO. TACHIRA	MP. URIBANTE	PQ. CARDENAS	ESCUELA BASICA BOLIVARIANA UNITARIA 7 NER 412	258	1	0	202	129	202	0	0	0	0	73	202
EDO. TACHIRA	MP. URIBANTE	PQ. CARDENAS	UNIDAD EDUCATIVA ESTADAL LINA CONTRERAS DE MORA	203	1	1	150	86	149	0	0	0	0	63	150
EDO. TACHIRA	MP. URIBANTE	PQ. CARDENAS	UNIDAD EDUCATIVA LICEO BOLIVARIANO JOSEFA MOLINA DE DUQUE	903	2	10	725	358	715	0	1	1	0	355	725
EDO. TACHIRA	MP. URIBANTE	PQ. CARDENAS	ESCUELA BASICA BOLIVARIANA CONCENTRADA 10 81 NUCLEO ESCOLAR RURAL 412	223	1	0	186	136	186	0	0	0	0	50	186
EDO. TACHIRA	MP. URIBANTE	PQ. POTOSI	ESCUELA BOLIVARIANA NACIONAL CONCENTRADA EL VIJAGUAL	97	1	4	64	21	60	0	0	0	0	39	64
EDO. TACHIRA	MP. URIBANTE	PQ. POTOSI	ESCUELA BOLIVARIANA NACIONAL UNITARIA SIN NUMERO SAN RAFAEL DEL CAÑO	45	1	1	35	16	34	0	0	0	0	18	35
EDO. TACHIRA	MP. URIBANTE	PQ. POTOSI	ESCUELA BOLIVARIANA NACIONAL CONCENTRADA SIN NUMERO EL PALMAR SANTA MARTA	188	1	3	120	54	117	0	0	0	0	63	120
EDO. TACHIRA	MP. URIBANTE	PQ. POTOSI	ESCUELA BOLIVARIANA NACIONAL RAIMUNDO BELANDRIA BELANDRIA	362	1	3	282	99	279	0	1	0	0	179	282
EDO. TACHIRA	MP. URIBANTE	PQ. POTOSI	ESCUELA TECNICA ROBINSONIANA AGROTURISTICA SIBERIA	607	2	9	293	187	284	1	0	0	0	96	293
EDO. TACHIRA	MP. URIBANTE	PQ. POTOSI	ESCUELA NACIONAL CONCENTRADA SIN NUMERO SAN BUENA	117	1	3	91	46	88	0	0	0	0	42	91
EDO. TACHIRA	MP. URIBANTE	PQ. POTOSI	ESCUELA BOLIVARIANA NACIONAL CONCENTRADA 2628 949 928 BUENA VISTA ABAJO	222	1	1	160	46	159	0	0	0	0	113	160
EDO. TACHIRA	MP. URIBANTE	PQ. JUAN PABLO PE#ALOZA	ESCUELA ESTADAL CONCENTRADA SIN NUMERO PLANES DEL HATO	95	1	2	85	44	83	0	1	0	0	38	85
EDO. TACHIRA	MP. URIBANTE	PQ. JUAN PABLO PE#ALOZA	ESCUELA BOLIVARIANA ZAYZAYAL 3206 01 08 PREESCOLAR	502	1	10	368	249	358	0	0	0	0	109	368
EDO. TACHIRA	MP. URIBANTE	PQ. JUAN PABLO PE#ALOZA	ESCUELA NACIONAL BOLIVARIANA AMBROSIO VIVAS ALDEA SAN JOSE	210	1	3	163	52	160	0	0	0	1	107	163
EDO. TACHIRA	MP. URIBANTE	PQ. JUAN PABLO PE#ALOZA	UNIDAD EDUCATIVA NACIONAL PROFESOR AMERICO ROA	823	2	11	633	382	622	0	1	0	0	239	633
EDO. TACHIRA	MP. URIBANTE	PQ. JUAN PABLO PE#ALOZA	ESCUELA BOLIVARIANA S N LA PALMA NER 439
EDO. TACHIRA	MP. GARCIA DE HEVIA	CM. LA FRIA	ESCUELA BOLIVARIANA RIO GRITA	1443	3	20	1197	803	1177	1	5	0	0	368	1197
EDO. TACHIRA	MP. GARCIA DE HEVIA	CM. LA FRIA	ESCUELA BOLIVARIANA KM 99	127	1	1	111	89	110	0	0	0	0	21	111
EDO. TACHIRA	MP. GARCIA DE HEVIA	CM. LA FRIA	ESCUELA BASICA SIMON BOLIVAR	1682	3	23	1345	838	1322	0	7	0	1	476	1345
EDO. TACHIRA	MP. GARCIA DE HEVIA	CM. LA FRIA	UNIDAD EDUCATIVA GENARO MENDEZ MORENO	3370	6	46	2671	1287	2625	0	11	0	0	1327	2671
EDO. TACHIRA	MP. GARCIA DE HEVIA	CM. LA FRIA	ESCUELA BASICA ANTONIO ROMULO COSTA	3012	6	45	2312	1245	2267	1	13	0	0	1008	2312
EDO. TACHIRA	MP. GARCIA DE HEVIA	CM. LA FRIA	ESCUELA NACIONAL CONCENTRADA PARAISO	2044	4	20	1558	981	1538	0	8	0	1	548	1558
EDO. TACHIRA	MP. GARCIA DE HEVIA	CM. LA FRIA	ESCUELA MUNICIPAL FRANCISCO DE MIRANDA	1532	3	28	1254	620	1226	1	9	0	0	596	1254
EDO. TACHIRA	MP. GARCIA DE HEVIA	CM. LA FRIA	UNIDAD EDUCATIVA NACIONAL GARCIA DE HEVIA	1093	2	16	906	604	890	0	4	0	0	282	906
EDO. TACHIRA	MP. GARCIA DE HEVIA	CM. LA FRIA	ESCUELA BOLIVARIANA MONSEÑOR MARCO TULIO RAMÍREZ ROA	229	1	4	182	92	178	0	1	0	0	85	182
EDO. TACHIRA	MP. GARCIA DE HEVIA	CM. LA FRIA	ESCUELA BASICA LAS DELICIAS	4295	8	79	3519	2080	3440	0	17	2	0	1341	3519
EDO. TACHIRA	MP. GARCIA DE HEVIA	CM. LA FRIA	ESCUELA CONCENTRADA MIXTA 251 231 274	415	1	2	302	227	300	0	0	0	0	73	302
EDO. TACHIRA	MP. GARCIA DE HEVIA	CM. LA FRIA	CASA COMUNAL PREFUNDACION ANDRES BELLO	310	1	7	282	217	275	0	1	0	0	57	282
EDO. TACHIRA	MP. GARCIA DE HEVIA	CM. LA FRIA	ESCUELA MUNICIPAL 625 3	414	1	7	331	195	324	0	4	0	0	125	331
EDO. TACHIRA	MP. GARCIA DE HEVIA	CM. LA FRIA	UNIDAD EDUCATIVA JOSE FELIX RIBAS	671	2	15	470	284	455	0	3	0	0	168	470
EDO. TACHIRA	MP. GARCIA DE HEVIA	CM. LA FRIA	ESCUELA MANUELITA SAENZ	412	1	5	340	256	335	0	5	0	0	74	340
EDO. TACHIRA	MP. GARCIA DE HEVIA	CM. LA FRIA	ESCUELA BOLIVARIANA BARRIO SUCRE	275	1	5	230	175	225	0	0	0	0	50	230
EDO. TACHIRA	MP. GARCIA DE HEVIA	CM. LA FRIA	LICEO PEDRO ANTONIO RIO REINA	2896	5	29	2411	1090	2382	1	11	2	1	1277	2411
EDO. TACHIRA	MP. GARCIA DE HEVIA	CM. LA FRIA	ESCUELA CARLOTA JAIMES DE GONZALEZ	879	2	17	754	541	737	0	3	0	0	193	754
EDO. TACHIRA	MP. GARCIA DE HEVIA	CM. LA FRIA	ESCUELA NACIONAL JUAN PABLO II	383	1	5	303	188	298	0	0	0	0	110	303
EDO. TACHIRA	MP. GARCIA DE HEVIA	CM. LA FRIA	UNIDAD EDUCATIVA COLEGIO FRANCISCO JAVIER GARCIA DE HEVIA	456	1	2	353	192	351	0	0	0	0	159	353
EDO. TACHIRA	MP. GARCIA DE HEVIA	CM. LA FRIA	CASA COMUNAL EL PARAISO PARTE ALTA	219	1	1	196	163	195	0	0	0	0	32	196
EDO. TACHIRA	MP. GARCIA DE HEVIA	CM. LA FRIA	UNIDAD EDUCATIVA NACIONAL VIRGEN DEL PERPETUO SOCORRO	501	1	1	426	287	425	0	1	0	0	137	426
EDO. TACHIRA	MP. GARCIA DE HEVIA	CM. LA FRIA	CONCENTRACIÓN NACIONAL Nº 159 2585	811	2	16	669	448	653	0	5	0	0	200	669
EDO. TACHIRA	MP. GARCIA DE HEVIA	PQ. BOCA DE GRITA	UNIDAD EDUCATIVA NACIONAL DOCTOR JOSE GREGORIO HERNANDEZ	1362	3	29	910	421	881	0	2	0	0	458	910
EDO. TACHIRA	MP. GARCIA DE HEVIA	PQ. BOCA DE GRITA	LICEO VICTORIANO DEL CARMEN MONCADA GARCIA	428	1	10	335	202	325	0	2	0	0	121	335
EDO. TACHIRA	MP. GARCIA DE HEVIA	PQ. JOSE ANTONIO PAEZ	ESCUELA ESTADAL EL DIQUE	76	1	2	64	50	62	0	0	0	0	12	64
EDO. TACHIRA	MP. GARCIA DE HEVIA	PQ. JOSE ANTONIO PAEZ	ESCUELA LA LORENA KILOMETRO 82	79	1	2	66	44	64	0	0	0	0	20	66
EDO. TACHIRA	MP. GARCIA DE HEVIA	PQ. JOSE ANTONIO PAEZ	UNIDAD EDUCATIVA ESTADAL ARTURO MICHELENA	1884	4	40	1448	886	1408	0	2	1	0	519	1448
EDO. TACHIRA	MP. GARCIA DE HEVIA	PQ. JOSE ANTONIO PAEZ	ESCUELA BASICA RURAL CASTELLON	280	1	3	214	117	211	0	0	0	0	94	214
EDO. TACHIRA	MP. GARCIA DE HEVIA	PQ. JOSE ANTONIO PAEZ	ESCUELA BOLIVARIANA KILOMETRO 96	304	1	4	263	194	259	0	0	0	0	65	263
EDO. TACHIRA	MP. GARCIA DE HEVIA	PQ. JOSE ANTONIO PAEZ	ESCUELA NACIONAL CONCENTRADA 460 SIN NUMERO NER 293	445	1	8	331	190	323	0	0	0	0	133	331
EDO. TACHIRA	MP. CORDOBA	CM. STA. ANA  DEL TACHIRA	ESCUELA BÁSICA MUNICIPAL SIN NUMERO NUCLEO ESCOLAR RURAL  171	311	1	11	243	90	232	0	0	0	2	140	243
EDO. TACHIRA	MP. CORDOBA	CM. STA. ANA  DEL TACHIRA	CENTRO DE EDUCACIÓN INICIAL DOCTOR. FRANCISCO JAVIER GARCIA DE HEVIA	624	2	12	550	298	538	0	0	0	0	240	550
EDO. TACHIRA	MP. CORDOBA	CM. STA. ANA  DEL TACHIRA	CASA DE LA CULTURA	886	2	26	786	374	760	0	3	0	3	380	786
EDO. TACHIRA	MP. CORDOBA	CM. STA. ANA  DEL TACHIRA	ESCUELA BASICA MUNICIPAL CONCENTRADA 6 10 NER 359	207	1	5	160	94	155	0	0	0	1	60	160
EDO. TACHIRA	MP. CORDOBA	CM. STA. ANA  DEL TACHIRA	ESCUELA ESTADAL BUENOS AIRES	1777	3	32	1521	938	1489	0	5	0	1	545	1521
EDO. TACHIRA	MP. CORDOBA	CM. STA. ANA  DEL TACHIRA	ESCUELA BOLIVARIANA DOCTOR FRANCISCO JAVIER GARCIA DE HEVIA	3929	7	123	3332	1473	3209	0	12	0	0	1724	3332
EDO. TACHIRA	MP. CORDOBA	CM. STA. ANA  DEL TACHIRA	CENTRO DE EDUCACION INICIAL BELEN SAN JUAN COLINAS	1963	4	48	1707	657	1659	0	4	0	0	998	1707
EDO. TACHIRA	MP. CORDOBA	CM. STA. ANA  DEL TACHIRA	LICEO BOLIVARIANO MONSEÑOR BERNABE VIVAS	2938	5	50	2455	760	2405	0	7	0	1	1637	2455
EDO. TACHIRA	MP. CORDOBA	CM. STA. ANA  DEL TACHIRA	UNIDAD EDUCATIVA NACIONAL BOLIVARIANA SAN JOAQUIN	1049	2	21	924	469	903	1	1	0	1	431	924
EDO. TACHIRA	MP. CORDOBA	CM. STA. ANA  DEL TACHIRA	UNIDAD EDUCATIVA BOLIVARIANA LA ESPUMA	207	1	6	168	100	162	0	4	0	0	58	168
EDO. TACHIRA	MP. CORDOBA	CM. STA. ANA  DEL TACHIRA	UNIDAD EDUCATIVA NACIONAL CONCENTRADA BOLIVARIANA LA BLANQUITA	646	2	20	527	312	507	0	2	0	0	193	527
EDO. TACHIRA	MP. CORDOBA	CM. STA. ANA  DEL TACHIRA	ESCUELA BÁSICA  ESTADAL UNITARIA NUMERO 52 NUCLEO ESCOLAR RURAL 359	216	1	3	149	94	146	0	0	0	0	52	149
EDO. TACHIRA	MP. CORDOBA	CM. STA. ANA  DEL TACHIRA	CENTRO PENITENCIARIO DE OCCIDENTE	1104	2	17	390	221	373	0	4	0	0	148	390
EDO. TACHIRA	MP. CORDOBA	CM. STA. ANA  DEL TACHIRA	MODULO FUNDACOMUN	1613	3	61	1395	718	1334	0	5	1	0	610	1395
EDO. TACHIRA	MP. CORDOBA	CM. STA. ANA  DEL TACHIRA	UNIDAD EDUCATIVA ESTADAL BOLIVARIANA DON ROMULO GALLEGO	2638	5	64	2183	1072	2119	0	15	0	1	1031	2183
EDO. TACHIRA	MP. JUNIN	PQ. BRAMON	UNIDAD EDUCATIVA BOLIVARIANA BOLIVIA	1621	3	53	1402	665	1349	0	4	1	2	677	1402
EDO. TACHIRA	MP. JUNIN	PQ. BRAMON	UNIDAD EDUCATIVA NACIONAL PREVOCACIONAL VEGA DE LA PIPA	1245	3	38	1047	561	1009	0	5	1	0	442	1047
EDO. TACHIRA	MP. JUNIN	PQ. BRAMON	UNIDAD EDUCATIVA CONCENTRADA MIXTA KILOMETRO 5	596	1	14	525	229	511	0	0	0	1	281	525
EDO. TACHIRA	MP. JUNIN	PQ. BRAMON	LICEO HERMES DE LAS MERCEDES MORA DE NAVARRO	680	2	7	600	350	593	0	3	0	0	240	600
EDO. TACHIRA	MP. JUNIN	PQ. BRAMON	UNIDAD EDUCATIVA BOLIVARIANA EL PORTICO NER 292	437	1	8	415	233	407	0	0	0	0	174	415
EDO. TACHIRA	MP. JUNIN	PQ. BRAMON	UNIDAD EDUCATIVA CONCENTRADA LA PEDREGOZA 1047	376	1	7	302	162	295	0	2	0	0	131	302
EDO. TACHIRA	MP. JUNIN	PQ. BRAMON	UNIDAD EDUCATIVA BOLIVARIANA LUIS BELISARIO DIAZ RANGEL	2900	5	45	2391	1101	2346	1	9	0	1	1234	2391
EDO. TACHIRA	MP. JUNIN	PQ. BRAMON	UNIDAD EDUCATIVA GRANJA LA GONZALERA	555	1	19	493	346	474	0	2	0	0	126	493
EDO. TACHIRA	MP. JUNIN	PQ. BRAMON	UNIDAD EDUCATIVA BOLIVARIANA LA COLINA	1677	3	39	1386	810	1347	1	7	1	1	527	1386
EDO. TACHIRA	MP. JUNIN	PQ. BRAMON	UNIDAD NACIONAL CONCENTRADA 282 EL HELECHAL NER 033	198	1	8	184	135	176	0	0	0	0	41	184
EDO. TACHIRA	MP. JUNIN	PQ. BRAMON	UNIDAD EDUCATIVA NACIONAL JESÚS REDENTOR	451	1	12	400	288	388	0	3	0	0	97	400
EDO. TACHIRA	MP. JUNIN	PQ. BRAMON	LICEO BOLIVARIANO TIERRA DEL CAFÉ	1759	3	31	1591	898	1560	0	5	2	1	654	1591
EDO. TACHIRA	MP. JUNIN	PQ. BRAMON	UNIDAD EDUCATIVA BOLIVARIANA ANTONIO MARIA CHACON PINEDA NER 33	433	1	3	363	187	360	0	0	0	0	173	363
EDO. TACHIRA	MP. JUNIN	PQ. BRAMON	UNIDAD EDUCATIVA ESTADAL DOCTOR RAUL LEONI	3866	7	75	3230	1479	3155	0	25	4	2	1645	3230
EDO. TACHIRA	MP. JUNIN	CM. RUBIO	UNIDAD EDUCATIVA IMELDA DEL CARMEN VERA QUINTERO	1796	4	18	1547	779	1529	0	6	0	0	744	1547
EDO. TACHIRA	MP. JUNIN	CM. RUBIO	LICEO BOLIVARIANO LAS AMERICAS	2239	4	25	1934	628	1909	0	11	0	2	1268	1934
EDO. TACHIRA	MP. JUNIN	CM. RUBIO	UNIDAD EDUCATIVA ESTADAL PROFESOR PABLO EMILIO OSTOS	1392	3	20	1195	542	1175	0	3	0	0	630	1195
EDO. TACHIRA	MP. JUNIN	CM. RUBIO	ESCUELA TECNICA ROBINSONIANA CARLOS RANGEL LAMUS	1897	4	31	1629	566	1598	0	8	0	2	1022	1629
EDO. TACHIRA	MP. JUNIN	CM. RUBIO	ESCUELA GRANJA BOLIVARIANA PROFESOR MARCO TULIO RODRIGUEZ	1908	4	32	1678	1035	1646	0	7	0	0	604	1678
EDO. TACHIRA	MP. JUNIN	CM. RUBIO	ESCUELA ESTADAL NUMERO 31 154 332 415 ALINEADERO	468	1	9	375	174	366	0	2	0	0	190	375
EDO. TACHIRA	MP. JUNIN	CM. RUBIO	UNIDAD EDUCATIVA BOLIVARIANA CANÉA	650	2	12	585	392	573	0	4	0	0	177	585
EDO. TACHIRA	MP. JUNIN	CM. RUBIO	ESCUELA BÁSICA ESTADAL NEGRA MATEA	1048	2	18	950	560	932	0	6	0	1	365	950
EDO. TACHIRA	MP. JUNIN	CM. RUBIO	UNIDAD EDUCATIVA BOLIVARIANA LA VICTORIA	3282	6	48	2717	993	2669	1	11	2	1	1661	2717
EDO. TACHIRA	MP. JUNIN	CM. RUBIO	UNIDAD EDUCATIVA BOLIVARIANA ESTADO YARACUY	2457	5	59	2005	904	1946	1	13	0	3	1025	2005
EDO. TACHIRA	MP. JUNIN	CM. RUBIO	LICEO NACIONAL ANTONIO JOSE DE SUCRE	566	1	19	500	211	481	0	2	0	0	268	500
EDO. TACHIRA	MP. JUNIN	CM. RUBIO	UNIDAD EDUCATIVA SAN DIEGO	1864	4	17	1602	733	1585	0	4	0	2	846	1602
EDO. TACHIRA	MP. JUNIN	CM. RUBIO	UNIDAD EDUCATIVA NACIONAL ESTADO SUCRE	3587	7	76	2881	815	2805	1	14	1	5	1969	2881
EDO. TACHIRA	MP. JUNIN	CM. RUBIO	ESCUELA BOLIVARIANA LA PAJARITA NUCLEO ESCOLAR RURAL 033	143	1	2	108	63	106	0	1	0	0	42	108
EDO. TACHIRA	MP. JUNIN	CM. RUBIO	ESCUELA MUNICIPAL NUMERO 76 NER 292	112	1	0	75	38	75	0	0	0	0	37	75
EDO. TACHIRA	MP. JUNIN	CM. RUBIO	ESCUELA BASICA LEONARDO RUIZ PINEDA	3374	6	57	2857	1028	2800	3	15	1	3	1750	2857
EDO. TACHIRA	MP. JUNIN	CM. RUBIO	ESCUELA BOLIVARIANA PROFESOR JOSE NATALIO BRUGUERA ORTIZ	2636	5	41	2214	812	2173	1	4	0	1	1355	2214
EDO. TACHIRA	MP. JUNIN	CM. RUBIO	ESCUELA ESTADAL UNITARIA NUMERO 42 NER 10	353	1	4	299	161	295	0	0	0	0	134	299
EDO. TACHIRA	MP. JUNIN	CM. RUBIO	UNIDAD EDUCATIVA ESTADO MERIDA	4070	7	53	3548	1040	3495	0	14	3	0	2438	3548
EDO. TACHIRA	MP. JUNIN	CM. RUBIO	INSTITUTO DE EDUCACIÓN ESPECIAL BOLIVARIANA RUBIO	765	2	5	687	344	682	0	0	0	0	338	687
EDO. TACHIRA	MP. JUNIN	CM. RUBIO	UNIDAD EDUCATIVA EL CHICARO	1388	3	32	1138	616	1106	0	6	1	0	483	1138
EDO. TACHIRA	MP. JUNIN	PQ. LA PETROLEA	UNIDAD EDUCATIVA CONCENTRADA 240 LA ALQUITRANA NER 08	874	2	20	723	442	703	0	5	0	0	256	723
EDO. TACHIRA	MP. JUNIN	PQ. LA PETROLEA	UNIDAD EDUCATIVA TORBES RIO CHIQUITO	511	1	9	404	183	395	0	2	0	0	210	404
EDO. TACHIRA	MP. JUNIN	PQ. QUINIMARI	UNIDAD EDUCATIVA DESIDERIO BOADA	1171	2	14	961	471	947	1	2	0	0	473	961
EDO. TACHIRA	MP. FERNANDEZ FEO	CM.SAN RAFAEL DEL PINAL	ESCUELA BOLIVARIANA EL MONERO	486	1	6	386	111	380	0	0	0	0	269	386
EDO. TACHIRA	MP. FERNANDEZ FEO	CM.SAN RAFAEL DEL PINAL	ESCUELA BASICA UNITARIA 466 LA BARRANQUILLA	74	1	2	49	24	47	0	0	0	0	23	49
EDO. TACHIRA	MP. FERNANDEZ FEO	CM.SAN RAFAEL DEL PINAL	UNIDAD EDUCATIVA ESTADAL INES LABRADOR DE LARA	3774	7	53	2991	1252	2938	0	21	1	1	1663	2991
EDO. TACHIRA	MP. FERNANDEZ FEO	CM.SAN RAFAEL DEL PINAL	ESCUELA BOLIVARIANA 3193 SIN NUMERO JUAN EVANGELISTA LABRADOR ZAMBRANO NUCLEO ESCOLAR RURAL 131	1704	3	21	1374	923	1353	0	16	0	0	414	1374
EDO. TACHIRA	MP. FERNANDEZ FEO	CM.SAN RAFAEL DEL PINAL	ESCUELA BASICA UNITARIA 71 EL CANAL	130	1	2	109	42	107	0	0	0	0	65	109
EDO. TACHIRA	MP. FERNANDEZ FEO	CM.SAN RAFAEL DEL PINAL	UNIDAD EDUCATIVA BOLIVARIANA ALTO VIENTO	179	1	1	140	116	139	0	1	0	0	22	140
EDO. TACHIRA	MP. FERNANDEZ FEO	CM.SAN RAFAEL DEL PINAL	ESCUELA BOLIVARIANA 1435  1870 LA ISLA TROPEZON	566	1	13	442	292	429	1	1	0	0	135	442
EDO. TACHIRA	MP. FERNANDEZ FEO	CM.SAN RAFAEL DEL PINAL	LICEO BOLIVARIANO UNIDAD EDUCATIVA FRANCISCO TAMAYO	2022	4	34	1658	721	1624	0	10	1	0	892	1658
EDO. TACHIRA	MP. FERNANDEZ FEO	CM.SAN RAFAEL DEL PINAL	UNIDAD EDUCATIVA BOLIVARIANA RUFINO BLANCO FOMBONA	609	2	12	494	215	482	0	1	0	0	266	494
EDO. TACHIRA	MP. FERNANDEZ FEO	CM.SAN RAFAEL DEL PINAL	UNIVERSIDAD NACIONAL EXPERIMENTAL DE LOS LLANOS EZEQUIEL ZAMORA	1213	3	29	1045	518	1016	0	2	0	0	496	1045
EDO. TACHIRA	MP. FERNANDEZ FEO	CM.SAN RAFAEL DEL PINAL	BOLIVARIANA UNIDAD EDUCATIVA GUAFITAS NUCLEO ESCOLAR RURAL 523	418	1	11	358	243	347	0	4	2	0	98	358
EDO. TACHIRA	MP. FERNANDEZ FEO	PQ. SANTO DOMINGO	ESCUELA BOLIVARIANA EL VARIANTE	242	1	6	214	109	208	0	2	0	0	97	214
EDO. TACHIRA	MP. FERNANDEZ FEO	PQ. SANTO DOMINGO	UNIDAD EDUCATIVA NACIONAL SAMUEL ROBINSON	436	1	6	399	295	393	0	0	0	0	98	399
EDO. TACHIRA	MP. FERNANDEZ FEO	PQ. SANTO DOMINGO	LICEO NACIONAL SEMINARISTA FREDDY WILSON ACEVEDO PEREZ	345	1	6	308	153	302	0	1	0	0	148	308
EDO. TACHIRA	MP. FERNANDEZ FEO	PQ. SANTO DOMINGO	UNIDAD EDUCATIVA BOLIVARIANA LA VALERIA	195	1	3	146	78	143	0	0	0	1	64	146
EDO. TACHIRA	MP. FERNANDEZ FEO	PQ. SANTO DOMINGO	ESCUELA BASICA NACIONAL CHURURU	631	2	10	545	279	535	0	4	0	1	251	545
EDO. TACHIRA	MP. FERNANDEZ FEO	PQ. SANTO DOMINGO	UNIDAD EDUCATIVA  BOLIVARIANA SAN LORENZO	2322	4	42	1972	949	1930	0	13	1	2	965	1972
EDO. TACHIRA	MP. FERNANDEZ FEO	PQ. SANTO DOMINGO	ESCUELA BOLIVARIANA EL ZIG ZAG	197	1	6	175	117	169	0	0	0	0	52	175
EDO. TACHIRA	MP. FERNANDEZ FEO	PQ. SANTO DOMINGO	ESCUELA BASICA NACIONAL BELEN MARIA SAN JUAN	339	1	12	306	196	294	0	2	0	0	96	306
EDO. TACHIRA	MP. FERNANDEZ FEO	PQ. SANTO DOMINGO	UNIDAD EDUCATIVA NACIONAL JOSE FELIX RIBAS NER 131 RIO FRIO	714	2	20	593	367	573	0	5	1	0	200	593
EDO. TACHIRA	MP. FERNANDEZ FEO	PQ. SANTO DOMINGO	EXTENSION DEL LICEO NACIONAL SEMINARISTA FREDDY WILSON ACEVEDO PEREZ	185	1	3	161	85	158	0	2	0	0	71	161
EDO. TACHIRA	MP. FERNANDEZ FEO	PQ. SANTO DOMINGO	ESCUELA BASICA UNITARIA 864 SANTO DOMINGO	670	2	12	494	311	482	1	4	0	0	166	494
EDO. TACHIRA	MP. FERNANDEZ FEO	PQ. SANTO DOMINGO	ESCUELA BOLIVARIANA CÉSAR DARIO GONZALEZ	194	1	1	172	112	171	0	1	0	0	58	172
EDO. TACHIRA	MP. FERNANDEZ FEO	PQ. ALBERTO ADRIANI	UNIDAD EDUCATIVA CONCENTRADA RENACER DE LA ESPERANZA	867	2	11	747	504	736	0	1	0	0	231	747
EDO. TACHIRA	MP. FERNANDEZ FEO	PQ. ALBERTO ADRIANI	UNIDAD EDUCATIVA BOLIVARIANA LA COLORADA	289	1	3	229	180	226	1	1	0	0	44	229
EDO. TACHIRA	MP. FERNANDEZ FEO	PQ. ALBERTO ADRIANI	UNIDAD EDUCATIVA BOLIVARIANA CONCENTRADA 1043 SIN NUMERO JOSE ANGEL MORALES	790	2	11	596	358	585	1	4	2	0	220	596
EDO. TACHIRA	MP. FERNANDEZ FEO	PQ. ALBERTO ADRIANI	UNIDAD EDUCATIVA NACIONAL BRISAS DE TETEO 2	381	1	7	335	233	328	0	1	0	0	94	335
EDO. TACHIRA	MP. FERNANDEZ FEO	PQ. ALBERTO ADRIANI	UNIDAD EDUCATIVA CONCENTRADA 127 342 408 SIN NUMERO LA REFORMA	326	1	4	261	80	257	0	0	0	0	177	261
EDO. TACHIRA	MP. FERNANDEZ FEO	PQ. ALBERTO ADRIANI	UNIDAD EDUCATIVA BOLIVARIANA CUITE	671	2	3	540	345	537	0	1	0	0	191	540
EDO. TACHIRA	MP. FERNANDEZ FEO	PQ. ALBERTO ADRIANI	ESCUELA BOLIVARIANA 27 DE FEBRERO	567	1	9	488	333	479	0	5	0	0	141	488
EDO. TACHIRA	MP. FERNANDEZ FEO	PQ. ALBERTO ADRIANI	UNIDAD EDUCATIVA ESTADAL VALLE LORENA	433	1	14	376	192	362	0	2	0	0	168	376
EDO. TACHIRA	MP. FERNANDEZ FEO	PQ. ALBERTO ADRIANI	UNIDAD EDUCATIVA BOLIVARIANA PREVOCACIONAL LOS JABILLOS	162	1	1	113	71	112	0	1	0	0	40	113
EDO. TACHIRA	MP. FERNANDEZ FEO	PQ. ALBERTO ADRIANI	UNIDAD EDUCATIVA NACIONAL JOSEFA CAMEJO	371	1	3	316	241	313	0	1	0	0	71	316
EDO. TACHIRA	MP. FERNANDEZ FEO	PQ. ALBERTO ADRIANI	UNIDAD EDUCATIVA BOLIVARIANA PUERTO TETEO	2947	6	84	2339	1240	2255	1	11	2	0	1001	2339
EDO. TACHIRA	MP. FERNANDEZ FEO	PQ. ALBERTO ADRIANI	UNIDAD EDUCATIVA NACIONAL LA MORITA	840	2	19	707	358	688	0	1	0	1	328	707
EDO. TACHIRA	MP. FERNANDEZ FEO	PQ. ALBERTO ADRIANI	UNIDAD EDUCATIVA NACIONAL IDEARIO BOLIVARIANO	242	1	3	221	187	218	0	1	0	0	30	221
EDO. TACHIRA	MP. AYACUCHO	CM. COLON	UNIDAD EDUCATIVA NACIONAL  DON CARLOS CHACON ALDEA LA ARENOSA	272	1	3	197	112	194	0	1	0	0	81	197
EDO. TACHIRA	MP. AYACUCHO	CM. COLON	ESCUELA BASICA UNITARIA NUMERO 16 NER 09 LOS VEGONES	262	1	3	199	140	196	0	1	0	0	55	199
EDO. TACHIRA	MP. AYACUCHO	CM. COLON	ESCUELA BOLIVARIANA FRANCISCO DE PAULA REINA	3391	6	55	2865	982	2810	1	13	2	0	1812	2865
EDO. TACHIRA	MP. AYACUCHO	CM. COLON	CENTRO DE EDUCACION INICIAL BOLIVARIANA SANTA EDUVIGES	776	2	14	662	237	648	0	1	0	0	410	662
EDO. TACHIRA	MP. AYACUCHO	CM. COLON	ESCUELA BOLIVARIANA NACIONAL DEBORA MEDINA VIVAS	3525	6	60	2957	1132	2897	0	9	0	0	1756	2957
EDO. TACHIRA	MP. AYACUCHO	CM. COLON	ESCUELA TECNICA   INDUSTRIAL AGROPECUARIA Y COMERCIAL TULIO FEBRES CORDERO	2558	5	38	2064	678	2026	1	6	0	0	1341	2064
EDO. TACHIRA	MP. AYACUCHO	CM. COLON	ESCUELA CONCENTREDA MIXTA BOLIVARIANA NUMERO 279 403 421 NER 069	1007	2	17	798	576	781	0	3	0	0	202	798
EDO. TACHIRA	MP. AYACUCHO	CM. COLON	UNIDAD EDUCATIVA NACIONAL BARRIO LAS FLORES	3039	6	50	2548	1207	2498	1	7	0	0	1283	2548
EDO. TACHIRA	MP. AYACUCHO	CM. COLON	ESCUELA BOLIVARIANA NACIONAL SAN VICENTE	401	1	8	346	239	338	0	4	0	0	95	346
EDO. TACHIRA	MP. AYACUCHO	CM. COLON	UNIDAD EDUCATIVA NACIONAL BOLIVARIANA JUDITH VIVAS DE SUAREZ	2106	4	63	1814	895	1751	0	5	0	1	850	1814
EDO. TACHIRA	MP. AYACUCHO	CM. COLON	UNIDAD EDUCATIVA ESTADAL ANDRES BELLO	2830	5	76	2372	777	2296	0	11	1	1	1506	2372
EDO. TACHIRA	MP. AYACUCHO	CM. COLON	INSTITUTO BOLIVARIANO DE EDUCACION ESPECIAL COLON IB.E.E. COLON	752	2	12	683	386	671	0	0	0	0	285	683
EDO. TACHIRA	MP. AYACUCHO	CM. COLON	UNIDAD EDUCATIVA NACIONAL SIMON RODRIGUEZ COLINAS DE AYACUCHO	500	1	3	440	265	437	0	3	0	0	169	440
EDO. TACHIRA	MP. AYACUCHO	CM. COLON	UNIDAD EDUCATIVA MUNICIPAL JUAN BAUTISTA GARCIA ROA	2580	5	44	2229	762	2185	1	8	0	1	1413	2229
EDO. TACHIRA	MP. AYACUCHO	CM. COLON	UNIDAD EDUCATIVA CONCENTRADA   NUMERO 13 501  EL PERONILO NER 09	150	1	2	92	46	90	0	0	0	0	44	92
EDO. TACHIRA	MP. AYACUCHO	CM. COLON	UNIDAD EDUCATIVA ESTADAL CAÑO DE GUERRA	730	2	13	609	425	596	0	1	0	0	170	609
EDO. TACHIRA	MP. AYACUCHO	CM. COLON	UNIDAD  EDUCETIVA  SAGRADO CORAZON DE JESÙS	324	1	10	287	169	277	0	0	0	0	108	287
EDO. TACHIRA	MP. AYACUCHO	CM. COLON	UNIDAD EDUCATIVA ESTADAL PROFESOR JOSE TEODOMIRO ESCALANTE	872	2	17	773	434	756	0	2	0	0	320	773
EDO. TACHIRA	MP. AYACUCHO	CM. COLON	UNIDAD EDUCTIVA COLEGIO    SUCRE	2513	5	35	2144	673	2109	1	6	0	1	1428	2144
EDO. TACHIRA	MP. AYACUCHO	CM. COLON	UNIDAD EDUCATIVA NACIONAL BOLIVARIANA BRINOLFO JAIMES TORRES	1057	2	6	923	398	917	0	2	0	0	517	923
EDO. TACHIRA	MP. AYACUCHO	CM. COLON	ESCUELA ESTADAL CONCENTRADA 62  73 261 LA SAN JUANA	991	2	24	818	419	794	0	2	0	3	370	818
EDO. TACHIRA	MP. AYACUCHO	PQ. RIVAS BERTI	ESCUELA UNITARIA BOLIVARIANA  NUMERO 267 NER 069 CAÑO ARENOSO	74	1	0	52	22	52	0	0	0	0	30	52
EDO. TACHIRA	MP. AYACUCHO	PQ. RIVAS BERTI	ESCUELA BOLIVARIANA NUMERO 175 498 1102 SIN NUMERO NUCLEO ESCOLAR RURAL 293 SAN ISIDRO	408	1	8	317	222	309	0	0	0	0	87	317
EDO. TACHIRA	MP. AYACUCHO	PQ. RIVAS BERTI	UNIDAD EDUCATIVA NACIONAL  GUARUMITO	135	1	3	115	99	112	0	3	0	0	10	115
EDO. TACHIRA	MP. AYACUCHO	PQ. RIVAS BERTI	ESCUELA BOLIVARIANA SAN FELIX	1025	2	17	805	358	788	0	3	0	0	427	805
EDO. TACHIRA	MP. AYACUCHO	PQ. RIVAS BERTI	ESCUELA NACIONAL GRADUADA PRE VOCACIONAL GUARAMITO	381	1	13	273	164	260	0	2	1	0	93	273
EDO. TACHIRA	MP. AYACUCHO	PQ. RIVAS BERTI	UNIDAD   EDUCATIVA  NACIONAL BOLIVARIANA KILOMETRO 4	444	1	9	401	308	392	0	2	0	0	82	401
EDO. TACHIRA	MP. AYACUCHO	PQ. RIVAS BERTI	ESCUELA NACIONAL CONCENTRADA NUMERO 791 SIN NUMERO NUCLEO ESCOLAR RURAL 069 MATA DE CURO	252	1	1	210	125	209	0	1	0	0	83	210
EDO. TACHIRA	MP. AYACUCHO	PQ. SAN PEDRO DEL RIO	UNIDAD EDUCATIVA CONCENTRADA 2 SIN NUMERO LA JABONOSA NER 358	186	1	2	178	138	176	0	1	0	0	37	178
EDO. TACHIRA	MP. AYACUCHO	PQ. SAN PEDRO DEL RIO	ESCUELA ESTADAL CONCENTREDA NUMERO 88 ( 122 449  589 ) NUCLEO ESCOLAR RURAL 09  LA POPA	243	1	5	173	117	168	0	4	0	0	47	173
EDO. TACHIRA	MP. AYACUCHO	PQ. SAN PEDRO DEL RIO	ESCUELA BOLIVARIANA LA LAJA	166	1	4	103	63	99	0	0	1	0	35	103
EDO. TACHIRA	MP. AYACUCHO	PQ. SAN PEDRO DEL RIO	UNIDAD EDUCATIVA BOLIVARIANA GUSTAVO NIETO	1176	2	20	955	294	935	0	2	0	0	639	955
EDO. TACHIRA	MP. AYACUCHO	PQ. SAN PEDRO DEL RIO	UNIDAD EDUCATIVA  ESTADAL   NUMERO 33   270   271 LOS PALMARES  NER 09	359	1	4	255	159	251	0	0	1	0	91	255
EDO. TACHIRA	MP. JAUREGUI	PQ. MONS. MIGUEL A SALAS	UNIDAD EDUCATIVA LA GRITA	1204	3	25	997	553	972	0	9	1	0	409	997
EDO. TACHIRA	MP. JAUREGUI	PQ. MONS. MIGUEL A SALAS	ESCUELA NACIONAL BOLIVARIANA VENEGARA	645	2	25	538	317	513	0	2	1	0	193	538
EDO. TACHIRA	MP. JAUREGUI	CM. LA GRITA	ESCUELA BOLIVARIANA EL TORNEADERO	172	1	1	153	97	152	0	0	0	0	55	153
EDO. TACHIRA	MP. JAUREGUI	CM. LA GRITA	ESCUELA BASICA MUNICIPAL UNITARIA NUMERO 10 ALTO MATEO	252	1	7	202	142	195	1	1	1	0	50	202
EDO. TACHIRA	MP. JAUREGUI	CM. LA GRITA	CENTRO DE EDUCACION INICIAL MONSEÑOR JAUREGUI MORENO	1952	4	30	1681	750	1651	0	2	0	0	899	1681
EDO. TACHIRA	MP. JAUREGUI	CM. LA GRITA	ESCUELA NACIONAL BOLIVARIANA JAUREGUI	3341	6	68	2839	1046	2771	0	15	2	3	1705	2839
EDO. TACHIRA	MP. JAUREGUI	CM. LA GRITA	ESCUELA COMBINADA NACIONAL SIN NUMERO MUNICIPAL NUMERO 3   12	230	1	4	192	113	188	0	1	0	0	74	192
EDO. TACHIRA	MP. JAUREGUI	CM. LA GRITA	ESCUELA BASICA CONCENTRADA SIN NUMERO 9	103	1	6	100	85	94	0	0	0	0	9	100
EDO. TACHIRA	MP. JAUREGUI	CM. LA GRITA	ESCUELA NACIONAL CONCENTRADA NUMERO 831	201	1	3	173	88	170	0	1	0	0	81	173
EDO. TACHIRA	MP. JAUREGUI	CM. LA GRITA	ESCUELA ESTADAL 105 NACIONAL SIN NUMERO ALTO DUQUE	284	1	7	258	199	251	0	1	0	0	51	258
EDO. TACHIRA	MP. JAUREGUI	CM. LA GRITA	CASA COMUNAL 2 DE FEBRERO	448	1	12	400	234	388	0	0	0	0	154	400
EDO. TACHIRA	MP. JAUREGUI	CM. LA GRITA	ESCUELA BOLIVARIANA SURURAL	659	2	16	575	248	559	0	0	1	1	309	575
EDO. TACHIRA	MP. JAUREGUI	CM. LA GRITA	ESCUELA BASICA CONCENTRADA CONCENTRACION 32	319	1	11	241	153	230	0	1	1	0	75	241
EDO. TACHIRA	MP. JAUREGUI	CM. LA GRITA	ESCUELA BOLIVARIANA CONCENTRADA NACIONAL SIN NUMERO LAS PORQUERAS	188	1	4	153	77	149	0	0	0	0	72	153
EDO. TACHIRA	MP. JAUREGUI	CM. LA GRITA	UNIDAD EDUCATIVA BOLIVARIANA CONCENTRADA NACIONAL 804 907 ESTADAL SIN NUMERO	862	2	14	692	320	678	0	2	1	0	355	692
EDO. TACHIRA	MP. JAUREGUI	CM. LA GRITA	INSTITUTO DE EDUCACION ESPECIAL BOLIVARIANO LA GRITA	3179	6	33	2641	888	2608	3	8	3	0	1706	2641
EDO. TACHIRA	MP. JAUREGUI	CM. LA GRITA	UNIDAD EDUCATIVA ESTADAL BOLIVARIANA AGUAS DIAS	1242	3	23	1062	594	1039	0	10	0	0	435	1062
EDO. TACHIRA	MP. JAUREGUI	CM. LA GRITA	ESCUELA MUNICIPAL NUMERO 11	490	1	18	370	186	352	0	1	0	0	165	370
EDO. TACHIRA	MP. JAUREGUI	CM. LA GRITA	ESCUELA BOLIVARIANA NACIONAL PADRE MAYA	3216	6	50	2716	850	2666	1	10	0	1	1804	2716
EDO. TACHIRA	MP. JAUREGUI	CM. LA GRITA	UNIVERSIDAD SIMON RODRIGUEZ NUCLEO LA GRITA	2076	4	24	1706	669	1682	0	6	0	0	1007	1706
EDO. TACHIRA	MP. JAUREGUI	CM. LA GRITA	ESCUELA BASICA NACIONAL 1393 MUNICIPAL 14	237	1	9	197	64	188	0	1	0	0	123	197
EDO. TACHIRA	MP. JAUREGUI	CM. LA GRITA	ESCUELA BOLIVARIANA NACIONAL SANTA ANA DEL VALLE	889	2	23	636	280	613	1	5	1	0	326	636
EDO. TACHIRA	MP. JAUREGUI	CM. LA GRITA	ESCUELA BASICA CONCENTRADA SIN NUMERO NER 599	658	2	11	520	306	509	0	4	1	0	198	520
EDO. TACHIRA	MP. JAUREGUI	CM. LA GRITA	ESCUELA CONCENTRADA NACIONAL SIN NUMERO MUNICIPAL NUMERO 13	651	2	17	534	254	517	0	4	0	0	259	534
EDO. TACHIRA	MP. JAUREGUI	CM. LA GRITA	ESCUELA BOLIVARIANA CONCENTRADA MUNICIPAL NUMERO 16 ESTADAL SIN NUMERO MESA DEL PALENQUE	117	1	1	107	77	106	0	0	0	0	29	107
EDO. TACHIRA	MP. JAUREGUI	CM. LA GRITA	ESCUELA ESTADAL NUMERO 6	115	1	3	100	54	97	0	0	0	0	43	100
EDO. TACHIRA	MP. JAUREGUI	CM. LA GRITA	UNIDAD EDUCATIVA NACIONAL GENERAL EZEQUIEL ZAMORA NER 601	949	2	12	764	380	752	1	2	2	0	367	764
EDO. TACHIRA	MP. JAUREGUI	CM. LA GRITA	ESCUELA CONCENTRADA NACIONAL 806 SIN NUMERO ESTADAL 112	850	2	10	718	426	708	0	4	0	0	278	718
EDO. TACHIRA	MP. JAUREGUI	PQ. EMILIO C. GUERRERO	GRUPO ESCOLAR ALBERTO ADRIANI	673	2	14	564	246	550	0	0	0	0	304	564
EDO. TACHIRA	MP. JAUREGUI	PQ. EMILIO C. GUERRERO	ESCUELA BOLIVARIANA NANJAR NUMERO  2	87	1	0	80	52	80	0	0	0	0	28	80
EDO. TACHIRA	MP. JAUREGUI	PQ. EMILIO C. GUERRERO	ESCUELA BÁSICA CONCENTRADA NUMERO 1 LAS PALMAS NER 599	95	1	0	61	27	61	0	0	0	0	34	61
EDO. TACHIRA	MP. JAUREGUI	PQ. EMILIO C. GUERRERO	UNIDAD EDUCATIVA SATURNO MEDINA OVALLES	673	2	15	560	328	545	0	3	0	0	214	560
EDO. TACHIRA	MP. FCO DE MIRANDA	CM. SAN JOSE DE BOLIVAR	ESCUELA BOLIVARIANA CONCENTRADA ESTADAL 507 SIN NUMERO 258	233	1	6	194	42	188	0	0	0	0	146	194
EDO. TACHIRA	MP. FCO DE MIRANDA	CM. SAN JOSE DE BOLIVAR	CASA DE LA CULTURA	619	2	4	550	231	546	0	1	0	0	314	550
EDO. TACHIRA	MP. FCO DE MIRANDA	CM. SAN JOSE DE BOLIVAR	UNIDAD EDUCATIVA ESTADAL JUAN PABLO II	433	1	1	388	122	387	0	0	0	0	265	388
EDO. TACHIRA	MP. FCO DE MIRANDA	CM. SAN JOSE DE BOLIVAR	ESCUELA BASICA BOLIVARIANA REGINA DE VELAZQUEZ	1186	2	17	971	313	954	0	4	2	0	635	971
EDO. TACHIRA	MP. FCO DE MIRANDA	CM. SAN JOSE DE BOLIVAR	ESCUELA INTEGRAL BOLIVARIANA CORONEL ANTONIO NICOLAS BRICEÑO NUCLEO ESCOLAR RURAL 07	294	1	5	239	159	234	0	0	0	0	75	239
EDO. TACHIRA	MP. FCO DE MIRANDA	CM. SAN JOSE DE BOLIVAR	UNIDAD EDUCATIVA CONCENTRADA NUMERO 845  NUCLEO ESCOLAR RURAL 258	599	1	6	507	158	501	0	3	0	0	340	507
EDO. TACHIRA	MP. FCO DE MIRANDA	CM. SAN JOSE DE BOLIVAR	ESCUELA BOLIVARIANA NACIONAL CONCENTRADA 801 SIN NUMERO NUCLEO ESCOLAR RURAL 258	253	1	0	204	69	204	0	0	0	0	135	204
EDO. TACHIRA	MP. FCO DE MIRANDA	CM. SAN JOSE DE BOLIVAR	ESCUELA BOLIVARIANA LOS PAJUILES NER 258	361	1	3	305	124	302	0	2	0	0	176	305
EDO. TACHIRA	MP. BOLIVAR	PQ. ISAIAS MEDINA ANGARIT	UNIDAD EDUCATIVA BOLIVARIANA MAESTRO LUIS BELTRAN PIETRO FIGUEROA	736	2	14	579	315	565	0	3	0	0	247	579
EDO. TACHIRA	MP. BOLIVAR	PQ. ISAIAS MEDINA ANGARIT	ESCUELA NACIONAL CONCENTRADA NUMERO 326	54	1	3	26	19	23	0	0	1	0	3	26
EDO. TACHIRA	MP. BOLIVAR	PQ. ISAIAS MEDINA ANGARIT	ESCUELA BOLIVARIANA 3 ESQUINAS	250	1	2	219	144	217	0	0	0	0	73	219
EDO. TACHIRA	MP. BOLIVAR	PQ. ISAIAS MEDINA ANGARIT	UNIDAD EDUCATIVA ESTADAL CONCENTRADA NUMERO 23 67 661 BUENA VISTA	254	1	8	182	99	174	0	3	0	0	72	182
EDO. TACHIRA	MP. BOLIVAR	PQ. JUAN VICENTE GOMEZ	ESCUELA BOLIVARIANA  SIN NUMERO NUCLEO ESCOLAR RURAL 278	510	1	17	416	184	399	0	2	0	0	213	416
EDO. TACHIRA	MP. BOLIVAR	PQ. JUAN VICENTE GOMEZ	UNIDAD EDUCATIVA LA MULERA	582	1	8	466	226	458	0	1	0	0	231	466
EDO. TACHIRA	MP. BOLIVAR	CM. SAN ANT DEL TACHIRA	UNIDAD EDUCATIVA NACIONAL BOLIVAR	191	1	1	141	67	140	0	0	0	0	73	141
EDO. TACHIRA	MP. BOLIVAR	CM. SAN ANT DEL TACHIRA	UNIDAD EDUCATIVA MUNICIPAL GRAN MARISCAL DE AYACUCHO	2281	4	16	971	318	955	0	5	0	0	632	971
EDO. TACHIRA	MP. BOLIVAR	CM. SAN ANT DEL TACHIRA	LICEO BOLIVARIANO MANUEL DIAZ RODRIGUEZ	2937	5	23	1440	511	1417	0	9	0	0	897	1440
EDO. TACHIRA	MP. BOLIVAR	CM. SAN ANT DEL TACHIRA	UNIDAD EDUCATIVA MUNICIPAL RAMONA REDONDO MUÑOZ	252	1	3	174	73	171	0	4	0	0	94	174
EDO. TACHIRA	MP. BOLIVAR	CM. SAN ANT DEL TACHIRA	ESCUELA BASICA  PROFESOR JUAN DE DIOS MUÑOZ	6999	13	83	3949	1350	3866	0	14	0	1	2501	3949
EDO. TACHIRA	MP. BOLIVAR	CM. SAN ANT DEL TACHIRA	ESCUELA BOLIVARIANA MANUEL FELIPE RUGELES	3542	7	41	2152	773	2111	1	10	1	0	1326	2152
EDO. TACHIRA	MP. BOLIVAR	CM. SAN ANT DEL TACHIRA	ESCUELA BASICA ESTADAL ANTONIO PINTO SALINAS	2687	5	44	1972	772	1928	0	4	0	1	1151	1972
EDO. TACHIRA	MP. BOLIVAR	CM. SAN ANT DEL TACHIRA	UNIDAD EDUCATIVA CRISTO REY	460	1	13	380	167	367	0	6	0	0	194	380
EDO. TACHIRA	MP. BOLIVAR	CM. SAN ANT DEL TACHIRA	UNIDAD EDUCATIVA ANTONIO MARIA PEREZ DEL REAL	2367	4	23	1277	418	1254	0	6	0	1	829	1277
EDO. TACHIRA	MP. BOLIVAR	CM. SAN ANT DEL TACHIRA	UNIDAD EDUCATIVA NACIONAL LLANO DE JORGE	1821	4	69	1419	753	1350	1	7	0	0	589	1419
EDO. TACHIRA	MP. BOLIVAR	CM. SAN ANT DEL TACHIRA	UNIDAD EDUCATIVA COLEGIO ROMULO GALLEGOS	432	1	8	326	107	318	0	1	0	1	209	326
EDO. TACHIRA	MP. BOLIVAR	CM. SAN ANT DEL TACHIRA	UNIDAD EDUCATIVA COLEGIO MI VENEZUELA	234	1	2	165	84	163	1	2	0	1	75	165
EDO. TACHIRA	MP. BOLIVAR	CM. SAN ANT DEL TACHIRA	INSTITUTO UNIVERSITARIO DE LA FRONTERA	2182	4	25	1039	328	1014	0	10	0	0	676	1039
EDO. TACHIRA	MP. BOLIVAR	CM. SAN ANT DEL TACHIRA	LICEO NACIONAL SAN ANTONIO	2569	5	42	1542	625	1500	0	8	1	0	866	1542
EDO. TACHIRA	MP. BOLIVAR	CM. SAN ANT DEL TACHIRA	ESCUELA BASICA NACIONAL BOLIVARIANA CAYETANO REDONDO	3934	7	39	2343	804	2304	0	12	1	0	1487	2343
EDO. TACHIRA	MP. BOLIVAR	CM. SAN ANT DEL TACHIRA	CENTRO DE EDUCACIÓN INICIAL GRACIELA MERCHAN DE ISEA	756	2	17	427	181	410	0	1	0	0	228	427
EDO. TACHIRA	MP. BOLIVAR	CM. SAN ANT DEL TACHIRA	UNIDAD EDUCATIVA CONCENTRADA 8434 SIN NUMERO LAS ADJUNTAS	709	2	23	552	312	529	0	4	0	0	213	552
EDO. TACHIRA	MP. BOLIVAR	CM. SAN ANT DEL TACHIRA	UNIDAD EDUCATIVA COLEGIO DIVINO NIÑO	2593	5	30	1447	510	1417	0	3	0	0	904	1447
EDO. TACHIRA	MP. BOLIVAR	CM. SAN ANT DEL TACHIRA	ESCUELA BASICA CONCENTRADA 23 23	772	2	13	492	207	479	0	0	0	1	271	492
EDO. TACHIRA	MP. BOLIVAR	CM. SAN ANT DEL TACHIRA	UNIDAD EDUCATIVA COLEGIO NAZARET	476	1	4	294	114	290	0	1	0	0	175	294
EDO. TACHIRA	MP. BOLIVAR	CM. SAN ANT DEL TACHIRA	ESCUELA BOLIVARIANA REPUBLICA DE CUBA	4151	8	56	1948	611	1892	2	7	0	1	1271	1948
EDO. TACHIRA	MP. BOLIVAR	PQ. PALOTAL	ESCUELA BASICA ESTADAL JOSE ANTONIO PAEZ	542	1	6	432	189	426	1	3	0	0	233	432
EDO. TACHIRA	MP. BOLIVAR	PQ. PALOTAL	LICEO NACIONAL MANUELITA SAENZ	395	1	7	309	177	302	0	0	0	0	125	309
EDO. TACHIRA	MP. BOLIVAR	PQ. PALOTAL	ESCUELA BOLIVARIANA EL PALOTAL	3569	7	55	2685	1152	2630	0	12	1	0	1465	2685
EDO. TACHIRA	MP. SEBORUCO	CM. SEBORUCO	UNIDAD EDUCATIVA NACIONAL RAMONA FAUSTINA ZAMBRANO DE RODRIGUEZ	522	1	3	425	248	422	0	1	0	0	173	425
EDO. TACHIRA	MP. SEBORUCO	CM. SEBORUCO	ESCUELA BASICA CONCENTRADA GUANIA	228	1	9	189	48	180	0	1	0	0	131	189
EDO. TACHIRA	MP. SEBORUCO	CM. SEBORUCO	LICEO BOLIVARIANO DOCTOR RAMON FERNANDEZ BELARDI	350	1	8	313	174	305	0	0	0	0	131	313
EDO. TACHIRA	MP. SEBORUCO	CM. SEBORUCO	UNIDAD EDUCATIVA NACIONAL  MANGARIA	304	1	10	246	115	236	0	1	0	0	120	246
EDO. TACHIRA	MP. SEBORUCO	CM. SEBORUCO	ESCUELA BASICA CONCENTRADA 110 269 517 LOS RIOS	294	1	5	251	86	246	0	0	0	0	160	251
EDO. TACHIRA	MP. SEBORUCO	CM. SEBORUCO	ESCUELA MUNICIPAL Nº 3	194	1	1	154	56	153	0	1	0	0	96	154
EDO. TACHIRA	MP. SEBORUCO	CM. SEBORUCO	UNIDAD EDUCATIVA CONCENTRADA 109 (117 497) ALTO DEL NIÑO	351	1	8	289	123	281	0	1	0	0	157	289
EDO. TACHIRA	MP. SEBORUCO	CM. SEBORUCO	UNIDAD EDUCATIVA MUNICIPAL ESTADAL SIN NUMERO  EL CERRO	306	1	5	246	102	241	0	1	0	0	138	246
EDO. TACHIRA	MP. SEBORUCO	CM. SEBORUCO	ESCUELA NACIONAL UNITARIA  942 BOLIVARIANA	258	1	6	204	134	198	0	0	0	0	64	204
EDO. TACHIRA	MP. SEBORUCO	CM. SEBORUCO	ESCUELA NACIONAL UNITARIA 554 NUCLEO ESCOLAR RURAL 202 BOLIVARIANA LAS TALAS	352	1	5	276	153	271	0	2	0	0	116	276
EDO. TACHIRA	MP. SEBORUCO	CM. SEBORUCO	UNIDAD EDUCATIVA CONCENTRADA MUNICIPAL 6 ESTADAL NACIONAL EL HATICO	561	1	8	470	299	462	0	1	0	0	162	470
EDO. TACHIRA	MP. SEBORUCO	CM. SEBORUCO	ESCUELA BASICA MUNICIPAL  09	128	1	1	114	90	113	0	0	0	0	23	114
EDO. TACHIRA	MP. SEBORUCO	CM. SEBORUCO	UNIDAD EDUCATVA  BOLIVARIANA FRANCISCO ANTONIO GUERRERO	1485	3	24	1226	508	1202	0	3	1	0	690	1226
EDO. TACHIRA	MP. SEBORUCO	CM. SEBORUCO	UNIDAD EDUCATIVA NACIONAL BOLIVARIANA  811 3204  MUNICIPAL 42 SANTA FILOMENA	807	2	20	664	398	644	0	2	0	0	244	664
EDO. TACHIRA	MP. RAFAEL URDANETA	CM. DELICIAS	ESCUELA TECNICA ROBINSONIANA ARNOLDO GABALDON	581	1	13	481	269	468	0	2	0	0	197	481
EDO. TACHIRA	MP. RAFAEL URDANETA	CM. DELICIAS	ESCUELA BOLIVARIANA LAS LAJAS	305	1	7	238	120	231	0	1	1	1	108	238
EDO. TACHIRA	MP. RAFAEL URDANETA	CM. DELICIAS	ESCUELA BASICA VILLA PAEZ	495	1	6	415	218	409	0	3	0	0	188	415
EDO. TACHIRA	MP. RAFAEL URDANETA	CM. DELICIAS	ESCUELA BOLIVARIANA ESTADAL CONCENTRADA 158 467 3197	166	1	3	151	125	148	0	0	0	0	23	151
EDO. TACHIRA	MP. RAFAEL URDANETA	CM. DELICIAS	ESCUELA ESTADAL GENERAL RAFAEL URDANETA	442	1	8	398	233	390	0	5	0	0	152	398
EDO. TACHIRA	MP. RAFAEL URDANETA	CM. DELICIAS	ESCUELA BOLIVARIANA AGUADITAS	137	1	7	123	97	116	0	0	0	0	19	123
EDO. TACHIRA	MP. RAFAEL URDANETA	CM. DELICIAS	ESCUELA ESTADAL NUMERO 311 EL TABOR
EDO. TACHIRA	MP. RAFAEL URDANETA	CM. DELICIAS	UNIDA EDUCATIVA NACIONAL BOLIVARIANA GERVACIO RUBIO	1025	2	23	787	399	764	1	5	1	2	356	787
EDO. TACHIRA	MP. RAFAEL URDANETA	CM. DELICIAS	BOLIVARIANA UNIDAD EDUCATIVA CONCENTRADA 1154 1408 3042 LA HONDA	271	1	3	218	132	215	0	0	1	0	82	218
EDO. TACHIRA	MP. RAFAEL URDANETA	CM. DELICIAS	ESCUELA BASICA ALTO VIENTO	215	1	12	165	89	153	0	0	0	0	64	165
EDO. TACHIRA	MP. RAFAEL URDANETA	CM. DELICIAS	ESCUELA ESTADAL CONCENTRADA NUMERO 125	176	1	1	158	141	157	0	0	0	0	16	158
EDO. TACHIRA	MP. RAFAEL URDANETA	CM. DELICIAS	UNIDA EDUCATIVA NACIONAL BOLIVARIANA EL REPOSO	375	1	7	288	92	281	0	1	0	0	188	288
EDO. TACHIRA	MP.PEDRO MARIA URE#A	CM. URE#A	ESCUELA TECNICA INDUSTRIAL ROBINSONIANA SIMON BOLIVAR	4280	8	77	2771	1317	2694	1	12	0	0	1364	2771
EDO. TACHIRA	MP.PEDRO MARIA URE#A	CM. URE#A	UNIDAD EDUCATIVA ESTADAL PROFESOR MAXIMILIANO ZAMBRANO DUQUE	4840	9	55	3333	1343	3278	0	11	2	0	1922	3333
EDO. TACHIRA	MP.PEDRO MARIA URE#A	CM. URE#A	UNIDAD EDUCATIVA BOLIVARIANA LA MULATA	461	1	8	287	168	279	0	0	1	0	110	287
EDO. TACHIRA	MP.PEDRO MARIA URE#A	CM. URE#A	LICEO BOLIVARIANO VICTOR MANUEL OLIVARES	2453	5	34	1560	659	1526	0	12	2	0	853	1560
EDO. TACHIRA	MP.PEDRO MARIA URE#A	CM. URE#A	ESCUELA NACIONAL BOLIVARIANA 2750  EL PALMAR	78	1	2	57	43	55	0	0	0	0	12	57
EDO. TACHIRA	MP.PEDRO MARIA URE#A	CM. URE#A	UNIDAD EDUCATIVA MUNICIPAL DOCTOR SAMUEL DARIO MALDONADO	3091	6	49	1915	827	1866	0	13	1	0	1025	1915
EDO. TACHIRA	MP.PEDRO MARIA URE#A	CM. URE#A	ESCUELA BOLIVARIANA NACIONAL LA FRONTERA	3625	7	58	2236	921	2178	0	4	2	3	1248	2236
EDO. TACHIRA	MP.PEDRO MARIA URE#A	CM. URE#A	UNIDAD EDUCATIVA GENERAL CIPRIANO CASTRO	2398	5	43	1530	768	1487	0	8	0	1	710	1530
EDO. TACHIRA	MP.PEDRO MARIA URE#A	CM. URE#A	ESCUELA NACIONAL BOLIVARIANA SIN NUMERO LAS CUMBRES	191	1	2	119	56	117	0	2	0	0	59	119
EDO. TACHIRA	MP.PEDRO MARIA URE#A	CM. URE#A	GRUPO ESCOLAR PEDRO MARIA UREÑA	4862	9	72	2849	1188	2777	0	16	1	0	1572	2849
EDO. TACHIRA	MP.PEDRO MARIA URE#A	PQ. NUEVA ARCADIA	COLEGIO PRIVADO ROMULO GALLEGOS	385	1	10	290	135	280	0	6	0	0	139	290
EDO. TACHIRA	MP.PEDRO MARIA URE#A	PQ. NUEVA ARCADIA	UNIDAD EDUCATIVA ESTADAL DOCTOR PATROCINIO PEÑUELA RUIZ	3276	6	46	2177	935	2131	0	9	0	0	1187	2177
EDO. TACHIRA	MP.PEDRO MARIA URE#A	PQ. NUEVA ARCADIA	UNIDAD GERIATRICA PEDRO MARIA UREÑA	1440	3	20	857	408	837	0	7	0	0	422	857
EDO. TACHIRA	MP.PEDRO MARIA URE#A	PQ. NUEVA ARCADIA	LICEO NACIONAL EZEQUIEL ZAMORA	1981	4	17	1072	404	1055	0	7	1	1	642	1072
EDO. TACHIRA	MP.PEDRO MARIA URE#A	PQ. NUEVA ARCADIA	UNIDAD EDUCATIVA NACIONAL ANDRES MARIA RUIZ	364	1	5	273	196	268	0	1	0	0	71	273
EDO. TACHIRA	MP. CARDENAS	PQ. AMENODORO RANGEL LAMU	UNIDAD EDUCATIVA NACIONAL LICEO LIBERTADOR	7672	14	127	6843	2511	6716	2	14	1	6	4182	6843
EDO. TACHIRA	MP. CARDENAS	PQ. AMENODORO RANGEL LAMU	ESCUELA BOLIVARIANA PALO GORDO	4234	8	62	3624	1389	3562	0	15	0	2	2156	3624
EDO. TACHIRA	MP. CARDENAS	CM. TARIBA	ESCUELA BOLIVARIANA EL SALADO NER 107	626	2	8	561	320	553	0	4	0	0	229	561
EDO. TACHIRA	MP. CARDENAS	CM. TARIBA	ESCUELA BOLIVARIANA SAN RAFAEL	3228	6	83	2769	1135	2686	0	9	1	0	1541	2769
EDO. TACHIRA	MP. CARDENAS	CM. TARIBA	ESCUELA BOLIVARIANA SIMON CANDIALES	4559	8	60	3926	1895	3866	0	16	0	2	1953	3926
EDO. TACHIRA	MP. CARDENAS	CM. TARIBA	ESCUELA BOLIVARIANA PARAMITO NUCLEO ESCOLAR RURAL 107	686	2	9	624	290	615	0	6	0	1	318	624
EDO. TACHIRA	MP. CARDENAS	CM. TARIBA	CENTRO DE EDUCACION INICIAL SIMONCITO''PENSAMIENTO BOLIVARIANO'' BARRANCAS PARTE BAJA	2821	5	59	2330	1011	2271	0	5	1	1	1253	2330
EDO. TACHIRA	MP. CARDENAS	CM. TARIBA	ESCUELA BOLIVARIANA RIBERAS DEL TORBES	903	2	28	800	403	772	0	5	0	0	364	800
EDO. TACHIRA	MP. CARDENAS	CM. TARIBA	ESCUELA ESTADAL RAFAEL ANGEL EUGENIO FUENTES	3658	7	61	3142	1139	3081	0	11	0	1	1930	3142
EDO. TACHIRA	MP. CARDENAS	CM. TARIBA	ESCUELA BOLIVARIANA GRACILIANO COLMENARES	2876	5	65	2460	834	2395	0	7	2	0	1552	2460
EDO. TACHIRA	MP. CARDENAS	CM. TARIBA	ESCUELA ESTADAL TOMAS ENRIQUE RIVERA CHAVEZ	1067	2	24	899	310	875	0	4	0	0	561	899
EDO. TACHIRA	MP. CARDENAS	CM. TARIBA	CASA PARROQUIAL ZORCA SAN ISIDRO	1216	3	21	1001	438	980	0	10	0	0	532	1001
EDO. TACHIRA	MP. CARDENAS	CM. TARIBA	CENTRO DE EDUCACIÓN INICIAL SIMONCITO BARRANCAS	1325	3	19	1188	597	1169	1	3	0	1	567	1188
EDO. TACHIRA	MP. CARDENAS	CM. TARIBA	ESCUELA BOLIVARIANA RAFAEL ALVAREZ	2730	5	38	2225	567	2187	0	5	1	0	1614	2225
EDO. TACHIRA	MP. CARDENAS	CM. TARIBA	BIBLIOTECA PUBLICA PRESBITERO JUAN BAUTISTA SOLERI	1166	2	13	963	285	950	0	0	0	1	664	963
EDO. TACHIRA	MP. CARDENAS	CM. TARIBA	UNIDAD EDUCATIVA COLEGIO VIRGEN DEL VALLE	1418	3	19	1316	375	1297	1	7	1	1	912	1316
EDO. TACHIRA	MP. CARDENAS	CM. TARIBA	LICEO NACIONAL BELEN SAN JUAN	2323	4	50	1951	907	1901	0	7	0	0	987	1951
EDO. TACHIRA	MP. CARDENAS	CM. TARIBA	LICEO BOLIVARIANO LUIS LOPEZ MENDEZ	4378	8	99	3782	1232	3683	0	10	2	0	2439	3782
EDO. TACHIRA	MP. CARDENAS	CM. TARIBA	LICEO BOLIVARIANO ANTONIO JOSE DE SUCRE	3145	6	80	2632	1059	2552	0	12	2	1	1478	2632
EDO. TACHIRA	MP. CARDENAS	CM. TARIBA	ESCUELA ESTADAL RAFAEL ANGEL MARQUEZ	524	1	14	474	178	460	0	3	0	0	279	474
EDO. TACHIRA	MP. CARDENAS	CM. TARIBA	ESCUELA BOLIVARIANA MONSEÑOR BRICEÑO PICON	3309	6	31	2867	799	2836	0	7	0	3	2027	2867
EDO. TACHIRA	MP. CARDENAS	CM. TARIBA	INSTITUTO DE EDUCACION ESPECIAL BOLIVARIANO TARIBA	716	2	6	609	150	603	0	6	1	1	445	609
EDO. TACHIRA	MP. CARDENAS	CM. TARIBA	ESCUELA BOLIVARIANA LLANITOS	2322	4	36	2012	1067	1976	1	11	0	0	897	2012
EDO. TACHIRA	MP. CARDENAS	CM. TARIBA	COLEGIO NUESTRA SEÑORA DE LA CONSOLACION DE TARIBA	4671	9	63	4034	1003	3971	0	15	0	2	2951	4034
EDO. TACHIRA	MP. CARDENAS	CM. TARIBA	ESCUELA BOLIVARIANA TUCAPE	4248	8	46	3620	1364	3574	0	9	2	0	2199	3620
EDO. TACHIRA	MP. CARDENAS	PQ. LA FLORIDA	ESCUELA BOLIVARIANA URIBANTE	573	1	6	468	261	462	0	0	0	0	201	468
EDO. TACHIRA	MP. CARDENAS	PQ. LA FLORIDA	ESCUELA MUNICIPAL NUMERO 5 ESTADAL 635	131	1	4	101	67	97	0	0	0	0	30	101
EDO. TACHIRA	MP. CARDENAS	PQ. LA FLORIDA	ESCUELA ESTADAL UNITARIA NUMERO 560 SAN CAYETANO NUCLEO ESCOLAR RURAL 524	78	1	2	64	50	62	0	0	0	0	12	64
EDO. TACHIRA	MP. CARDENAS	PQ. LA FLORIDA	ESCUELA COCENTRADA MIXTA NACIONAL SIN NUMERO ESTADAL 294 MUNICIPAL 5	123	1	0	94	57	94	0	0	0	0	37	94
EDO. TACHIRA	MP. CARDENAS	PQ. LA FLORIDA	UNIDAD EDUCATIVA BOLIVARIANA POTOSI NUCLEO ESCOLAR RURAL 524	324	1	8	270	155	262	0	0	0	0	107	270
EDO. TACHIRA	MP. CARDENAS	PQ. LA FLORIDA	ESCUELA CONCENTRADA NUMERO 6 ESTADAL 297 380 LA ARENOSA NUCLEO ESCOLAR RURAL 524	183	1	1	150	129	149	0	0	0	0	20	150
EDO. TACHIRA	MP. CARDENAS	PQ. LA FLORIDA	ESCUELA CONCENTRADA MIXTA NACIONAL NUMERO 2635	61	1	2	51	22	49	1	0	0	0	26	51
EDO. TACHIRA	MP. CARDENAS	PQ. LA FLORIDA	ESCUELA MUNICIPAL NUMERO 3  CAÑO HONDO NUCLEO ESCOLAR RURAL 524	45	1	2	40	31	38	0	0	0	0	7	40
EDO. TACHIRA	MP. CARDENAS	PQ. LA FLORIDA	ESCUELA CONCENTRADA ESTADAL NUMERO 250 NUCLEO ESCOLAR RURAL 524	63	1	0	47	34	47	0	0	0	0	13	47
