EDO. PORTUGUESA	MP. GUANARITO	PQ. DIVINA PASTORA	10	3600	107	11	2029	2	2834	25	1	2941	3820	2941	0	777
EDO. PORTUGUESA	MP. GUANARITO	CM. GUANARITO	42	19134	370	42	10274	6	15168	56	29	15538	19134	15538	1	4802
EDO. PORTUGUESA	MP. GUANARITO	PQ.TRINIDAD DE LA CAPILLA	6	1913	23	8	1229	1	1428	4	4	1451	2534	1451	2	188
EDO. PORTUGUESA	MP. OSPINO	PQ. APARICION	18	6424	112	18	4007	2	5067	29	6	5179	6424	5179	1	1022
EDO. PORTUGUESA	MP. OSPINO	CM. OSPINO	44	18245	320	44	10100	6	14529	104	13	14849	18245	14849	5	4301
EDO. PORTUGUESA	MP. OSPINO	PQ. LA ESTACION	29	7094	118	29	4252	2	5053	41	7	5171	7094	5171	0	751
EDO. PORTUGUESA	MP.GENARO BOCONOITO	PQ. ANTOLIN TOVAR AQUINO	16	5964	115	16	4134	3	4878	22	5	4993	5964	4993	0	714
EDO. PORTUGUESA	MP.GENARO BOCONOITO	CM. BOCONOITO	20	10366	172	20	6805	1	8332	53	4	8504	10366	8504	1	1468
EDO. PORTUGUESA	MP.S RAFAEL DE ONOTO	CM. SAN RAFAEL DE ONOTO	21	9679	185	21	5627	1	7882	56	3	8067	9679	8067	2	2193
EDO. PORTUGUESA	MP.S RAFAEL DE ONOTO	PQ. SANTA FE	2	966	12	2	652	1	837	1	2	849	966	849	0	181
EDO. PORTUGUESA	MP.S RAFAEL DE ONOTO	PQ. THERMO MORLES	4	1624	26	4	975	0	1270	12	0	1296	1624	1296	0	283
EDO. PORTUGUESA	CE. GUANARE	CM. GUANARE	216	102759	2065	220	53748	40	83531	545	61	85596	104179	85596	26	29111
EDO. PORTUGUESA	CE. GUANARE	PQ. CORDOBA	2	387	4	7	262	0	288	2	0	292	1963	292	0	24
EDO. PORTUGUESA	CE. GUANARE	PQ. VIRGEN DE LA COROMOTO	15	6329	168	16	4005	1	5072	39	5	5240	6387	5240	1	1021
EDO. PORTUGUESA	CE. GUANARE	PQ.SAN JUAN GUANAGUANARE	23	9330	162	23	5274	3	7610	51	11	7772	9330	7772	3	2268
EDO. PORTUGUESA	CE. GUANARE	PQ.SAN JOSE DE LA MONTA#A	1	371	4	4	182	0	233	1	0	237	1414	237	0	50
EDO. PORTUGUESA	MP. ESTELLER	PQ. UVERAL	15	4494	73	16	3005	4	3539	29	6	3612	4698	3612	1	494
EDO. PORTUGUESA	MP. ESTELLER	CM. PIRITU	55	24354	435	55	15170	10	19722	138	16	20157	24354	20157	6	4382
EDO. PORTUGUESA	MP. SANTA ROSALIA	PQ. FLORIDA	3	1413	19	7	888	1	1069	9	0	1088	2669	1088	0	171
EDO. PORTUGUESA	MP. SANTA ROSALIA	CM. EL PLAYON	17	6919	93	23	4459	4	5579	26	2	5672	9463	5672	0	1088
EDO. PORTUGUESA	MP. TUREN	PQ. SAN ISIDRO LABRADOR	9	3735	35	9	2143	0	2913	18	2	2948	3735	2948	2	748
EDO. PORTUGUESA	MP. TUREN	CM. VILLA BRUZUAL	60	29083	422	61	16507	5	23322	157	13	23744	29626	23744	8	6632
EDO. PORTUGUESA	MP. TUREN	PQ. CANELONES	13	5668	97	13	3942	1	4676	26	5	4773	5668	4773	0	702
EDO. PORTUGUESA	MP. TUREN	PQ. SANTA CRUZ	9	3351	69	9	2100	2	2493	19	10	2562	3351	2562	1	361
EDO. PORTUGUESA	MP. PAPELON	CM. PAPELON	9	4542	83	10	1958	2	3604	21	3	3687	4841	3687	0	1620
EDO. PORTUGUESA	MP. PAPELON	PQ. CA#O DELGADITO	16	5266	97	20	3435	4	4113	23	7	4210	6561	4210	1	643
EDO. PORTUGUESA	MP. AGUA BLANCA	CM. AGUA BLANCA	32	14214	285	32	9578	6	11920	53	11	12205	14214	12205	5	2267
EDO. PORTUGUESA	MP. ARAURE	CM. ARAURE	167	79570	1335	167	45209	28	66343	330	40	67678	79570	67678	37	20699
EDO. PORTUGUESA	MP. ARAURE	PQ. RIO ACARIGUA	17	7679	104	18	5270	4	6127	28	10	6231	8220	6231	1	814
EDO. PORTUGUESA	MP. SUCRE	PQ. SAN JOSE DE SAGUAZ	5	1441	29	5	865	0	1146	7	2	1175	1441	1175	0	272
EDO. PORTUGUESA	MP. SUCRE	PQ.SAN RAFAEL PALO ALZADO	7	2456	40	7	1374	0	1909	6	2	1949	2456	1949	0	527
EDO. PORTUGUESA	MP. SUCRE	CM. BISCUCUY	31	14027	345	35	6731	4	11271	64	6	11616	16185	11616	3	4463
EDO. PORTUGUESA	MP. SUCRE	PQ. UVENCIO A VELASQUEZ	11	4550	67	11	2403	1	3468	16	4	3535	4550	3535	0	1044
EDO. PORTUGUESA	MP. SUCRE	PQ. CONCEPCION	8	2901	53	8	1688	1	2161	8	1	2214	2901	2214	0	463
EDO. PORTUGUESA	MP. SUCRE	PQ. VILLA ROSA	12	4320	54	12	2499	1	3452	18	6	3506	4320	3506	3	925
EDO. PORTUGUESA	MP. M.JOSE V DE UNDA	PQ. PE#A BLANCA	6	2104	32	7	1271	1	1584	14	1	1616	2527	1616	0	297
EDO. PORTUGUESA	MP. M.JOSE V DE UNDA	CM. CHABASQUEN	31	11459	224	38	6353	3	8525	62	6	8749	14266	8749	2	2099
EDO. PORTUGUESA	MP. PAEZ	PQ. PIMPINELA	9	3670	61	9	2645	3	2948	13	5	3009	3670	3009	1	281
EDO. PORTUGUESA	MP. PAEZ	CM. ACARIGUA	211	108025	1884	212	59290	32	87810	542	44	89694	108550	89694	55	27847
EDO. PORTUGUESA	MP. PAEZ	PQ. PAYARA	15	6874	89	15	4769	5	5381	26	3	5470	6874	5470	3	575
EDO. PORTUGUESA	MP. PAEZ	PQ. RAMON PERAZA	9	3756	100	9	2435	0	2999	20	3	3099	3756	3099	0	541
EDO. SUCRE	MP. ANDRES E BLANCO	PQ. ROMULO GALLEGOS	13	5336	65	15	2151	2	3620	12	2	3685	5972	3685	1	1452
EDO. SUCRE	MP. ANDRES E BLANCO	PQ. MARI#O	28	12925	163	29	5238	5	9480	53	5	9643	13230	9643	2	4177
EDO. SUCRE	MP. MARI#O	PQ. MARABAL	4	1703	15	4	889	0	1197	6	3	1212	1703	1212	0	299
EDO. SUCRE	MP. MARI#O	PQ. SORO	3	1501	12	3	668	0	972	3	0	984	1501	984	0	301
EDO. SUCRE	MP. MARI#O	PQ. IRAPA	19	8429	95	19	3516	1	5825	18	0	5920	8429	5920	1	2289
EDO. SUCRE	MP. MARI#O	PQ. CAMPO CLARO	8	3160	61	8	1398	0	2107	4	1	2168	3160	2168	1	703
EDO. SUCRE	MP. MARI#O	PQ. SAN ANTONIO DE IRAPA	4	1758	20	4	736	0	1123	3	0	1143	1758	1143	0	384
EDO. SUCRE	MP. ARISMENDI	PQ. ANTONIO JOSE DE SUCRE	7	2046	30	10	864	0	1249	5	1	1279	2178	1279	0	379
EDO. SUCRE	MP. ARISMENDI	PQ. EL MORRO DE PTO SANTO	11	5653	57	11	2873	2	4225	10	1	4282	5653	4282	3	1336
EDO. SUCRE	MP. ARISMENDI	PQ. PUERTO SANTO	10	4183	53	10	1898	1	3059	9	0	3112	4183	3112	0	1151
EDO. SUCRE	MP. ARISMENDI	PQ. RIO CARIBE	47	17846	182	49	8475	2	13106	41	3	13288	18521	13288	1	4584
EDO. SUCRE	MP. ARISMENDI	PQ. SAN JUAN GALDONAS	9	3015	36	11	1448	1	2029	11	1	2065	3370	2065	0	568
EDO. SUCRE	MP. ANDRES MATA	PQ. TAVERA ACOSTA	20	6508	57	21	3203	1	4584	18	2	4641	7070	4641	1	1359
EDO. SUCRE	MP. ANDRES MATA	PQ. SAN JOSE DE AREOCUAR	29	9502	141	29	4564	0	7253	11	2	7394	9502	7394	4	2672
EDO. SUCRE	MP. BERMUDEZ	PQ. SANTA TERESA	8	4021	34	8	1656	0	3237	13	2	3271	4021	3271	0	1566
EDO. SUCRE	MP. BERMUDEZ	PQ. BOLIVAR	45	21336	287	46	11163	3	16651	76	10	16938	21862	16938	2	5397
EDO. SUCRE	MP. BERMUDEZ	PQ. MACARAPANA	10	4288	55	10	1972	0	3349	15	0	3404	4288	3404	0	1362
EDO. SUCRE	MP. BERMUDEZ	PQ. SANTA CATALINA	86	43853	550	87	20260	7	34097	162	27	34647	44328	34647	15	13626
EDO. SUCRE	MP. BERMUDEZ	PQ. SANTA ROSA	45	21004	277	47	9061	4	16363	58	10	16640	22126	16640	7	7223
EDO. SUCRE	MP. CAJIGAL	PQ. PAUJIL	9	2756	42	9	1313	0	1908	7	0	1950	2756	1950	0	588
EDO. SUCRE	MP. CAJIGAL	PQ. LIBERTAD	14	3978	57	15	2047	0	2687	15	1	2744	4167	2744	1	623
EDO. SUCRE	MP. CAJIGAL	PQ. YAGUARAPARO	23	8225	117	23	4255	1	5980	17	0	6097	8225	6097	1	1706
EDO. SUCRE	MP. CRUZ S ACOSTA	PQ. ARAYA	28	13685	199	28	6782	2	10390	44	8	10589	13685	10589	1	3553
EDO. SUCRE	MP. CRUZ S ACOSTA	PQ. MANICUARE	14	5591	65	14	2994	1	4488	21	0	4553	5591	4553	1	1471
EDO. SUCRE	MP. CRUZ S ACOSTA	PQ. CHACOPATA	11	5397	65	11	2750	0	4105	13	4	4170	5397	4170	0	1338
EDO. SUCRE	MP. BOLIVAR	CM. MARIGUITAR	36	15272	221	36	6355	1	11653	57	4	11874	15272	11874	1	5235
EDO. SUCRE	MP. BENITEZ	PQ. EL RINCON	5	2651	30	5	1162	0	1941	12	2	1971	2651	1971	0	765
EDO. SUCRE	MP. BENITEZ	PQ. UNION	5	1569	11	6	795	0	1064	1	0	1075	2105	1075	0	268
EDO. SUCRE	MP. BENITEZ	PQ. GRAL FCO. A VASQUEZ	3	1569	17	3	722	0	1175	2	0	1192	1569	1192	0	451
EDO. SUCRE	MP. BENITEZ	PQ. GUARAUNOS	2	987	11	3	403	0	732	3	0	743	1458	743	0	326
EDO. SUCRE	MP. BENITEZ	PQ. TUNAPUICITO	7	1932	21	7	1115	1	1421	1	2	1442	1932	1442	0	302
EDO. SUCRE	MP. BENITEZ	PQ. EL PILAR	38	13130	127	39	6538	3	9549	35	5	9676	13573	9676	2	2966
EDO. SUCRE	MP. RIBERO	PQ. CATUARO	17	6292	65	18	2707	1	3951	10	3	4016	6430	4016	2	1228
EDO. SUCRE	MP. RIBERO	PQ. RENDON	11	3803	34	11	1675	0	2497	14	2	2531	3803	2531	0	806
EDO. SUCRE	MP. RIBERO	PQ. CARIACO	47	21781	269	47	10744	3	16127	66	7	16396	21781	16396	1	5306
EDO. SUCRE	MP. RIBERO	PQ. SANTA CRUZ	5	1738	29	5	820	0	1124	2	1	1153	1738	1153	0	301
EDO. SUCRE	MP. RIBERO	PQ. SANTA MARIA	14	5037	58	14	2315	1	3222	17	3	3280	5037	3280	2	884
EDO. SUCRE	CE. SUCRE	PQ.GRAN MARISCAL	14	5770	90	14	2523	2	4260	19	5	4350	5770	4350	5	1706
EDO. SUCRE	CE. SUCRE	PQ. SANTA INES	97	49811	706	101	19997	9	37950	216	14	38656	52040	38656	12	17702
EDO. SUCRE	CE. SUCRE	PQ. RAUL LEONI	21	9922	147	21	4307	2	6714	45	4	6861	9922	6861	3	2353
EDO. SUCRE	CE. SUCRE	PQ. SAN JUAN	22	9508	125	23	4588	3	6757	42	6	6882	9844	6882	4	2114
EDO. SUCRE	CE. SUCRE	PQ. VALENTIN VALIENTE	75	38184	500	75	14421	10	30704	134	9	31204	38184	31204	11	16119
EDO. SUCRE	CE. SUCRE	PQ. AYACUCHO	72	35243	430	72	14423	14	26924	134	12	27354	35243	27354	10	12331
EDO. SUCRE	CE. SUCRE	PQ. ALTAGRACIA	171	88659	1090	173	38915	21	69710	376	44	70800	89753	70800	28	30326
EDO. SUCRE	MP. MONTES	PQ. ARENAS	11	4819	54	11	2510	2	3516	23	0	3570	4819	3570	0	981
EDO. SUCRE	MP. MONTES	PQ. COCOLLAR	10	3423	27	12	1356	2	2375	2	1	2402	4457	2402	0	1014
EDO. SUCRE	MP. MONTES	PQ. SAN LORENZO	11	4687	58	11	1861	2	3124	12	1	3182	4687	3182	0	1248
EDO. SUCRE	MP. MONTES	PQ. SAN FERNANDO	12	4961	44	12	2577	1	3468	5	3	3512	4961	3512	0	882
EDO. SUCRE	MP. MONTES	PQ. CUMANACOA	32	15397	166	33	7536	3	11415	48	6	11581	15440	11581	4	3818
EDO. SUCRE	MP. MONTES	PQ. ARICAGUA	14	5653	62	14	2369	1	3871	21	5	3933	5653	3933	1	1474
EDO. SUCRE	MP. LIBERTADOR	PQ. TUNAPUY	17	7128	125	17	3434	2	5351	16	2	5476	7128	5476	3	1894
EDO. SUCRE	MP. LIBERTADOR	PQ. CAMPO ELIAS	4	1037	10	4	546	0	701	3	0	711	1037	711	0	152
EDO. SUCRE	MP. MEJIA	CM. SAN ANT DEL GOLFO	28	11394	132	29	5120	2	8514	31	5	8646	11813	8646	1	3355
EDO. SUCRE	MP. VALDEZ	PQ. CRISTOBAL COLON	4	1246	15	4	692	0	812	4	0	827	1246	827	0	116
EDO. SUCRE	MP. VALDEZ	PQ. PUNTA DE PIEDRA	10	3481	32	10	1623	0	2422	3	2	2454	3481	2454	0	794
EDO. SUCRE	MP. VALDEZ	PQ. BIDEAU	5	1669	19	5	930	0	1108	6	0	1127	1669	1127	0	172
EDO. SUCRE	MP. VALDEZ	PQ. GUIRIA	42	20450	277	42	10639	2	14522	47	7	14799	20450	14799	5	3822
EDO. MERIDA	CE. LIBERTADOR	PQ. ARIAS	25	12183	214	25	4250	3	10142	39	3	10356	12183	10356	8	5839
EDO. MERIDA	CE. LIBERTADOR	PQ. EL MORRO	5	1299	19	6	673	0	1024	2	0	1043	1402	1043	0	349
EDO. MERIDA	CE. LIBERTADOR	PQ. CARACCIOLO PARRA P	21	10957	101	21	2002	2	9420	17	4	9521	10957	9521	7	7388
EDO. MERIDA	CE. LIBERTADOR	PQ. LOS NEVADOS	2	619	15	2	350	0	461	0	0	476	619	476	0	111
EDO. MERIDA	CE. LIBERTADOR	PQ. GONZALO PICON FEBRES	10	4913	89	10	1864	4	4093	14	2	4182	4913	4182	0	2209
EDO. MERIDA	CE. LIBERTADOR	PQ. MILLA	33	17122	238	34	4996	10	14148	60	3	14386	17605	14386	10	9069
EDO. MERIDA	CE. LIBERTADOR	PQ. MARIANO PICON SALAS	18	9753	119	20	2389	6	8317	25	1	8436	10698	8436	2	5894
EDO. MERIDA	CE. LIBERTADOR	PQ. EL LLANO	22	11325	113	22	2315	1	9385	30	4	9498	11325	9498	5	7030
EDO. MERIDA	CE. LIBERTADOR	PQ. DOMINGO PE#A	38	19271	238	38	5925	5	16482	56	4	16720	19271	16720	10	10482
EDO. MERIDA	CE. LIBERTADOR	PQ. JACINTO PLAZA	33	17450	295	34	7683	6	14318	65	11	14613	18004	14613	3	6550
EDO. MERIDA	CE. LIBERTADOR	PQ. ANTONIO SPINETTI DINI	37	20205	253	37	5929	4	16943	42	5	17196	20205	17196	11	10952
EDO. MERIDA	CE. LIBERTADOR	PQ. JUAN RODRIGUEZ SUAREZ	27	13718	127	27	2317	4	11806	25	5	11933	13718	11933	6	9449
EDO. MERIDA	CE. LIBERTADOR	PQ. OSUNA RODRIGUEZ	24	11954	188	24	4720	2	10060	30	6	10248	11954	10248	1	5301
EDO. MERIDA	CE. LIBERTADOR	PQ. LASSO DE LA VEGA	16	8572	116	16	2438	1	7248	22	2	7364	8572	7364	5	4780
EDO. MERIDA	CE. LIBERTADOR	PQ. SAGRARIO	10	5211	73	10	1215	0	4182	12	2	4255	5211	4255	5	2948
EDO. MERIDA	MP. PUEBLO LLANO	CM. PUEBLO LLANO	15	7149	113	15	3017	1	5849	13	1	5962	7149	5962	0	2817
EDO. MERIDA	MP.OB. RAMOS DE LORA	PQ. PQ R DE ALCAZAR	9	3871	51	9	1801	0	2945	7	1	2996	3871	2996	0	1136
EDO. MERIDA	MP.OB. RAMOS DE LORA	CM. STA ELENA DE ARENALES	22	9459	117	22	4453	0	7624	31	3	7741	9459	7741	3	3134
EDO. MERIDA	MP.OB. RAMOS DE LORA	PQ. ELOY PAREDES	14	5174	49	14	2522	0	4167	24	2	4216	5174	4216	1	1618
EDO. MERIDA	MP. SUCRE	PQ. CHIGUARA	14	5790	120	14	2510	1	4576	11	3	4696	5790	4696	1	2050
EDO. MERIDA	MP. SUCRE	PQ. PUEBLO NUEVO DEL SUR	7	2114	18	10	1023	0	1546	6	2	1564	3093	1564	2	513
EDO. MERIDA	MP. SUCRE	CM. LAGUNILLAS	30	14013	225	30	6364	4	11251	51	3	11476	14013	11476	5	4824
EDO. MERIDA	MP. SUCRE	PQ. ESTANQUES	8	2700	38	10	1268	2	2058	9	0	2096	3137	2096	0	779
EDO. MERIDA	MP. SUCRE	PQ. LA TRAMPA	6	1720	25	6	844	0	1227	7	4	1252	1720	1252	0	372
EDO. MERIDA	MP. SUCRE	PQ. SAN JUAN	16	7407	138	17	3434	0	5890	31	2	6028	7945	6028	1	2422
EDO. MERIDA	MP. MIRANDA	PQ. PI#ANGO	4	1082	14	4	544	1	906	3	0	920	1082	920	1	357
EDO. MERIDA	MP. MIRANDA	PQ. LA VENTA	3	1257	25	3	425	0	1008	8	0	1033	1257	1033	0	575
EDO. MERIDA	MP. MIRANDA	PQ. ANDRES ELOY BLANCO	3	1594	33	3	554	0	1209	10	1	1242	1594	1242	1	643
EDO. MERIDA	MP. MIRANDA	CM. CHACHOPO	25	10950	238	26	4626	3	9056	30	7	9294	11454	9294	3	4387
EDO. MERIDA	MP.JULIO CESAR SALAS	PQ. PALMIRA	5	1919	12	5	953	0	1534	5	0	1546	1919	1546	0	576
EDO. MERIDA	MP.JULIO CESAR SALAS	CM. ARAPUEY	21	8025	138	21	3969	2	6013	19	1	6151	8025	6151	0	2022
EDO. MERIDA	MP. SANTOS MARQUINA	CM. TABAY	25	12001	219	25	5205	6	10022	32	10	10241	12001	10241	6	4763
EDO. MERIDA	MP. JUSTO BRICE#O	CM. TORONDOY	11	3701	49	11	1840	0	2865	10	2	2914	3701	2914	1	1012
EDO. MERIDA	MP. JUSTO BRICE#O	PQ. SAN CRISTOBAL DE T	3	1311	21	3	645	1	1061	0	0	1082	1311	1082	0	415
EDO. MERIDA	MP. CAMPO ELIAS	PQ. MONTALBAN	38	19786	272	38	7320	3	16668	40	2	16940	19786	16940	4	9299
EDO. MERIDA	MP. CAMPO ELIAS	PQ. MATRIZ	54	28796	460	55	11910	9	23743	104	10	24203	29293	24203	15	11695
EDO. MERIDA	MP. CAMPO ELIAS	PQ. SAN JOSE	3	901	12	3	329	0	646	1	0	658	901	658	0	316
EDO. MERIDA	MP. CAMPO ELIAS	PQ. LA MESA	7	3431	61	7	1529	1	2663	5	0	2724	3431	2724	0	1128
EDO. MERIDA	MP. CAMPO ELIAS	PQ. FERNANDEZ PE#A	17	8182	173	18	3050	1	6860	20	4	7033	8727	7033	8	3777
EDO. MERIDA	MP. CAMPO ELIAS	PQ. ACEQUIAS	2	640	6	2	292	0	440	4	0	446	640	446	0	144
EDO. MERIDA	MP. CAMPO ELIAS	PQ. JAJI	7	2505	34	7	1086	2	2019	3	1	2053	2505	2053	0	927
EDO. MERIDA	MP. ARICAGUA	PQ. SAN ANTONIO	2	922	7	2	335	0	664	1	1	671	922	671	0	327
EDO. MERIDA	MP. ARICAGUA	CM. ARICAGUA	7	2902	37	7	950	0	2283	6	1	2320	2902	2320	0	1326
EDO. MERIDA	MP. ARZOBISPO CHACON	PQ. EL MOLINO	3	1264	21	3	486	0	983	3	0	1004	1264	1004	0	494
EDO. MERIDA	MP. ARZOBISPO CHACON	CM. CANAGUA	6	2555	44	6	1106	2	2064	5	1	2108	2555	2108	0	950
EDO. MERIDA	MP. ARZOBISPO CHACON	PQ. CHACANTA	5	1404	7	5	721	0	1063	5	1	1070	1404	1070	1	335
EDO. MERIDA	MP. ARZOBISPO CHACON	PQ. GUAIMARAL	1	335	1	3	105	0	227	1	0	228	662	228	0	121
EDO. MERIDA	MP. ARZOBISPO CHACON	PQ. MUCUTUY	7	2017	56	7	722	0	1423	5	1	1479	2017	1479	1	694
EDO. MERIDA	MP. ARZOBISPO CHACON	PQ. CAPURI	2	596	5	2	290	0	438	0	0	443	596	443	0	148
EDO. MERIDA	MP. ARZOBISPO CHACON	PQ. MUCUCHACHI	3	1155	10	7	529	0	863	2	0	873	1503	873	0	332
EDO. MERIDA	MP. RANGEL	PQ. CACUTE	2	1044	37	2	482	0	842	3	0	879	1044	879	0	357
EDO. MERIDA	MP. RANGEL	PQ. LA TOMA	3	1346	56	3	635	0	1100	2	0	1156	1346	1156	1	462
EDO. MERIDA	MP. RANGEL	CM. MUCUCHIES	10	5240	104	10	2131	3	4497	10	0	4601	5240	4601	0	2353
EDO. MERIDA	MP. RANGEL	PQ. SAN RAFAEL	6	2704	79	6	1104	0	2199	17	3	2278	2704	2278	0	1075
EDO. MERIDA	MP. RANGEL	PQ. MUCURUBA	6	2510	46	6	1052	1	2081	10	1	2127	2510	2127	1	1016
EDO. MERIDA	MP. PADRE NOGUERA	CM. STA MARIA DE CAPARO	5	2531	32	5	1054	0	2074	15	1	2106	2531	2106	0	1004
EDO. MERIDA	MP. GUARAQUE	PQ. MESA DE QUINTERO	2	890	8	2	438	0	683	0	0	691	890	691	0	245
EDO. MERIDA	MP. GUARAQUE	CM. GUARAQUE	6	2907	42	8	1382	1	2154	2	0	2196	3805	2196	0	769
EDO. MERIDA	MP. GUARAQUE	PQ. RIO NEGRO	6	2682	30	6	1018	0	2106	0	1	2136	2682	2136	0	1087
EDO. MERIDA	MP. TULIO F CORDERO	CM. NUEVA BOLIVIA	21	10082	164	21	4908	4	8208	41	4	8372	10082	8372	3	3248
EDO. MERIDA	MP. TULIO F CORDERO	PQ. MARIA C PALACIOS	10	2864	72	10	1658	0	2212	7	1	2284	2864	2284	0	546
EDO. MERIDA	MP. TULIO F CORDERO	PQ. SANTA APOLONIA	6	2233	28	6	1002	0	1710	4	1	1738	2233	1738	1	702
EDO. MERIDA	MP. TULIO F CORDERO	PQ. INDEPENDENCIA	13	5484	108	13	3163	0	4329	19	2	4437	5484	4437	0	1145
EDO. MERIDA	MP. ANTONIO PINTO S.	PQ. MESA DE LAS PALMAS	6	1847	32	6	974	0	1535	0	0	1567	1847	1567	1	560
EDO. MERIDA	MP. ANTONIO PINTO S.	PQ. MESA BOLIVAR	8	3538	64	8	1665	0	2795	10	0	2859	3538	2859	1	1119
EDO. MERIDA	MP. ANTONIO PINTO S.	CM. STA CRUZ DE MORA	26	12742	180	27	5270	1	10450	38	3	10630	13242	10630	0	5138
EDO. MERIDA	MP. ANDRES BELLO	CM. LA AZULITA	26	9652	145	27	4785	0	7828	26	0	7973	9909	7973	3	3014
EDO. MERIDA	MP. TOVAR	PQ. EL LLANO	12	6387	66	14	2133	3	5396	15	1	5462	7417	5462	1	3243
EDO. MERIDA	MP. TOVAR	PQ. SAN FRANCISCO	5	1833	13	5	866	0	1549	2	0	1562	1833	1562	1	680
EDO. MERIDA	MP. TOVAR	PQ. EL AMPARO	4	1600	29	4	749	0	1266	3	0	1295	1600	1295	0	514
EDO. MERIDA	MP. TOVAR	PQ. TOVAR	33	16512	240	33	6313	0	13518	44	6	13758	16512	13758	3	7152
EDO. MERIDA	MP. CARACCIOLO PARRA	CM. TUCANI	27	11866	272	27	5122	3	9108	33	7	9380	11866	9380	1	3942
EDO. MERIDA	MP. CARACCIOLO PARRA	PQ. FLORENCIO RAMIREZ	8	4123	58	8	2143	0	3178	10	1	3236	4123	3236	1	1023
EDO. MERIDA	MP. ZEA	CM. ZEA	14	5849	56	14	2133	1	4886	16	3	4942	5849	4942	3	2730
EDO. MERIDA	MP. ZEA	PQ. CA#O EL TIGRE	3	1574	22	4	780	0	1292	6	1	1314	2152	1314	0	505
EDO. MERIDA	MP.CARDENAL QUINTERO	CM. SANTO DOMINGO	8	3839	102	8	1789	0	3143	9	1	3245	3839	3245	0	1344
EDO. MERIDA	MP.CARDENAL QUINTERO	PQ. LAS PIEDRAS	9	3112	50	9	1713	0	2490	11	1	2540	3112	2540	1	764
EDO. MERIDA	MP. RIVAS DAVILA	CM. BAILADORES	25	11006	181	25	4606	2	8995	35	2	9176	11006	9176	5	4345
EDO. MERIDA	MP. RIVAS DAVILA	PQ. GERONIMO MALDONADO	5	2665	28	5	1042	0	2229	9	0	2257	2665	2257	1	1177
EDO. MERIDA	MP. ALBERTO ADRIANI	PQ. PRESIDENTE PAEZ	51	23796	381	51	9869	8	19149	87	10	19530	23796	19530	4	9171
EDO. MERIDA	MP. ALBERTO ADRIANI	PQ. PTE. ROMULO GALLEGOS	34	17316	257	34	7277	6	14145	52	7	14402	17316	14402	2	6801
EDO. MERIDA	MP. ALBERTO ADRIANI	PQ. HECTOR AMABLE MORA	16	6589	109	16	3186	1	5160	17	4	5269	6589	5269	3	1949
EDO. MERIDA	MP. ALBERTO ADRIANI	PQ. JOSE NUCETE SARDI	4	1548	25	4	968	0	1181	4	0	1206	1548	1206	0	209
EDO. MERIDA	MP. ALBERTO ADRIANI	PQ. PULIDO MENDEZ	32	15119	289	32	7133	4	12333	46	0	12622	15119	12622	1	5149
EDO. MERIDA	MP. ALBERTO ADRIANI	PQ. PRESIDENTE BETANCOURT	32	15918	294	32	6237	4	12693	55	8	12987	15918	12987	5	6384
EDO. MERIDA	MP. ALBERTO ADRIANI	PQ. GABRIEL PICON G.	9	3219	55	9	1399	2	2439	12	1	2494	3219	2494	0	1025
EDO. AMAZONAS	MP. ATABAPO	CM. SAN FERNANDO DE ATABA	11	4584	100	11	1390	3	3299	41	1	3399	4584	3399	6	1858
EDO. AMAZONAS	MP. ATABAPO	PQ. YAPACANA	1	174	11	3	18	0	121	4	0	132	614	132	0	99
EDO. AMAZONAS	MP. ATABAPO	PQ. CANAME	1	232	5	1	76	0	139	0	0	144	232	144	0	63
EDO. AMAZONAS	MP. ATABAPO	PQ. UCATA	2	674	16	2	291	0	515	5	1	531	674	531	0	218
EDO. AMAZONAS	MP. RIO NEGRO	PQ. COCUY	1	165	1	1	24	0	86	1	0	87	165	87	0	61
EDO. AMAZONAS	MP. RIO NEGRO	CM. SAN CARLOS DE RIO NEG	4	1663	33	4	463	0	1093	20	0	1126	1663	1126	0	610
EDO. AMAZONAS	MP. RIO NEGRO	PQ. CASIQUIARE	1	146	1	1	46	0	124	0	0	125	146	125	0	78
EDO. AMAZONAS	MP. RIO NEGRO	PQ. SOLANO	2	329	14	2	95	1	233	11	0	247	329	247	0	126
EDO. AMAZONAS	CE. ATURES	PQ. FERNANDO GIRON TOVAR	49	23268	591	50	8574	5	17829	146	2	18420	23716	18420	9	9093
EDO. AMAZONAS	CE. ATURES	PQ. PARHUE#A	9	3556	105	17	1549	0	2847	15	2	2952	6738	2952	0	1281
EDO. AMAZONAS	CE. ATURES	PQ. LUIS ALBERTO GOMEZ	63	30020	679	69	13436	10	23872	158	10	24551	32825	24551	11	10247
EDO. AMAZONAS	CE. ATURES	PQ. PLATANILLAL	11	4250	161	18	2046	1	3392	24	2	3553	6493	3553	0	1319
EDO. AMAZONAS	MP. MANAPIARE	CM. SAN JUAN DE MANAPIARE	6	2558	46	6	1346	1	1842	13	1	1888	2558	1888	0	481
EDO. AMAZONAS	MP. MANAPIARE	PQ. MEDIO VENTUARI	1	275	6	2	98	0	166	4	0	172	593	172	0	64
EDO. AMAZONAS	MP. MANAPIARE	PQ. ALTO VENTUARI
EDO. AMAZONAS	MP. MANAPIARE	PQ. BAJO VENTUARI
EDO. AMAZONAS	MP. ALTO ORINOCO	PQ. MAVACA
EDO. AMAZONAS	MP. ALTO ORINOCO	PQ. HUACHAMACARE
EDO. AMAZONAS	MP. ALTO ORINOCO	PQ. MARAWAKA
EDO. AMAZONAS	MP. ALTO ORINOCO	CM. LA ESMERALDA	3	919	12	4	355	0	526	9	0	538	1170	538	0	162
EDO. AMAZONAS	MP. ALTO ORINOCO	PQ. SIERRA PARIMA
EDO. AMAZONAS	MP. MAROA	PQ. COMUNIDAD	1	177	1	1	94	0	128	0	0	129	177	129	0	34
EDO. AMAZONAS	MP. MAROA	PQ. VICTORINO	2	389	4	2	202	0	304	1	0	308	389	308	0	101
EDO. AMAZONAS	MP. MAROA	CM. MAROA	3	1587	19	3	700	0	1166	10	0	1185	1587	1185	1	455
EDO. AMAZONAS	MP. AUTANA	PQ. SAMARIAPO	5	1749	33	5	687	0	1351	12	2	1384	1749	1384	1	649
EDO. AMAZONAS	MP. AUTANA	PQ. MUNDUAPO	1	278	3	2	130	0	244	1	0	247	847	247	0	113
EDO. AMAZONAS	MP. AUTANA	CM. ISLA DE RATON	3	1487	28	4	469	1	1103	10	1	1131	2009	1131	0	622
EDO. AMAZONAS	MP. AUTANA	PQ. GUAYAPO	2	810	15	2	399	0	617	4	1	632	810	632	0	213
EDO. AMAZONAS	MP. AUTANA	PQ. SIPAPO	3	924	32	3	408	0	799	5	0	831	924	831	0	386
EDO. DELTA AMAC	CE. TUCUPITA	PQ. SAN RAFAEL	28	8333	205	30	4039	7	6352	56	4	6557	8771	6557	3	2243
EDO. DELTA AMAC	CE. TUCUPITA	PQ. VIRGEN DEL VALLE	18	4499	96	20	2487	3	3590	26	1	3686	5166	3686	0	1073
EDO. DELTA AMAC	CE. TUCUPITA	PQ.MCL.ANTONIO J DE SUCRE	15	6208	170	16	2830	6	4815	48	2	4985	6696	4985	6	1923
EDO. DELTA AMAC	CE. TUCUPITA	PQ. JUAN MILLAN	13	5226	75	19	2760	5	3865	37	8	3940	6907	3940	1	1054
EDO. DELTA AMAC	CE. TUCUPITA	PQ. SAN JOSE	15	6255	113	15	2174	2	4869	46	0	4982	6255	4982	4	2643
EDO. DELTA AMAC	CE. TUCUPITA	PQ. MONS. ARGIMIRO GARCIA	22	10564	243	22	4566	2	8616	80	6	8859	10564	8859	1	3961
EDO. DELTA AMAC	CE. TUCUPITA	PQ. JOSE VIDAL MARCANO	27	10558	207	27	4608	3	8567	87	4	8774	10558	8774	3	3862
EDO. DELTA AMAC	CE. TUCUPITA	PQ. LEONARDO RUIZ PINEDA	17	7912	202	17	3547	1	6398	73	7	6600	7912	6600	2	2768
EDO. DELTA AMAC	MP. PEDERNALES	PQ. PEDERNALES	10	5168	51	10	2306	0	2994	8	0	3045	5168	3045	1	679
EDO. DELTA AMAC	MP. PEDERNALES	PQ. LUIS B PRIETO FIGUERO	8	3527	33	8	1805	0	2280	13	1	2313	3527	2313	1	460
EDO. DELTA AMAC	MP. ANTONIO DIAZ	PQ. SANTOS DE ABELGAS	2	388	1	5	267	0	289	2	0	290	1173	290	0	20
EDO. DELTA AMAC	MP. ANTONIO DIAZ	PQ. MANUEL RENAUD	3	1269	9	12	710	1	882	5	1	891	4400	891	0	165
EDO. DELTA AMAC	MP. ANTONIO DIAZ	PQ. ANICETO LUGO	3	1248	3	5	510	0	554	7	0	557	1808	557	0	37
EDO. DELTA AMAC	MP. ANTONIO DIAZ	PQ. ALMIRANTE LUIS BRION	1	194	0	6	125	0	131	0	0	131	1412	131	0	6
EDO. DELTA AMAC	MP. ANTONIO DIAZ	PQ. PADRE BARRAL	4	1560	2	11	1073	0	1091	0	1	1093	5020	1093	0	17
EDO. DELTA AMAC	MP. ANTONIO DIAZ	PQ. CURIAPO	14	6100	39	14	2723	1	3407	12	2	3446	6100	3446	0	669
EDO. DELTA AMAC	MP. CASACOIMA	PQ. IMATACA	8	3552	82	9	1890	2	2474	20	9	2556	4101	2556	0	553
EDO. DELTA AMAC	MP. CASACOIMA	PQ. JUAN BAUTISTA ARISMEN	8	3236	50	8	1820	2	2338	7	1	2388	3236	2388	0	508
EDO. DELTA AMAC	MP. CASACOIMA	PQ. 5 DE JULIO	5	1765	36	5	1031	1	1203	10	1	1239	1765	1239	1	159
EDO. DELTA AMAC	MP. CASACOIMA	PQ. MANUEL PIAR	22	10716	217	22	6303	2	8267	50	6	8484	10716	8484	1	1905
EDO. DELTA AMAC	MP. CASACOIMA	PQ. ROMULO GALLEGOS	9	1991	23	9	915	1	1377	11	2	1400	1991	1400	1	447
EDO. GUARICO	MP. ZARAZA	PQ. SAN JOSE DE UNARE	5	2266	52	5	1137	1	1622	10	1	1674	2266	1674	0	473
EDO. GUARICO	MP. ZARAZA	PQ. ZARAZA	76	36171	456	81	17737	16	27126	189	26	27582	38646	27582	10	9148
EDO. GUARICO	MP. CHAGUARAMAS	PQ. CHAGUARAMAS	23	9737	220	24	4746	2	7283	34	5	7503	10270	7503	2	2494
EDO. GUARICO	CE. ROSCIO	PQ. CANTAGALLO	4	1681	12	4	1011	0	1432	7	0	1444	1681	1444	0	414
EDO. GUARICO	CE. ROSCIO	PQ. PARAPARA	7	2582	21	7	1505	1	2054	6	2	2075	2582	2075	0	540
EDO. GUARICO	CE. ROSCIO	PQ.SAN JUAN DE LOS MORROS	160	79488	1211	163	37348	17	65799	372	24	67010	81082	67010	33	28005
EDO. GUARICO	MP. MELLADO	PQ. EL SOMBRERO	38	17340	269	38	9507	3	13793	72	9	14062	17340	14062	5	4197
EDO. GUARICO	MP. MELLADO	PQ. SOSA	3	1157	13	3	598	0	949	3	0	962	1157	962	0	348
EDO. GUARICO	MP. CAMAGUAN	PQ. CAMAGUAN	21	9763	195	23	4802	3	7553	50	7	7748	10927	7748	0	2691
EDO. GUARICO	MP. CAMAGUAN	PQ. PUERTO MIRANDA	6	2496	57	6	1315	1	1923	9	1	1980	2496	1980	0	597
EDO. GUARICO	MP. CAMAGUAN	PQ. UVERITO	4	1460	28	4	780	0	1091	11	3	1119	1460	1119	1	296
EDO. GUARICO	MP. INFANTE	PQ. VALLE DE LA PASCUA	145	73330	962	152	34278	17	60091	335	30	61053	75918	61053	34	25397
EDO. GUARICO	MP. INFANTE	PQ. ESPINO
EDO. GUARICO	MP. EL SOCORRO	PQ. EL SOCORRO	27	12240	202	29	6517	1	9461	42	5	9663	13306	9663	4	2892
EDO. GUARICO	MP. MIRANDA	PQ. EL CALVARIO	2	1127	30	2	577	0	814	3	1	844	1127	844	0	233
EDO. GUARICO	MP. MIRANDA	PQ. GUARDATINAJAS	5	2623	38	7	1433	2	2003	6	0	2041	3224	2041	0	562
EDO. GUARICO	MP. MIRANDA	PQ. CALABOZO	134	67419	963	168	37045	27	54615	325	29	55578	82758	55578	28	17161
EDO. GUARICO	MP. MIRANDA	PQ. EL RASTRO	5	2180	52	5	1141	1	1636	11	0	1688	2180	1688	0	483
EDO. GUARICO	MP. ORTIZ	PQ. ORTIZ	16	7011	97	16	3588	0	5574	47	7	5671	7011	5671	1	1931
EDO. GUARICO	MP. ORTIZ	PQ. SAN FCO. DE TIZNADOS	7	2314	42	7	1430	1	1745	8	1	1787	2314	1787	0	305
EDO. GUARICO	MP. ORTIZ	PQ. S LORENZO DE TIZNADOS	6	1954	17	7	1152	0	1434	3	0	1451	2306	1451	0	279
EDO. GUARICO	MP. ORTIZ	PQ. SAN JOSE DE TIZNADOS	7	2859	46	9	1640	0	2228	8	1	2274	3803	2274	1	578
EDO. GUARICO	MP. S MARIA DE IPIRE	PQ. ALTAMIRA	2	847	15	2	555	0	615	1	3	630	847	630	0	56
EDO. GUARICO	MP. S MARIA DE IPIRE	PQ. SANTA MARIA DE IPIRE	24	9638	142	24	4897	5	7072	52	12	7214	9638	7214	2	2104
EDO. GUARICO	MP. LAS MERCEDES	PQ. CABRUTA	14	6331	98	14	3865	3	4719	25	4	4817	6331	4817	0	822
EDO. GUARICO	MP. LAS MERCEDES	PQ. LAS MERCEDES	24	12017	303	29	5542	0	8779	51	8	9082	14269	9082	0	3178
EDO. GUARICO	MP. LAS MERCEDES	PQ. STA RITA DE MANAPIRE	3	1435	20	3	910	1	1101	2	0	1121	1435	1121	0	188
EDO. GUARICO	MP.S JOSE DE GUARIBE	PQ. SAN JOSE DE GUARIBE	20	8052	146	20	4240	1	6265	40	2	6411	8052	6411	1	1981
EDO. GUARICO	MP.SAN GERONIMO DE G	PQ. CAZORLA	10	4281	35	11	1875	0	2867	10	1	2902	4748	2902	0	981
EDO. GUARICO	MP.SAN GERONIMO DE G	PQ. GUAYABAL	20	9228	130	20	4814	0	6912	41	6	7042	9228	7042	0	2051
EDO. GUARICO	MP. MONAGAS	PQ. LEZAMA	8	3356	59	8	1647	1	2497	16	2	2556	3356	2556	1	830
EDO. GUARICO	MP. MONAGAS	PQ. SOUBLETTE	5	2174	21	5	1132	1	1625	7	0	1646	2174	1646	0	485
EDO. GUARICO	MP. MONAGAS	PQ. SAN FCO DE MACAIRA	4	2074	21	4	1189	0	1505	3	2	1526	2074	1526	0	311
EDO. GUARICO	MP. MONAGAS	PQ. ALTAGRACIA DE ORITUCO	75	35886	623	76	19092	8	28587	174	21	29210	36205	29210	11	9281
EDO. GUARICO	MP. MONAGAS	PQ. LIBERTAD DE ORITUCO	2	670	11	2	375	0	480	1	0	491	670	491	0	104
EDO. GUARICO	MP. MONAGAS	PQ. SAN RAFAEL DE ORITUCO	7	3293	76	7	1886	0	2600	11	0	2676	3293	2676	1	702
EDO. GUARICO	MP. MONAGAS	PQ. PASO REAL DE MACAIRA	7	3294	48	7	1743	1	2469	15	3	2517	3294	2517	0	707
EDO. GUARICO	MP. RIBAS	PQ. TUCUPIDO	59	24896	352	59	11941	5	19400	108	15	19752	24896	19752	8	7323
EDO. GUARICO	MP. RIBAS	PQ. SAN RAFAEL DE LAYA	6	2553	30	6	1352	1	1876	4	0	1906	2553	1906	0	519
EDO. YARACUY	MP. INDEPENDENCIA	CM. INDEPENDENCIA	81	38154	893	81	14004	6	31022	178	20	31915	38154	31915	15	16799
EDO. YARACUY	MP.JOSE ANTONIO PAEZ	CM. SABANA DE PARRA	27	12713	257	27	7305	2	10421	77	7	10678	12713	10678	2	3028
EDO. YARACUY	MP. NIRGUA	CM. NIRGUA	80	29194	557	81	14187	13	22928	118	17	23485	29687	23485	14	8579
EDO. YARACUY	MP. NIRGUA	PQ. SALOM	22	9434	146	23	4981	1	7409	39	7	7555	9888	7555	5	2376
EDO. YARACUY	MP. NIRGUA	PQ. TEMERLA	9	2048	39	9	1240	0	1575	7	0	1614	2048	1614	1	327
EDO. YARACUY	MP. LA TRINIDAD	CM. BORAURE	25	11118	253	26	5253	2	9179	46	3	9432	11486	9432	3	3872
EDO. YARACUY	MP. VEROES	CM. FARRIAR	22	8809	184	23	5777	1	6995	27	3	7179	9231	7179	1	1186
EDO. YARACUY	MP. VEROES	PQ. EL GUAYABO	26	9109	205	27	5491	2	7199	27	5	7404	9194	7404	2	1672
EDO. YARACUY	MP. ARISTIDES BASTID	CM. SAN PABLO	35	13828	273	35	7386	4	11040	66	6	11313	13828	11313	2	3576
EDO. YARACUY	MP. PE#A	PQ. SAN ANDRES	14	5626	109	14	2759	1	4383	34	6	4492	5626	4492	3	1580
EDO. YARACUY	MP. PE#A	CM. YARITAGUA	124	57830	1080	125	29677	14	46572	250	38	47652	58267	47652	17	16576
EDO. YARACUY	MP. SUCRE	CM. GUAMA	32	14178	287	32	6746	4	11876	68	4	12163	14178	12163	3	5051
EDO. YARACUY	MP. URACHICHE	CM. URACHICHE	34	14404	318	35	8220	6	11501	61	5	11819	15001	11819	2	3207
EDO. YARACUY	MP. BOLIVAR	CM. AROA	54	20744	388	55	10898	7	16544	78	6	16932	21269	16932	3	5552
EDO. YARACUY	MP. BRUZUAL	PQ. CAMPO ELIAS	21	8787	161	21	5261	5	6957	29	6	7118	8787	7118	2	1654
EDO. YARACUY	MP. BRUZUAL	CM. CHIVACOA	76	36618	643	78	18426	16	29529	160	23	30172	37767	30172	17	10887
EDO. YARACUY	CE. SAN FELIPE	CM. SAN FELIPE	84	40844	706	84	13804	6	33578	155	23	34284	40844	34284	16	19574
EDO. YARACUY	CE. SAN FELIPE	PQ. SAN JAVIER	21	9140	179	22	4823	3	7295	44	4	7474	9686	7474	2	2419
EDO. YARACUY	CE. SAN FELIPE	PQ. ALBARICO	42	18774	373	42	9298	5	14540	99	9	14913	18774	14913	9	5120
EDO. YARACUY	MP. MANUEL MONGE	CM. YUMARE	27	11493	212	28	6708	7	9183	33	5	9395	12072	9395	3	2427
EDO. YARACUY	MP. COCOROTE	CM. COCOROTE	55	26885	660	55	10455	7	21550	106	11	22210	26885	22210	14	10957
EDO. FALCON	MP. MAUROA	PQ. MENE DE MAUROA	27	10694	235	28	4840	4	8465	51	9	8700	11186	8700	1	3560
EDO. FALCON	MP. MAUROA	PQ. CASIGUA	14	4427	98	14	2463	3	3484	11	0	3582	4427	3582	0	1007
EDO. FALCON	MP. MAUROA	PQ. SAN FELIX	4	1385	9	4	640	1	1061	12	0	1070	1385	1070	0	408
EDO. FALCON	MP. SUCRE	PQ. PECAYA	6	1693	8	6	1008	0	1222	2	1	1230	1693	1230	0	211
EDO. FALCON	MP. SUCRE	PQ. SUCRE	10	3873	37	11	2186	1	3016	16	2	3053	4234	3053	0	811
EDO. FALCON	MP. FALCON	PQ. PUEBLO NUEVO	26	12037	174	26	5931	2	9556	61	4	9730	12037	9730	1	3557
EDO. FALCON	MP. FALCON	PQ. ADAURE	4	1637	25	4	811	1	1282	9	0	1307	1637	1307	0	461
EDO. FALCON	MP. FALCON	PQ. EL VINCULO	6	2558	55	6	1230	1	1960	7	4	2015	2558	2015	0	718
EDO. FALCON	MP. FALCON	PQ. EL HATO	4	1635	11	4	948	0	1295	3	1	1306	1635	1306	0	343
EDO. FALCON	MP. FALCON	PQ. MORUY	13	5317	107	13	2975	1	4371	23	3	4478	5317	4478	1	1368
EDO. FALCON	MP. FALCON	PQ. BARAIVED	7	2838	41	7	1506	0	2331	17	2	2372	2838	2372	1	805
EDO. FALCON	MP. FALCON	PQ. ADICORA	11	4356	78	11	2214	1	3434	20	1	3512	4356	3512	1	1197
EDO. FALCON	MP. FALCON	PQ. JADACAQUIVA	11	3210	43	11	1551	3	2577	13	1	2620	3210	2620	1	1008
EDO. FALCON	MP. FALCON	PQ. BUENA VISTA	7	3133	44	8	1619	0	2581	10	0	2625	3663	2625	2	950
EDO. FALCON	MP. MONS. ITURRIZA	PQ. BOCA DE TOCUYO	3	1421	18	3	611	0	1121	5	0	1139	1421	1139	0	505
EDO. FALCON	MP. MONS. ITURRIZA	PQ. CHICHIRIVICHE	13	6460	129	13	2141	3	4693	24	1	4822	6460	4822	0	2524
EDO. FALCON	MP. MONS. ITURRIZA	PQ. TOCUYO DE LA COSTA	15	6454	114	15	3269	0	4891	15	1	5005	6454	5005	0	1606
EDO. FALCON	MP. COLINA	PQ. ACURIGUA	3	1364	23	3	680	0	1066	3	1	1089	1364	1089	0	382
EDO. FALCON	MP. COLINA	PQ. LAS CALDERAS	7	3836	40	7	1586	1	3205	23	1	3245	3836	3245	2	1592
EDO. FALCON	MP. COLINA	PQ. LA VELA DE CORO	37	19047	285	38	9175	1	15212	85	2	15497	19432	15497	2	5947
EDO. FALCON	MP. COLINA	PQ. GUAIBACOA	2	634	7	2	274	0	491	2	0	498	634	498	0	215
EDO. FALCON	MP. COLINA	PQ. MACORUCA	3	1262	19	3	609	0	811	5	0	830	1262	830	0	197
EDO. FALCON	MP. TOCOPERO	CM. TOCOPERO	13	5895	128	13	3433	1	4595	16	0	4723	5895	4723	0	1145
EDO. FALCON	MP. SILVA	PQ. BOCA DE AROA	13	4731	121	14	1991	2	3103	15	3	3224	5259	3224	0	1092
EDO. FALCON	MP. SILVA	PQ. TUCACAS	36	16696	323	36	5589	2	11103	71	10	11426	16696	11426	3	5428
EDO. FALCON	MP. FEDERACION	PQ. CHURUGUARA	26	10623	185	26	4318	6	8183	39	7	8368	10623	8368	4	3809
EDO. FALCON	MP. FEDERACION	PQ. EL PAUJI	6	2358	44	6	1375	0	1752	7	2	1796	2358	1796	0	368
EDO. FALCON	MP. FEDERACION	PQ. INDEPENDENCIA	4	734	9	4	366	0	557	5	1	566	734	566	0	185
EDO. FALCON	MP. FEDERACION	PQ. AGUA LARGA	10	2238	28	10	1277	1	1665	12	0	1693	2238	1693	0	375
EDO. FALCON	MP. FEDERACION	PQ. MAPARARI	14	4652	118	14	2320	1	3361	17	5	3479	4652	3479	0	1018
EDO. FALCON	MP. LOS TAQUES	PQ. LOS TAQUES	32	16059	324	32	8452	3	13070	79	4	13394	16059	13394	2	4530
EDO. FALCON	MP. LOS TAQUES	PQ. JUDIBANA	31	16131	239	32	7639	2	13324	66	2	13563	16660	13563	7	5608
EDO. FALCON	MP. CARIRUBANA	PQ. NORTE	65	33744	476	65	17430	3	27640	158	10	28116	33744	28116	8	10031
EDO. FALCON	MP. CARIRUBANA	PQ. SANTA ANA	25	11018	189	25	6531	0	9037	58	3	9226	11018	9226	3	2442
EDO. FALCON	MP. CARIRUBANA	PQ. CARIRUBANA	132	67982	1116	137	30739	23	54516	294	21	55632	70605	55632	28	23411
EDO. FALCON	MP. CARIRUBANA	PQ. PUNTA CARDON	84	44420	761	85	20938	1	37022	187	26	37783	45000	37783	27	15843
EDO. FALCON	MP. DABAJURO	CM. DABAJURO	30	13825	244	33	6020	1	10786	60	4	11030	15197	11030	3	4698
EDO. FALCON	MP. CACIQUE MANAURE	CM. YARACAL	16	8049	244	16	3577	0	6074	30	2	6318	8049	6318	1	2464
EDO. FALCON	MP. JACURA	PQ. ARAURIMA	7	2509	38	7	1274	0	1914	10	0	1952	2509	1952	1	629
EDO. FALCON	MP. JACURA	PQ. AGUA LINDA	4	1288	26	5	629	0	805	5	0	831	1387	831	0	171
EDO. FALCON	MP. JACURA	PQ. JACURA	11	4565	54	11	2206	1	3241	25	1	3295	4565	3295	2	1006
EDO. FALCON	MP. PALMA SOLA	CM. PALMA SOLA	13	3754	46	13	2482	1	2988	14	2	3034	3754	3034	1	488
EDO. FALCON	MP. ACOSTA	PQ. LA PASTORA	9	2491	31	9	1342	2	1834	11	2	1865	2491	1865	1	476
EDO. FALCON	MP. ACOSTA	PQ. LIBERTADOR	2	759	19	2	285	0	551	2	0	570	759	570	0	264
EDO. FALCON	MP. ACOSTA	PQ. SAN JUAN DE LOS CAYOS	14	6318	109	14	2523	1	4781	22	2	4890	6318	4890	1	2232
EDO. FALCON	MP. ACOSTA	PQ. CAPADARE	11	4979	71	11	2357	1	3623	11	1	3694	4979	3694	0	1253
EDO. FALCON	MP. DEMOCRACIA	PQ. PURURECHE	4	851	9	6	473	0	689	1	0	698	1198	698	0	215
EDO. FALCON	MP. DEMOCRACIA	PQ. AVARIA	1	273	1	6	164	0	181	0	0	182	856	182	0	17
EDO. FALCON	MP. DEMOCRACIA	PQ. PIEDRA GRANDE	3	815	7	3	400	0	576	5	0	583	815	583	0	171
EDO. FALCON	MP. DEMOCRACIA	PQ. AGUA CLARA	1	288	3	1	112	0	211	2	0	214	288	214	0	97
EDO. FALCON	MP. DEMOCRACIA	PQ. PEDREGAL	17	5038	69	19	2588	2	3985	21	1	4054	5809	4054	1	1372
EDO. FALCON	MP. ZAMORA	PQ. ZAZARIDA	5	1028	7	5	627	1	695	0	0	702	1028	702	0	67
EDO. FALCON	MP. ZAMORA	PQ. LA SOLEDAD	6	1508	24	6	813	0	1136	5	0	1160	1508	1160	2	316
EDO. FALCON	MP. ZAMORA	PQ. PUEBLO CUMAREBO	8	1956	12	8	1099	1	1497	8	0	1509	1956	1509	0	389
EDO. FALCON	MP. ZAMORA	PQ. LA CIENAGA	2	1117	16	2	509	0	916	2	0	932	1117	932	0	405
EDO. FALCON	MP. ZAMORA	PQ. PUERTO CUMAREBO	39	17140	211	39	7794	5	13382	97	3	13593	17140	13593	5	5478
EDO. FALCON	MP. UNION	PQ. EL CHARAL	12	3432	29	12	1857	0	2450	22	3	2479	3432	2479	1	567
EDO. FALCON	MP. UNION	PQ. LAS VEGAS DEL TUY	7	2016	33	7	1225	0	1556	6	1	1589	2016	1589	0	324
EDO. FALCON	MP. UNION	PQ. STA.CRUZ DE BUCARAL	16	5421	81	17	2417	1	4019	23	3	4100	5941	4100	0	1575
EDO. FALCON	MP. URUMACO	PQ. URUMACO	12	4445	80	13	2204	1	3636	11	0	3716	4639	3716	0	1420
EDO. FALCON	MP. URUMACO	PQ. BRUZUAL	9	2032	16	9	1163	0	1672	6	1	1688	2032	1688	0	502
EDO. FALCON	MP. PETIT	PQ. COLINA	8	2446	41	8	1382	0	1665	5	2	1706	2446	1706	0	276
EDO. FALCON	MP. PETIT	PQ. CABURE	16	5673	85	16	3049	1	4294	27	4	4379	5673	4379	1	1212
EDO. FALCON	MP. PETIT	PQ. CURIMAGUA	7	2102	46	8	1138	0	1515	7	1	1561	2677	1561	1	368
EDO. FALCON	MP. PIRITU	PQ. PIRITU	20	6530	126	20	3487	2	4664	38	3	4790	6530	4790	0	1134
EDO. FALCON	MP. PIRITU	PQ. SAN JOSE DE LA COSTA	9	2592	50	9	1435	0	1907	9	3	1957	2592	1957	2	458
EDO. FALCON	MP. SAN FRANCISCO	CM. MIRIMIRE	23	9219	122	23	4603	3	6839	26	2	6961	9219	6961	2	2203
EDO. FALCON	MP. BOLIVAR	PQ. SAN LUIS	15	3696	62	15	2024	0	2994	22	3	3056	3696	3056	4	941
EDO. FALCON	MP. BOLIVAR	PQ. ARACUA	4	1734	23	5	947	1	1343	4	0	1366	2050	1366	0	391
EDO. FALCON	MP. BOLIVAR	PQ. LA PE#A	4	1532	29	4	949	0	1232	6	1	1261	1532	1261	1	275
EDO. FALCON	MP. BUCHIVACOA	PQ. ZAZARIDA	12	4039	58	12	2533	0	3152	17	2	3210	4039	3210	1	599
EDO. FALCON	MP. BUCHIVACOA	PQ. BARIRO	5	2232	47	5	793	0	1635	8	2	1682	2232	1682	0	832
EDO. FALCON	MP. BUCHIVACOA	PQ. GUAJIRO	5	1689	22	5	714	0	1252	7	1	1274	1689	1274	3	527
EDO. FALCON	MP. BUCHIVACOA	PQ. SEQUE	7	1992	33	7	964	1	1558	8	1	1591	1992	1591	1	583
EDO. FALCON	MP. BUCHIVACOA	PQ. CAPATARIDA	13	6085	100	13	2872	0	4922	28	0	5022	6085	5022	3	2019
EDO. FALCON	MP. BUCHIVACOA	PQ. BOROJO	5	1649	15	5	731	0	1329	6	0	1344	1649	1344	0	592
EDO. FALCON	CE. MIRANDA	PQ. RIO SECO	5	2069	37	5	1244	2	1664	11	1	1701	2069	1701	0	406
EDO. FALCON	CE. MIRANDA	PQ. SAN ANTONIO	138	69929	1212	140	32577	27	55821	366	37	57033	70890	57033	27	22787
EDO. FALCON	CE. MIRANDA	PQ. MITARE	3	1284	17	3	564	0	970	6	1	987	1284	987	0	399
EDO. FALCON	CE. MIRANDA	PQ. SABANETA	7	2839	51	10	1475	0	2197	9	2	2248	3296	2248	1	710
EDO. FALCON	CE. MIRANDA	PQ. GUZMAN GUILLERMO	12	4411	71	14	2341	3	3294	27	3	3365	4829	3365	2	918
EDO. FALCON	CE. MIRANDA	PQ. SANTA ANA	34	16810	292	35	6450	3	13225	87	7	13517	17355	13517	5	6673
EDO. FALCON	CE. MIRANDA	PQ. SAN GABRIEL	73	37297	573	75	12760	9	30251	168	9	30824	38427	30824	12	17293
DTTO. CAPITAL	CE. BLVNO LIBERTADOR	PQ. LA PASTORA	143	70087	975	143	29109	15	55650	254	39	56625	70087	56625	67	26166
DTTO. CAPITAL	CE. BLVNO LIBERTADOR	PQ. CARICUAO	206	105140	1653	206	45583	27	87419	379	64	89072	105140	89072	98	41268
DTTO. CAPITAL	CE. BLVNO LIBERTADOR	PQ. EL PARAISO	175	90236	1074	175	26591	22	71756	269	28	72830	90236	72830	60	44786
DTTO. CAPITAL	CE. BLVNO LIBERTADOR	PQ. ALTAGRACIA	68	35211	440	68	12975	5	27900	133	11	28340	35211	28340	22	14754
DTTO. CAPITAL	CE. BLVNO LIBERTADOR	PQ. SAN PEDRO	116	58591	519	116	11964	23	45494	103	23	46013	58591	46013	46	33335
DTTO. CAPITAL	CE. BLVNO LIBERTADOR	PQ. SAN JOSE	64	33204	532	64	11442	1	25863	114	16	26395	33204	26395	31	14259
DTTO. CAPITAL	CE. BLVNO LIBERTADOR	PQ. EL JUNQUITO	85	42688	685	85	18317	19	33625	167	21	34310	42688	34310	32	15069
DTTO. CAPITAL	CE. BLVNO LIBERTADOR	PQ. SANTA TERESA	41	20779	276	41	6498	7	15863	71	8	16139	20779	16139	17	9262
DTTO. CAPITAL	CE. BLVNO LIBERTADOR	PQ. CANDELARIA	96	50240	731	96	12527	12	38044	120	23	38775	50240	38775	48	25314
DTTO. CAPITAL	CE. BLVNO LIBERTADOR	PQ. ANTIMANO	192	95159	1618	192	56372	28	75069	320	51	76687	95159	76687	57	18241
DTTO. CAPITAL	CE. BLVNO LIBERTADOR	PQ. LA VEGA	189	96695	1461	189	44943	25	77444	342	44	78905	96695	78905	70	32020
DTTO. CAPITAL	CE. BLVNO LIBERTADOR	PQ. MACARAO	96	45892	905	96	26970	21	37437	155	33	38342	45892	38342	37	10221
DTTO. CAPITAL	CE. BLVNO LIBERTADOR	PQ. SAN BERNARDINO	52	26501	255	52	6273	5	19377	66	5	19632	26501	19632	16	13012
DTTO. CAPITAL	CE. BLVNO LIBERTADOR	PQ. 23 DE ENERO	153	72324	1271	153	38663	23	58268	241	51	59539	72324	59539	70	19220
DTTO. CAPITAL	CE. BLVNO LIBERTADOR	PQ. COCHE	113	52996	764	113	25357	16	42173	162	25	42937	52996	42937	39	16574
DTTO. CAPITAL	CE. BLVNO LIBERTADOR	PQ. EL RECREO	185	94280	1005	185	24965	22	70096	224	24	71101	94280	71101	70	44791
DTTO. CAPITAL	CE. BLVNO LIBERTADOR	PQ. CATEDRAL	33	16891	323	33	8403	6	12279	55	7	12602	16891	12602	6	3802
DTTO. CAPITAL	CE. BLVNO LIBERTADOR	PQ. SAN AGUSTIN	65	32983	499	65	16028	10	25634	88	13	26133	32983	26133	17	9478
DTTO. CAPITAL	CE. BLVNO LIBERTADOR	PQ. SAN JUAN	154	77913	1211	154	32389	21	61336	278	47	62547	77913	62547	66	28535
DTTO. CAPITAL	CE. BLVNO LIBERTADOR	PQ. EL VALLE	223	114667	2274	223	55677	22	90700	361	62	92974	114667	92974	81	34497
DTTO. CAPITAL	CE. BLVNO LIBERTADOR	PQ. SANTA ROSALIA	168	85106	1420	168	36481	18	66370	260	44	67790	85106	67790	52	29515
DTTO. CAPITAL	CE. BLVNO LIBERTADOR	PQ. SUCRE	590	291393	5346	590	147635	92	229490	1162	157	234836	291393	234836	251	80193
EDO. TRUJILLO	MP. PAMPANITO	PQ. LA CONCEPCION	8	3250	51	8	1654	0	2730	10	1	2781	3250	2781	2	1063
EDO. TRUJILLO	MP. PAMPANITO	PQ. PAMPANITO	19	7941	125	19	3997	2	6601	25	1	6726	7941	6726	2	2574
EDO. TRUJILLO	MP. PAMPANITO	PQ. PAMPANITO II	14	6095	95	14	3458	2	4971	21	2	5066	6095	5066	0	1488
EDO. TRUJILLO	MP. MOTATAN	PQ. MOTATAN	18	8417	182	18	4689	1	6852	29	0	7034	8417	7034	2	2131
EDO. TRUJILLO	MP. MOTATAN	PQ. EL BA#O	3	1443	27	3	880	0	1254	2	1	1281	1443	1281	0	371
EDO. TRUJILLO	MP. MOTATAN	PQ. JALISCO	8	3184	79	8	2095	1	2684	6	3	2763	3184	2763	0	579
EDO. TRUJILLO	MP. ANDRES BELLO	PQ. EL JAGUITO	6	2707	67	6	1374	0	1974	2	1	2041	2707	2041	0	597
EDO. TRUJILLO	MP. ANDRES BELLO	PQ. SANTA ISABEL	10	4812	99	10	2419	0	3558	10	3	3657	4812	3657	1	1125
EDO. TRUJILLO	MP. ANDRES BELLO	PQ. ARAGUANEY	4	1558	22	4	738	0	1140	2	0	1162	1558	1162	0	400
EDO. TRUJILLO	MP. ANDRES BELLO	PQ. LA ESPERANZA	5	2645	62	5	1452	0	1933	3	0	1995	2645	1995	0	478
EDO. TRUJILLO	MP. BOCONO	PQ. MOSQUEY	8	3706	41	8	2262	0	2907	23	1	2948	3706	2948	1	620
EDO. TRUJILLO	MP. BOCONO	PQ. EL CARMEN	41	19063	325	41	9329	4	15017	101	10	15342	19063	15342	7	5566
EDO. TRUJILLO	MP. BOCONO	PQ. GENERAL RIVAS	13	3507	65	13	1545	3	2311	10	6	2376	3507	2376	1	746
EDO. TRUJILLO	MP. BOCONO	PQ. BURBUSAY	9	3326	44	9	1945	0	2436	11	0	2480	3326	2480	0	480
EDO. TRUJILLO	MP. BOCONO	PQ. SAN JOSE	15	4008	53	15	2381	0	2875	11	5	2928	4008	2928	1	477
EDO. TRUJILLO	MP. BOCONO	PQ. GUARAMACAL	3	897	6	4	636	1	676	0	0	682	1147	682	0	39
EDO. TRUJILLO	MP. BOCONO	PQ. LA VEGA DE GUARAMACAL	4	1178	31	4	793	0	859	2	1	890	1178	890	0	63
EDO. TRUJILLO	MP. BOCONO	PQ. RAFAEL RANGEL	13	3385	46	13	1929	1	2462	14	3	2508	3385	2508	1	514
EDO. TRUJILLO	MP. BOCONO	PQ. SAN MIGUEL	10	3145	24	10	2052	1	2304	5	2	2328	3145	2328	1	243
EDO. TRUJILLO	MP. BOCONO	PQ. MONSE#OR JAUREGUI	13	3307	58	15	1760	2	2306	13	1	2364	4009	2364	2	528
EDO. TRUJILLO	MP. BOCONO	PQ. BOCONO	43	17491	304	43	8069	7	13228	66	15	13532	17491	13532	9	5062
EDO. TRUJILLO	MP. BOCONO	PQ. AYACUCHO	8	2348	25	9	1312	0	1655	4	3	1680	2871	1680	1	335
EDO. TRUJILLO	MP. RAFAEL RANGEL	PQ. JOSE G HERNANDEZ	9	4238	54	9	2055	1	3425	20	1	3479	4238	3479	4	1344
EDO. TRUJILLO	MP. RAFAEL RANGEL	PQ. EL CEDRO	7	3365	68	7	1563	0	2615	11	0	2683	3365	2683	2	1039
EDO. TRUJILLO	MP. RAFAEL RANGEL	PQ. BETIJOQUE	8	3943	72	8	1593	1	3137	9	0	3209	3943	3209	0	1534
EDO. TRUJILLO	MP. RAFAEL RANGEL	PQ. LA PUEBLITA	8	3876	75	8	1830	0	3276	15	3	3351	3876	3351	0	1428
EDO. TRUJILLO	MP. BOLIVAR	PQ. GRANADOS	5	2124	34	5	1226	0	1658	6	2	1692	2124	1692	0	424
EDO. TRUJILLO	MP. BOLIVAR	PQ. CHEREGUE	8	3247	37	8	1974	0	2467	13	0	2504	3247	2504	1	479
EDO. TRUJILLO	MP. BOLIVAR	PQ. SABANA GRANDE	11	5242	83	11	2943	0	4098	8	0	4181	5242	4181	1	1146
EDO. TRUJILLO	CE. TRUJILLO	PQ. TRES ESQUINAS	8	3639	61	8	1869	0	2995	11	4	3056	3639	3056	0	1111
EDO. TRUJILLO	CE. TRUJILLO	PQ. ANDRES LINARES	10	2917	48	10	1354	0	2076	3	5	2124	2917	2124	0	714
EDO. TRUJILLO	CE. TRUJILLO	PQ. MATRIZ	14	6663	106	14	2908	1	5657	20	6	5763	6663	5763	5	2717
EDO. TRUJILLO	CE. TRUJILLO	PQ. MONSE#OR CARRILLO	18	7434	111	18	3898	0	5831	34	5	5942	7434	5942	1	1893
EDO. TRUJILLO	CE. TRUJILLO	PQ. CHIQUINQUIRA	15	7437	94	15	3423	0	6000	29	3	6094	7437	6094	2	2543
EDO. TRUJILLO	CE. TRUJILLO	PQ. CRISTOBAL MENDOZA	25	11262	140	25	5395	0	8855	39	1	8995	11262	8995	9	3411
EDO. TRUJILLO	CE. TRUJILLO	PQ. CRUZ CARRILLO	9	3356	41	10	1550	0	2696	10	1	2737	3437	2737	3	1132
EDO. TRUJILLO	MP. CARACHE	PQ. PANAMERICANA	7	1917	20	7	1364	0	1564	8	1	1584	1917	1584	0	191
EDO. TRUJILLO	MP. CARACHE	PQ. LA CONCEPCION	16	3903	36	16	2523	1	3050	7	2	3086	3903	3086	1	516
EDO. TRUJILLO	MP. CARACHE	PQ. CARACHE	29	9162	150	29	4407	2	6926	32	4	7076	9162	7076	0	2481
EDO. TRUJILLO	MP. CARACHE	PQ. SANTA CRUZ	6	1774	41	6	1026	0	1347	8	0	1388	1774	1388	1	312
EDO. TRUJILLO	MP. CARACHE	PQ. CUICAS	20	5062	41	20	2829	0	3661	14	4	3702	5062	3702	1	813
EDO. TRUJILLO	MP. CANDELARIA	PQ. MANUEL SALVADOR ULLOA	3	1613	33	3	956	0	1154	4	0	1187	1613	1187	0	194
EDO. TRUJILLO	MP. CANDELARIA	PQ. ARNOLDO GABALDON	6	2023	18	7	1333	1	1588	5	0	1606	2489	1606	0	249
EDO. TRUJILLO	MP. CANDELARIA	PQ. CEGARRA	3	871	8	3	483	0	634	2	0	642	871	642	0	149
EDO. TRUJILLO	MP. CANDELARIA	PQ. SAN JOSE	5	2503	22	5	1650	0	1936	9	2	1958	2503	1958	0	275
EDO. TRUJILLO	MP. CANDELARIA	PQ. BOLIVIA	11	2429	21	11	1498	0	1818	9	2	1839	2429	1839	0	309
EDO. TRUJILLO	MP. CANDELARIA	PQ. CARRILLO	6	1779	13	6	1003	0	1289	1	0	1302	1779	1302	0	285
EDO. TRUJILLO	MP. CANDELARIA	PQ. CHEJENDE	24	8142	123	26	4559	1	6048	27	2	6171	9048	6171	1	1458
EDO. TRUJILLO	MP. SUCRE	PQ. EL PARAISO	3	1331	20	3	632	0	921	0	0	941	1331	941	0	289
EDO. TRUJILLO	MP. SUCRE	PQ. SABANA DE MENDOZA	15	7517	106	15	3541	3	6022	25	0	6128	7517	6128	2	2451
EDO. TRUJILLO	MP. SUCRE	PQ. JUNIN	5	2702	22	5	1452	0	2112	3	0	2134	2702	2134	0	657
EDO. TRUJILLO	MP. SUCRE	PQ. VALMORE RODRIGUEZ	17	7841	108	17	4331	4	6198	22	5	6306	7841	6306	0	1836
EDO. TRUJILLO	MP. PAMPAN	PQ. SANTA ANA	17	5834	62	17	3535	1	4457	11	2	4519	5834	4519	1	907
EDO. TRUJILLO	MP. PAMPAN	PQ. FLOR DE PATRIA	21	9168	163	22	4815	2	7410	24	1	7573	9429	7573	1	2567
EDO. TRUJILLO	MP. PAMPAN	PQ. LA PAZ	26	11486	202	27	6717	2	8867	41	6	9069	12027	9069	1	2100
EDO. TRUJILLO	MP. PAMPAN	PQ. PAMPAN	15	6416	112	15	2832	1	5159	28	0	5271	6416	5271	2	2296
EDO. TRUJILLO	MP. JUAN V CAMPO ELI	PQ. ARNOLDO GABALDON	6	1810	22	6	1125	1	1360	3	1	1382	1810	1382	0	230
EDO. TRUJILLO	MP. JUAN V CAMPO ELI	PQ. CAMPO ELIAS	8	3632	48	8	2161	1	2936	8	2	2984	3632	2984	2	762
EDO. TRUJILLO	MP. ESCUQUE	PQ. ESCUQUE	26	10104	146	27	5176	0	8306	38	3	8452	10625	8452	3	3086
EDO. TRUJILLO	MP. ESCUQUE	PQ. SANTA RITA	6	2202	39	6	1272	0	1854	11	1	1893	2202	1893	1	569
EDO. TRUJILLO	MP. ESCUQUE	PQ. SABANA LIBRE	11	4769	77	11	2210	0	3906	14	2	3983	4769	3983	0	1680
EDO. TRUJILLO	MP. ESCUQUE	PQ. LA UNION	5	2246	32	5	1079	1	1860	10	0	1892	2246	1892	0	770
EDO. TRUJILLO	MP. VALERA	PQ. LA PUERTA	15	6902	98	15	3207	0	5452	18	2	5550	6902	5550	3	2222
EDO. TRUJILLO	MP. VALERA	PQ. SAN LUIS	23	10208	206	23	5491	1	8477	46	6	8683	10208	8683	4	2929
EDO. TRUJILLO	MP. VALERA	PQ. MERCEDES DIAZ	80	39957	595	83	18803	14	32698	127	17	33293	41482	33293	17	13720
EDO. TRUJILLO	MP. VALERA	PQ. MENDOZA	15	6501	82	15	2939	3	5179	20	2	5261	6501	5261	3	2212
EDO. TRUJILLO	MP. VALERA	PQ. LA BEATRIZ	16	8224	92	16	3278	1	7272	24	3	7364	8224	7364	3	3963
EDO. TRUJILLO	MP. VALERA	PQ. JUAN IGNACIO MONTILLA	52	25740	298	53	8953	2	21421	67	9	21719	26223	21719	7	12383
EDO. TRUJILLO	MP. MONTE CARMELO	PQ. STA MARIA DEL HORCON	4	1095	21	4	666	0	846	1	0	867	1095	867	1	178
EDO. TRUJILLO	MP. MONTE CARMELO	PQ. MONTE CARMELO	15	5330	69	15	2748	0	3966	20	2	4035	5330	4035	0	1196
EDO. TRUJILLO	MP. MONTE CARMELO	PQ. BUENA VISTA	12	4495	71	12	2587	1	3458	7	0	3529	4495	3529	0	863
EDO. TRUJILLO	MP. URDANETA	PQ. CABIMBU	5	1941	7	5	830	1	1530	1	3	1537	1941	1537	0	695
EDO. TRUJILLO	MP. URDANETA	PQ. TU#AME	7	3307	49	7	1670	2	2265	15	10	2314	3307	2314	0	568
EDO. TRUJILLO	MP. URDANETA	PQ. JAJO	14	4866	68	14	2277	1	3772	8	1	3840	4866	3840	0	1485
EDO. TRUJILLO	MP. URDANETA	PQ. LA QUEBRADA	15	5499	103	15	2366	1	4071	10	2	4174	5499	4174	1	1691
EDO. TRUJILLO	MP. URDANETA	PQ. LA MESA	12	5476	95	12	2707	0	4080	22	2	4175	5476	4175	1	1348
EDO. TRUJILLO	MP. URDANETA	PQ. SANTIAGO	10	3319	29	10	1933	0	2494	8	1	2523	3319	2523	1	551
EDO. TRUJILLO	MP. LA CEIBA	PQ. LA CEIBA	2	835	15	2	544	1	642	0	0	657	835	657	0	97
EDO. TRUJILLO	MP. LA CEIBA	PQ. SANTA APOLONIA	8	3567	35	8	2115	0	2674	4	0	2709	3567	2709	0	555
EDO. TRUJILLO	MP. LA CEIBA	PQ. TRES DE FEBRERO	10	4786	52	10	2871	1	3510	11	1	3562	4786	3562	0	626
EDO. TRUJILLO	MP. LA CEIBA	PQ. EL PROGRESO	7	3588	37	7	2039	1	2700	5	0	2737	3588	2737	0	655
EDO. TRUJILLO	MP. JOSE F M CA#IZAL	PQ. ANTONIO JOSE DE SUCRE	2	950	9	2	357	0	653	1	0	662	950	662	0	295
EDO. TRUJILLO	MP. JOSE F M CA#IZAL	PQ. EL SOCORRO	6	3032	43	6	1490	1	2301	6	2	2344	3032	2344	0	802
EDO. TRUJILLO	MP. JOSE F M CA#IZAL	PQ. LOS CAPRICHOS	1	413	2	1	183	0	277	4	0	279	413	279	0	90
EDO. TRUJILLO	MP. MIRANDA	PQ. EL CENIZO	4	1897	27	4	1157	0	1401	8	2	1428	1897	1428	0	234
EDO. TRUJILLO	MP. MIRANDA	PQ. AGUA SANTA	8	3564	65	8	2057	1	2727	10	1	2792	3564	2792	1	657
EDO. TRUJILLO	MP. MIRANDA	PQ. EL DIVIDIVE	17	7622	154	17	3819	0	6060	18	0	6214	7622	6214	0	2223
EDO. TRUJILLO	MP. MIRANDA	PQ. VALERITA	1	596	7	1	363	0	429	7	0	436	596	436	0	59
EDO. TRUJILLO	MP. MIRANDA	PQ. AGUA CALIENTE	3	1146	14	3	657	0	827	4	0	841	1146	841	0	166
EDO. TRUJILLO	MP.S RAFAEL CARVAJAL	PQ. CARVAJAL	18	8850	144	18	3763	1	7331	16	2	7475	8850	7475	3	3546
EDO. TRUJILLO	MP.S RAFAEL CARVAJAL	PQ. ANTONIO N BRICE#O	15	7307	109	15	3554	1	6035	15	4	6144	7307	6144	2	2459
EDO. TRUJILLO	MP.S RAFAEL CARVAJAL	PQ. JOSE LEONARDO SUAREZ	13	6126	112	13	3296	0	4935	20	1	5047	6126	5047	1	1617
EDO. TRUJILLO	MP.S RAFAEL CARVAJAL	PQ. CAMPO ALEGRE	27	13726	208	27	6497	1	11162	33	3	11370	13726	11370	1	4627
EDO. APURE	MP. PEDRO CAMEJO	PQ. CUNAVICHE	23	9132	76	26	4386	0	6810	24	3	6886	10420	6886	1	2396
EDO. APURE	MP. PEDRO CAMEJO	PQ. SAN JUAN DE PAYARA	14	7417	88	14	3724	2	5692	16	1	5780	7417	5780	1	1948
EDO. APURE	MP. PEDRO CAMEJO	PQ. CODAZZI	8	2852	108	10	1407	0	1804	5	1	1912	3440	1912	0	391
EDO. APURE	MP. MU#OZ	PQ. QUINTERO	2	847	5	3	390	0	594	2	0	599	1276	599	0	202
EDO. APURE	MP. MU#OZ	PQ. RINCON HONDO	11	3781	57	11	2119	1	2795	13	0	2852	3781	2852	1	661
EDO. APURE	MP. MU#OZ	PQ. MANTECAL	21	9276	126	21	5385	1	7116	44	3	7242	9276	7242	0	1683
EDO. APURE	MP. MU#OZ	PQ. SAN VICENTE	6	1898	11	6	1054	0	1409	7	0	1420	1898	1420	0	348
EDO. APURE	MP. MU#OZ	PQ. BRUZUAL	10	4449	54	10	2645	1	3448	20	3	3502	4449	3502	0	779
EDO. APURE	MP. ROMULO GALLEGOS	PQ. ELORZA	31	14459	211	31	7310	2	10406	59	9	10617	14459	10617	0	3026
EDO. APURE	MP. ROMULO GALLEGOS	PQ. LA TRINIDAD	8	3480	64	8	1792	1	2521	8	2	2585	3480	2585	1	717
EDO. APURE	CE. SAN FERNANDO	PQ. SAN FERNANDO	157	78408	1384	159	38752	11	63765	364	45	65149	79456	65149	21	24572
EDO. APURE	CE. SAN FERNANDO	PQ. EL RECREO	39	17319	262	39	10343	1	14126	89	6	14388	17319	14388	6	3681
EDO. APURE	CE. SAN FERNANDO	PQ. SN RAFAEL DE ATAMAICA	10	4761	29	12	2301	1	3443	16	1	3472	5267	3472	0	1124
EDO. APURE	CE. SAN FERNANDO	PQ. PE#ALVER	13	5173	39	17	2972	0	3944	5	1	3983	6559	3983	2	964
EDO. APURE	MP. PAEZ	PQ. SAN CAMILO	22	11063	168	23	5064	3	8099	52	8	8267	11600	8267	0	2972
EDO. APURE	MP. PAEZ	PQ. EL AMPARO	20	9332	205	21	3574	3	5725	64	2	5930	9793	5930	3	2079
EDO. APURE	MP. PAEZ	PQ. ARAMENDI	8	2680	23	8	1184	1	1807	9	0	1830	2680	1830	0	613
EDO. APURE	MP. PAEZ	PQ. URDANETA	22	8360	107	22	4624	4	5928	56	7	6035	8360	6035	2	1235
EDO. APURE	MP. PAEZ	PQ. GUASDUALITO	70	33061	647	71	14016	10	25197	196	16	25844	33653	25844	11	10948
EDO. APURE	MP. ACHAGUAS	PQ. EL YAGUAL	7	3167	37	8	1665	0	2263	6	2	2300	3549	2300	0	590
EDO. APURE	MP. ACHAGUAS	PQ. GUACHARA	8	2941	18	10	1525	0	2140	6	0	2158	3532	2158	0	609
EDO. APURE	MP. ACHAGUAS	PQ. ACHAGUAS	45	20440	330	49	11608	5	16164	131	15	16494	21628	16494	2	4403
EDO. APURE	MP. ACHAGUAS	PQ. MUCURITAS	9	3671	57	10	1972	0	2744	11	1	2801	3887	2801	1	759
EDO. APURE	MP. ACHAGUAS	PQ. APURITO	8	3398	52	8	1802	1	2462	19	3	2514	3398	2514	2	635
EDO. APURE	MP. ACHAGUAS	PQ. QUESERAS DEL MEDIO	9	3586	35	9	2127	1	2733	9	2	2768	3586	2768	0	594
EDO. APURE	MP. BIRUACA	PQ. BIRUACA	82	35884	630	82	19146	4	28722	147	10	29352	35884	29352	7	9408
EDO. CARABOBO	MP. SAN DIEGO	PQ. URB SAN DIEGO	110	59286	555	110	14289	9	51282	184	31	51837	59286	51837	30	36739
EDO. CARABOBO	MP. LOS GUAYOS	PQ. U LOS GUAYOS	184	96651	1506	184	48671	19	76737	428	36	78243	96651	78243	47	27536
EDO. CARABOBO	MP. BEJUMA	PQ. CANOABO	14	5310	71	14	2290	2	4108	11	5	4179	5310	4179	4	1796
EDO. CARABOBO	MP. BEJUMA	PQ. SIMON BOLIVAR	13	5838	79	13	2421	2	4771	14	1	4850	5838	4850	1	2332
EDO. CARABOBO	MP. BEJUMA	PQ. BEJUMA	42	21679	253	42	8765	4	17134	64	7	17387	21679	17387	7	8287
EDO. CARABOBO	MP. NAGUANAGUA	PQ. NAGUANAGUA	184	98332	1173	186	32100	29	80358	298	40	81531	99406	81531	42	47849
EDO. CARABOBO	MP. CARLOS ARVELO	PQ. GUIGUE	95	47756	861	96	24870	11	35914	235	22	36775	48290	36775	17	10759
EDO. CARABOBO	MP. CARLOS ARVELO	PQ. BELEN	21	10115	123	22	5444	1	7347	29	6	7470	10284	7470	2	1865
EDO. CARABOBO	MP. CARLOS ARVELO	PQ. TACARIGUA	82	40343	693	82	21941	14	30524	175	24	31217	40343	31217	15	8355
EDO. CARABOBO	MP. LIBERTADOR	PQ. U INDEPENDENCIA	53	25590	370	53	14448	10	19974	99	27	20344	25590	20344	10	5380
EDO. CARABOBO	MP. LIBERTADOR	PQ. U TOCUYITO	156	82890	1193	157	39261	35	63276	286	37	64469	83416	64469	36	23621
EDO. CARABOBO	MP. MIRANDA	PQ. MIRANDA	38	19116	272	38	9829	2	14916	64	5	15188	19116	15188	5	5011
EDO. CARABOBO	MP. SAN JOAQUIN	PQ. SAN JOAQUIN	74	38296	573	75	18013	9	31058	151	18	31631	38795	31631	23	12844
EDO. CARABOBO	MP. DIEGO IBARRA	PQ. AGUAS CALIENTES	65	33896	624	65	21002	8	26951	148	18	27575	33896	27575	11	5764
EDO. CARABOBO	MP. DIEGO IBARRA	PQ. MARIARA	61	32772	560	61	17288	4	26147	125	24	26707	32772	26707	13	8693
EDO. CARABOBO	CE. VALENCIA	PQ. SANTA ROSA	102	52551	926	106	23433	17	40316	256	18	41242	54606	41242	33	16559
EDO. CARABOBO	CE. VALENCIA	PQ. CATEDRAL	8	4206	45	8	1275	1	3074	17	4	3119	4206	3119	1	1776
EDO. CARABOBO	CE. VALENCIA	PQ. NEGRO PRIMERO	3	517	6	20	376	0	404	2	1	410	6095	410	0	25
EDO. CARABOBO	CE. VALENCIA	PQ. EL SOCORRO	10	5197	64	10	1240	1	3904	20	2	3968	5197	3968	2	2639
EDO. CARABOBO	CE. VALENCIA	PQ. SAN JOSE	196	106363	632	197	10250	10	85959	169	19	86591	106895	86591	48	75463
EDO. CARABOBO	CE. VALENCIA	PQ. CANDELARIA	49	25645	328	49	9489	8	19802	103	8	20130	25645	20130	18	10176
EDO. CARABOBO	CE. VALENCIA	PQ. SAN BLAS	41	21274	246	41	5916	5	16491	64	4	16737	21274	16737	5	10497
EDO. CARABOBO	CE. VALENCIA	PQ. MIGUEL PE#A	425	223905	3425	428	105770	69	172295	1062	93	175720	225359	175720	105	65196
EDO. CARABOBO	CE. VALENCIA	PQ. RAFAEL URDANETA	231	124158	1565	232	52652	27	99746	530	48	101311	124714	101311	37	46452
EDO. CARABOBO	MP. JUAN JOSE MORA	PQ. URAMA	15	6236	81	15	3745	3	4802	14	3	4883	6236	4883	1	1036
EDO. CARABOBO	MP. JUAN JOSE MORA	PQ. MORON	89	42125	688	90	25302	25	34432	143	20	35120	42586	35120	20	8922
EDO. CARABOBO	MP. GUACARA	PQ. CIUDAD ALIANZA	27	14776	99	27	2640	1	12101	24	2	12200	14776	12200	4	9430
EDO. CARABOBO	MP. GUACARA	PQ. GUACARA	165	86559	1272	167	42274	18	70736	409	42	72008	87621	72008	39	27954
EDO. CARABOBO	MP. GUACARA	PQ. YAGUA	24	12758	155	24	5899	4	10175	41	7	10330	12758	10330	1	4223
EDO. CARABOBO	MP. MONTALBAN	PQ. MONTALBAN	35	16769	250	35	7394	2	13410	46	5	13660	16769	13660	3	5960
EDO. CARABOBO	MP. PUERTO CABELLO	PQ. FRATERNIDAD	18	8921	101	18	3378	4	6859	29	2	6960	8921	6960	3	3443
EDO. CARABOBO	MP. PUERTO CABELLO	PQ. PATANEMO	6	2874	54	6	1340	0	2148	17	1	2202	2874	2202	0	790
EDO. CARABOBO	MP. PUERTO CABELLO	PQ. JUAN JOSE FLORES	87	45099	647	88	22366	15	36422	136	15	37069	45395	37069	17	13873
EDO. CARABOBO	MP. PUERTO CABELLO	PQ. GOAIGOAZA	61	31237	450	61	15901	2	25121	85	15	25571	31237	25571	15	9103
EDO. CARABOBO	MP. PUERTO CABELLO	PQ. DEMOCRACIA	24	12187	201	24	6914	8	9330	36	5	9531	12187	9531	5	2362
EDO. CARABOBO	MP. PUERTO CABELLO	PQ. BORBURATA	13	6833	65	13	3215	1	4753	26	2	4818	6833	4818	3	1506
EDO. CARABOBO	MP. PUERTO CABELLO	PQ. UNION	8	4471	62	8	1771	3	3231	16	2	3293	4471	3293	2	1437
EDO. CARABOBO	MP. PUERTO CABELLO	PQ. BARTOLOME SALOM	58	28913	426	58	13691	9	23278	81	4	23704	28913	23704	13	9480
EDO. VARGAS	CE. VARGAS	PQ. CARABALLEDA	59	29271	415	59	11200	5	22989	95	9	23404	29271	23404	14	11666
EDO. VARGAS	CE. VARGAS	PQ. MAIQUETIA	59	29967	472	59	13985	8	23061	106	13	23533	29967	23533	24	8925
EDO. VARGAS	CE. VARGAS	PQ. CARLOS SOUBLETTE	67	33647	560	67	16759	5	26135	145	13	26695	33647	26695	25	9188
EDO. VARGAS	CE. VARGAS	PQ. CARAYACA	63	23555	342	66	13480	9	18094	87	21	18436	24298	18436	11	4486
EDO. VARGAS	CE. VARGAS	PQ. NAIGUATA	29	13771	209	29	7481	3	10906	47	5	11115	13771	11115	8	3362
EDO. VARGAS	CE. VARGAS	PQ. MACUTO	30	14757	163	30	5419	2	11540	51	3	11703	14757	11703	9	6056
EDO. VARGAS	CE. VARGAS	PQ. CARUAO	12	4824	87	12	2587	2	3742	16	5	3829	4824	3829	3	1129
EDO. VARGAS	CE. VARGAS	PQ. URIMARE	49	24359	337	50	11516	15	19793	95	13	20130	24895	20130	12	8142
EDO. VARGAS	CE. VARGAS	PQ. CATIA LA MAR	125	63843	967	127	32487	12	49837	244	34	50804	64819	50804	38	17022
EDO. VARGAS	CE. VARGAS	PQ. EL JUNKO	17	7133	151	17	3113	4	5437	32	10	5588	7133	5588	3	2275
EDO. VARGAS	CE. VARGAS	PQ. LA GUAIRA	37	18529	402	37	8338	3	14135	89	7	14537	18529	14537	10	5688
EDO. ZULIA	MP. LA CA#ADA DE U.	PQ. CHIQUINQUIRA	15	8046	59	15	3887	1	6331	12	1	6390	8046	6390	0	2430
EDO. ZULIA	MP. LA CA#ADA DE U.	PQ. POTRERITOS	8	4604	23	8	2263	0	3762	3	0	3785	4604	3785	0	1496
EDO. ZULIA	MP. LA CA#ADA DE U.	PQ. CONCEPCION	42	21793	168	42	8164	0	17515	32	3	17683	21793	17683	3	9313
EDO. ZULIA	MP. LA CA#ADA DE U.	PQ. ANDRES BELLO (KM 48)	13	6193	52	13	3035	0	4565	9	0	4617	6193	4617	2	1519
EDO. ZULIA	MP. LA CA#ADA DE U.	PQ. EL CARMELO	10	5680	34	11	2466	0	4784	5	1	4818	6160	4818	0	2312
EDO. ZULIA	MP. LAGUNILLAS	PQ. ELEAZAR LOPEZ C	4	2199	42	4	1130	1	1749	3	0	1791	2199	1791	0	615
EDO. ZULIA	MP. LAGUNILLAS	PQ. LIBERTAD	46	24746	381	46	9757	3	19986	90	8	20367	24746	20367	6	10122
EDO. ZULIA	MP. LAGUNILLAS	PQ. ALONSO DE OJEDA	129	68616	1156	131	25818	19	55891	196	38	57047	69767	57047	27	29793
EDO. ZULIA	MP. LAGUNILLAS	PQ. CAMPO LARA	7	3776	65	7	1737	0	3022	7	0	3087	3776	3087	1	1277
EDO. ZULIA	MP. LAGUNILLAS	PQ. VENEZUELA	43	22897	334	43	8438	7	18623	67	9	18957	22897	18957	6	10096
EDO. ZULIA	MP. BLVNO GUAJIRA	PQ. ELIAS SANCHEZ RUBIO	16	7150	72	16	3130	0	4648	19	2	4720	7150	4720	0	1497
EDO. ZULIA	MP. BLVNO GUAJIRA	PQ. ALTA GUAJIRA	16	6672	58	16	2138	1	2754	8	1	2812	6672	2812	0	606
EDO. ZULIA	MP. BLVNO GUAJIRA	PQ. SINAMAICA	25	11309	125	25	5292	2	7907	40	6	8032	11309	8032	0	2567
EDO. ZULIA	MP. BLVNO GUAJIRA	PQ. GUAJIRA	78	37268	366	79	14564	9	20120	90	18	20486	37750	20486	3	5436
EDO. ZULIA	MP. COLON	PQ. SAN CARLOS DEL ZULIA	21	10952	159	21	4585	0	8957	34	3	9116	10952	9116	2	4333
EDO. ZULIA	MP. COLON	PQ. URRIBARRI	17	7714	64	17	3659	2	5852	23	3	5916	7714	5916	1	2164
EDO. ZULIA	MP. COLON	PQ. SANTA BARBARA	61	31736	429	61	13923	6	25551	77	4	25980	31736	25980	6	11535
EDO. ZULIA	MP. COLON	PQ. MORALITO	28	11809	161	30	5740	1	9057	22	5	9218	12690	9218	0	3289
EDO. ZULIA	MP. COLON	PQ. SANTA CRUZ DEL ZULIA	11	5684	58	11	2200	1	4441	4	1	4499	5684	4499	0	2235
EDO. ZULIA	MP. JESUS E LOSSADA	PQ. SAN JOSE	18	8422	90	18	4371	1	6379	14	4	6469	8422	6469	1	1988
EDO. ZULIA	MP. JESUS E LOSSADA	PQ. LA CONCEPCION	75	38542	621	76	16495	7	29503	97	16	30124	39042	30124	12	12876
EDO. ZULIA	MP. JESUS E LOSSADA	PQ. MARIANO PARRA LEON	9	4746	60	9	2179	0	3620	4	1	3680	4746	3680	0	1436
EDO. ZULIA	MP. JESUS E LOSSADA	PQ. JOSE RAMON YEPEZ	25	12198	165	25	5838	0	9113	13	5	9278	12198	9278	0	3257
EDO. ZULIA	MP. ALMIRANTE P	PQ. ISLA DE TOAS	14	6986	43	14	3899	0	5461	15	0	5504	6986	5504	0	1547
EDO. ZULIA	MP. ALMIRANTE P	PQ. MONAGAS	5	2649	30	5	1746	0	2085	0	0	2115	2649	2115	0	339
EDO. ZULIA	MP. CATATUMBO	PQ. UDON PEREZ	17	8061	81	17	3004	1	5915	17	1	5996	8061	5996	2	2890
EDO. ZULIA	MP. CATATUMBO	PQ. ENCONTRADOS	21	9945	105	27	3979	0	7526	18	3	7631	11991	7631	0	3526
EDO. ZULIA	MP. SIMON BOLIVAR	PQ. RAFAEL MARIA BARALT	22	11251	195	22	5675	5	9197	23	8	9392	11251	9392	4	3482
EDO. ZULIA	MP. SIMON BOLIVAR	PQ. MANUEL MANRIQUE	33	17577	287	33	6828	5	14237	51	3	14524	17577	14524	4	7346
EDO. ZULIA	MP. SIMON BOLIVAR	PQ. RAFAEL URDANETA	7	3420	69	7	1728	2	2636	11	2	2705	3420	2705	2	891
EDO. ZULIA	MP. MACHIQUES DE P	PQ. SAN JOSE DE PERIJA	24	12787	102	24	4055	1	8885	24	3	8987	12787	8987	1	4801
EDO. ZULIA	MP. MACHIQUES DE P	PQ. RIO NEGRO	10	4266	57	10	2035	0	2793	8	4	2850	4266	2850	0	746
EDO. ZULIA	MP. MACHIQUES DE P	PQ. LIBERTAD	99	48119	621	100	19148	12	35040	132	20	35661	48618	35661	2	15726
EDO. ZULIA	MP. MACHIQUES DE P	PQ.BARTOLOME DE LAS CASAS	18	9748	116	18	3468	0	6927	19	3	7043	9748	7043	0	3437
EDO. ZULIA	MP. SAN FRANCISCO	PQ. LOS CORTIJOS	56	28556	394	56	15084	4	22098	70	9	22492	28556	22492	9	6922
EDO. ZULIA	MP. SAN FRANCISCO	PQ. DOMITILA FLORES	166	84877	1127	169	41385	6	66863	263	34	67990	86554	67990	15	25160
EDO. ZULIA	MP. SAN FRANCISCO	PQ. MARCIAL HERNANDEZ	31	16408	188	31	8624	2	12968	28	6	13156	16408	13156	2	4306
EDO. ZULIA	MP. SAN FRANCISCO	PQ. SAN FRANCISCO	149	79371	774	149	32456	6	65825	185	16	66599	79371	66599	26	33136
EDO. ZULIA	MP. SAN FRANCISCO	PQ. EL BAJO	23	11713	128	23	5998	2	9670	27	7	9798	11713	9798	2	3634
EDO. ZULIA	MP. SAN FRANCISCO	PQ. FRANCISCO OCHOA	97	50605	582	97	20282	5	40780	122	24	41362	50605	41362	15	20332
EDO. ZULIA	MP. SANTA RITA	PQ. PEDRO LUCAS URRIBARRI	8	3438	55	8	1657	0	2677	5	0	2732	3438	2732	0	1015
EDO. ZULIA	MP. SANTA RITA	PQ. JOSE CENOVIO URRIBARR	21	10805	131	21	4920	5	8767	28	2	8898	10805	8898	2	3810
EDO. ZULIA	MP. SANTA RITA	PQ. EL MENE	8	4099	42	8	1932	1	3356	16	1	3398	4099	3398	3	1403
EDO. ZULIA	MP. SANTA RITA	PQ. SANTA RITA	42	20725	268	42	9913	4	16909	60	5	17177	20725	17177	5	6922
EDO. ZULIA	MP.VALMORE RODRIGUEZ	PQ. LA VICTORIA	37	19448	352	37	7847	4	15478	74	11	15830	19448	15830	4	7538
EDO. ZULIA	MP.VALMORE RODRIGUEZ	PQ. RAUL CUENCA	20	9772	170	20	5135	1	7919	30	10	8089	9772	8089	1	2742
EDO. ZULIA	MP.VALMORE RODRIGUEZ	PQ. RAFAEL URDANETA	16	7606	158	16	3061	1	5901	32	2	6059	7606	6059	2	2803
EDO. ZULIA	MP. SUCRE	PQ. ROMULO GALLEGOS	27	14285	238	28	6575	2	11017	46	6	11255	14843	11255	3	4385
EDO. ZULIA	MP. SUCRE	PQ. EL BATEY	9	4547	62	9	2470	3	3497	11	1	3559	4547	3559	1	1011
EDO. ZULIA	MP. SUCRE	PQ. GIBRALTAR	17	7026	103	17	3604	1	5272	8	2	5375	7026	5375	0	1657
EDO. ZULIA	MP. SUCRE	PQ. BOBURES	10	4189	66	10	2051	1	3173	3	0	3239	4189	3239	2	1116
EDO. ZULIA	MP. SUCRE	PQ. HERAS	11	4142	67	11	1944	2	2967	7	0	3034	4142	3034	1	1013
EDO. ZULIA	MP. SUCRE	PQ. M.ARTURO CELESTINO A	10	4854	69	10	2287	2	3724	6	2	3793	4854	3793	1	1426
EDO. ZULIA	MP. BARALT	PQ. GENERAL URDANETA	19	8085	73	19	4740	0	6307	23	2	6380	8085	6380	1	1541
EDO. ZULIA	MP. BARALT	PQ. MARCELINO BRICE#O	8	3604	30	8	1814	1	2594	3	0	2624	3604	2624	0	776
EDO. ZULIA	MP. BARALT	PQ. PUEBLO NUEVO	36	17174	256	36	8094	2	13561	82	8	13817	17174	13817	2	5373
EDO. ZULIA	MP. BARALT	PQ. MANUEL GUANIPA MATOS	16	7759	92	16	3607	1	6239	16	1	6331	7759	6331	1	2613
EDO. ZULIA	MP. BARALT	PQ. SAN TIMOTEO	11	5368	47	11	2952	0	4480	20	0	4527	5368	4527	1	1507
EDO. ZULIA	MP. BARALT	PQ. LIBERTADOR	28	13578	179	28	6197	1	10674	42	6	10853	13578	10853	1	4427
EDO. ZULIA	MP. CABIMAS	PQ. ARISTIDES CALVANI	8	2452	34	13	1251	0	1972	6	1	2006	4065	2006	0	714
EDO. ZULIA	MP. CABIMAS	PQ. JORGE HERNANDEZ	59	29999	486	59	16041	5	24996	75	13	25482	29999	25482	8	8854
EDO. ZULIA	MP. CABIMAS	PQ. AMBROSIO	69	35676	388	70	13592	6	29226	125	15	29614	36217	29614	12	15476
EDO. ZULIA	MP. CABIMAS	PQ. LA ROSA	44	22456	299	45	9895	3	18649	71	5	18948	22983	18948	8	8667
EDO. ZULIA	MP. CABIMAS	PQ. GERMAN RIOS LINARES	52	26529	373	53	14073	4	22166	75	9	22539	27037	22539	9	7996
EDO. ZULIA	MP. CABIMAS	PQ. CARMEN HERRERA	47	24306	300	47	8959	3	20262	62	9	20562	24306	20562	7	11222
EDO. ZULIA	MP. CABIMAS	PQ. PUNTA GORDA	13	6419	80	14	3492	1	5285	25	0	5365	6574	5365	3	1764
EDO. ZULIA	MP. CABIMAS	PQ. SAN BENITO	29	14873	215	29	8000	2	12387	50	7	12602	14873	12602	6	4322
EDO. ZULIA	MP. CABIMAS	PQ. ROMULO BETANCOURT	33	16553	196	33	9041	3	13797	52	4	13993	16553	13993	4	4693
EDO. ZULIA	MP.ROSARIO DE PERIJA	PQ. EL ROSARIO	84	44665	572	84	17849	7	33565	86	17	34137	44665	34137	4	15602
EDO. ZULIA	MP.ROSARIO DE PERIJA	PQ. SIXTO ZAMBRANO	13	6348	51	15	2467	0	4030	3	0	4081	7426	4081	0	1560
EDO. ZULIA	MP.ROSARIO DE PERIJA	PQ. DONALDO GARCIA	6	3044	8	7	1902	0	2209	1	0	2217	3601	2217	0	306
EDO. ZULIA	CE. MARACAIBO	PQ. CHIQUINQUIRA	88	45743	536	88	11103	8	35732	105	11	36268	45743	36268	18	24487
EDO. ZULIA	CE. MARACAIBO	PQ. CRISTO DE ARANZA	149	78722	917	149	29194	8	63286	144	24	64203	78722	64203	19	33897
EDO. ZULIA	CE. MARACAIBO	PQ. JUANA DE AVILA	102	53750	458	103	13455	2	43848	100	19	44306	54308	44306	15	30257
EDO. ZULIA	CE. MARACAIBO	PQ. ANTONIO BORJAS ROMERO	87	44647	664	87	21547	11	33313	111	9	33977	44647	33977	13	11622
EDO. ZULIA	CE. MARACAIBO	PQ. RAUL LEONI	82	44558	350	82	11392	4	36836	62	9	37186	44558	37186	19	25350
EDO. ZULIA	CE. MARACAIBO	PQ. IDELFONZO VASQUEZ	132	68941	949	132	29462	18	47240	149	28	48189	68941	48189	12	17571
EDO. ZULIA	CE. MARACAIBO	PQ. CACIQUE MARA	90	48761	563	90	18282	0	38753	98	17	39316	48761	39316	21	20335
EDO. ZULIA	CE. MARACAIBO	PQ. LUIS HURTADO HIGUERA	72	37636	457	72	19336	4	29897	82	7	30354	37636	30354	7	10461
EDO. ZULIA	CE. MARACAIBO	PQ. MANUEL DAGNINO	103	52825	649	103	22115	4	42727	128	18	43376	52825	43376	25	20437
EDO. ZULIA	CE. MARACAIBO	PQ. VENANCIO PULGAR	116	59233	858	117	27920	18	44360	105	31	45218	59722	45218	18	16268
EDO. ZULIA	CE. MARACAIBO	PQ. OLEGARIO VILLALOBOS	122	65123	512	122	11209	2	50636	97	15	51148	65123	51148	25	39288
EDO. ZULIA	CE. MARACAIBO	PQ.CARACCIOLO PARRA PEREZ	92	47632	498	92	13299	4	36745	88	7	37243	47632	37243	24	23323
EDO. ZULIA	CE. MARACAIBO	PQ. SAN ISIDRO	36	18598	218	36	9422	2	13409	38	11	13627	18598	13627	5	3931
EDO. ZULIA	CE. MARACAIBO	PQ. FRANCISCO EUGENIO B	192	99774	1286	194	44601	15	80580	204	53	81866	100937	81866	40	35667
EDO. ZULIA	CE. MARACAIBO	PQ. SANTA LUCIA	57	29995	306	58	7887	3	23642	49	7	23948	30516	23948	12	15684
EDO. ZULIA	CE. MARACAIBO	PQ. COQUIVACOA	127	65957	728	127	22832	2	52776	119	13	53504	65957	53504	23	29787
EDO. ZULIA	CE. MARACAIBO	PQ. BOLIVAR	38	19734	160	39	5149	2	15414	29	6	15574	20244	15574	5	10223
EDO. ZULIA	CE. MARACAIBO	PQ. CECILIO ACOSTA	77	41614	433	77	13090	2	34018	86	14	34451	41614	34451	15	20811
EDO. ZULIA	MP. JESUS M SEMPRUN	PQ. BARI	8	3544	32	11	2116	1	2575	14	0	2607	4087	2607	0	444
EDO. ZULIA	MP. JESUS M SEMPRUN	PQ. JESUS M SEMPRUN	28	11805	150	28	6045	0	9276	40	2	9426	11805	9426	1	3188
EDO. ZULIA	MP. FRANCISCO J PULG	PQ. SIMON RODRIGUEZ	23	10324	197	24	4288	1	7818	14	3	8015	10621	8015	1	3511
EDO. ZULIA	MP. FRANCISCO J PULG	PQ. CARLOS QUEVEDO	11	5767	99	11	2599	2	4385	8	4	4484	5767	4484	1	1771
EDO. ZULIA	MP. FRANCISCO J PULG	PQ. FRANCISCO J PULGAR	5	2522	35	5	1018	0	1988	4	0	2023	2522	2023	0	966
EDO. ZULIA	MP. MARA	PQ. LAS PARCELAS	19	9621	81	19	6007	2	7662	16	8	7743	9621	7743	1	1628
EDO. ZULIA	MP. MARA	PQ. MONS.MARCOS SERGIO G	6	2924	18	6	1638	0	2029	1	0	2047	2924	2047	0	390
EDO. ZULIA	MP. MARA	PQ. LA SIERRITA	55	26644	307	55	14122	3	19678	62	11	19985	26644	19985	4	5476
EDO. ZULIA	MP. MARA	PQ. SAN RAFAEL	57	30246	220	57	17586	5	24459	46	7	24679	30246	24679	6	6809
EDO. ZULIA	MP. MARA	PQ. LUIS DE VICENTE	25	11513	106	25	5627	0	8905	26	8	9011	11513	9011	0	3244
EDO. ZULIA	MP. MARA	PQ. RICAURTE	58	30593	485	58	15529	9	23296	86	13	23781	30593	23781	6	7653
EDO. ZULIA	MP. MARA	PQ. TAMARE	20	10142	98	20	5482	1	7763	24	4	7861	10142	7861	1	2251
EDO. ZULIA	MP. MIRANDA	PQ. SAN ANTONIO	16	6175	103	16	2957	2	4883	17	4	4986	6175	4986	2	1901
EDO. ZULIA	MP. MIRANDA	PQ. SAN JOSE	26	12947	131	27	7802	1	10636	20	1	10767	13445	10767	3	2809
EDO. ZULIA	MP. MIRANDA	PQ. ALTAGRACIA	74	35262	465	76	19586	4	29714	87	10	30179	36131	30179	6	10021
EDO. ZULIA	MP. MIRANDA	PQ. ANA MARIA CAMPOS	13	5345	71	13	2608	1	4294	24	2	4365	5345	4365	1	1658
EDO. ZULIA	MP. MIRANDA	PQ. FARIA	10	4002	61	11	2219	0	3358	4	1	3419	4296	3419	1	1133
EDO. ANZOATEGUI	MP. INDEPENDENCIA	PQ. MAMO	11	5069	120	12	3345	1	4016	19	6	4136	5218	4136	2	643
EDO. ANZOATEGUI	MP. INDEPENDENCIA	CM. SOLEDAD	39	17714	332	41	9098	3	13299	79	9	13631	18665	13631	6	4104
EDO. ANZOATEGUI	MP. FREITES	CM. CANTAURA	82	41165	636	83	18295	9	33370	208	18	34006	41715	34006	6	14834
EDO. ANZOATEGUI	MP. FREITES	PQ. URICA	10	4963	57	10	2379	3	3897	14	3	3954	4963	3954	1	1497
EDO. ANZOATEGUI	MP. FREITES	PQ. SANTA ROSA	10	4425	53	10	2258	0	3597	15	2	3650	4425	3650	0	1322
EDO. ANZOATEGUI	MP. FREITES	PQ. LIBERTADOR
EDO. ANZOATEGUI	MP. CARVAJAL	PQ. SANTA BARBARA	2	992	15	2	478	0	815	0	0	830	992	830	0	337
EDO. ANZOATEGUI	MP. CARVAJAL	PQ. VALLE GUANAPE	18	8840	130	18	3806	1	7129	32	4	7259	8840	7259	2	3284
EDO. ANZOATEGUI	MP. ARAGUA	CM. ARAGUA DE BARCELONA	49	20423	305	49	9537	10	16344	109	14	16649	20423	16649	4	6670
EDO. ANZOATEGUI	MP. ARAGUA	PQ. CACHIPO	2	931	21	3	541	1	728	4	0	749	1397	749	1	181
EDO. ANZOATEGUI	MP. MONAGAS	PQ. PIAR	3	1218	16	3	543	0	908	1	0	924	1218	924	0	364
EDO. ANZOATEGUI	MP. MONAGAS	PQ. UVERITO	4	1906	48	4	805	0	1442	11	0	1490	1906	1490	2	624
EDO. ANZOATEGUI	MP. MONAGAS	PQ. ZUATA	5	2414	58	5	1197	0	1743	8	1	1801	2414	1801	0	537
EDO. ANZOATEGUI	MP. MONAGAS	PQ. SANTA CLARA	5	2427	51	5	1279	0	1828	9	4	1879	2427	1879	0	536
EDO. ANZOATEGUI	MP. MONAGAS	CM. MAPIRE	6	2523	66	8	1133	1	1922	17	3	1988	3374	1988	0	768
EDO. ANZOATEGUI	MP. MONAGAS	PQ. SN DIEGO DE CABRUTICA	9	4091	75	9	2284	2	3061	17	1	3136	4091	3136	0	757
EDO. ANZOATEGUI	MP. LIBERTAD	CM. SAN MATEO	16	8224	121	16	3625	0	6239	43	3	6360	8224	6360	0	2568
EDO. ANZOATEGUI	MP. LIBERTAD	PQ. EL CARITO	3	1598	17	3	614	0	1176	7	0	1193	1598	1193	0	555
EDO. ANZOATEGUI	MP. LIBERTAD	PQ. SANTA INES	4	2057	19	6	921	0	1506	7	1	1525	3056	1525	0	577
EDO. ANZOATEGUI	MP. GUANTA	PQ. GUANTA	31	15499	297	31	6373	2	12850	55	2	13147	15499	13147	1	6417
EDO. ANZOATEGUI	MP. GUANTA	PQ. CHORRERON	19	8858	201	19	4356	1	7025	50	2	7226	8858	7226	4	2612
EDO. ANZOATEGUI	CE. BOLIVAR	PQ. SAN CRISTOBAL	242	122011	1998	247	49917	25	96458	705	57	98456	124779	98456	38	45716
EDO. ANZOATEGUI	CE. BOLIVAR	PQ. CAIGUA	8	4074	90	8	2010	1	3126	16	2	3216	4074	3216	2	1095
EDO. ANZOATEGUI	CE. BOLIVAR	PQ. BERGANTIN	6	3450	49	8	1526	0	2405	17	4	2454	3662	2454	0	858
EDO. ANZOATEGUI	CE. BOLIVAR	PQ. EL CARMEN	226	118878	1984	229	48068	39	96096	582	48	98080	120558	98080	40	47319
EDO. ANZOATEGUI	CE. BOLIVAR	PQ. NARICUAL	24	10487	232	25	4595	2	7742	70	4	7974	10880	7974	2	3069
EDO. ANZOATEGUI	CE. BOLIVAR	PQ. EL PILAR	5	2337	20	5	999	1	1653	13	2	1673	2337	1673	1	637
EDO. ANZOATEGUI	MP. PE#ALVER	CM. PUERTO PIRITU	32	16838	308	32	6775	6	13656	112	10	13964	16838	13964	5	6748
EDO. ANZOATEGUI	MP. PE#ALVER	PQ. SUCRE	5	2072	33	5	955	0	1623	8	0	1656	2072	1656	0	660
EDO. ANZOATEGUI	MP. PE#ALVER	PQ. SAN MIGUEL	5	2589	56	5	1190	0	2044	14	0	2100	2589	2100	0	840
EDO. ANZOATEGUI	MP. SOTILLO	CM. PUERTO LA CRUZ	108	56446	768	108	19287	19	44533	230	25	45301	56446	45301	22	24950
EDO. ANZOATEGUI	MP. SOTILLO	PQ. POZUELOS	222	110768	1782	226	47294	37	87702	538	50	89484	112708	89484	51	39732
EDO. ANZOATEGUI	MP. GUANIPA	CM. SAN JOSE DE GUANIPA	101	50706	789	103	22772	6	41011	298	14	41800	51674	41800	14	17907
EDO. ANZOATEGUI	MP. MIRANDA	CM. PARIAGUAN	45	23049	467	46	10458	3	18180	142	14	18647	23640	18647	7	7556
EDO. ANZOATEGUI	MP. MIRANDA	PQ. EL PAO	6	2837	54	6	1248	0	2186	12	3	2240	2837	2240	0	923
EDO. ANZOATEGUI	MP. MIRANDA	PQ. ATAPIRIRE	9	3387	85	9	1340	1	2538	17	1	2623	3387	2623	0	1179
EDO. ANZOATEGUI	MP. MIRANDA	PQ. BOCA DEL PAO	5	2201	26	5	889	0	1474	1	2	1500	2201	1500	0	582
EDO. ANZOATEGUI	MP. CAJIGAL	PQ. SAN PABLO	5	2094	28	5	1188	0	1699	2	2	1727	2094	1727	1	506
EDO. ANZOATEGUI	MP. CAJIGAL	CM. ONOTO	16	7378	122	17	3449	3	5602	48	2	5724	7724	5724	1	2099
EDO. ANZOATEGUI	MP. SANTA ANA	PQ. SANTA ANA	14	6877	95	14	2777	2	5557	41	4	5652	6877	5652	0	2733
EDO. ANZOATEGUI	MP. SANTA ANA	PQ. PUEBLO NUEVO	3	955	27	3	444	1	689	4	1	716	955	716	1	238
EDO. ANZOATEGUI	MP. PIRITU	PQ. SAN FRANCISCO	2	703	6	2	346	0	566	2	0	572	703	572	0	218
EDO. ANZOATEGUI	MP. PIRITU	PQ. PIRITU	34	16893	343	35	7619	1	13774	69	9	14117	17337	14117	6	6070
EDO. ANZOATEGUI	MP. BRUZUAL	PQ. GUANAPE	13	5507	87	13	2250	1	4210	25	5	4297	5507	4297	0	1929
EDO. ANZOATEGUI	MP. BRUZUAL	PQ. SABANA DE UCHIRE	9	4161	68	9	1627	0	3251	24	4	3319	4161	3319	1	1595
EDO. ANZOATEGUI	MP. BRUZUAL	CM. CLARINES	25	12052	243	25	4772	4	9808	36	3	10051	12052	10051	2	4991
EDO. ANZOATEGUI	MP. ANACO	PQ. SAN JOAQUIN	11	6197	120	12	2841	1	4866	41	3	4986	6536	4986	0	1980
EDO. ANZOATEGUI	MP. ANACO	PQ. ANACO	154	79557	1526	155	31500	15	64320	525	41	65846	80156	65846	32	32207
EDO. ANZOATEGUI	MP.S JUAN CAPISTRANO	PQ. BOCA UCHIRE	12	6041	108	12	2618	3	4687	30	3	4795	6041	4795	1	2032
EDO. ANZOATEGUI	MP.S JUAN CAPISTRANO	PQ. BOCA DE CHAVEZ	2	833	22	2	346	0	646	4	0	668	833	668	0	296
EDO. ANZOATEGUI	MP. SIMON RODRIGUEZ	CM. EL TIGRE	221	113514	1973	222	42636	25	90755	619	35	92728	113972	92728	29	47411
EDO. ANZOATEGUI	MP. MC GREGOR	PQ.TOMAS ALFARO CALATRAVA	3	1708	15	3	1034	1	1228	9	3	1243	1708	1243	0	181
EDO. ANZOATEGUI	MP. MC GREGOR	PQ. EL CHAPARRO	13	5875	88	13	3086	1	4446	18	4	4534	5875	4534	0	1337
EDO. ANZOATEGUI	MP. L/DIEGO BAUTISTA	PQ. EL MORRO	10	5147	30	10	771	0	4238	13	1	4268	5147	4268	1	3452
EDO. ANZOATEGUI	MP. L/DIEGO BAUTISTA	PQ. LECHERIAS	53	26981	167	53	3934	3	22374	44	1	22541	26981	22541	12	18380
EDO. LARA	MP. ANDRES E BLANCO	PQ. PIO TAMAYO	48	20902	312	48	9905	8	17083	100	7	17395	20902	17395	8	7055
EDO. LARA	MP. ANDRES E BLANCO	PQ. YACAMBU	16	4449	67	22	2355	4	3227	18	6	3294	5816	3294	1	843
EDO. LARA	MP. ANDRES E BLANCO	PQ. QBDA. HONDA DE GUACHE	13	4165	24	13	2871	2	3184	7	4	3208	4165	3208	2	298
EDO. LARA	MP. MORAN	PQ. HILARIO LUNA Y LUNA	21	6883	99	21	4200	9	4918	36	10	5017	6883	5017	1	662
EDO. LARA	MP. MORAN	PQ. HUMOCARO BAJO	21	8040	162	22	3820	5	6138	29	16	6300	8166	6300	1	2267
EDO. LARA	MP. MORAN	PQ. HUMOCARO ALTO	14	6392	102	14	3984	2	4942	31	9	5044	6392	5044	1	915
EDO. LARA	MP. MORAN	PQ. ANZOATEGUI	13	3962	68	13	2145	3	2951	14	3	3019	3962	3019	0	786
EDO. LARA	MP. MORAN	PQ. GUARICO	28	10726	163	29	5852	11	8176	68	17	8339	10963	8339	3	2225
EDO. LARA	MP. MORAN	PQ. BOLIVAR	99	45937	837	101	21322	12	36608	228	27	37445	46370	37445	16	15003
EDO. LARA	MP. MORAN	PQ. LA CANDELARIA	4	1505	28	4	926	0	1026	1	1	1054	1505	1054	1	97
EDO. LARA	MP. MORAN	PQ. MORAN	8	2843	62	8	1539	0	2089	13	5	2151	2843	2151	2	530
EDO. LARA	MP. JIMENEZ	PQ. CRNEL. MARIANO PERAZA	21	9087	188	21	4532	5	7524	62	9	7712	9087	7712	10	2906
EDO. LARA	MP. JIMENEZ	PQ. JUAN B RODRIGUEZ	53	26839	411	53	13000	10	21689	152	13	22100	26839	22100	14	8500
EDO. LARA	MP. JIMENEZ	PQ. TINTORERO	17	8003	157	17	4454	3	6503	41	8	6660	8003	6660	7	1990
EDO. LARA	MP. JIMENEZ	PQ. SAN MIGUEL	7	2761	22	7	1696	1	2156	21	2	2178	2761	2178	0	436
EDO. LARA	MP. JIMENEZ	PQ. PARAISO DE SAN JOSE	2	867	13	3	603	0	694	1	1	707	1105	707	0	89
EDO. LARA	MP. JIMENEZ	PQ. CUARA	8	3316	48	8	1810	1	2687	23	3	2735	3316	2735	0	850
EDO. LARA	MP. JIMENEZ	PQ. DIEGO DE LOZADA	12	5383	114	12	2792	0	4279	36	5	4393	5383	4393	0	1446
EDO. LARA	MP. JIMENEZ	PQ. JOSE BERNARDO DORANTE	17	7879	163	17	4379	2	6378	46	7	6541	7879	6541	3	1941
EDO. LARA	MP. TORRES	PQ. EL BLANCO	10	4880	56	17	2114	1	3730	16	1	3786	6158	3786	0	1598
EDO. LARA	MP. TORRES	PQ. MANUEL MORILLO	4	2230	38	6	1160	0	1697	6	0	1735	2858	1735	1	530
EDO. LARA	MP. TORRES	PQ. LAS MERCEDES	12	4906	97	14	2298	3	3773	18	2	3870	5719	3870	1	1451
EDO. LARA	MP. TORRES	PQ. TORRES	2	1113	14	2	463	0	730	4	2	744	1113	744	0	261
EDO. LARA	MP. TORRES	PQ. ANTONIO DIAZ	6	2790	42	9	1251	0	2024	9	1	2066	3626	2066	1	762
EDO. LARA	MP. TORRES	PQ. CECILIO ZUBILLAGA	9	4137	68	10	2476	0	3309	15	3	3377	4595	3377	1	814
EDO. LARA	MP. TORRES	PQ. TRINIDAD SAMUEL	142	69893	1186	149	28039	24	57307	294	31	58493	73550	58493	24	28895
EDO. LARA	MP. TORRES	PQ. LARA	2	1027	13	3	491	0	816	4	1	829	1133	829	1	319
EDO. LARA	MP. TORRES	PQ. CHIQUINQUIRA	7	3476	44	9	1635	0	2721	9	1	2765	3767	2765	1	1075
EDO. LARA	MP. TORRES	PQ. MONTA A VERDE	12	5345	71	19	2523	1	3888	38	10	3959	7390	3959	3	1313
EDO. LARA	MP. TORRES	PQ. ESPINOZA LOS MONTEROS	9	4163	82	9	2123	1	3279	16	2	3361	4163	3361	3	1134
EDO. LARA	MP. TORRES	PQ. HERIBERTO ARROYO	1	293	2	1	154	2	215	0	0	217	293	217	0	59
EDO. LARA	MP. TORRES	PQ. CASTA#EDA	4	2072	31	7	920	2	1604	15	0	1635	2859	1635	2	665
EDO. LARA	MP. TORRES	PQ. MONTES DE OCA	4	1840	30	8	797	0	1357	6	0	1387	2951	1387	1	553
EDO. LARA	MP. TORRES	PQ. CAMACARO	9	4735	67	15	2664	1	3907	5	5	3974	6932	3974	0	1232
EDO. LARA	MP. TORRES	PQ. ALTAGRACIA	2	967	7	6	351	0	786	3	0	793	1426	793	2	430
EDO. LARA	MP. TORRES	PQ. REYES VARGAS
EDO. LARA	MP. SIMON PLANAS	PQ. SARARE	24	11545	198	24	6756	7	9194	43	10	9392	11545	9392	6	2372
EDO. LARA	MP. SIMON PLANAS	PQ. GUSTAVO VEGAS LEON	17	7946	128	17	4819	5	6456	43	3	6584	7946	6584	1	1585
EDO. LARA	MP. SIMON PLANAS	PQ. BURIA	12	5353	112	12	3059	2	4106	27	5	4218	5353	4218	2	1011
EDO. LARA	MP. CRESPO	PQ. JOSE MARIA BLANCO	23	11356	272	23	5290	1	9142	61	18	9414	11356	9414	4	3768
EDO. LARA	MP. CRESPO	PQ. FREITEZ	48	21884	414	49	8675	9	17250	98	17	17664	22372	17664	14	8437
EDO. LARA	MP. PALAVECINO	PQ. CABUDARE	85	41539	545	85	14259	7	34941	238	22	35486	41539	35486	18	20397
EDO. LARA	MP. PALAVECINO	PQ. AGUA VIVA	18	9681	188	18	4055	2	8093	46	12	8281	9681	8281	4	3974
EDO. LARA	MP. PALAVECINO	PQ. JOSE G. BASTIDAS	99	51077	601	99	15268	7	44389	164	27	44990	51077	44990	17	28906
EDO. LARA	MP. URDANETA	PQ. MOROTURO	37	14397	196	37	8198	6	11233	72	17	11429	14397	11429	3	2937
EDO. LARA	MP. URDANETA	PQ. SIQUISIQUE	47	15851	217	50	8164	5	12603	66	18	12820	17130	12820	2	4348
EDO. LARA	MP. URDANETA	PQ. XAGUAS	9	2469	27	11	831	0	1865	7	2	1892	2805	1892	0	1025
EDO. LARA	MP. URDANETA	PQ. SAN MIGUEL	29	8986	90	29	4794	2	7131	44	11	7221	8986	7221	2	2278
EDO. LARA	CE. IRIBARREN	PQ. TAMACA	75	36178	657	78	16868	11	28974	268	38	29631	37542	29631	12	11777
EDO. LARA	CE. IRIBARREN	PQ. SANTA ROSA	108	57271	717	108	15671	14	48275	217	27	48992	57271	48992	29	32317
EDO. LARA	CE. IRIBARREN	PQ. CATEDRAL	197	98537	1308	199	26765	15	81339	421	52	82647	99534	82647	37	54049
EDO. LARA	CE. IRIBARREN	PQ. AGUEDO F. ALVARADO	19	7866	143	36	3705	3	6202	49	7	6345	14970	6345	1	2437
EDO. LARA	CE. IRIBARREN	PQ. EL CUJI	56	27422	431	56	11873	6	22562	185	24	22993	27422	22993	21	10453
EDO. LARA	CE. IRIBARREN	PQ. UNION	191	97254	1764	194	44397	28	78951	566	39	80715	98434	80715	50	33871
EDO. LARA	CE. IRIBARREN	PQ. LA CONCEPCION	231	117491	1512	232	32832	21	98113	460	48	99625	118079	99625	68	64684
EDO. LARA	CE. IRIBARREN	PQ. JUAREZ	21	9940	201	22	4795	2	7598	51	11	7799	10161	7799	7	2732
EDO. LARA	CE. IRIBARREN	PQ. JUAN DE VILLEGAS	416	208648	3700	422	96880	64	169713	1269	157	173413	211716	173413	110	71233
EDO. LARA	CE. IRIBARREN	PQ. BUENA VISTA	13	4791	55	14	2688	5	3513	17	5	3568	5270	3568	2	796
EDO. ARAGUA	MP.OCUMARE D L COSTA	PQ. OCUMARE DE LA COSTA	18	8585	140	18	4057	2	6521	26	2	6661	8585	6661	2	2432
EDO. ARAGUA	MP. SANTOS MICHELENA	PQ. TIARA	8	2993	102	8	1800	0	2262	9	1	2364	2993	2364	1	451
EDO. ARAGUA	MP. SANTOS MICHELENA	CM. LAS TEJERIAS	43	21289	434	43	13141	8	16934	51	9	17368	21289	17368	4	3721
EDO. ARAGUA	MP. JOSE ANGEL LAMAS	CM. SANTA CRUZ	48	22721	302	48	11485	4	19052	94	15	19354	22721	19354	9	7445
EDO. ARAGUA	MP. CAMATAGUA	CM. CAMATAGUA	19	8631	131	19	4697	1	6729	47	3	6860	8631	6860	1	1980
EDO. ARAGUA	MP. CAMATAGUA	PQ. CARMEN DE CURA	7	3195	77	7	1456	0	2377	14	1	2454	3195	2454	0	906
EDO. ARAGUA	MP.FRANCISCO LINARES	PQ. FRANCISCO DE MIRANDA	34	17704	332	34	9291	6	14201	67	7	14533	17704	14533	12	4818
EDO. ARAGUA	MP.FRANCISCO LINARES	CM. SANTA RITA	106	53578	997	108	30587	6	43652	230	39	44649	54711	44649	30	12760
EDO. ARAGUA	MP.FRANCISCO LINARES	PQ. MONS FELICIANO G	21	11007	142	21	6875	0	8897	47	3	9039	11007	9039	5	1967
EDO. ARAGUA	MP. JOSE R REVENGA	CM. EL CONSEJO	63	30956	528	63	19022	12	25541	104	22	26069	30956	26069	12	6369
EDO. ARAGUA	MP. SUCRE	CM. CAGUA	146	76296	1253	146	33000	17	63280	311	23	64533	76296	64533	46	29883
EDO. ARAGUA	MP. SUCRE	PQ. BELLA VISTA	13	6452	145	13	3755	2	5066	17	6	5211	6452	5211	3	1283
EDO. ARAGUA	MP. LIBERTADOR	CM. PALO NEGRO	46	24060	373	46	12429	3	19544	96	7	19917	24060	19917	18	6991
EDO. ARAGUA	MP. LIBERTADOR	PQ. SAN MARTIN DE PORRES	72	36081	624	72	19970	7	29833	145	24	30457	36081	30457	21	9666
EDO. ARAGUA	MP. TOVAR	CM. COLONIA TOVAR	31	12296	237	32	4874	7	9315	40	9	9552	12552	9552	4	4381
EDO. ARAGUA	MP. BOLIVAR	CM. SAN MATEO	57	28943	734	58	16072	4	22537	101	13	23271	29497	23271	6	6341
EDO. ARAGUA	MP. MARIO B IRAGORRY	CM. EL LIMON	55	29383	373	56	9651	5	24332	77	21	24705	29961	24705	23	14555
EDO. ARAGUA	MP. MARIO B IRAGORRY	PQ. CA A DE AZUCAR	92	47535	632	93	21793	10	40492	162	27	41124	48021	41124	30	18470
EDO. ARAGUA	MP. URDANETA	PQ. TAGUAY	8	3321	67	8	1988	1	2689	19	1	2756	3321	2756	2	678
EDO. ARAGUA	MP. URDANETA	PQ. SAN FRANCISCO DE CARA	4	1968	41	4	1099	0	1569	4	0	1610	1968	1610	0	466
EDO. ARAGUA	MP. URDANETA	CM. BARBACOAS	18	8621	231	18	4826	0	6914	32	4	7145	8621	7145	4	2048
EDO. ARAGUA	MP. URDANETA	PQ. LAS PE#ITAS	4	1697	47	4	937	1	1324	5	1	1371	1697	1371	1	379
EDO. ARAGUA	MP. JOSE FELIX RIVAS	CM. JUAN VICENTE BOLIVAR	83	42860	731	84	19630	13	34631	178	27	35362	43361	35362	23	14760
EDO. ARAGUA	MP. JOSE FELIX RIVAS	PQ. CASTOR NIEVES RIOS	63	33499	536	65	14035	2	28504	118	12	29040	34508	29040	23	14314
EDO. ARAGUA	MP. JOSE FELIX RIVAS	PQ. ZUATA	39	18495	334	39	11870	3	14880	72	8	15214	18495	15214	6	2921
EDO. ARAGUA	MP. JOSE FELIX RIVAS	PQ. PAO DE ZARATE	4	2280	33	4	1466	1	1807	6	3	1840	2280	1840	2	329
EDO. ARAGUA	MP. JOSE FELIX RIVAS	PQ. LAS GUACAMAYAS	10	4472	96	11	2430	2	3525	17	1	3621	4978	3621	1	1074
EDO. ARAGUA	MP. SAN SEBASTIAN	CM. SAN SEBASTIAN	34	16236	244	34	8062	3	12969	39	11	13213	16236	13213	5	4849
EDO. ARAGUA	MP. ZAMORA	PQ. MAGDALENO	27	12857	294	27	7280	3	10012	59	10	10306	12857	10306	3	2657
EDO. ARAGUA	MP. ZAMORA	CM. VILLA DE CURA	109	55981	921	109	30692	17	45692	250	47	46613	55981	46613	25	14661
EDO. ARAGUA	MP. ZAMORA	PQ. PQ AUGUSTO MIJARES	10	4693	113	10	2797	0	3605	22	1	3718	4693	3718	1	784
EDO. ARAGUA	MP. ZAMORA	PQ. VALLES DE TUCUTUNEMO	12	5991	156	12	3955	5	4728	32	6	4884	5991	4884	3	727
EDO. ARAGUA	MP. ZAMORA	PQ. SAN FRANCISCO DE ASIS	28	13724	280	28	7388	3	11137	60	5	11417	13724	11417	6	3675
EDO. ARAGUA	MP. SAN CASIMIRO	CM. SAN CASIMIRO	31	14809	324	31	7960	4	11811	42	8	12135	14809	12135	4	3793
EDO. ARAGUA	MP. SAN CASIMIRO	PQ. VALLE MORIN	3	1197	21	3	670	1	951	10	0	972	1197	972	2	268
EDO. ARAGUA	MP. SAN CASIMIRO	PQ. OLLAS DE CARAMACATE	4	943	14	4	551	0	695	6	1	709	943	709	0	137
EDO. ARAGUA	MP. SAN CASIMIRO	PQ. GUIRIPA	4	1479	32	4	869	0	1203	2	2	1235	1479	1235	0	330
EDO. ARAGUA	MP. SANTIAGO MARI#O	PQ. AREVALO APONTE	51	24736	417	53	13998	5	18566	91	11	18983	25832	18983	10	4451
EDO. ARAGUA	MP. SANTIAGO MARI#O	CM. TURMERO	77	40607	419	77	14192	10	33387	126	22	33806	40607	33806	26	19011
EDO. ARAGUA	MP. SANTIAGO MARI#O	PQ. ALFREDO PACHECO M	28	14469	230	28	7899	3	11737	69	5	11967	14469	11967	11	3750
EDO. ARAGUA	MP. SANTIAGO MARI#O	PQ. CHUAO	3	1129	10	3	769	0	890	3	1	900	1129	900	0	117
EDO. ARAGUA	MP. SANTIAGO MARI#O	PQ. SAMAN DE GUERE	92	48899	923	93	24760	7	39826	199	25	40749	49497	40749	16	14819
EDO. ARAGUA	CE. GIRARDOT	PQ. LOS TACARIGUAS	110	56568	827	110	29475	21	45538	219	20	46365	56568	46365	27	15776
EDO. ARAGUA	CE. GIRARDOT	PQ. MADRE MA DE SAN JOSE	105	54497	525	105	14489	9	44609	134	18	45134	54497	45134	25	29934
EDO. ARAGUA	CE. GIRARDOT	PQ. PEDRO JOSE OVALLES	84	43530	628	85	22062	8	35452	175	31	36080	44017	36080	25	13151
EDO. ARAGUA	CE. GIRARDOT	PQ. JOAQUIN CRESPO	86	44273	559	86	16151	10	36224	166	15	36783	44273	36783	28	19854
EDO. ARAGUA	CE. GIRARDOT	PQ. LAS DELICIAS	82	42963	564	82	15050	8	34301	146	25	34865	42963	34865	26	19046
EDO. ARAGUA	CE. GIRARDOT	PQ. ANDRES ELOY BLANCO	87	45717	492	87	17155	11	36718	153	20	37210	45717	37210	22	19357
EDO. ARAGUA	CE. GIRARDOT	PQ. JOSE CASANOVA GODOY	95	49560	751	95	19797	3	40210	169	24	40961	49560	40961	18	20199
EDO. ARAGUA	CE. GIRARDOT	PQ. CHORONI	7	3734	51	7	1980	1	2859	16	1	2910	3734	2910	0	861
EDO. MONAGAS	MP. SOTILLO	LOS BARRANCOS DE FAJARDO	12	4760	72	12	2991	1	3632	30	5	3704	4760	3704	0	605
EDO. MONAGAS	MP. SOTILLO	CM. BARRANCAS	21	10110	162	24	4608	0	7247	55	5	7409	11142	7409	2	2577
EDO. MONAGAS	MP. PUNCERES	CM. QUIRIQUIRE	26	11318	205	26	5703	4	8631	74	3	8836	11318	8836	3	2844
EDO. MONAGAS	MP. PUNCERES	PQ. CACHIPO	20	9919	154	20	4751	2	7711	42	0	7865	9919	7865	4	2912
EDO. MONAGAS	MP. CEDE#O	PQ. AREO	11	3971	60	13	2258	0	3027	22	1	3087	4264	3087	0	746
EDO. MONAGAS	MP. CEDE#O	CM. CAICARA	27	13399	169	30	4358	1	10697	58	14	10866	14928	10866	4	6262
EDO. MONAGAS	MP. CEDE#O	PQ. SAN FELIX	9	3550	33	9	1300	0	2791	9	0	2824	3550	2824	0	1482
EDO. MONAGAS	MP. CEDE#O	PQ. VIENTO FRESCO	5	2622	50	5	1129	0	2015	14	1	2065	2622	2065	1	870
EDO. MONAGAS	MP. PIAR	PQ. GUANAGUANA	10	3870	79	10	1816	0	2928	8	4	3007	3870	3007	1	1099
EDO. MONAGAS	MP. PIAR	PQ. APARICIO	8	2819	38	8	1352	0	2254	7	2	2292	2819	2292	0	893
EDO. MONAGAS	MP. PIAR	PQ. LA TOSCANA	16	7158	105	16	3590	2	5480	27	0	5585	7158	5585	2	1859
EDO. MONAGAS	MP. PIAR	CM. ARAGUA	14	7112	112	14	3566	0	5601	26	4	5713	7112	5713	0	2005
EDO. MONAGAS	MP. PIAR	PQ. EL PINTO	4	1549	17	6	852	3	1124	12	1	1141	2302	1141	0	256
EDO. MONAGAS	MP. PIAR	PQ. CHAGUARAMAL	14	5898	90	14	2786	2	4427	22	0	4517	5898	4517	3	1614
EDO. MONAGAS	MP. PIAR	PQ. TAGUAYA	6	2376	26	6	1140	0	1903	8	1	1929	2376	1929	0	754
EDO. MONAGAS	MP. ACOSTA	PQ. SAN FRANCISCO	12	5333	102	12	2281	1	3824	6	2	3926	5333	3926	3	1531
EDO. MONAGAS	MP. ACOSTA	CM. SAN ANTONIO	23	9888	163	23	3807	0	7640	27	2	7803	9888	7803	4	3800
EDO. MONAGAS	MP. LIBERTADOR	CM. TEMBLADOR	40	20803	371	41	11669	6	16461	132	6	16832	21323	16832	4	4644
EDO. MONAGAS	MP. LIBERTADOR	PQ. CHAGUARAMAS	7	3681	78	7	2230	1	2736	14	2	2814	3681	2814	1	488
EDO. MONAGAS	MP. LIBERTADOR	PQ. LAS ALHUACAS
EDO. MONAGAS	MP. LIBERTADOR	PQ. TABASCA	8	2715	49	8	1401	0	1974	16	3	2023	2715	2023	2	552
EDO. MONAGAS	MP. SANTA BARBARA	CM. SANTA BARBARA	16	7182	151	17	3522	0	5694	28	1	5845	7580	5845	5	2138
EDO. MONAGAS	MP. BOLIVAR	CM. CARIPITO	63	26627	438	64	12845	6	20221	101	4	20659	27194	20659	5	7260
EDO. MONAGAS	MP. CARIPE	PQ. LA GUANOTA	6	2118	16	6	918	0	1461	12	4	1477	2118	1477	2	525
EDO. MONAGAS	MP. CARIPE	PQ. SAN AGUSTIN	6	2794	48	6	1335	2	2080	8	3	2128	2794	2128	0	732
EDO. MONAGAS	MP. CARIPE	CM. CARIPE	17	8346	143	18	3295	2	6449	19	6	6592	8850	6592	1	3126
EDO. MONAGAS	MP. CARIPE	PQ. TERESEN	14	5603	95	14	2900	2	4055	9	4	4150	5603	4150	0	1140
EDO. MONAGAS	MP. CARIPE	PQ. SABANA DE PIEDRA	4	1764	38	4	607	0	1204	2	1	1242	1764	1242	0	594
EDO. MONAGAS	MP. CARIPE	PQ. EL GUACHARO	7	3030	29	8	1344	1	2262	8	1	2291	3489	2291	1	907
EDO. MONAGAS	MP. URACOA	CM. URACOA	17	7404	171	17	2757	1	5718	24	4	5889	7404	5889	1	2931
EDO. MONAGAS	CE. MATURIN	PQ. SAN SIMON	185	90388	1143	202	34894	15	72795	425	40	73938	97879	73938	30	37391
EDO. MONAGAS	CE. MATURIN	PQ. SANTA CRUZ	45	23669	357	45	10349	4	19768	112	11	20125	23669	20125	6	9286
EDO. MONAGAS	CE. MATURIN	PQ. SAN VICENTE	12	6371	89	13	3293	1	4892	31	2	4981	6893	4981	1	1564
EDO. MONAGAS	CE. MATURIN	PQ. ALTO DE LOS GODOS	169	85841	1111	170	40861	10	70966	448	26	72077	86322	72077	21	29600
EDO. MONAGAS	CE. MATURIN	PQ. BOQUERON	66	32787	548	73	14782	6	26245	170	16	26793	36282	26793	8	11263
EDO. MONAGAS	CE. MATURIN	PQ. JUSEPIN	17	8445	129	17	5107	2	6925	42	1	7054	8445	7054	1	1772
EDO. MONAGAS	CE. MATURIN	PQ. LA PICA	22	9914	197	22	4725	4	7285	45	3	7482	9914	7482	4	2504
EDO. MONAGAS	CE. MATURIN	PQ. EL FURRIAL	13	6750	128	13	3516	0	5414	34	4	5542	6750	5542	4	1856
EDO. MONAGAS	CE. MATURIN	PQ. EL COROZO	8	4027	98	8	2048	0	3154	18	2	3252	4027	3252	3	1083
EDO. MONAGAS	CE. MATURIN	PQ. LAS COCUIZAS	114	56064	895	117	25859	7	44704	311	25	45599	57415	45599	21	18481
EDO. MONAGAS	MP. EZEQUIEL ZAMORA	CM. PUNTA DE MATA	66	32960	651	69	16716	8	26643	157	12	27294	34530	27294	8	9742
EDO. MONAGAS	MP. EZEQUIEL ZAMORA	PQ. EL TEJERO	15	7517	184	15	3871	2	5976	24	2	6160	7517	6160	1	2076
EDO. MONAGAS	MP. AGUASAY	CM. AGUASAY	23	10684	212	23	5276	1	8305	59	4	8517	10684	8517	0	2965
EDO. BOLIVAR	MP. BLVNO ANGOSTURA	PQ. SAN FRANCISCO	16	5102	101	16	2438	1	3632	22	5	3733	5102	3733	0	1166
EDO. BOLIVAR	MP. BLVNO ANGOSTURA	PQ. BARCELONETA	13	5955	88	23	1942	2	3772	30	5	3860	8833	3860	1	1792
EDO. BOLIVAR	MP. BLVNO ANGOSTURA	PQ. SANTA BARBARA	6	2131	50	6	844	1	1455	11	0	1505	2131	1505	1	598
EDO. BOLIVAR	MP. BLVNO ANGOSTURA	CM. CIUDAD PIAR	23	11116	139	24	4240	1	8309	54	5	8448	11698	8448	4	4005
EDO. BOLIVAR	MP. GRAN SABANA	CM. SANTA ELENA DE UAIREN	43	16970	296	49	6576	17	11145	98	20	11441	19267	11441	12	4422
EDO. BOLIVAR	MP. GRAN SABANA	PQ. IKABARU	3	1322	13	4	343	0	606	0	1	619	1500	619	0	262
EDO. BOLIVAR	MP. ROSCIO	CM. GUASIPATI	33	15538	320	33	5513	2	11665	75	7	11985	15538	11985	2	6066
EDO. BOLIVAR	MP. ROSCIO	PQ. SALOM	3	1420	44	3	515	0	1056	6	1	1100	1420	1100	0	534
EDO. BOLIVAR	MP. CEDE#O	PQ. LA URBANA	5	1923	11	7	976	1	1313	0	0	1324	2468	1324	0	336
EDO. BOLIVAR	MP. CEDE#O	CM. CAICARA DEL ORINOCO	61	28182	425	62	13732	7	19757	84	22	20182	28695	20182	4	5908
EDO. BOLIVAR	MP. CEDE#O	PQ. GUANIAMO
EDO. BOLIVAR	MP. CEDE#O	PQ. PIJIGUAOS	11	4419	84	18	2419	1	3289	18	3	3373	5566	3373	1	847
EDO. BOLIVAR	MP. CEDE#O	PQ. ASCENSION FARRERAS	15	5219	85	16	2390	0	3490	22	2	3575	5638	3575	1	1075
EDO. BOLIVAR	MP. CEDE#O	PQ. ALTAGRACIA	4	1278	39	4	757	0	880	0	0	919	1278	919	0	123
EDO. BOLIVAR	MP. PIAR	CM. UPATA	115	59054	1084	116	19720	11	46274	330	30	47358	59543	47358	6	26177
EDO. BOLIVAR	MP. PIAR	PQ. ANDRES ELOY BLANCO	15	6284	104	15	2955	2	4727	38	1	4831	6284	4831	2	1729
EDO. BOLIVAR	MP. PIAR	PQ. PEDRO COVA	12	5195	100	15	1425	0	3308	21	0	3408	5866	3408	1	1861
EDO. BOLIVAR	MP. SIFONTES	PQ. DALLA COSTA	11	5366	59	11	2280	6	3266	29	2	3325	5366	3325	0	949
EDO. BOLIVAR	MP. SIFONTES	CM. TUMEREMO	39	18467	341	40	5815	6	12285	112	9	12626	18553	12626	5	6338
EDO. BOLIVAR	MP. SIFONTES	PQ. SAN ISIDRO	11	5994	114	11	2513	5	3530	43	3	3644	5994	3644	2	964
EDO. BOLIVAR	MP. EL CALLAO	CM. EL CALLAO	34	16364	375	34	4664	7	11959	68	3	12334	16364	12334	3	7214
EDO. BOLIVAR	MP. CARONI	PQ. SIMON BOLIVAR	119	58686	911	126	24944	18	47078	344	25	47989	62392	47989	23	21724
EDO. BOLIVAR	MP. CARONI	PQ. VISTA AL SOL	83	42758	809	86	24264	10	33082	254	24	33891	44049	33891	10	8520
EDO. BOLIVAR	MP. CARONI	PQ. CHIRICA	114	56692	914	114	30920	11	44261	369	24	45175	56692	45175	15	12922
EDO. BOLIVAR	MP. CARONI	PQ. CACHAMAY	70	37072	380	75	9166	3	30502	112	12	30882	39646	30882	21	21188
EDO. BOLIVAR	MP. CARONI	PQ. UNARE	171	90436	1088	175	36937	15	76583	410	44	77671	92511	77671	55	39122
EDO. BOLIVAR	MP. CARONI	PQ. DALLA COSTA	103	52401	816	106	26642	7	42502	301	30	43318	53888	43318	16	15506
EDO. BOLIVAR	MP. CARONI	PQ. UNIVERSIDAD	71	37525	325	72	7349	4	32368	98	11	32693	38053	32693	12	24894
EDO. BOLIVAR	MP. CARONI	PQ. YOCOIMA	12	4854	72	19	2735	1	3651	30	6	3723	8170	3723	0	879
EDO. BOLIVAR	MP. CARONI	PQ. ONCE DE ABRIL	103	51979	903	109	28038	12	40303	338	28	41206	54972	41206	10	11877
EDO. BOLIVAR	MP. CARONI	PQ. POZO VERDE	25	10793	216	25	6072	8	7894	50	11	8110	10793	8110	3	1750
EDO. BOLIVAR	MP. SUCRE	CM. MARIPA	8	3668	115	9	1354	0	2204	25	5	2319	4193	2319	0	820
EDO. BOLIVAR	MP. SUCRE	PQ. LAS MAJADAS	2	762	18	2	249	0	450	0	0	468	762	468	0	201
EDO. BOLIVAR	MP. SUCRE	PQ. ARIPAO	4	1312	29	7	492	0	712	4	2	741	1892	741	0	214
EDO. BOLIVAR	MP. SUCRE	PQ. MOITACO	15	4784	80	15	2207	2	3270	18	2	3350	4784	3350	0	1041
EDO. BOLIVAR	MP. SUCRE	PQ. GUARATARO	13	5780	79	13	3109	1	3977	20	3	4056	5780	4056	4	840
EDO. BOLIVAR	MP.PADRE PEDRO CHIEN	CM. EL PALMAR	20	8957	135	26	3714	0	6839	39	6	6974	11594	6974	1	3079
EDO. BOLIVAR	CE. HERES	PQ. CATEDRAL	106	48850	810	107	17126	8	38183	265	10	38993	49358	38993	21	20753
EDO. BOLIVAR	CE. HERES	PQ. MARHUANTA	36	15916	331	36	7637	7	12240	98	5	12571	15916	12571	4	4489
EDO. BOLIVAR	CE. HERES	PQ. VISTA HERMOSA	85	42366	576	86	12557	5	34346	180	11	34922	42916	34922	27	21566
EDO. BOLIVAR	CE. HERES	PQ. PANAPANA	8	1816	56	8	1113	2	1422	9	2	1478	1816	1478	2	294
EDO. BOLIVAR	CE. HERES	PQ. JOSE ANTONIO PAEZ	41	17542	358	41	8462	5	12959	127	14	13317	17542	13317	1	4350
EDO. BOLIVAR	CE. HERES	PQ. LA SABANITA	125	55315	921	125	21902	16	42460	321	22	43381	55315	43381	15	20184
EDO. BOLIVAR	CE. HERES	PQ. AGUA SALADA	83	37343	676	83	15903	8	29230	206	11	29906	37343	29906	24	13078
EDO. BOLIVAR	CE. HERES	PQ. ORINOCO	5	1464	21	5	784	1	1085	6	1	1106	1464	1106	1	292
EDO. BOLIVAR	CE. HERES	PQ. ZEA	9	1755	35	9	716	0	1120	5	0	1155	1755	1155	1	398
EDO. MIRANDA	MP. CRISTOBAL ROJAS	PQ. CHARALLAVE	135	67818	1313	136	35542	17	55811	262	25	57124	68385	57124	48	19917
EDO. MIRANDA	MP. CRISTOBAL ROJAS	PQ. LAS BRISAS	22	10668	247	22	5861	5	8243	41	6	8490	10668	8490	10	2320
EDO. MIRANDA	MP. INDEPENDENCIA	PQ. STA TERESA DEL TUY	89	45714	758	91	25695	14	36384	139	29	37142	46683	37142	15	10492
EDO. MIRANDA	MP. INDEPENDENCIA	PQ. EL CARTANAL	82	42703	776	85	25810	7	34671	180	20	35447	44327	35447	30	8624
EDO. MIRANDA	MP. EL HATILLO	PQ. EL HATILLO	95	50654	407	96	7329	4	40399	82	16	40806	51215	40806	18	32950
EDO. MIRANDA	MP. BRION	PQ. HIGUEROTE	40	21096	503	40	9638	4	16588	74	12	17091	21096	17091	11	6849
EDO. MIRANDA	MP. BRION	PQ. CURIEPE	19	8285	175	19	4515	2	6418	27	6	6593	8285	6593	3	1865
EDO. MIRANDA	MP. BRION	PQ. TACARIGUA	21	9427	188	21	4683	0	7480	42	2	7668	9427	7668	8	2745
EDO. MIRANDA	MP. BARUTA	PQ. BARUTA	279	147569	1150	281	24046	24	113989	210	32	115139	148683	115139	76	89601
EDO. MIRANDA	MP. BARUTA	PQ. EL CAFETAL	82	43168	171	83	2504	6	32830	37	4	33001	43708	33001	17	30262
EDO. MIRANDA	MP. BARUTA	PQ. LAS MINAS DE BARUTA	68	35976	398	68	9793	4	28239	71	13	28637	35976	28637	12	18346
EDO. MIRANDA	MP. CARRIZAL	PQ. CARRIZAL	70	35876	529	71	12818	8	29453	101	21	29982	36403	29982	39	16466
EDO. MIRANDA	MP. PLAZA	PQ. GUARENAS	257	134220	2234	262	66334	24	111907	454	48	114141	136683	114141	94	44953
EDO. MIRANDA	MP. SIMON BOLIVAR	PQ. S ANTONIO DE YARE	16	6552	124	16	4326	0	5240	25	4	5364	6552	5364	7	878
EDO. MIRANDA	MP. SIMON BOLIVAR	PQ. SAN FCO DE YARE	40	19204	360	40	10830	4	15753	57	8	16113	19204	16113	9	4845
EDO. MIRANDA	CE. GUAICAIPURO	PQ. SAN PEDRO	15	7559	160	15	2915	2	6017	29	5	6177	7559	6177	5	3061
EDO. MIRANDA	CE. GUAICAIPURO	PQ. EL JARILLO	4	2320	61	4	814	2	1683	6	0	1744	2320	1744	1	860
EDO. MIRANDA	CE. GUAICAIPURO	PQ. LOS TEQUES	290	150804	2367	292	61846	51	122728	511	69	125095	151901	125095	108	60143
EDO. MIRANDA	CE. GUAICAIPURO	PQ. ALTAGRACIA DE LA M	6	2609	74	6	1181	1	1943	11	2	2017	2609	2017	0	748
EDO. MIRANDA	CE. GUAICAIPURO	PQ. TACATA	6	3028	44	6	1653	0	2463	10	2	2507	3028	2507	3	795
EDO. MIRANDA	CE. GUAICAIPURO	PQ. CECILIO ACOSTA	23	11695	153	23	4585	1	9221	36	6	9374	11695	9374	6	4587
EDO. MIRANDA	CE. GUAICAIPURO	PQ. PARACOTOS	20	8482	160	20	4127	0	6755	20	10	6915	8482	6915	4	2594
EDO. MIRANDA	MP. PEDRO GUAL	PQ. CUPIRA	30	12735	282	31	5936	5	9492	62	4	9774	12836	9774	4	3481
EDO. MIRANDA	MP. PEDRO GUAL	PQ. MACHURUCUTO	2	944	15	2	380	0	726	3	0	741	944	741	0	343
EDO. MIRANDA	MP. PAZ CASTILLO	PQ. SANTA LUCIA	127	63099	1078	127	38237	13	50639	234	29	51717	63099	51717	33	12093
EDO. MIRANDA	MP. BUROZ	PQ. MAMPORAL	35	16109	326	35	8728	1	12520	51	5	12846	16109	12846	4	3731
EDO. MIRANDA	MP. SUCRE	PQ. LEONCIO MARTINEZ	116	60629	572	116	9889	10	45696	89	12	46268	60629	46268	37	35659
EDO. MIRANDA	MP. SUCRE	PQ. PETARE	615	319672	4174	619	115481	69	250260	918	127	254434	321644	254434	181	133484
EDO. MIRANDA	MP. SUCRE	PQ. LA DOLORITA	42	21413	461	42	11755	10	16873	99	17	17334	21413	17334	13	4979
EDO. MIRANDA	MP. SUCRE	PQ. CAUCAGUITA	61	32234	644	62	15770	8	25107	106	12	25751	32802	25751	20	9191
EDO. MIRANDA	MP. SUCRE	PQ. FILAS DE MARICHES	42	21642	360	42	12149	9	16714	75	14	17074	21642	17074	4	4463
EDO. MIRANDA	MP. URDANETA	PQ. NUEVA CUA	56	25674	502	56	15710	14	20398	102	13	20900	25674	20900	12	4547
EDO. MIRANDA	MP. URDANETA	PQ. CUA	111	55581	1101	112	28101	14	45651	198	28	46752	56115	46752	49	17261
EDO. MIRANDA	MP. ANDRES BELLO	PQ. CUMBO	2	863	23	3	345	1	599	2	0	622	1297	622	0	251
EDO. MIRANDA	MP. ANDRES BELLO	PQ.SAN JOSE DE BARLOVENTO	35	14153	292	36	7603	4	11049	41	6	11341	14607	11341	4	3391
EDO. MIRANDA	MP. LANDER	PQ. LA DEMOCRACIA	4	1285	20	4	706	0	899	2	0	919	1285	919	0	191
EDO. MIRANDA	MP. LANDER	PQ. SANTA BARBARA	15	7867	154	15	5231	2	6515	18	5	6669	7867	6669	5	1254
EDO. MIRANDA	MP. LANDER	PQ. OCUMARE DEL TUY	156	79613	1469	157	47028	18	64049	309	38	65518	80142	65518	44	16612
EDO. MIRANDA	MP. ZAMORA	PQ. BOLIVAR	34	13885	221	35	7729	2	10922	34	7	11143	14434	11143	10	3140
EDO. MIRANDA	MP. ZAMORA	PQ. GUATIRE	199	103091	1801	201	45310	11	86226	318	40	88027	104206	88027	72	40475
EDO. MIRANDA	MP. LOS SALIAS	PQ. SAN ANTONIO LOS ALTOS	104	55106	474	104	10862	9	45748	74	21	46222	55106	46222	42	34740
EDO. MIRANDA	MP. ACEVEDO	PQ. AREVALO GONZALEZ	13	4193	89	13	2311	1	3066	13	4	3155	4193	3155	0	737
EDO. MIRANDA	MP. ACEVEDO	PQ. PANAQUIRE	14	4827	112	14	2649	1	3672	13	3	3784	4827	3784	1	1005
EDO. MIRANDA	MP. ACEVEDO	PQ. ARAGUITA	12	4896	90	12	2741	1	3598	13	3	3688	4896	3688	0	840
EDO. MIRANDA	MP. ACEVEDO	PQ. MARIZAPA	12	5649	199	12	3180	1	4437	22	2	4636	5649	4636	2	1230
EDO. MIRANDA	MP. ACEVEDO	PQ. CAUCAGUA	40	19049	381	40	9272	6	14349	82	12	14730	19049	14730	14	4963
EDO. MIRANDA	MP. ACEVEDO	PQ. RIBAS	18	4926	64	21	2622	0	3582	12	2	3646	5403	3646	3	943
EDO. MIRANDA	MP. ACEVEDO	PQ. EL CAFE	11	3984	56	11	2200	0	2973	14	2	3029	3984	3029	0	757
EDO. MIRANDA	MP. ACEVEDO	PQ. CAPAYA	20	7680	215	21	3882	0	5763	23	5	5978	7850	5978	4	1849
EDO. MIRANDA	MP. CHACAO	PQ. CHACAO	156	81580	698	157	10910	13	59379	128	26	60077	82111	60077	40	48262
EDO. MIRANDA	MP. PAEZ	PQ. PAPARO	2	1029	17	2	532	0	849	5	0	866	1029	866	0	312
EDO. MIRANDA	MP. PAEZ	PQ. SN FERNANDO DEL GUAPO	5	2332	57	5	1202	1	1780	14	1	1837	2332	1837	0	562
EDO. MIRANDA	MP. PAEZ	PQ. RIO CHICO	28	13964	328	28	6579	4	10948	37	5	11276	13964	11276	2	4321
EDO. MIRANDA	MP. PAEZ	PQ.TACARIGUA DE LA LAGUNA	6	3224	63	6	1459	0	2602	12	1	2665	3224	2665	2	1128
EDO. MIRANDA	MP. PAEZ	PQ. EL GUAPO	14	5406	80	14	3139	0	4181	14	3	4261	5406	4261	2	1023
EDO. BARINAS	CE. BARINAS	PQ. DOMINGA ORTIZ P	10	4679	102	13	2273	0	3563	13	1	3665	5076	3665	0	1276
EDO. BARINAS	CE. BARINAS	PQ. RAMON I MENDEZ	72	36889	797	72	18423	7	29768	167	17	30565	36889	30565	5	11149
EDO. BARINAS	CE. BARINAS	PQ. CORAZON DE JESUS	76	35432	612	80	16834	16	28484	160	14	29096	37390	29096	16	11444
EDO. BARINAS	CE. BARINAS	PQ. EL CARMEN	67	36738	635	67	13955	8	30096	144	9	30731	36738	30731	10	15970
EDO. BARINAS	CE. BARINAS	PQ. ALTO BARINAS	63	32453	485	67	12515	3	27833	119	15	28318	34293	28318	14	15167
EDO. BARINAS	CE. BARINAS	PQ. JUAN A RODRIGUEZ D	5	2580	78	5	1217	0	1988	5	2	2066	2580	2066	0	764
EDO. BARINAS	CE. BARINAS	PQ. MANUEL P FAJARDO	13	5614	128	13	2618	0	4420	13	5	4548	5614	4548	0	1784
EDO. BARINAS	CE. BARINAS	PQ. TORUNOS	6	2854	62	7	1474	0	2337	4	0	2399	3404	2399	0	859
EDO. BARINAS	CE. BARINAS	PQ. BARINAS	25	12370	195	25	3825	2	9574	50	5	9769	12370	9769	3	5689
EDO. BARINAS	CE. BARINAS	PQ. SANTA LUCIA	9	3879	96	9	1674	0	2762	19	2	2858	3879	2858	0	1067
EDO. BARINAS	CE. BARINAS	PQ. ROMULO BETANCOURT	55	29312	454	55	13258	2	23689	144	11	24143	29312	24143	13	10261
EDO. BARINAS	CE. BARINAS	PQ. SAN SILVESTRE	15	5482	95	15	3030	1	4353	29	1	4448	5482	4448	1	1291
EDO. BARINAS	CE. BARINAS	PQ. ALFREDO A LARRIVA	12	5254	82	12	2537	0	4185	17	3	4267	5254	4267	1	1627
EDO. BARINAS	CE. BARINAS	PQ. SANTA INES	5	2317	32	5	1262	0	1850	7	0	1882	2317	1882	0	581
EDO. BARINAS	MP. CRUZ PAREDES	PQ. BARRANCAS	36	14536	229	37	8614	2	11598	67	4	11827	14590	11827	1	2910
EDO. BARINAS	MP. CRUZ PAREDES	PQ. EL SOCORRO	10	2916	55	10	1544	0	2314	17	3	2369	2916	2369	0	750
EDO. BARINAS	MP. CRUZ PAREDES	PQ. MASPARRITO
EDO. BARINAS	MP. PEDRAZA	PQ. JOSE FELIX RIBAS	16	5435	96	17	2755	2	4188	14	1	4284	5494	4284	1	1415
EDO. BARINAS	MP. PEDRAZA	PQ. IGNACIO BRICE#O	7	2686	33	7	917	0	1874	7	1	1907	2686	1907	0	949
EDO. BARINAS	MP. PEDRAZA	PQ. CIUDAD BOLIVIA	63	29238	500	65	11879	2	22629	90	19	23129	29723	23129	1	10638
EDO. BARINAS	MP. PEDRAZA	PQ. PAEZ	12	4821	103	12	2100	0	3428	30	6	3531	4821	3531	0	1292
EDO. BARINAS	MP. ROJAS	PQ. DOLORES	12	5260	89	12	2583	0	3918	23	4	4007	5260	4007	0	1308
EDO. BARINAS	MP. ROJAS	PQ. PALACIO FAJARDO	14	6663	72	14	4266	1	5186	22	3	5258	6663	5258	0	894
EDO. BARINAS	MP. ROJAS	PQ. LIBERTAD	18	7889	143	18	4198	1	6116	47	0	6259	7889	6259	1	1869
EDO. BARINAS	MP. ROJAS	PQ. SANTA ROSA	17	6732	87	17	3867	2	5230	29	4	5317	6732	5317	1	1327
EDO. BARINAS	MP. ARISMENDI	PQ. SAN ANTONIO	8	3103	46	8	1405	0	2139	13	0	2185	3103	2185	2	719
EDO. BARINAS	MP. ARISMENDI	PQ. ARISMENDI	22	6501	111	25	3240	2	4494	32	6	4605	7507	4605	0	1214
EDO. BARINAS	MP. ARISMENDI	PQ. GUADARRAMA	9	1661	27	9	962	0	1214	7	1	1241	1661	1241	0	244
EDO. BARINAS	MP. ARISMENDI	PQ. LA UNION	13	4617	49	14	2069	2	2949	8	2	2998	5188	2998	0	868
EDO. BARINAS	MP. ANDRES E. BLANCO	PQ. EL CANTON	12	5052	57	13	2354	1	3890	14	1	3947	5651	3947	2	1518
EDO. BARINAS	MP. ANDRES E. BLANCO	PQ. PUERTO VIVAS	7	2288	41	8	1168	0	1790	9	0	1831	2808	1831	0	613
EDO. BARINAS	MP. ANDRES E. BLANCO	PQ. SANTA CRUZ DE GUACAS	8	3382	48	8	1446	0	2513	24	1	2561	3382	2561	0	1042
EDO. BARINAS	MP. A JOSE DE SUCRE	PQ. ANDRES BELLO	9	4253	75	9	1839	2	3289	14	2	3364	4253	3364	0	1432
EDO. BARINAS	MP. A JOSE DE SUCRE	PQ. TICOPORO	73	36937	659	74	15171	7	28531	145	20	29190	37502	29190	6	13182
EDO. BARINAS	MP. A JOSE DE SUCRE	PQ. NICOLAS PULIDO	12	5259	82	12	2611	2	4005	23	2	4087	5259	4087	0	1367
EDO. BARINAS	MP. SOSA	PQ. EL REGALO	9	4106	51	9	2156	0	3367	16	2	3418	4106	3418	0	1193
EDO. BARINAS	MP. SOSA	PQ. SANTA CATALINA	4	1316	14	4	551	0	834	6	0	848	1316	848	0	277
EDO. BARINAS	MP. SOSA	PQ. PUERTO DE NUTRIAS	5	2089	30	5	1026	0	1457	5	1	1487	2089	1487	1	424
EDO. BARINAS	MP. SOSA	PQ. CIUDAD DE NUTRIAS	20	8537	145	22	4266	0	6651	33	1	6796	9472	6796	1	2350
EDO. BARINAS	MP. BOLIVAR	PQ. ALTAMIRA	9	2529	34	9	1422	1	2044	11	1	2078	2529	2078	1	608
EDO. BARINAS	MP. BOLIVAR	PQ. BARINITAS	58	28664	485	58	13259	5	23176	114	10	23661	28664	23661	8	9780
EDO. BARINAS	MP. BOLIVAR	PQ. CALDERAS	20	4640	53	20	2435	1	3580	16	2	3633	4640	3633	0	1126
EDO. BARINAS	MP. ALBERTO ARVELO T	PQ. RODRIGUEZ DOMINGUEZ	14	5690	73	14	3875	1	4702	22	4	4775	5690	4775	0	800
EDO. BARINAS	MP. ALBERTO ARVELO T	PQ. SABANETA	45	21387	399	46	14025	1	17280	81	3	17679	21965	17679	6	3164
EDO. BARINAS	MP. EZEQUIEL ZAMORA	PQ. PEDRO BRICE#O MENDEZ	8	3717	78	9	1364	0	2855	12	2	2933	4273	2933	1	1476
EDO. BARINAS	MP. EZEQUIEL ZAMORA	PQ. SANTA BARBARA	57	25511	438	60	10467	3	19886	100	16	20324	26805	20324	1	9299
EDO. BARINAS	MP. EZEQUIEL ZAMORA	PQ. RAMON IGNACIO MENDEZ	5	2597	44	5	1015	1	1998	4	0	2042	2597	2042	1	977
EDO. BARINAS	MP. EZEQUIEL ZAMORA	PQ.JOSE IGNACIO DEL PUMAR	7	2621	63	7	994	0	1901	5	1	1964	2621	1964	1	900
EDO. BARINAS	MP. OBISPOS	PQ. LOS GUASIMITOS	12	5945	104	12	2979	1	4675	32	2	4779	5945	4779	3	1658
EDO. BARINAS	MP. OBISPOS	PQ. OBISPOS	22	9643	157	27	4911	0	7624	59	5	7781	11306	7781	1	2648
EDO. BARINAS	MP. OBISPOS	PQ. EL REAL	5	2261	25	5	1513	1	1890	8	1	1915	2261	1915	0	367
EDO. BARINAS	MP. OBISPOS	PQ. LA LUZ	5	1391	8	15	987	0	1157	8	1	1165	4724	1165	0	161
EDO. COJEDES	MP. GIRARDOT	PQ. EL BAUL	16	7507	132	16	3910	1	5848	34	3	5980	7507	5980	4	1896
EDO. COJEDES	MP. GIRARDOT	PQ. SUCRE	5	1705	15	5	1032	0	1342	12	2	1357	1705	1357	0	296
EDO. COJEDES	MP. TINACO	PQ. GRL/JEFE JOSE L SILVA	50	23109	471	50	12204	2	18517	104	13	18988	23109	18988	6	6188
EDO. COJEDES	MP. RICAURTE	PQ. LIBERTAD DE COJEDES	20	8864	158	20	5617	1	7098	44	2	7256	8864	7256	2	1432
EDO. COJEDES	MP. RICAURTE	PQ. EL AMPARO	3	1438	19	3	927	1	1109	8	2	1128	1438	1128	0	171
EDO. COJEDES	MP. ROMULO GALLEGOS	PQ. ROMULO GALLEGOS	28	13397	276	29	7312	2	10632	87	6	10908	13984	10908	1	3224
EDO. COJEDES	MP. PAO S J BAUTISTA	PQ. EL PAO	41	12105	268	43	7543	8	9602	59	6	9870	12439	9870	3	1983
EDO. COJEDES	MP. LIMA BLANCO	PQ. LA AGUADITA	8	3135	70	8	1840	1	2532	11	3	2602	3135	2602	0	677
EDO. COJEDES	MP. LIMA BLANCO	PQ. MACAPO	10	5516	101	10	2972	0	4538	15	0	4639	5516	4639	2	1549
EDO. COJEDES	MP. ANZOATEGUI	PQ. JUAN DE MATA SUAREZ	17	7221	192	17	3927	1	5747	31	0	5939	7221	5939	2	1786
EDO. COJEDES	MP. ANZOATEGUI	PQ. COJEDES	11	4612	90	11	2810	1	3766	13	0	3856	4612	3856	1	941
EDO. COJEDES	CE. EZEQUIEL ZAMORA	PQ. MANUEL MANRIQUE	7	3023	61	7	1538	1	2434	12	2	2495	3023	2495	2	879
EDO. COJEDES	CE. EZEQUIEL ZAMORA	PQ. JUAN ANGEL BRAVO	6	1143	14	6	637	0	899	6	0	913	1143	913	0	256
EDO. COJEDES	CE. EZEQUIEL ZAMORA	PQ. SAN CARLOS DE AUSTRIA	140	65201	1281	142	31182	28	53365	379	20	54646	66305	54646	24	21732
EDO. COJEDES	MP. TINAQUILLO	PQ. TINAQUILLO	133	62694	1348	134	32437	23	50157	281	22	51505	63027	51505	22	17372
EDO.NVA.ESPARTA	MP.VILLALBA(I.COCHE)	PQ. VICENTE FUENTES	6	3173	40	6	1476	0	2660	7	4	2700	3173	2700	0	1173
EDO.NVA.ESPARTA	MP.VILLALBA(I.COCHE)	CM. SAN PEDRO DE COCHE	8	4059	57	8	1770	0	3178	15	10	3235	4059	3235	1	1382
EDO.NVA.ESPARTA	CE. ARISMENDI	CM. LA ASUNCION	41	20288	294	42	6839	3	16648	58	6	16942	20813	16942	10	9732
EDO.NVA.ESPARTA	MP. MANEIRO	PQ. AGUIRRE	37	18577	148	37	3751	1	15124	37	1	15272	18577	15272	3	11331
EDO.NVA.ESPARTA	MP. MANEIRO	CM. PAMPATAR	33	15909	202	33	5415	0	12848	29	1	13050	15909	13050	6	7397
EDO.NVA.ESPARTA	MP. GOMEZ	PQ. BOLIVAR	3	1705	14	3	799	0	1460	11	1	1474	1705	1474	0	649
EDO.NVA.ESPARTA	MP. GOMEZ	CM. SANTA ANA	20	9975	102	20	4871	0	8173	37	1	8275	9975	8275	4	3260
EDO.NVA.ESPARTA	MP. GOMEZ	PQ. SUCRE	14	7047	93	14	3007	0	5531	31	0	5624	7047	5624	1	2492
EDO.NVA.ESPARTA	MP. GOMEZ	PQ. MATASIETE	8	3747	41	8	1683	0	3107	18	0	3148	3747	3148	0	1406
EDO.NVA.ESPARTA	MP. GOMEZ	PQ. GUEVARA	8	3982	45	8	1628	0	3256	17	1	3301	3982	3301	0	1610
EDO.NVA.ESPARTA	MP. GARCIA	CM. VALLE ESP SANTO	15	8052	131	15	2819	1	6350	26	2	6481	8052	6481	4	3498
EDO.NVA.ESPARTA	MP. GARCIA	PQ. FRANCISCO FAJARDO	59	29973	511	59	13777	1	23701	131	6	24212	29973	24212	9	9777
EDO.NVA.ESPARTA	MP. MARCANO	CM. JUAN GRIEGO	30	14764	194	30	6662	4	11880	63	8	12074	14764	12074	2	5141
EDO.NVA.ESPARTA	MP. MARCANO	PQ. ADRIAN	22	10537	159	22	5023	0	8566	53	5	8725	10537	8725	2	3483
EDO.NVA.ESPARTA	MP. DIAZ	PQ. ZABALA	25	12517	286	25	6196	4	9700	46	3	9986	12517	9986	5	3446
EDO.NVA.ESPARTA	MP. DIAZ	CM. SAN JUAN BAUTISTA	57	27717	633	57	12616	5	22647	106	2	23280	27717	23280	8	9910
EDO.NVA.ESPARTA	MP. TUBORES	CM. PUNTA DE PIEDRAS	35	16858	262	36	7640	2	13454	54	5	13716	17280	13716	2	5751
EDO.NVA.ESPARTA	MP. TUBORES	PQ. LOS BARALES	13	5967	92	13	2950	0	4724	19	1	4816	5967	4816	1	1753
EDO.NVA.ESPARTA	MP.PENIN. DE MACANAO	PQ. SAN FRANCISCO	25	9787	102	25	4408	0	7062	25	4	7164	9787	7164	4	2621
EDO.NVA.ESPARTA	MP.PENIN. DE MACANAO	CM. BOCA DEL RIO	15	7609	74	16	3146	1	5997	31	0	6071	7965	6071	3	2816
EDO.NVA.ESPARTA	MP. MARI#O	CM. PORLAMAR	142	71928	1104	150	26683	9	55371	247	18	56475	75992	56475	16	28398
EDO.NVA.ESPARTA	MP.ANTOLIN DEL CAMPO	CM.LA PLAZA DE PARAGUACHI	42	20006	250	42	8423	3	16567	80	1	16817	20006	16817	8	8052
EDO. TACHIRA	MP. INDEPENDENCIA	CM. CAPACHO NUEVO	33	16033	282	33	5733	2	13256	64	3	13538	16033	13538	4	7450
EDO. TACHIRA	MP. INDEPENDENCIA	PQ. JUAN GERMAN ROSCIO	12	6190	126	12	2528	3	5172	32	0	5298	6190	5298	1	2608
EDO. TACHIRA	MP. INDEPENDENCIA	PQ. ROMAN CARDENAS	4	2067	35	4	799	0	1733	7	1	1768	2067	1768	1	925
EDO. TACHIRA	MP. SAN JUDAS TADEO	CM. UMUQUENA	16	6821	139	17	3332	0	5384	24	2	5523	7314	5523	1	2025
EDO. TACHIRA	CE. SAN CRISTOBAL	PQ. LA CONCORDIA	135	70855	1006	138	21637	11	57840	208	28	58846	72226	58846	22	35934
EDO. TACHIRA	CE. SAN CRISTOBAL	PQ. SN JUAN BAUTISTA	127	66369	862	129	16212	5	55522	168	13	56384	67456	56384	26	39098
EDO. TACHIRA	CE. SAN CRISTOBAL	PQ. SAN SEBASTIAN	28	13043	224	28	4685	4	10413	51	5	10637	13043	10637	3	5665
EDO. TACHIRA	CE. SAN CRISTOBAL	PQ. DR. FCO. ROMERO LOBO	2	798	13	3	293	0	637	1	0	650	1051	650	0	343
EDO. TACHIRA	CE. SAN CRISTOBAL	PQ. PEDRO MARIA MORANTES	98	50176	469	98	9666	4	42008	104	7	42477	50176	42477	21	32206
EDO. TACHIRA	MP. ANTONIO ROMULO C	CM. LAS MESAS	17	7473	169	17	3823	2	6017	27	0	6186	7473	6186	2	2163
EDO. TACHIRA	MP. SUCRE	PQ. SAN PABLO	8	1858	16	8	957	0	1459	2	0	1475	1858	1475	0	500
EDO. TACHIRA	MP. SUCRE	PQ.ELEAZAR LOPEZ CONTRERA	1	440	4	1	156	0	357	0	0	361	440	361	0	201
EDO. TACHIRA	MP. SUCRE	CM. QUENIQUEA	12	3802	45	13	1766	0	3077	5	0	3122	3933	3122	1	1305
EDO. TACHIRA	MP. LIBERTADOR	CM. ABEJALES	14	6088	109	14	2547	0	5035	12	1	5144	6088	5144	1	2474
EDO. TACHIRA	MP. LIBERTADOR	PQ. DORADAS	6	2889	18	6	1253	2	2351	13	3	2369	2889	2369	0	1080
EDO. TACHIRA	MP. LIBERTADOR	PQ. SAN JOAQUIN DE NAVAY	6	2149	32	6	782	0	1659	10	1	1691	2149	1691	1	865
EDO. TACHIRA	MP. LIBERTADOR	PQ. EMETERIO OCHOA	8	3413	36	8	1379	2	2831	4	0	2867	3413	2867	3	1443
EDO. TACHIRA	MP. PANAMERICANO	PQ. LA PALMITA	11	4050	67	11	1981	1	3105	21	0	3172	4050	3172	1	1101
EDO. TACHIRA	MP. PANAMERICANO	CM. COLONCITO	31	14870	261	31	5908	3	11659	51	3	11920	14870	11920	1	5693
EDO. TACHIRA	MP. SIMON RODRIGUEZ	CM. SAN SIMON	5	2520	41	5	953	0	2067	7	4	2108	2520	2108	0	1103
EDO. TACHIRA	MP. ANDRES BELLO	CM. CORDERO	35	16661	310	35	5740	2	13895	42	6	14205	16661	14205	9	8096
EDO. TACHIRA	MP. LIBERTAD	CM. CAPACHO VIEJO	21	9030	196	21	3844	3	7283	29	2	7479	9030	7479	3	3402
EDO. TACHIRA	MP. LIBERTAD	PQ. MANUEL FELIPE RUGELES	14	6408	147	14	2606	1	5249	22	1	5396	6408	5396	1	2618
EDO. TACHIRA	MP. LIBERTAD	PQ. CIPRIANO CASTRO	8	2597	25	8	1095	0	2056	8	1	2081	2597	2081	0	952
EDO. TACHIRA	MP. SAMUEL MALDONADO	CM. LA TENDIDA	13	5623	123	14	2488	0	4577	14	0	4700	6159	4700	2	2073
EDO. TACHIRA	MP. SAMUEL MALDONADO	PQ. HERNANDEZ	8	2513	39	8	1208	0	2111	4	0	2150	2513	2150	1	898
EDO. TACHIRA	MP. SAMUEL MALDONADO	PQ. BOCONO	7	2818	51	7	1370	2	2193	2	2	2244	2818	2244	1	816
EDO. TACHIRA	MP. TORBES	CM. SAN JOSECITO	51	26756	687	52	11054	5	21232	83	9	21919	27311	21919	10	10071
EDO. TACHIRA	MP. JOSE MARIA VARGA	CM. EL COBRE	20	7536	135	20	3311	0	6187	24	2	6322	7536	6322	0	2850
EDO. TACHIRA	MP. LOBATERA	CM. LOBATERA	13	5562	87	13	2617	0	4542	17	1	4629	5562	4629	3	1904
EDO. TACHIRA	MP. LOBATERA	PQ. CONSTITUCION	11	4073	58	11	1947	0	3394	12	0	3452	4073	3452	1	1434
EDO. TACHIRA	MP. MICHELENA	CM. MICHELENA	30	13253	202	30	5546	2	10993	40	5	11195	13253	11195	9	5391
EDO. TACHIRA	MP. GUASIMOS	CM. PALMIRA	56	27640	598	57	9454	8	23541	71	10	24139	28127	24139	13	13985
EDO. TACHIRA	MP. URIBANTE	CM. PREGONERO	27	8434	140	28	3322	1	6710	14	1	6850	8901	6850	1	3371
EDO. TACHIRA	MP. URIBANTE	PQ. JUAN PABLO PE#ALOZA	5	1630	26	6	727	0	1223	2	0	1249	1748	1249	1	493
EDO. TACHIRA	MP. URIBANTE	PQ. CARDENAS	9	2166	14	10	919	0	1721	3	1	1735	2392	1735	0	798
EDO. TACHIRA	MP. URIBANTE	PQ. POTOSI	8	1638	24	8	469	1	1021	1	0	1045	1638	1045	0	550
EDO. TACHIRA	MP. GARCIA DE HEVIA	CM. LA FRIA	57	27469	394	57	12902	4	21728	108	4	22122	27469	22122	3	8707
EDO. TACHIRA	MP. GARCIA DE HEVIA	PQ. BOCA DE GRITA	4	1790	39	6	623	0	1206	4	0	1245	2687	1245	0	579
EDO. TACHIRA	MP. GARCIA DE HEVIA	PQ. JOSE ANTONIO PAEZ	9	3068	59	9	1481	0	2327	2	1	2386	3068	2386	0	843
EDO. TACHIRA	MP. CORDOBA	CM. STA. ANA  DEL TACHIRA	41	20108	499	41	7670	1	15991	62	1	16490	20108	16490	10	8247
EDO. TACHIRA	MP. JUNIN	PQ. BRAMON	33	16794	359	33	7444	2	13970	65	9	14329	16794	14329	8	6442
EDO. TACHIRA	MP. JUNIN	CM. RUBIO	73	35995	578	73	12434	7	29946	131	8	30524	35995	30524	20	17346
EDO. TACHIRA	MP. JUNIN	PQ. LA PETROLEA	3	1385	29	3	625	0	1098	7	0	1127	1385	1127	0	466
EDO. TACHIRA	MP. JUNIN	PQ. QUINIMARI	2	1171	14	2	471	1	947	2	0	961	1171	961	0	473
EDO. TACHIRA	MP. FERNANDEZ FEO	CM.SAN RAFAEL DEL PINAL	25	11175	184	25	4457	1	8862	56	4	9046	11175	9046	1	4343
EDO. TACHIRA	MP. FERNANDEZ FEO	PQ. SANTO DOMINGO	18	6470	127	18	3051	1	5358	34	2	5485	6470	5485	4	2266
EDO. TACHIRA	MP. FERNANDEZ FEO	PQ. ALBERTO ADRIANI	22	8886	172	22	4322	3	7096	30	4	7268	8886	7268	1	2736
EDO. TACHIRA	MP. AYACUCHO	CM. COLON	62	30636	553	62	10952	5	25267	85	3	25820	30636	25820	7	14215
EDO. TACHIRA	MP. AYACUCHO	PQ. RIVAS BERTI	8	2719	51	9	1298	0	2122	11	1	2173	3230	2173	0	812
EDO. TACHIRA	MP. AYACUCHO	PQ. SAN PEDRO DEL RIO	6	2130	35	6	771	0	1629	7	2	1664	2130	1664	0	849
EDO. TACHIRA	MP. JAUREGUI	PQ. MONS. MIGUEL A SALAS	5	1849	50	5	870	0	1485	11	2	1535	1849	1535	0	602
EDO. TACHIRA	MP. JAUREGUI	CM. LA GRITA	56	23680	417	56	8580	7	19313	79	13	19730	23680	19730	5	10629
EDO. TACHIRA	MP. JAUREGUI	PQ. EMILIO C. GUERRERO	6	1528	29	6	653	0	1236	3	0	1265	1528	1265	0	580
EDO. TACHIRA	MP. FCO DE MIRANDA	CM. SAN JOSE DE BOLIVAR	9	3684	37	10	1059	0	3082	10	2	3119	3978	3119	0	2011
EDO. TACHIRA	MP. BOLIVAR	PQ. ISAIAS MEDINA ANGARIT	5	1294	27	5	577	0	979	6	1	1006	1294	1006	0	395
EDO. TACHIRA	MP. BOLIVAR	PQ. JUAN VICENTE GOMEZ	2	1092	25	2	410	0	857	3	0	882	1092	882	0	444
EDO. TACHIRA	MP. BOLIVAR	CM. SAN ANT DEL TACHIRA	83	42345	575	83	9085	5	23875	114	3	24450	42345	24450	7	14661
EDO. TACHIRA	MP. BOLIVAR	PQ. PALOTAL	9	4506	68	9	1518	1	3358	15	1	3426	4506	3426	0	1823
EDO. TACHIRA	MP. SEBORUCO	CM. SEBORUCO	17	6140	113	20	2534	0	4954	14	1	5067	7510	5067	0	2405
EDO. TACHIRA	MP. RAFAEL URDANETA	CM. DELICIAS	12	4188	90	14	1915	1	3332	17	3	3422	5006	3422	3	1393
EDO. TACHIRA	MP.PEDRO MARIA URE#A	CM. URE#A	52	26279	400	52	7290	1	16257	78	9	16657	26279	16657	4	8875
EDO. TACHIRA	MP.PEDRO MARIA URE#A	PQ. NUEVA ARCADIA	15	7446	98	16	2078	0	4571	30	1	4669	7833	4669	1	2461
EDO. TACHIRA	MP. CARDENAS	PQ. AMENODORO RANGEL LAMU	22	11906	189	22	3900	2	10278	29	1	10467	11906	10467	8	6338
EDO. TACHIRA	MP. CARDENAS	CM. TARIBA	103	53915	932	106	17358	3	45253	172	13	46185	55529	46185	15	27692
EDO. TACHIRA	MP. CARDENAS	PQ. LA FLORIDA	7	1179	15	9	601	1	936	0	0	951	1581	951	0	334
