EDO. PORTUGUESA	MP. GUANARITO	58	24647	500	61	13532	9	19430	85	34	19930	25488	19930	3	5767
EDO. PORTUGUESA	MP. OSPINO	91	31763	550	91	18359	10	24649	174	26	25199	31763	25199	6	6074
EDO. PORTUGUESA	MP.GENARO BOCONOITO	36	16330	287	36	10939	4	13210	75	9	13497	16330	13497	1	2182
EDO. PORTUGUESA	MP.S RAFAEL DE ONOTO	27	12269	223	27	7254	2	9989	69	5	10212	12269	10212	2	2657
EDO. PORTUGUESA	CE. GUANARE	257	119176	2403	270	63471	44	96734	638	77	99137	123273	99137	30	32474
EDO. PORTUGUESA	MP. ESTELLER	70	28848	508	71	18175	14	23261	167	22	23769	29052	23769	7	4876
EDO. PORTUGUESA	MP. SANTA ROSALIA	20	8332	112	30	5347	5	6648	35	2	6760	12132	6760	0	1259
EDO. PORTUGUESA	MP. TUREN	91	41837	623	92	24692	8	33404	220	30	34027	42380	34027	11	8443
EDO. PORTUGUESA	MP. PAPELON	25	9808	180	30	5393	6	7717	44	10	7897	11402	7897	1	2263
EDO. PORTUGUESA	MP. AGUA BLANCA	32	14214	285	32	9578	6	11920	53	11	12205	14214	12205	5	2267
EDO. PORTUGUESA	MP. ARAURE	184	87249	1439	185	50479	32	72470	358	50	73909	87790	73909	38	21513
EDO. PORTUGUESA	MP. SUCRE	74	29695	588	78	15560	7	23407	119	21	23995	31853	23995	6	7694
EDO. PORTUGUESA	MP. M.JOSE V DE UNDA	37	13563	256	45	7624	4	10109	76	7	10365	16793	10365	2	2396
EDO. PORTUGUESA	MP. PAEZ	244	122325	2134	245	69139	40	99138	601	55	101272	122850	101272	59	29244
EDO. SUCRE	MP. ANDRES E BLANCO	41	18261	228	44	7389	7	13100	65	7	13328	19202	13328	3	5629
EDO. SUCRE	MP. LIBERTADOR	21	8165	135	21	3980	2	6052	19	2	6187	8165	6187	3	2046
EDO. SUCRE	MP. MARI#O	38	16551	203	38	7207	1	11224	34	4	11427	16551	11427	2	3976
EDO. SUCRE	MP. ARISMENDI	84	32743	358	91	15558	6	23668	76	6	24026	33905	24026	4	8018
EDO. SUCRE	MP. ANDRES MATA	49	16010	198	50	7767	1	11837	29	4	12035	16572	12035	5	4031
EDO. SUCRE	MP. BERMUDEZ	194	94502	1203	198	44112	14	73697	324	49	74900	96625	74900	24	29174
EDO. SUCRE	MP. CAJIGAL	46	14959	216	47	7615	1	10575	39	1	10791	15148	10791	2	2917
EDO. SUCRE	MP. CRUZ S ACOSTA	53	24673	329	53	12526	3	18983	78	12	19312	24673	19312	2	6362
EDO. SUCRE	MP. BOLIVAR	36	15272	221	36	6355	1	11653	57	4	11874	15272	11874	1	5235
EDO. SUCRE	MP. BENITEZ	60	21838	217	63	10735	4	15882	54	9	16099	23288	16099	2	5078
EDO. SUCRE	MP. RIBERO	94	38651	455	95	18261	5	26921	109	16	27376	38789	27376	5	8525
EDO. SUCRE	CE. SUCRE	472	237097	3088	479	99174	61	183019	966	94	186107	240756	186107	73	82651
EDO. SUCRE	MP. MONTES	90	38940	411	93	18209	11	27769	111	16	28180	40017	28180	5	9417
EDO. SUCRE	MP. MEJIA	28	11394	132	29	5120	2	8514	31	5	8646	11813	8646	1	3355
EDO. SUCRE	MP. VALDEZ	61	26846	343	61	13884	2	18864	60	9	19207	26846	19207	5	4904
EDO. MERIDA	CE. LIBERTADOR	321	164552	2198	326	49066	48	138029	439	52	140227	166637	140227	73	88351
EDO. MERIDA	MP. PUEBLO LLANO	15	7149	113	15	3017	1	5849	13	1	5962	7149	5962	0	2817
EDO. MERIDA	MP.OB. RAMOS DE LORA	45	18504	217	45	8776	0	14736	62	6	14953	18504	14953	4	5888
EDO. MERIDA	MP. SUCRE	81	33744	564	87	15443	7	26548	115	14	27112	35698	27112	9	10960
EDO. MERIDA	MP. MIRANDA	35	14883	310	36	6149	4	12179	51	8	12489	15387	12489	5	5962
EDO. MERIDA	MP.JULIO CESAR SALAS	26	9944	150	26	4922	2	7547	24	1	7697	9944	7697	0	2598
EDO. MERIDA	MP. SANTOS MARQUINA	25	12001	219	25	5205	6	10022	32	10	10241	12001	10241	6	4763
EDO. MERIDA	MP. JUSTO BRICE#O	14	5012	70	14	2485	1	3926	10	2	3996	5012	3996	1	1427
EDO. MERIDA	MP. CAMPO ELIAS	128	64241	1018	130	25516	16	53039	177	17	54057	65283	54057	27	27286
EDO. MERIDA	MP. ARICAGUA	9	3824	44	9	1285	0	2947	7	2	2991	3824	2991	0	1653
EDO. MERIDA	MP. ARZOBISPO CHACON	27	9326	144	33	3959	2	7061	21	3	7205	10001	7205	2	3074
EDO. MERIDA	MP. RANGEL	27	12844	322	27	5404	4	10719	42	4	11041	12844	11041	2	5263
EDO. MERIDA	MP. PADRE NOGUERA	5	2531	32	5	1054	0	2074	15	1	2106	2531	2106	0	1004
EDO. MERIDA	MP. GUARAQUE	14	6479	80	16	2838	1	4943	2	1	5023	7377	5023	0	2101
EDO. MERIDA	MP. TULIO F CORDERO	50	20663	372	50	10731	4	16459	71	8	16831	20663	16831	4	5641
EDO. MERIDA	MP. ANTONIO PINTO S.	40	18127	276	41	7909	1	14780	48	3	15056	18627	15056	2	6817
EDO. MERIDA	MP. ANDRES BELLO	26	9652	145	27	4785	0	7828	26	0	7973	9909	7973	3	3014
EDO. MERIDA	MP. TOVAR	54	26332	348	56	10061	3	21729	64	7	22077	27362	22077	5	11589
EDO. MERIDA	MP. CARACCIOLO PARRA	35	15989	330	35	7265	3	12286	43	8	12616	15989	12616	2	4965
EDO. MERIDA	MP. ZEA	17	7423	78	18	2913	1	6178	22	4	6256	8001	6256	3	3235
EDO. MERIDA	MP.CARDENAL QUINTERO	17	6951	152	17	3502	0	5633	20	2	5785	6951	5785	1	2108
EDO. MERIDA	MP. RIVAS DAVILA	30	13671	209	30	5648	2	11224	44	2	11433	13671	11433	6	5522
EDO. MERIDA	MP. ALBERTO ADRIANI	178	83505	1410	178	36069	25	67100	273	30	68510	83505	68510	15	30688
EDO. AMAZONAS	MP. ATABAPO	15	5664	132	17	1775	3	4074	50	2	4206	6104	4206	6	2238
EDO. AMAZONAS	MP. RIO NEGRO	8	2303	49	8	628	1	1536	32	0	1585	2303	1585	0	875
EDO. AMAZONAS	CE. ATURES	132	61094	1536	154	25605	16	47940	343	16	49476	69772	49476	20	21940
EDO. AMAZONAS	MP. MANAPIARE	7	2833	52	14	1444	1	2008	17	1	2060	4901	2060	0	545
EDO. AMAZONAS	MP. ALTO ORINOCO	3	919	12	17	355	0	526	9	0	538	4718	538	0	162
EDO. AMAZONAS	MP. MAROA	6	2153	24	6	996	0	1598	11	0	1622	2153	1622	1	590
EDO. AMAZONAS	MP. AUTANA	14	5248	111	16	2093	1	4114	32	4	4225	6339	4225	1	1983
EDO. DELTA AMAC	CE. TUCUPITA	155	59555	1311	166	27011	29	47072	453	32	48383	62829	48383	20	19527
EDO. DELTA AMAC	MP. PEDERNALES	18	8695	84	18	4111	0	5274	21	1	5358	8695	5358	2	1139
EDO. DELTA AMAC	MP. ANTONIO DIAZ	27	10759	54	53	5408	2	6354	26	4	6408	19913	6408	0	914
EDO. DELTA AMAC	MP. CASACOIMA	52	21260	408	53	11959	8	15659	98	19	16067	21809	16067	3	3572
EDO. GUARICO	MP. ZARAZA	81	38437	508	86	18874	17	28748	199	27	29256	40912	29256	10	9621
EDO. GUARICO	MP. CHAGUARAMAS	23	9737	220	24	4746	2	7283	34	5	7503	10270	7503	2	2494
EDO. GUARICO	CE. ROSCIO	171	83751	1244	174	39864	18	69285	385	26	70529	85345	70529	33	28959
EDO. GUARICO	MP. MELLADO	41	18497	282	41	10105	3	14742	75	9	15024	18497	15024	5	4545
EDO. GUARICO	MP.SAN GERONIMO DE G	30	13509	165	31	6689	0	9779	51	7	9944	13976	9944	0	3032
EDO. GUARICO	MP. INFANTE	145	73330	962	161	34278	17	60091	335	30	61053	79652	61053	34	25397
EDO. GUARICO	MP. EL SOCORRO	27	12240	202	29	6517	1	9461	42	5	9663	13306	9663	4	2892
EDO. GUARICO	MP. MIRANDA	146	73349	1083	182	40196	30	59068	345	30	60151	89289	60151	28	18439
EDO. GUARICO	MP. CAMAGUAN	31	13719	280	33	6897	4	10567	70	11	10847	14883	10847	1	3584
EDO. GUARICO	MP. ORTIZ	36	14138	202	39	7810	1	10981	66	9	11183	15434	11183	2	3093
EDO. GUARICO	MP. S MARIA DE IPIRE	26	10485	157	26	5452	5	7687	53	15	7844	10485	7844	2	2160
EDO. GUARICO	MP. LAS MERCEDES	41	19783	421	46	10317	4	14599	78	12	15020	22035	15020	0	4188
EDO. GUARICO	MP.S JOSE DE GUARIBE	20	8052	146	20	4240	1	6265	40	2	6411	8052	6411	1	1981
EDO. GUARICO	MP. MONAGAS	108	50747	859	109	27064	11	39763	227	28	40622	51066	40622	13	12420
EDO. GUARICO	MP. RIBAS	65	27449	382	65	13293	6	21276	112	15	21658	27449	21658	8	7842
EDO. YARACUY	MP. INDEPENDENCIA	81	38154	893	81	14004	6	31022	178	20	31915	38154	31915	15	16799
EDO. YARACUY	MP.JOSE ANTONIO PAEZ	27	12713	257	27	7305	2	10421	77	7	10678	12713	10678	2	3028
EDO. YARACUY	MP. NIRGUA	111	40676	742	113	20408	14	31912	164	24	32654	41623	32654	20	11282
EDO. YARACUY	MP. LA TRINIDAD	25	11118	253	26	5253	2	9179	46	3	9432	11486	9432	3	3872
EDO. YARACUY	MP. VEROES	48	17918	389	50	11268	3	14194	54	8	14583	18425	14583	3	2858
EDO. YARACUY	MP. ARISTIDES BASTID	35	13828	273	35	7386	4	11040	66	6	11313	13828	11313	2	3576
EDO. YARACUY	MP. PE#A	138	63456	1189	139	32436	15	50955	284	44	52144	63893	52144	20	18156
EDO. YARACUY	MP. SUCRE	32	14178	287	32	6746	4	11876	68	4	12163	14178	12163	3	5051
EDO. YARACUY	MP. URACHICHE	34	14404	318	35	8220	6	11501	61	5	11819	15001	11819	2	3207
EDO. YARACUY	MP. BOLIVAR	54	20744	388	55	10898	7	16544	78	6	16932	21269	16932	3	5552
EDO. YARACUY	MP. BRUZUAL	97	45405	804	99	23687	21	36486	189	29	37290	46554	37290	19	12541
EDO. YARACUY	CE. SAN FELIPE	147	68758	1258	148	27925	14	55413	298	36	56671	69304	56671	27	27113
EDO. YARACUY	MP. MANUEL MONGE	27	11493	212	28	6708	7	9183	33	5	9395	12072	9395	3	2427
EDO. YARACUY	MP. COCOROTE	55	26885	660	55	10455	7	21550	106	11	22210	26885	22210	14	10957
EDO. FALCON	MP. MAUROA	45	16506	342	46	7943	8	13010	74	9	13352	16998	13352	1	4975
EDO. FALCON	MP. SUCRE	16	5566	45	17	3194	1	4238	18	3	4283	5927	4283	0	1022
EDO. FALCON	MP. FALCON	89	36721	578	90	18785	9	29387	163	16	29965	37251	29965	7	10407
EDO. FALCON	MP. MONS. ITURRIZA	31	14335	261	31	6021	3	10705	44	2	10966	14335	10966	0	4635
EDO. FALCON	MP. TOCOPERO	13	5895	128	13	3433	1	4595	16	0	4723	5895	4723	0	1145
EDO. FALCON	MP. SILVA	49	21427	444	50	7580	4	14206	86	13	14650	21955	14650	3	6520
EDO. FALCON	MP. COLINA	52	26143	374	53	12324	2	20785	118	4	21159	26528	21159	4	8333
EDO. FALCON	MP. FEDERACION	60	20605	384	60	9656	8	15518	80	15	15902	20605	15902	4	5755
EDO. FALCON	MP. LOS TAQUES	63	32190	563	64	16091	5	26394	145	6	26957	32719	26957	9	10138
EDO. FALCON	MP. CARIRUBANA	306	157164	2542	312	75638	27	128215	697	60	130757	160367	130757	66	51727
EDO. FALCON	MP. DABAJURO	30	13825	244	33	6020	1	10786	60	4	11030	15197	11030	3	4698
EDO. FALCON	MP. CACIQUE MANAURE	16	8049	244	16	3577	0	6074	30	2	6318	8049	6318	1	2464
EDO. FALCON	MP. JACURA	22	8362	118	23	4109	1	5960	40	1	6078	8461	6078	3	1806
EDO. FALCON	MP. PALMA SOLA	13	3754	46	13	2482	1	2988	14	2	3034	3754	3034	1	488
EDO. FALCON	MP. ACOSTA	36	14547	230	36	6507	4	10789	46	5	11019	14547	11019	2	4225
EDO. FALCON	MP. DEMOCRACIA	26	7265	89	35	3737	2	5642	29	1	5731	8966	5731	1	1872
EDO. FALCON	MP. ZAMORA	60	22749	270	60	10842	7	17626	112	3	17896	22749	17896	7	6655
EDO. FALCON	MP. UNION	35	10869	143	36	5499	1	8025	51	7	8168	11389	8168	1	2466
EDO. FALCON	MP. URUMACO	21	6477	96	22	3367	1	5308	17	1	5404	6671	5404	0	1922
EDO. FALCON	MP. PETIT	31	10221	172	32	5569	1	7474	39	7	7646	10796	7646	2	1856
EDO. FALCON	MP. PIRITU	29	9122	176	29	4922	2	6571	47	6	6747	9122	6747	2	1592
EDO. FALCON	MP. SAN FRANCISCO	23	9219	122	23	4603	3	6839	26	2	6961	9219	6961	2	2203
EDO. FALCON	MP. BOLIVAR	23	6962	114	24	3920	1	5569	32	4	5683	7278	5683	5	1607
EDO. FALCON	MP. BUCHIVACOA	47	17686	275	47	8607	1	13848	74	6	14123	17686	14123	8	5152
EDO. FALCON	CE. MIRANDA	272	134639	2253	282	57411	44	107422	674	60	109675	138150	109675	47	49186
DTTO. CAPITAL	CE. BLVNO LIBERTADOR	3207	1608976	25237	3207	695162	440	1267287	5324	796	1292524	1608976	1292524	1253	564312
EDO. TRUJILLO	MP. PAMPANITO	41	17286	271	41	9109	4	14302	56	4	14573	17286	14573	4	5125
EDO. TRUJILLO	MP. MOTATAN	29	13044	288	29	7664	2	10790	37	4	11078	13044	11078	2	3081
EDO. TRUJILLO	MP. ANDRES BELLO	25	11722	250	25	5983	0	8605	17	4	8855	11722	8855	1	2600
EDO. TRUJILLO	MP. BOCONO	180	65361	1022	184	34013	19	49036	260	47	50058	66836	50058	24	14673
EDO. TRUJILLO	MP. RAFAEL RANGEL	32	15422	269	32	7041	2	12453	55	4	12722	15422	12722	6	5345
EDO. TRUJILLO	MP. BOLIVAR	24	10613	154	24	6143	0	8223	27	2	8377	10613	8377	2	2049
EDO. TRUJILLO	CE. TRUJILLO	99	42708	601	100	20397	1	34110	146	25	34711	42789	34711	20	13521
EDO. TRUJILLO	MP. CARACHE	78	21818	288	78	12149	3	16548	69	11	16836	21818	16836	3	4313
EDO. TRUJILLO	MP. CANDELARIA	58	19360	238	61	11482	2	14467	57	6	14705	20732	14705	1	2919
EDO. TRUJILLO	MP. SUCRE	40	19391	256	40	9956	7	15253	50	5	15509	19391	15509	2	5233
EDO. TRUJILLO	MP. PAMPAN	79	32904	539	81	17899	6	25893	104	9	26432	33706	26432	5	7870
EDO. TRUJILLO	MP. JUAN V CAMPO ELI	14	5442	70	14	3286	2	4296	11	3	4366	5442	4366	2	992
EDO. TRUJILLO	MP. ESCUQUE	48	19321	294	49	9737	1	15926	73	6	16220	19842	16220	4	6105
EDO. TRUJILLO	MP. VALERA	201	97532	1371	205	42671	21	80499	302	39	81870	99540	81870	37	37429
EDO. TRUJILLO	MP. MONTE CARMELO	31	10920	161	31	6001	1	8270	28	2	8431	10920	8431	1	2237
EDO. TRUJILLO	MP. URDANETA	63	24408	351	63	11783	5	18212	64	19	18563	24408	18563	3	6338
EDO. TRUJILLO	MP. LA CEIBA	27	12776	139	27	7569	3	9526	20	1	9665	12776	9665	0	1933
EDO. TRUJILLO	MP. JOSE F M CA#IZAL	9	4395	54	9	2030	1	3231	11	2	3285	4395	3285	0	1187
EDO. TRUJILLO	MP. MIRANDA	33	14825	267	33	8053	1	11444	47	3	11711	14825	11711	1	3339
EDO. TRUJILLO	MP.S RAFAEL CARVAJAL	73	36009	573	73	17110	3	29463	84	10	30036	36009	30036	7	12249
EDO. APURE	MP. PEDRO CAMEJO	45	19401	272	50	9517	2	14306	45	5	14578	21277	14578	2	4735
EDO. APURE	MP. MU#OZ	50	20251	253	51	11593	3	15362	86	6	15615	20680	15615	1	3673
EDO. APURE	MP. ROMULO GALLEGOS	39	17939	275	39	9102	3	12927	67	11	13202	17939	13202	1	3743
EDO. APURE	CE. SAN FERNANDO	219	105661	1714	227	54368	13	85278	474	53	86992	108601	86992	29	30341
EDO. APURE	MP. PAEZ	142	64496	1150	145	28462	21	46756	377	33	47906	66086	47906	16	17847
EDO. APURE	MP. ACHAGUAS	86	37203	529	94	20699	7	28506	182	23	29035	39580	29035	5	7590
EDO. APURE	MP. BIRUACA	82	35884	630	82	19146	4	28722	147	10	29352	35884	29352	7	9408
EDO. CARABOBO	MP. SAN DIEGO	110	59286	555	110	14289	9	51282	184	31	51837	59286	51837	30	36739
EDO. CARABOBO	MP. LOS GUAYOS	184	96651	1506	184	48671	19	76737	428	36	78243	96651	78243	47	27536
EDO. CARABOBO	MP. BEJUMA	69	32827	403	69	13476	8	26013	89	13	26416	32827	26416	12	12415
EDO. CARABOBO	MP. NAGUANAGUA	184	98332	1173	186	32100	29	80358	298	40	81531	99406	81531	42	47849
EDO. CARABOBO	MP. CARLOS ARVELO	198	98214	1677	200	52255	26	73785	439	52	75462	98917	75462	34	20979
EDO. CARABOBO	MP. LIBERTADOR	209	108480	1563	210	53709	45	83250	385	64	84813	109006	84813	46	29001
EDO. CARABOBO	MP. MIRANDA	38	19116	272	38	9829	2	14916	64	5	15188	19116	15188	5	5011
EDO. CARABOBO	MP. SAN JOAQUIN	74	38296	573	75	18013	9	31058	151	18	31631	38795	31631	23	12844
EDO. CARABOBO	MP. DIEGO IBARRA	126	66668	1184	126	38290	12	53098	273	42	54282	66668	54282	24	14457
EDO. CARABOBO	CE. VALENCIA	1065	563816	7237	1091	210401	138	441991	2223	197	449228	573991	449228	249	228783
EDO. CARABOBO	MP. JUAN JOSE MORA	104	48361	769	105	29047	28	39234	157	23	40003	48822	40003	21	9958
EDO. CARABOBO	MP. GUACARA	216	114093	1526	218	50813	23	93012	474	51	94538	115155	94538	44	41607
EDO. CARABOBO	MP. MONTALBAN	35	16769	250	35	7394	2	13410	46	5	13660	16769	13660	3	5960
EDO. CARABOBO	MP. PUERTO CABELLO	275	140535	2006	276	68576	42	111142	426	46	113148	140831	113148	58	41994
EDO. VARGAS	CE. VARGAS	547	263656	4105	553	126365	68	205669	1007	133	209774	265911	209774	157	77939
EDO. ZULIA	MP. LA CA#ADA DE U.	88	46316	336	89	19815	1	36957	61	5	37293	46796	37293	5	17070
EDO. ZULIA	MP. COLON	138	67895	871	140	30107	10	53858	160	16	54729	68776	54729	9	23556
EDO. ZULIA	MP. JESUS E LOSSADA	127	63908	936	128	28883	8	48615	128	26	49551	64408	49551	13	19557
EDO. ZULIA	MP. SIMON BOLIVAR	62	32248	551	62	14231	12	26070	85	13	26621	32248	26621	10	11719
EDO. ZULIA	MP. SUCRE	84	39043	605	85	18931	11	29650	81	11	30255	39601	30255	8	10608
EDO. ZULIA	MP. MIRANDA	139	63731	831	143	35172	8	52885	152	18	53716	65392	53716	13	17522
EDO. ZULIA	MP. LAGUNILLAS	229	122234	1978	231	46880	30	99271	363	55	101249	123385	101249	40	51903
EDO. ZULIA	MP. CATATUMBO	38	18006	186	44	6983	1	13441	35	4	13627	20052	13627	2	6416
EDO. ZULIA	MP. MACHIQUES DE P	151	74920	896	152	28706	13	53645	183	30	54541	75419	54541	3	24710
EDO. ZULIA	MP. CABIMAS	354	179263	2371	363	84344	27	148740	541	63	151111	182607	151111	57	63708
EDO. ZULIA	MP. BLVNO GUAJIRA	135	62399	621	136	25124	12	35429	157	27	36050	62881	36050	3	10106
EDO. ZULIA	MP. JESUS M SEMPRUN	36	15349	182	39	8161	1	11851	54	2	12033	15892	12033	1	3632
EDO. ZULIA	CE. MARACAIBO	1762	923243	10542	1768	331295	109	723212	1794	299	733754	926484	733754	316	389399
EDO. ZULIA	MP. ALMIRANTE P	19	9635	73	19	5645	0	7546	15	0	7619	9635	7619	0	1886
EDO. ZULIA	MP.ROSARIO DE PERIJA	103	54057	631	106	22218	7	39804	90	17	40435	55692	40435	4	17468
EDO. ZULIA	MP. SAN FRANCISCO	522	271530	3193	525	123829	25	218204	695	96	221397	273207	221397	69	93490
EDO. ZULIA	MP. SANTA RITA	79	39067	496	79	18422	10	31709	109	8	32205	39067	32205	10	13150
EDO. ZULIA	MP. BARALT	118	55568	677	118	27404	5	43855	186	17	44532	55568	44532	6	16237
EDO. ZULIA	MP.VALMORE RODRIGUEZ	73	36826	680	73	16043	6	29298	136	23	29978	36826	29978	7	13083
EDO. ZULIA	MP. FRANCISCO J PULG	39	18613	331	40	7905	3	14191	26	7	14522	18910	14522	2	6248
EDO. ZULIA	MP. MARA	240	121683	1315	240	65991	20	93792	261	51	95107	121683	95107	18	27451
EDO. ANZOATEGUI	MP. INDEPENDENCIA	50	22783	452	53	12443	4	17315	98	15	17767	23883	17767	8	4747
EDO. ANZOATEGUI	MP. ARAGUA	51	21354	326	52	10078	11	17072	113	14	17398	21820	17398	5	6851
EDO. ANZOATEGUI	MP. MC GREGOR	16	7583	103	16	4120	2	5674	27	7	5777	7583	5777	0	1518
EDO. ANZOATEGUI	MP. PE#ALVER	42	21499	397	42	8920	6	17323	134	10	17720	21499	17720	5	8248
EDO. ANZOATEGUI	MP. MIRANDA	65	31474	632	66	13935	4	24378	172	20	25010	32065	25010	7	10240
EDO. ANZOATEGUI	MP. BRUZUAL	47	21720	398	47	8649	5	17269	85	12	17667	21720	17667	3	8515
EDO. ANZOATEGUI	MP.S JUAN CAPISTRANO	14	6874	130	14	2964	3	5333	34	3	5463	6874	5463	1	2328
EDO. ANZOATEGUI	MP. SIMON RODRIGUEZ	221	113514	1973	222	42636	25	90755	619	35	92728	113972	92728	29	47411
EDO. ANZOATEGUI	MP. LIBERTAD	23	11879	157	25	5160	0	8921	57	4	9078	12878	9078	0	3700
EDO. ANZOATEGUI	MP. CAJIGAL	21	9472	150	22	4637	3	7301	50	4	7451	9818	7451	2	2605
EDO. ANZOATEGUI	MP. SOTILLO	330	167214	2550	334	66581	56	132235	768	75	134785	169154	134785	73	64682
EDO. ANZOATEGUI	MP. CARVAJAL	20	9832	145	20	4284	1	7944	32	4	8089	9832	8089	2	3621
EDO. ANZOATEGUI	MP. SANTA ANA	17	7832	122	17	3221	3	6246	45	5	6368	7832	6368	1	2971
EDO. ANZOATEGUI	MP. ANACO	165	85754	1646	167	34341	16	69186	566	44	70832	86692	70832	32	34187
EDO. ANZOATEGUI	MP. FREITES	102	50553	746	107	22932	12	40864	237	23	41610	52968	41610	7	17653
EDO. ANZOATEGUI	MP. GUANTA	50	24357	498	50	10729	3	19875	105	4	20373	24357	20373	5	9029
EDO. ANZOATEGUI	CE. BOLIVAR	511	261237	4373	522	107115	68	207480	1403	117	211853	266290	211853	83	98694
EDO. ANZOATEGUI	MP. L/DIEGO BAUTISTA	63	32128	197	63	4705	3	26612	57	2	26809	32128	26809	13	21832
EDO. ANZOATEGUI	MP. PIRITU	36	17596	349	37	7965	1	14340	71	9	14689	18040	14689	6	6288
EDO. ANZOATEGUI	MP. GUANIPA	101	50706	789	103	22772	6	41011	298	14	41800	51674	41800	14	17907
EDO. ANZOATEGUI	MP. MONAGAS	32	14579	314	34	7241	3	10904	63	9	11218	15430	11218	2	3586
EDO. LARA	MP. ANDRES E BLANCO	77	29516	403	83	15131	14	23494	125	17	23897	30883	23897	11	8196
EDO. LARA	MP. MORAN	208	86288	1521	212	43788	42	66848	420	88	68369	87084	68369	25	22485
EDO. LARA	MP. JIMENEZ	137	64135	1116	138	33266	22	51910	382	48	53026	64373	53026	34	18158
EDO. LARA	MP. TORRES	235	113867	1848	289	49459	35	91143	458	59	92991	130764	92991	41	41091
EDO. LARA	MP. SIMON PLANAS	53	24844	438	53	14634	14	19756	113	18	20194	24844	20194	9	4968
EDO. LARA	MP. CRESPO	71	33240	686	72	13965	10	26392	159	35	27078	33728	27078	18	12205
EDO. LARA	MP. PALAVECINO	202	102297	1334	202	33582	16	87423	448	61	88757	102297	88757	39	53277
EDO. LARA	CE. IRIBARREN	1327	665398	10488	1361	256474	169	545240	3503	408	555728	680399	555728	337	284349
EDO. LARA	MP. URDANETA	122	41703	530	127	21987	13	32832	189	48	33362	43318	33362	7	10588
EDO. ARAGUA	MP.OCUMARE D L COSTA	18	8585	140	18	4057	2	6521	26	2	6661	8585	6661	2	2432
EDO. ARAGUA	MP. SANTOS MICHELENA	51	24282	536	51	14941	8	19196	60	10	19732	24282	19732	5	4172
EDO. ARAGUA	MP. ZAMORA	186	93246	1764	186	52112	28	75174	423	69	76938	93246	76938	38	22504
EDO. ARAGUA	MP. JOSE ANGEL LAMAS	48	22721	302	48	11485	4	19052	94	15	19354	22721	19354	9	7445
EDO. ARAGUA	MP. CAMATAGUA	26	11826	208	26	6153	1	9106	61	4	9314	11826	9314	1	2886
EDO. ARAGUA	MP.FRANCISCO LINARES	161	82289	1471	163	46753	12	66750	344	49	68221	83422	68221	47	19545
EDO. ARAGUA	MP. JOSE R REVENGA	63	30956	528	63	19022	12	25541	104	22	26069	30956	26069	12	6369
EDO. ARAGUA	MP. SUCRE	159	82748	1398	159	36755	19	68346	328	29	69744	82748	69744	49	31166
EDO. ARAGUA	MP. LIBERTADOR	118	60141	997	118	32399	10	49377	241	31	50374	60141	50374	39	16657
EDO. ARAGUA	MP. TOVAR	31	12296	237	32	4874	7	9315	40	9	9552	12552	9552	4	4381
EDO. ARAGUA	MP. BOLIVAR	57	28943	734	58	16072	4	22537	101	13	23271	29497	23271	6	6341
EDO. ARAGUA	MP. MARIO B IRAGORRY	147	76918	1005	149	31444	15	64824	239	48	65829	77982	65829	53	33025
EDO. ARAGUA	MP. URDANETA	34	15607	386	34	8850	2	12496	60	6	12882	15607	12882	7	3571
EDO. ARAGUA	MP. JOSE FELIX RIVAS	199	101606	1730	203	49431	21	83347	391	51	85077	103622	85077	55	33398
EDO. ARAGUA	MP. SAN SEBASTIAN	34	16236	244	34	8062	3	12969	39	11	13213	16236	13213	5	4849
EDO. ARAGUA	MP. SAN CASIMIRO	42	18428	391	42	10050	5	14660	60	11	15051	18428	15051	6	4528
EDO. ARAGUA	MP. SANTIAGO MARI#O	251	129840	1999	254	61618	25	104406	488	64	106405	131534	106405	63	42148
EDO. ARAGUA	CE. GIRARDOT	656	340842	4397	657	136159	71	275911	1178	154	280308	341329	280308	171	138178
EDO. MONAGAS	MP. SOTILLO	33	14870	234	36	7599	1	10879	85	10	11113	15902	11113	2	3182
EDO. MONAGAS	MP. PUNCERES	46	21237	359	46	10454	6	16342	116	3	16701	21237	16701	7	5756
EDO. MONAGAS	MP. CEDE#O	52	23542	312	57	9045	1	18530	103	16	18842	25364	18842	5	9360
EDO. MONAGAS	MP. PIAR	72	30782	467	74	15102	7	23717	110	12	24184	31535	24184	6	8480
EDO. MONAGAS	MP. ACOSTA	35	15221	265	35	6088	1	11464	33	4	11729	15221	11729	7	5331
EDO. MONAGAS	MP. LIBERTADOR	55	27199	498	58	15300	7	21171	162	11	21669	28703	21669	7	5684
EDO. MONAGAS	MP. SANTA BARBARA	16	7182	151	17	3522	0	5694	28	1	5845	7580	5845	5	2138
EDO. MONAGAS	MP. BOLIVAR	63	26627	438	64	12845	6	20221	101	4	20659	27194	20659	5	7260
EDO. MONAGAS	MP. CARIPE	54	23655	369	56	10399	7	17511	58	19	17880	24618	17880	4	7024
EDO. MONAGAS	MP. URACOA	17	7404	171	17	2757	1	5718	24	4	5889	7404	5889	1	2931
EDO. MONAGAS	CE. MATURIN	651	324256	4695	680	145434	49	262148	1636	130	266843	337596	266843	99	114800
EDO. MONAGAS	MP. EZEQUIEL ZAMORA	81	40477	835	84	20587	10	32619	181	14	33454	42047	33454	9	11818
EDO. MONAGAS	MP. AGUASAY	23	10684	212	23	5276	1	8305	59	4	8517	10684	8517	0	2965
EDO. BOLIVAR	MP. BLVNO ANGOSTURA	58	24304	378	69	9464	5	17168	117	15	17546	27764	17546	6	7561
EDO. BOLIVAR	MP. GRAN SABANA	46	18292	309	53	6919	17	11751	98	21	12060	20767	12060	12	4684
EDO. BOLIVAR	MP. ROSCIO	36	16958	364	36	6028	2	12721	81	8	13085	16958	13085	2	6600
EDO. BOLIVAR	MP. CEDE#O	96	41021	644	111	20274	9	28729	124	27	29373	44642	29373	6	8289
EDO. BOLIVAR	MP. PIAR	142	70533	1288	146	24100	13	54309	389	31	55597	71693	55597	9	29767
EDO. BOLIVAR	MP. SIFONTES	61	29827	514	62	10608	17	19081	184	14	19595	29913	19595	7	8251
EDO. BOLIVAR	MP. EL CALLAO	34	16364	375	34	4664	7	11959	68	3	12334	16364	12334	3	7214
EDO. BOLIVAR	MP. CARONI	871	443196	6434	907	197067	89	358224	2306	215	364658	461166	364658	165	158382
EDO. BOLIVAR	MP. SUCRE	42	16306	321	46	7411	3	10613	67	12	10934	17411	10934	4	3116
EDO. BOLIVAR	MP.PADRE PEDRO CHIEN	20	8957	135	26	3714	0	6839	39	6	6974	11594	6974	1	3079
EDO. BOLIVAR	CE. HERES	498	222367	3784	500	86200	52	173045	1217	76	176829	223425	176829	96	85404
EDO. MIRANDA	MP. INDEPENDENCIA	171	88417	1534	176	51505	21	71055	319	49	72589	91010	72589	45	19116
EDO. MIRANDA	MP. BARUTA	429	226713	1719	432	36343	34	175058	318	49	176777	228367	176777	105	138209
EDO. MIRANDA	MP. SIMON BOLIVAR	56	25756	484	56	15156	4	20993	82	12	21477	25756	21477	16	5723
EDO. MIRANDA	MP. PLAZA	257	134220	2234	262	66334	24	111907	454	48	114141	136683	114141	94	44953
EDO. MIRANDA	MP. SUCRE	876	455590	6211	881	165044	106	354650	1287	182	360861	458130	360861	255	187776
EDO. MIRANDA	MP. BUROZ	35	16109	326	35	8728	1	12520	51	5	12846	16109	12846	4	3731
EDO. MIRANDA	MP. EL HATILLO	95	50654	407	96	7329	4	40399	82	16	40806	51215	40806	18	32950
EDO. MIRANDA	MP. LOS SALIAS	104	55106	474	104	10862	9	45748	74	21	46222	55106	46222	42	34740
EDO. MIRANDA	MP. ANDRES BELLO	37	15016	315	39	7948	5	11648	43	6	11963	15904	11963	4	3642
EDO. MIRANDA	MP. PEDRO GUAL	32	13679	297	33	6316	5	10218	65	4	10515	13780	10515	4	3824
EDO. MIRANDA	MP. PAZ CASTILLO	127	63099	1078	127	38237	13	50639	234	29	51717	63099	51717	33	12093
EDO. MIRANDA	MP. CRISTOBAL ROJAS	157	78486	1560	158	41403	22	64054	303	31	65614	79053	65614	58	22237
EDO. MIRANDA	MP. CARRIZAL	70	35876	529	71	12818	8	29453	101	21	29982	36403	29982	39	16466
EDO. MIRANDA	MP. CHACAO	156	81580	698	157	10910	13	59379	128	26	60077	82111	60077	40	48262
EDO. MIRANDA	MP. ZAMORA	233	116976	2022	236	53039	13	97148	352	47	99170	118640	99170	82	43615
EDO. MIRANDA	MP. BRION	80	38808	866	80	18836	6	30486	143	20	31352	38808	31352	22	11459
EDO. MIRANDA	MP. URDANETA	167	81255	1603	168	43811	28	66049	300	41	67652	81789	67652	61	21808
EDO. MIRANDA	MP. LANDER	175	88765	1643	176	52965	20	71463	329	43	73106	89294	73106	49	18057
EDO. MIRANDA	MP. ACEVEDO	140	55204	1206	144	28857	10	41440	192	33	42646	55851	42646	24	12324
EDO. MIRANDA	CE. GUAICAIPURO	364	186497	3019	366	77121	57	150810	623	94	153829	187594	153829	127	72788
EDO. MIRANDA	MP. PAEZ	55	25955	545	55	12911	5	20360	82	10	20905	25955	20905	6	7346
EDO. BARINAS	CE. BARINAS	433	215853	3853	445	94895	39	174902	891	85	178755	220598	178755	63	78929
EDO. BARINAS	MP. CRUZ PAREDES	46	17452	284	50	10158	2	13912	84	7	14196	17969	14196	1	3660
EDO. BARINAS	MP. PEDRAZA	98	42180	732	101	17651	4	32119	141	27	32851	42724	32851	2	14294
EDO. BARINAS	MP. ROJAS	61	26544	391	61	14914	4	20450	121	11	20841	26544	20841	2	5398
EDO. BARINAS	MP. ARISMENDI	52	15882	233	56	7676	4	10796	60	9	11029	17459	11029	2	3045
EDO. BARINAS	MP. ALBERTO ARVELO T	59	27077	472	60	17900	2	21982	103	7	22454	27655	22454	6	3964
EDO. BARINAS	MP. ANDRES E. BLANCO	27	10722	146	29	4968	1	8193	47	2	8339	11841	8339	2	3173
EDO. BARINAS	MP. A JOSE DE SUCRE	94	46449	816	95	19621	11	35825	182	24	36641	47014	36641	6	15981
EDO. BARINAS	MP. SOSA	38	16048	240	40	7999	0	12309	60	4	12549	16983	12549	2	4244
EDO. BARINAS	MP. BOLIVAR	87	35833	572	87	17116	7	28800	141	13	29372	35833	29372	9	11514
EDO. BARINAS	MP. EZEQUIEL ZAMORA	77	34446	623	81	13840	4	26640	121	19	27263	36296	27263	4	12652
EDO. BARINAS	MP. OBISPOS	44	19240	294	59	10390	2	15346	107	9	15640	24236	15640	4	4834
EDO. COJEDES	MP. GIRARDOT	21	9212	147	21	4942	1	7190	46	5	7337	9212	7337	4	2192
EDO. COJEDES	MP. TINACO	50	23109	471	50	12204	2	18517	104	13	18988	23109	18988	6	6188
EDO. COJEDES	CE. EZEQUIEL ZAMORA	153	69367	1356	155	33357	29	56698	397	22	58054	70471	58054	26	22867
EDO. COJEDES	MP. RICAURTE	23	10302	177	23	6544	2	8207	52	4	8384	10302	8384	2	1603
EDO. COJEDES	MP. ROMULO GALLEGOS	28	13397	276	29	7312	2	10632	87	6	10908	13984	10908	1	3224
EDO. COJEDES	MP. PAO S J BAUTISTA	41	12105	268	43	7543	8	9602	59	6	9870	12439	9870	3	1983
EDO. COJEDES	MP. LIMA BLANCO	18	8651	171	18	4812	1	7070	26	3	7241	8651	7241	2	2226
EDO. COJEDES	MP. ANZOATEGUI	28	11833	282	28	6737	2	9513	44	0	9795	11833	9795	3	2727
EDO. COJEDES	MP. TINAQUILLO	133	62694	1348	134	32437	23	50157	281	22	51505	63027	51505	22	17372
EDO.NVA.ESPARTA	MP.VILLALBA(I.COCHE)	14	7232	97	14	3246	0	5838	22	14	5935	7232	5935	1	2555
EDO.NVA.ESPARTA	CE. ARISMENDI	41	20288	294	42	6839	3	16648	58	6	16942	20813	16942	10	9732
EDO.NVA.ESPARTA	MP. MANEIRO	70	34486	350	70	9166	1	27972	66	2	28322	34486	28322	9	18728
EDO.NVA.ESPARTA	MP. GOMEZ	53	26456	295	53	11988	0	21527	114	3	21822	26456	21822	5	9417
EDO.NVA.ESPARTA	MP. GARCIA	74	38025	642	74	16596	2	30051	157	8	30693	38025	30693	13	13275
EDO.NVA.ESPARTA	MP. MARCANO	52	25301	353	52	11685	4	20446	116	13	20799	25301	20799	4	8624
EDO.NVA.ESPARTA	MP. DIAZ	82	40234	919	82	18812	9	32347	152	5	33266	40234	33266	13	13356
EDO.NVA.ESPARTA	MP. TUBORES	48	22825	354	49	10590	2	18178	73	6	18532	23247	18532	3	7504
EDO.NVA.ESPARTA	MP.PENIN. DE MACANAO	40	17396	176	41	7554	1	13059	56	4	13235	17752	13235	7	5437
EDO.NVA.ESPARTA	MP. MARI#O	142	71928	1104	150	26683	9	55371	247	18	56475	75992	56475	16	28398
EDO.NVA.ESPARTA	MP.ANTOLIN DEL CAMPO	42	20006	250	42	8423	3	16567	80	1	16817	20006	16817	8	8052
EDO. TACHIRA	MP. INDEPENDENCIA	49	24290	443	49	9060	5	20161	103	4	20604	24290	20604	6	10983
EDO. TACHIRA	MP. SAN JUDAS TADEO	16	6821	139	17	3332	0	5384	24	2	5523	7314	5523	1	2025
EDO. TACHIRA	CE. SAN CRISTOBAL	390	201241	2574	396	52493	24	166420	532	53	168994	203952	168994	72	113246
EDO. TACHIRA	MP. ANTONIO ROMULO C	17	7473	169	17	3823	2	6017	27	0	6186	7473	6186	2	2163
EDO. TACHIRA	MP. SUCRE	21	6100	65	22	2879	0	4893	7	0	4958	6231	4958	1	2006
EDO. TACHIRA	MP. LIBERTADOR	34	14539	195	34	5961	4	11876	39	5	12071	14539	12071	5	5862
EDO. TACHIRA	MP. PANAMERICANO	42	18920	328	42	7889	4	14764	72	3	15092	18920	15092	2	6794
EDO. TACHIRA	MP. SIMON RODRIGUEZ	5	2520	41	5	953	0	2067	7	4	2108	2520	2108	0	1103
EDO. TACHIRA	MP. ANDRES BELLO	35	16661	310	35	5740	2	13895	42	6	14205	16661	14205	9	8096
EDO. TACHIRA	MP. LIBERTAD	43	18035	368	43	7545	4	14588	59	4	14956	18035	14956	4	6972
EDO. TACHIRA	MP. SAMUEL MALDONADO	28	10954	213	29	5066	2	8881	20	2	9094	11490	9094	4	3787
EDO. TACHIRA	MP. TORBES	51	26756	687	52	11054	5	21232	83	9	21919	27311	21919	10	10071
EDO. TACHIRA	MP. JOSE MARIA VARGA	20	7536	135	20	3311	0	6187	24	2	6322	7536	6322	0	2850
EDO. TACHIRA	MP. LOBATERA	24	9635	145	24	4564	0	7936	29	1	8081	9635	8081	4	3338
EDO. TACHIRA	MP. MICHELENA	30	13253	202	30	5546	2	10993	40	5	11195	13253	11195	9	5391
EDO. TACHIRA	MP. GUASIMOS	56	27640	598	57	9454	8	23541	71	10	24139	28127	24139	13	13985
EDO. TACHIRA	MP. URIBANTE	49	13868	204	52	5437	2	10675	20	2	10879	14679	10879	2	5212
EDO. TACHIRA	MP. GARCIA DE HEVIA	70	32327	492	72	15006	4	25261	114	5	25753	33224	25753	3	10129
EDO. TACHIRA	MP. CORDOBA	41	20108	499	41	7670	1	15991	62	1	16490	20108	16490	10	8247
EDO. TACHIRA	MP. JUNIN	111	55345	980	111	20974	10	45961	205	17	46941	55345	46941	28	24727
EDO. TACHIRA	MP. FERNANDEZ FEO	65	26531	483	65	11830	5	21316	120	10	21799	26531	21799	6	9345
EDO. TACHIRA	MP. AYACUCHO	76	35485	639	77	13021	5	29018	103	6	29657	35996	29657	7	15876
EDO. TACHIRA	MP. JAUREGUI	67	27057	496	67	10103	7	22034	93	15	22530	27057	22530	5	11811
EDO. TACHIRA	MP. FCO DE MIRANDA	9	3684	37	10	1059	0	3082	10	2	3119	3978	3119	0	2011
EDO. TACHIRA	MP. BOLIVAR	99	49237	695	99	11590	6	29069	138	5	29764	49237	29764	7	17323
EDO. TACHIRA	MP. SEBORUCO	17	6140	113	20	2534	0	4954	14	1	5067	7510	5067	0	2405
EDO. TACHIRA	MP. RAFAEL URDANETA	12	4188	90	14	1915	1	3332	17	3	3422	5006	3422	3	1393
EDO. TACHIRA	MP.PEDRO MARIA URE#A	67	33725	498	68	9368	1	20828	108	10	21326	34112	21326	5	11336
EDO. TACHIRA	MP. CARDENAS	132	67000	1136	137	21859	6	56467	201	14	57603	69016	57603	23	34364
