Estado,Municipio,Parroquia,Centro,Número de Electores escrutados.,Número de Actas Procesadas.,Número total de Votos Nulos.,Número Total de Votantes que votaron realmente.,HUGO CHAVEZ,Número total de Votos Válidos.,ORLANDO CHIRINO,REINA SEQUERA,LUIS REYES,MARIA BOLIVAR,HENRIQUE CAPRILES RADONSKI,Número de Votos Escrutados.
EDO. MONAGAS,MP. SOTILLO,LOS BARRANCOS DE FAJARDO,ESCUELA UNITARIA 302 CAFETERA,117,1,2,104,76,102,0,0,0,0,26,104
EDO. MONAGAS,MP. SOTILLO,LOS BARRANCOS DE FAJARDO,ESCUELA UNITARIA NUMERO 301 LOS BARRANCOS DE FAJARDOS,600,1,8,459,335,451,0,2,1,0,113,459
EDO. MONAGAS,MP. SOTILLO,LOS BARRANCOS DE FAJARDO,ESCUELA UNITARIA 421 CHIGUICHIGUAL,97,1,5,89,66,84,0,2,1,0,15,89
EDO. MONAGAS,MP. SOTILLO,LOS BARRANCOS DE FAJARDO,ESCUELA 415 UVERITO,296,1,2,269,208,267,0,2,0,0,57,269
EDO. MONAGAS,MP. SOTILLO,LOS BARRANCOS DE FAJARDO,ESCUELA 417 SAN ROQUE,133,1,1,117,102,116,0,0,0,0,14,117
EDO. MONAGAS,MP. SOTILLO,LOS BARRANCOS DE FAJARDO,ESCUELA UNITARIA NUMERO 320 419 VARADERO DE LIMONES,399,1,6,284,215,278,0,5,0,0,58,284
EDO. MONAGAS,MP. SOTILLO,LOS BARRANCOS DE FAJARDO,ESCUELA BÁSICA ALARICO GÓMEZ,3118,6,48,2382,1989,2334,1,19,3,0,322,2382
EDO. MONAGAS,MP. SOTILLO,CM. BARRANCAS,JARDIN DE INFANCIA BOLIVARIANO URIAPARA,1386,3,25,995,585,970,0,7,1,0,377,995
EDO. MONAGAS,MP. SOTILLO,CM. BARRANCAS,ESCUELA BASICA CONCENTRADA NUMERO 7,149,1,0,107,55,107,0,0,0,0,52,107
EDO. MONAGAS,MP. SOTILLO,CM. BARRANCAS,ESCUELA UNITARIA NUEMRO 307 332
EDO. MONAGAS,MP. SOTILLO,CM. BARRANCAS,ESCUELA BASICA BLANCA GUEVARA DE BALAN,2509,5,37,1936,1253,1899,0,14,1,1,630,1936
EDO. MONAGAS,MP. SOTILLO,CM. BARRANCAS,ESCUELA UNITARIA 93 PUNTA DE PIEDRA,131,1,0,79,68,79,0,1,0,0,10,79
EDO. MONAGAS,MP. SOTILLO,CM. BARRANCAS,ESCUELA ESTADAL 416 BAJO HONDO,232,1,3,179,140,176,0,1,0,0,35,179
EDO. MONAGAS,MP. SOTILLO,CM. BARRANCAS,ESCUELA BASICA FLORENTINO MONTERO ARIAS,2724,5,40,1946,1222,1906,0,18,2,1,663,1946
EDO. MONAGAS,MP. SOTILLO,CM. BARRANCAS,ESCUELA BÁSICA URIAPARA,3128,6,57,2274,1340,2217,0,14,1,0,862,2274
EDO. MONAGAS,MP. PUNCERES,CM. QUIRIQUIRE,CASA DE LA CULTURA,1091,2,24,909,466,885,1,5,0,1,412,909
EDO. MONAGAS,MP. PUNCERES,CM. QUIRIQUIRE,ESCUELA BASICA EL LIMON,517,1,12,350,254,338,0,1,0,0,83,350
EDO. MONAGAS,MP. PUNCERES,CM. QUIRIQUIRE,ESCUELA BASICA 23 DE ENERO,564,1,5,444,358,439,2,6,1,0,72,444
EDO. MONAGAS,MP. PUNCERES,CM. QUIRIQUIRE,ESCUELA BASICA BOLIVARIANA EL DANTO,709,2,11,518,347,507,0,6,1,0,153,518
EDO. MONAGAS,MP. PUNCERES,CM. QUIRIQUIRE,ESCUELA BOLIVARIANA AIDA DE LEONETT,1182,2,26,900,590,874,0,4,0,0,280,900
EDO. MONAGAS,MP. PUNCERES,CM. QUIRIQUIRE,GRUPO ESCOLAR MATURIN,1581,3,20,1179,827,1159,1,11,0,0,320,1179
EDO. MONAGAS,MP. PUNCERES,CM. QUIRIQUIRE,ESCUELA BASICA NUMERO 156 LOS BAÑOS,193,1,2,171,133,169,0,1,0,0,35,171
EDO. MONAGAS,MP. PUNCERES,CM. QUIRIQUIRE,UNIDAD EDUCATIVA JUANA RAMIREZ,1362,3,28,1031,624,1003,0,9,0,1,369,1031
EDO. MONAGAS,MP. PUNCERES,CM. QUIRIQUIRE,ESCUELA BASICA ESTADAL LA CRUZ BLANCA,285,1,5,208,122,203,0,1,0,0,80,208
EDO. MONAGAS,MP. PUNCERES,CM. QUIRIQUIRE,CENTRO DE EDUCACION INICIAL QUIRIQUIRE NEGRO,167,1,7,155,115,148,0,1,0,0,32,155
EDO. MONAGAS,MP. PUNCERES,CM. QUIRIQUIRE,ESCUELA BÁSICA BOLIVARIANA  BARQUISIMETO,1572,3,22,1224,676,1202,0,13,0,1,512,1224
EDO. MONAGAS,MP. PUNCERES,CM. QUIRIQUIRE,ESCUELA PRIMARIA BOLIVARIANA NUMERO 62 LA PLACA,187,1,4,164,121,160,0,5,1,0,33,164
EDO. MONAGAS,MP. PUNCERES,CM. QUIRIQUIRE,ESCUELA 15 DE ENERO PUEBLO LIBRE,983,2,22,801,576,779,0,5,0,0,198,801
EDO. MONAGAS,MP. PUNCERES,CM. QUIRIQUIRE,JARDIN DE INFANCIA NACIONAL DOMINGO HERNANDEZ,185,1,3,175,111,172,0,2,0,0,59,175
EDO. MONAGAS,MP. PUNCERES,CM. QUIRIQUIRE,ESCUELA SABANA LARGA,740,2,14,607,383,593,0,4,0,0,206,607
EDO. MONAGAS,MP. PUNCERES,PQ. CACHIPO,ESCUELA BASICA RAFAEL URDANETA,513,1,11,373,280,362,0,1,0,0,81,373
EDO. MONAGAS,MP. PUNCERES,PQ. CACHIPO,ESCUELA BASICA BOLIVARIANA PUENTE PUNCERES,797,2,9,660,422,651,0,3,0,1,225,660
EDO. MONAGAS,MP. PUNCERES,PQ. CACHIPO,COLEGIO PRIVADO SAN MARTIN,357,1,6,293,206,287,0,3,0,1,77,293
EDO. MONAGAS,MP. PUNCERES,PQ. CACHIPO,ESCUELA BÁSICA ANDRES ELOY BLANCO,2566,5,39,1940,1320,1901,0,6,0,0,575,1940
EDO. MONAGAS,MP. PUNCERES,PQ. CACHIPO,GRUPO ESCOLAR LIBERTADOR,1386,3,13,1110,458,1097,1,7,0,2,629,1110
EDO. MONAGAS,MP. PUNCERES,PQ. CACHIPO,ESCUELA PUENTE PUNCERES NUMERO 101,411,1,3,295,201,292,0,1,0,0,90,295
EDO. MONAGAS,MP. PUNCERES,PQ. CACHIPO,LICEO NACIONAL ANTONIO JOSÉ DE SUCRE,532,1,11,433,325,422,0,2,0,0,95,433
EDO. MONAGAS,MP. PUNCERES,PQ. CACHIPO,CLUB JUAN VICENTE GONZALEZ,1193,2,20,1029,513,1009,0,6,0,0,490,1029
EDO. MONAGAS,MP. PUNCERES,PQ. CACHIPO,ESCUELA BASICA LEONARDO RUIZ PINEDA,2164,4,42,1732,1026,1690,1,13,0,0,650,1732
EDO. MONAGAS,MP. CEDE#O,PQ. SAN FELIX,ESCUELA BASICA GUARAPICHE,205,1,1,194,134,193,0,0,0,0,59,194
EDO. MONAGAS,MP. CEDE#O,PQ. SAN FELIX,ESCUELA ESTADAL QUEBRADA SECA,557,1,4,423,212,419,0,0,0,0,207,423
EDO. MONAGAS,MP. CEDE#O,PQ. SAN FELIX,ESCUELA BASICA CONSUELO NAVAS TOVAR,2219,4,13,1681,657,1668,0,7,0,0,1004,1681
EDO. MONAGAS,MP. CEDE#O,PQ. SAN FELIX,ESCUELA BASICA BOLIVARIANA GUATATA,127,1,3,120,59,117,0,0,0,0,58,120
EDO. MONAGAS,MP. CEDE#O,PQ. SAN FELIX,ESCUELA BÁSICA CONCENTRADA LOS CARDONES,340,1,9,313,200,304,0,1,0,0,103,313
EDO. MONAGAS,MP. CEDE#O,PQ. SAN FELIX,ESCUELA BASICA BOLIVARIANA LA LLANERA,102,1,3,93,38,90,0,1,0,0,51,93
EDO. MONAGAS,MP. CEDE#O,PQ. AREO,ESCUELA BASICA LOS POZOS DE AREO,387,1,11,279,200,268,0,1,1,0,66,279
EDO. MONAGAS,MP. CEDE#O,PQ. AREO,ESCUELA BASICA LOS DOS CAMINOS
EDO. MONAGAS,MP. CEDE#O,PQ. AREO,ESCUELA BASICA CONCENTRADA SAN RAMON,604,2,7,528,460,521,0,2,0,0,59,528
EDO. MONAGAS,MP. CEDE#O,PQ. AREO,ESCUELA BASICA BOLIVARIANA LA TARRAGONA,317,1,9,295,248,286,0,1,0,0,37,295
EDO. MONAGAS,MP. CEDE#O,PQ. AREO,ESCUELA BASICA LA MORITA,604,2,0,396,281,396,0,2,0,0,113,396
EDO. MONAGAS,MP. CEDE#O,PQ. AREO,ESCUELA BASICA SAN JUAN DE AREO,529,1,5,396,283,391,0,4,0,0,104,396
EDO. MONAGAS,MP. CEDE#O,PQ. AREO,ESCUELA BASICA VOLADERO,217,1,3,170,111,167,0,2,0,0,54,170
EDO. MONAGAS,MP. CEDE#O,PQ. AREO,ESCUELA BASICA EL RANGELEÑO,172,1,0,106,72,106,0,1,0,0,33,106
EDO. MONAGAS,MP. CEDE#O,PQ. AREO,ESCUELA BÁSICA LUIS FELIPE TURMERO CORVO,1134,2,22,893,573,871,0,7,0,0,291,893
EDO. MONAGAS,MP. CEDE#O,PQ. AREO,ESCUELA BASICA MANACAL,179,1,3,130,102,127,0,3,0,0,22,130
EDO. MONAGAS,MP. CEDE#O,CM. CAICARA,UNIDAD EDUCATIVA DROZ BLANCO,1391,3,24,1161,472,1137,0,3,4,0,658,1161
EDO. MONAGAS,MP. CEDE#O,CM. CAICARA,ESCUELA BASICA LUIS FELIPE TURMERO CORVO,2953,6,45,2312,709,2267,1,17,3,1,1536,2312
EDO. MONAGAS,MP. CEDE#O,CM. CAICARA,ESCUELA BASICA LAGUNA DE JUSEPIN,435,1,1,307,149,306,0,1,0,0,156,307
EDO. MONAGAS,MP. CEDE#O,CM. CAICARA,ESCUELA BASICA BEJUCALES,567,1,7,455,325,448,0,3,0,0,120,455
EDO. MONAGAS,MP. CEDE#O,CM. CAICARA,ESCUELA BASICA BAJO GRANDE,322,1,5,256,98,251,0,2,1,0,150,256
EDO. MONAGAS,MP. CEDE#O,CM. CAICARA,ESCUELA BASICA CAICARITA,507,1,4,410,264,406,0,3,0,1,138,410
EDO. MONAGAS,MP. CEDE#O,CM. CAICARA,UNIDAD EDUCATIVA JUAN FRANCISCO MILA DE LA ROCA,2419,5,25,2064,768,2039,0,11,1,0,1259,2064
EDO. MONAGAS,MP. CEDE#O,CM. CAICARA,ESCUELA BASICA POTRERITO,1124,2,12,901,603,889,0,4,3,1,278,901
EDO. MONAGAS,MP. CEDE#O,CM. CAICARA,ESCUELA BÁSICA BOLIVARIANA JOSÉ FRANCISCO BERMÚDEZ,3681,7,46,3000,970,2954,0,14,2,1,1967,3000
EDO. MONAGAS,MP. CEDE#O,PQ. VIENTO FRESCO,UNIDAD EDUCATIVA IDELFONSO NUÑEZ MARES,2622,5,50,2065,1129,2015,0,14,1,1,870,2065
EDO. MONAGAS,MP. PIAR,PQ. GUANAGUANA,ESCUELA UNITARIA NUMERO 98,202,1,2,155,108,153,0,0,1,0,44,155
EDO. MONAGAS,MP. PIAR,PQ. GUANAGUANA,UNIDAD EDUCATIVA CIRILO MARQUEZ BLANCO,944,2,24,686,492,662,0,2,0,0,168,686
EDO. MONAGAS,MP. PIAR,PQ. GUANAGUANA,ESCUELA BÁSICA BARRANCAS,1408,3,23,1089,605,1066,0,3,2,1,455,1089
EDO. MONAGAS,MP. PIAR,PQ. GUANAGUANA,ESCUELA BASICA BOLIVARIANA BOCA DE RIO CHIQUITO,760,2,20,606,316,586,0,2,1,0,267,606
EDO. MONAGAS,MP. PIAR,PQ. GUANAGUANA,ESCUELA BASICA BOLIVARIANA LA CUCHILLA NUMERO 31   181,242,1,2,191,98,189,0,0,0,0,91,191
EDO. MONAGAS,MP. PIAR,PQ. GUANAGUANA,UNIDAD EDUCATIVA BARRANCAS,314,1,8,280,197,272,0,1,0,0,74,280
EDO. MONAGAS,MP. PIAR,PQ. APARICIO,JARDIN DE INFANCIA MATIAS NUÑEZ,174,1,1,159,111,158,0,0,0,0,47,159
EDO. MONAGAS,MP. PIAR,PQ. APARICIO,ESCUELA PRIMARIA 291 LOS PEREZ,149,1,0,137,106,137,0,0,1,0,30,137
EDO. MONAGAS,MP. PIAR,PQ. APARICIO,ESCUELA BÁSICA BOLIVARIANA MATIAS NUÑEZ,957,2,21,779,366,758,0,2,1,0,389,779
EDO. MONAGAS,MP. PIAR,PQ. APARICIO,ESCUELA BASICA BOLIVARIANA LOLA BASTARDO DE GONZALEZ,715,2,12,546,341,534,0,2,0,0,191,546
EDO. MONAGAS,MP. PIAR,PQ. APARICIO,ESCUELA BASICA BOLIVARIANA JESUS EROTEIDA BARRETO DE MENDOZA,824,2,4,671,428,667,0,3,0,0,236,671
EDO. MONAGAS,MP. PIAR,PQ. LA TOSCANA,UNIDAD EDUCATIVA CAYETANO FARIAS VILLARROEL,832,2,14,691,389,677,0,3,0,0,285,691
EDO. MONAGAS,MP. PIAR,PQ. LA TOSCANA,ESCUELA TERESA CARREÑO,3694,7,43,2735,1593,2692,1,17,0,2,1079,2735
EDO. MONAGAS,MP. PIAR,PQ. LA TOSCANA,ESCUELA UNITARIA NUMERO 257,646,2,8,503,453,495,0,1,0,0,41,503
EDO. MONAGAS,MP. PIAR,PQ. LA TOSCANA,CV MOVIL LA TOSCANA,365,1,10,318,201,308,0,1,0,0,106,318
EDO. MONAGAS,MP. PIAR,PQ. LA TOSCANA,ESCUELA BASICA BOLIVARIANA VIRGEN DEL VALLE,873,2,16,712,531,696,1,4,0,0,160,712
EDO. MONAGAS,MP. PIAR,PQ. LA TOSCANA,CASA COMUNAL LA CEIBA,748,2,14,626,423,612,0,1,0,0,188,626
EDO. MONAGAS,MP. PIAR,CM. ARAGUA,ESCUELA BASICA ANICETO GUEVARA VEGA,2379,5,42,1797,1108,1755,0,9,1,0,637,1797
EDO. MONAGAS,MP. PIAR,CM. ARAGUA,ESCUELA TÉCNICA AGROPECUARIA ARAGUA DE MATURIN,487,1,5,430,353,425,0,1,2,0,69,430
EDO. MONAGAS,MP. PIAR,CM. ARAGUA,LICEO BOLIVARIANO FELIX ANTONIO CALDERON,734,2,18,609,409,591,0,2,0,0,180,609
EDO. MONAGAS,MP. PIAR,CM. ARAGUA,GRUPO ESCOLAR CACIQUE TAGUAY,2918,5,44,2358,1270,2314,0,13,1,0,1030,2358
EDO. MONAGAS,MP. PIAR,CM. ARAGUA,CENTRO DE EDUCACION INICIAL SAN ISIDRO,594,1,3,519,426,516,0,1,0,0,89,519
EDO. MONAGAS,MP. PIAR,PQ. EL PINTO,ESCUELA BASICA LA MESA DE PUNCERES,753,2,10,572,399,562,0,4,1,0,158,572
EDO. MONAGAS,MP. PIAR,PQ. EL PINTO,ESCUELA PRIMARIA BUENA VISTA DE PUNCERES,273,1,2,233,166,231,0,3,0,0,62,233
EDO. MONAGAS,MP. PIAR,PQ. EL PINTO,UNIDAD EDUCATIVA MANUEL HERNANDEZ ROCA,1276,3,15,908,686,893,3,9,1,0,194,908
EDO. MONAGAS,MP. PIAR,PQ. CHAGUARAMAL,ESCUELA BASICA CONCENTRADA LEONARDO INFANTE (LA OREJANA),325,1,2,243,177,241,0,1,0,0,63,243
EDO. MONAGAS,MP. PIAR,PQ. CHAGUARAMAL,ESCUELA BASICA NUMERO 279 CAÑO DE LOS BECERROS,371,1,5,279,187,274,0,4,0,2,81,279
EDO. MONAGAS,MP. PIAR,PQ. CHAGUARAMAL,ESCUELA BÁSICA ELOY PALACIOS CABELLO,3115,6,45,2305,1252,2260,2,12,0,0,994,2305
EDO. MONAGAS,MP. PIAR,PQ. CHAGUARAMAL,ESCUELA BASICA CONCENTRADA 288 506 LOS POZOS,395,1,6,330,291,324,0,0,0,0,33,330
EDO. MONAGAS,MP. PIAR,PQ. CHAGUARAMAL,CENTRO DE EDUCACION NACIONAL ELOY PALACIO CABELLO,640,2,8,525,335,517,0,1,0,0,181,525
EDO. MONAGAS,MP. PIAR,PQ. CHAGUARAMAL,LICEO BOLIVARIANO JUANA RAMIREZ,339,1,8,281,160,273,0,1,0,1,111,281
EDO. MONAGAS,MP. PIAR,PQ. CHAGUARAMAL,ESCUELA BASICA CHAPARRAL,713,2,16,554,384,538,0,3,0,0,151,554
EDO. MONAGAS,MP. PIAR,PQ. TAGUAYA,ESCUELA BASICA BOLIVARIANA LA VIGIA,645,2,9,507,335,498,0,3,0,0,160,507
EDO. MONAGAS,MP. PIAR,PQ. TAGUAYA,COMPLEJO EDUCATIVO ESTADAL GUAYUTA,183,1,5,169,121,164,0,0,0,0,43,169
EDO. MONAGAS,MP. PIAR,PQ. TAGUAYA,UNIDAD EDUCATIVA OLGA BETANCOURT DE PEREZ,1548,3,12,1253,684,1241,0,5,1,0,551,1253
EDO. MONAGAS,MP. ACOSTA,PQ. SAN FRANCISCO,UNIDAD EDUCATIVA CREACION EL RINCON,2127,4,41,1560,905,1519,0,3,2,1,608,1560
EDO. MONAGAS,MP. ACOSTA,PQ. SAN FRANCISCO,ESCUELA BOLIVARIANA EL BANQUEADO,210,1,1,195,92,194,0,0,0,0,102,195
EDO. MONAGAS,MP. ACOSTA,PQ. SAN FRANCISCO,ESCUELA BASICA JULIAN PADRON,857,2,15,657,415,642,0,0,0,1,226,657
EDO. MONAGAS,MP. ACOSTA,PQ. SAN FRANCISCO,ESCUELA UNITARIA 68 438,669,2,8,466,247,458,0,0,0,0,211,466
EDO. MONAGAS,MP. ACOSTA,PQ. SAN FRANCISCO,ESCUELA BASICA CONCENTRADA NUMERO 14 393 CERRO NEGRO,463,1,13,340,232,327,0,0,0,0,95,340
EDO. MONAGAS,MP. ACOSTA,PQ. SAN FRANCISCO,ESCUELA BASICA CONCENTRADA 2 35 387,536,1,12,374,166,362,1,2,0,1,192,374
EDO. MONAGAS,MP. ACOSTA,PQ. SAN FRANCISCO,ESCUELA BASICA CONCENTRADA 361 488 LAS DELICIAS,471,1,12,334,224,322,0,1,0,0,97,334
EDO. MONAGAS,MP. ACOSTA,CM. SAN ANTONIO,ESCUELA BASICA TERESA HEREDIA,1400,3,31,1096,527,1065,0,2,1,1,534,1096
EDO. MONAGAS,MP. ACOSTA,CM. SAN ANTONIO,ESCUELA UNITARIA NUMERO 1661,225,1,8,147,114,139,0,1,0,0,24,147
EDO. MONAGAS,MP. ACOSTA,CM. SAN ANTONIO,PROGRAMA DE EDUCACION RURAL UPEL,1473,3,23,1222,600,1199,0,8,0,0,591,1222
EDO. MONAGAS,MP. ACOSTA,CM. SAN ANTONIO,UNIDAD EDUCATIVA BELLA VISTA,203,1,3,143,99,140,0,0,0,0,41,143
EDO. MONAGAS,MP. ACOSTA,CM. SAN ANTONIO,ESCUELA BASICA FRANCISCO JAVIER GOMEZ,1475,3,18,1203,565,1185,0,3,0,1,616,1203
EDO. MONAGAS,MP. ACOSTA,CM. SAN ANTONIO,ESCUELA BASICA UNITARIA LA LAGUNA DE IPURE,642,2,9,440,225,431,0,2,0,0,204,440
EDO. MONAGAS,MP. ACOSTA,CM. SAN ANTONIO,ESCUELA BASICA CONCENTRADA NUMERO 389 391 LAS PIÑAS,615,2,9,488,208,479,0,0,1,0,270,488
EDO. MONAGAS,MP. ACOSTA,CM. SAN ANTONIO,LICEO MANUEL SATURNINO PEÑALVER GOMEZ,2164,4,35,1752,783,1717,0,6,0,2,926,1752
EDO. MONAGAS,MP. ACOSTA,CM. SAN ANTONIO,ESCUELA UNITARIA CONCENTRADA NUMERO 6 11 388 439,709,2,18,530,319,512,0,1,0,0,192,530
EDO. MONAGAS,MP. ACOSTA,CM. SAN ANTONIO,ESCUELA UNITARIA SIMON RODRIGUEZ,562,1,8,451,178,443,0,2,0,0,263,451
EDO. MONAGAS,MP. ACOSTA,CM. SAN ANTONIO,ESCUELA BASICA CONCENTRADA LA CAGUA,420,1,1,331,189,330,0,2,0,0,139,331
EDO. MONAGAS,MP. LIBERTADOR,PQ. CHAGUARAMAS,ESCUELA BASICA SAN SIMON,903,2,17,769,633,752,1,4,1,0,113,769
EDO. MONAGAS,MP. LIBERTADOR,PQ. CHAGUARAMAS,ESCUELA BÁSICA CHAGUARAMAS,2210,4,35,1589,1216,1554,0,10,1,1,326,1589
EDO. MONAGAS,MP. LIBERTADOR,PQ. CHAGUARAMAS,ESCUELA TÉCNICA AGROPECUARIA FORESTAL CHAGUARAMAS,568,1,26,456,381,430,0,0,0,0,49,456
EDO. MONAGAS,MP. LIBERTADOR,CM. TEMBLADOR,JARDIN DE INFANCIA TEMBLADOR,1500,3,28,1234,844,1206,0,9,0,0,353,1234
EDO. MONAGAS,MP. LIBERTADOR,CM. TEMBLADOR,ESCUELA PRIMARIA BELQUIZ GUEVARA DE DIQUEZ,1023,2,23,847,687,824,0,5,0,0,132,847
EDO. MONAGAS,MP. LIBERTADOR,CM. TEMBLADOR,UNIDAD EDUCATIVA LIBERTADOR BOLIVAR,2247,4,32,1757,1223,1725,0,18,0,0,484,1757
EDO. MONAGAS,MP. LIBERTADOR,CM. TEMBLADOR,UNIDAD EDUCATIVA RAMON PIERLUISSI,1852,4,26,1458,842,1432,1,17,0,1,571,1458
EDO. MONAGAS,MP. LIBERTADOR,CM. TEMBLADOR,ESCUELA BASICA DORA ROMERO DE AVILA,3436,6,62,2732,1890,2670,2,24,2,0,752,2732
EDO. MONAGAS,MP. LIBERTADOR,CM. TEMBLADOR,ESCUELA BASICA BOLIVARIANA MATA DE VENADO,440,1,4,364,262,360,0,2,0,0,96,364
EDO. MONAGAS,MP. LIBERTADOR,CM. TEMBLADOR,ESCUELA BASICA INAVI,2981,6,67,2567,1804,2500,0,13,1,0,682,2567
EDO. MONAGAS,MP. LIBERTADOR,CM. TEMBLADOR,ESCUELA BÁSICA ANTONIO GÚZMAN BLANCO,3480,6,60,2775,1740,2715,0,28,2,3,942,2775
EDO. MONAGAS,MP. LIBERTADOR,CM. TEMBLADOR,ESCUELA BASICA BOLIVARIANA CARMEN DE PIAMO,802,2,17,687,552,670,0,6,0,0,112,687
EDO. MONAGAS,MP. LIBERTADOR,CM. TEMBLADOR,UNIDAD EDUCATIVA FE Y ALEGRIA TEMBLADOR,3242,6,59,2586,1943,2527,3,12,1,0,568,2586
EDO. MONAGAS,MP. LIBERTADOR,CM. TEMBLADOR,ESCUELA PRIMARIA BOLIVARIANA SAN JOSE DE YABO,320,1,6,255,224,249,0,1,0,0,24,255
EDO. MONAGAS,MP. LIBERTADOR,PQ. TABASCA,ESCUELA UNITARIA 309,233,1,5,176,124,171,0,1,0,0,46,176
EDO. MONAGAS,MP. LIBERTADOR,PQ. TABASCA,ESCUELA CREACION EL FANGAL,648,2,13,545,409,532,0,8,0,2,113,545
EDO. MONAGAS,MP. LIBERTADOR,PQ. TABASCA,ESCUELA BASICA BOLIVARIANA INDIGENA EL PAJAL,248,1,4,164,147,160,0,0,0,0,13,164
EDO. MONAGAS,MP. LIBERTADOR,PQ. TABASCA,UNIDAD EDUCATIVA ISABEL DE VERDE ORTEGA,882,2,21,679,395,658,0,1,0,0,262,679
EDO. MONAGAS,MP. LIBERTADOR,PQ. TABASCA,UNIDAD EDUCATIVA BOLIVARIANA BOCA DE URACOA,496,1,3,344,232,341,0,3,2,0,104,344
EDO. MONAGAS,MP. LIBERTADOR,PQ. TABASCA,ESCUELA BASICA INDIGENA WARAO DOJO SANUKA,208,1,3,115,94,112,0,3,1,0,14,115
EDO. MONAGAS,MP. LIBERTADOR,PQ. LAS ALHUACAS,GRUPO ESCOLAR YARUA,494,1,6,394,295,388,0,2,0,0,91,394
EDO. MONAGAS,MP. SANTA BARBARA,CM. SANTA BARBARA,ESCUELA BOLIVARIANA JUAN VICENTE BOLIVAR,2553,5,42,2029,1144,1987,0,6,0,1,836,2029
EDO. MONAGAS,MP. SANTA BARBARA,CM. SANTA BARBARA,ESCUELA BOLIVARIANA ARNOLDO GABALDON,764,2,13,637,408,624,0,5,0,0,211,637
EDO. MONAGAS,MP. SANTA BARBARA,CM. SANTA BARBARA,KINDER ARNOLDO GABALDON,744,2,18,605,339,587,0,2,0,0,246,605
EDO. MONAGAS,MP. SANTA BARBARA,CM. SANTA BARBARA,LICEO BENJAMIN BRICEÑO MARTIN,2007,4,47,1631,951,1584,0,10,0,0,623,1631
EDO. MONAGAS,MP. SANTA BARBARA,CM. SANTA BARBARA,ESCUELA BOLIVARIANA LUISA DORINA MARCANO,714,2,20,617,460,597,0,4,1,0,132,617
EDO. MONAGAS,MP. SANTA BARBARA,CM. SANTA BARBARA,ESCUELA UNITARIA NUMERO 207,400,1,11,326,220,315,0,1,0,4,90,326
EDO. MONAGAS,MP. BOLIVAR,CM. CARIPITO,ESCUELA BASICA LUIS BELTRAN PRIETO FIGUEROA,658,2,13,542,359,529,0,4,0,0,166,542
EDO. MONAGAS,MP. BOLIVAR,CM. CARIPITO,ESCUELA BASICA BOLIVARIANA LA PLENA,355,1,7,314,238,307,0,0,0,0,69,314
EDO. MONAGAS,MP. BOLIVAR,CM. CARIPITO,ESCUELA BASICA BOLIVARIANA SIMON RODRIGUEZ,635,2,9,516,324,507,0,3,1,0,179,516
EDO. MONAGAS,MP. BOLIVAR,CM. CARIPITO,ESCUELA PRIMARIA LUISA CACERES DE ARISMENDI,253,1,5,234,138,229,0,5,0,0,86,234
EDO. MONAGAS,MP. BOLIVAR,CM. CARIPITO,ESCUELA BASICA LIZANDRO ALVARADO,519,1,13,434,281,421,0,4,0,0,136,434
EDO. MONAGAS,MP. BOLIVAR,CM. CARIPITO,ESCUELA BASICA UDON PEREZ,743,2,14,595,332,581,0,2,0,0,247,595
EDO. MONAGAS,MP. BOLIVAR,CM. CARIPITO,ESCUELA BASICA CONCENTRADA 26 74 LA ACEQUIA,560,1,19,388,275,369,0,2,0,0,92,388
EDO. MONAGAS,MP. BOLIVAR,CM. CARIPITO,ESCUELA BOLIVARIANA INDÍGENA MOSÚ,123,1,2,108,102,106,0,0,0,0,4,108
EDO. MONAGAS,MP. BOLIVAR,CM. CARIPITO,CLUB DE ANCIANOS EL RINCÓN,1474,3,26,1093,731,1067,1,5,0,0,330,1093
EDO. MONAGAS,MP. BOLIVAR,CM. CARIPITO,ESCUELA PRIMARIA JOSE ANTONIO PAEZ,126,1,1,114,83,113,0,0,0,0,30,114
EDO. MONAGAS,MP. BOLIVAR,CM. CARIPITO,ESCUELA BASICA AUDENCIO DIAZ FEBRES,1466,3,24,1173,657,1149,0,3,0,1,488,1173
EDO. MONAGAS,MP. BOLIVAR,CM. CARIPITO,ESCUELA BASICA BOLIVARIANA CARMEN DE LEON,1220,3,8,841,532,833,1,6,1,0,293,841
EDO. MONAGAS,MP. BOLIVAR,CM. CARIPITO,ESCUELA BASICA JOSE GIL FORTUOL,1879,4,47,1391,857,1344,0,4,0,0,483,1391
EDO. MONAGAS,MP. BOLIVAR,CM. CARIPITO,ESCUELA BASICA ZOILA VILLAMIZAR,846,2,14,685,479,671,0,1,0,1,190,685
EDO. MONAGAS,MP. BOLIVAR,CM. CARIPITO,ESCUELA BASICA ANDRES BELLO,252,1,2,211,129,209,1,3,0,0,76,211
EDO. MONAGAS,MP. BOLIVAR,CM. CARIPITO,ESCUELA BASICA NACIONAL JOSEFINA DE FIERRO,235,1,4,212,181,208,0,2,0,0,25,212
EDO. MONAGAS,MP. BOLIVAR,CM. CARIPITO,ESCUELA BASICA BOLIVARIANA PEDRO GUAL,2894,5,37,2207,1192,2170,0,17,1,2,958,2207
EDO. MONAGAS,MP. BOLIVAR,CM. CARIPITO,ESCUELA BASICA EL AMPARO,544,1,11,410,321,399,0,1,0,0,77,410
EDO. MONAGAS,MP. BOLIVAR,CM. CARIPITO,UNIDAD EDUCATIVA FRANCISCO DE MIRANDA,524,1,4,411,276,407,0,1,0,0,130,411
EDO. MONAGAS,MP. BOLIVAR,CM. CARIPITO,ESCUELA BASICA LA CONCEPCION,158,1,5,144,108,139,0,1,0,0,30,144
EDO. MONAGAS,MP. BOLIVAR,CM. CARIPITO,ESCUELA BASICA JOSE FELIX RIBAS,266,1,1,234,182,233,0,1,0,0,50,234
EDO. MONAGAS,MP. BOLIVAR,CM. CARIPITO,ESCUELA BASICA BOLIVARIANA SIMÓN RODRIGUEZ,857,2,9,582,440,573,1,4,0,0,128,582
EDO. MONAGAS,MP. BOLIVAR,CM. CARIPITO,ESCUELA BASICA FRANCISCO DE MIRANDA,215,1,2,205,137,203,0,2,0,0,64,205
EDO. MONAGAS,MP. BOLIVAR,CM. CARIPITO,LICEO BOLIVARIANO JOSE TADEO MONAGAS,656,2,8,520,327,512,0,1,1,0,183,520
EDO. MONAGAS,MP. BOLIVAR,CM. CARIPITO,JARDIN DE INFANCIA COLINAS DE BELLO MONTE,271,1,6,250,153,244,1,0,0,0,90,250
EDO. MONAGAS,MP. BOLIVAR,CM. CARIPITO,ESCUELA BASICA CIUDAD DE LOS TEQUES,3002,6,55,2346,1378,2291,1,13,0,1,898,2346
EDO. MONAGAS,MP. BOLIVAR,CM. CARIPITO,ESCUELA NACIONAL BOLIVARIANA RAFAEL URDANETA,206,1,1,189,134,188,0,0,0,0,54,189
EDO. MONAGAS,MP. BOLIVAR,CM. CARIPITO,ESCUELA BASICA BOLIVARIANA MANUELA SAENZ,751,2,3,481,365,478,0,1,0,0,112,481
EDO. MONAGAS,MP. BOLIVAR,CM. CARIPITO,PREESCOLAR BOLIVARIANO ADELAIDA NUÑEZ SUCRE,981,2,19,728,467,709,0,1,0,0,241,728
EDO. MONAGAS,MP. BOLIVAR,CM. CARIPITO,ESCUELA NACIONAL BOLIVARIANA LIBERTADOR SIMON BOLIVAR,246,1,6,225,170,219,0,0,0,0,49,225
EDO. MONAGAS,MP. BOLIVAR,CM. CARIPITO,ESCUELA BASICA ROMULO GALLEGOS,1989,4,28,1579,714,1551,0,6,0,0,831,1579
EDO. MONAGAS,MP. BOLIVAR,CM. CARIPITO,ESCUELA BASICA VALMORE RODRIGUEZ,1723,3,35,1297,783,1262,0,8,0,0,471,1297
EDO. MONAGAS,MP. CARIPE,PQ. LA GUANOTA,ESCUELA BÁSICA RAMONA ROCCA DE LÓPEZ,1167,2,7,863,462,856,0,4,0,2,388,863
EDO. MONAGAS,MP. CARIPE,PQ. LA GUANOTA,ESCUELA BOLIVARIANA ALTAMIRA,88,1,2,81,48,79,0,2,0,0,29,81
EDO. MONAGAS,MP. CARIPE,PQ. LA GUANOTA,ESCUELA BASICA UNITARIA CONCENTRADA ALTO DE MONAGAL,519,1,4,335,258,331,0,4,2,0,67,335
EDO. MONAGAS,MP. CARIPE,PQ. LA GUANOTA,ESCUELA ESTADAL UNITARIA  486,204,1,1,116,96,115,0,1,1,0,17,116
EDO. MONAGAS,MP. CARIPE,PQ. LA GUANOTA,ESCUELA BASICA UNITARIA 1654,140,1,2,82,54,80,0,1,1,0,24,82
EDO. MONAGAS,MP. CARIPE,PQ. SAN AGUSTIN,ESCUELA BÁSICA BOLIVARIANA DOCTOR RAFAEL MARSIGLIA,1770,3,18,1277,762,1259,2,7,3,0,485,1277
EDO. MONAGAS,MP. CARIPE,PQ. SAN AGUSTIN,ESCUELA BASICA CONCENTRADA EL BANQUEADO,409,1,12,321,202,309,0,0,0,0,107,321
EDO. MONAGAS,MP. CARIPE,PQ. SAN AGUSTIN,LICEO NACIONAL SAN AGUSTIN,615,2,18,530,371,512,0,1,0,0,140,530
EDO. MONAGAS,MP. CARIPE,CM. CARIPE,ESCUELA BASICA BOLIVARIANA ELENA PEREZ DE MATA,685,2,13,544,321,531,0,1,0,0,209,544
EDO. MONAGAS,MP. CARIPE,CM. CARIPE,ESCUELA BASICA EDMUNDO ROMERO,977,2,8,806,508,798,0,3,2,1,284,806
EDO. MONAGAS,MP. CARIPE,CM. CARIPE,LICEO JULIAN PADRON,1473,3,17,1081,442,1064,1,2,1,0,618,1081
EDO. MONAGAS,MP. CARIPE,CM. CARIPE,ESCUELA BASICA CONCENTRADA 91 78 BELLA VISTA,451,1,3,329,247,326,0,1,2,0,76,329
EDO. MONAGAS,MP. CARIPE,CM. CARIPE,ESCUELA BASICA MIGUEL VECCHIO MARSIGLIA,1555,3,25,1267,692,1242,1,3,0,0,546,1267
EDO. MONAGAS,MP. CARIPE,CM. CARIPE,ESCUELA BÁSICA ABRAHAM LINCOLN,3205,6,77,2565,1085,2488,0,9,1,0,1393,2565
EDO. MONAGAS,MP. CARIPE,PQ. TERESEN,ESCUELA BASICA CREACION TERESEN,278,1,2,214,143,212,1,1,0,0,67,214
EDO. MONAGAS,MP. CARIPE,PQ. TERESEN,ESCUELA PRIMARIA ESTADAL LOS CIGARRONES,84,1,0,79,67,79,0,1,0,0,11,79
EDO. MONAGAS,MP. CARIPE,PQ. TERESEN,ESCUELA BASICA CONCENTRADA MIXTA 100 S N,363,1,2,263,203,261,0,0,1,0,57,263
EDO. MONAGAS,MP. CARIPE,PQ. TERESEN,ESCUELA BASICA CONCENTRADA 96 333 444 LA MARGARITA,284,1,3,189,114,186,0,0,0,0,72,189
EDO. MONAGAS,MP. CARIPE,PQ. TERESEN,ESCUELA BASICA CONCENTRADA 86 97 QUEBRADA GRANDE,592,1,8,378,266,370,0,1,0,0,103,378
EDO. MONAGAS,MP. CARIPE,PQ. TERESEN,ESCUELA BASICA BOLIVARIANA SANTA INES,1122,2,30,849,566,819,0,2,1,0,250,849
EDO. MONAGAS,MP. CARIPE,PQ. TERESEN,ESCUELA BÁSICA BOLIVARIANA CARIPITO,1862,4,36,1423,891,1387,1,3,0,0,492,1423
EDO. MONAGAS,MP. CARIPE,PQ. TERESEN,ESCUELA ESTADAL UNITARIA 379,143,1,2,65,53,63,0,0,0,0,10,65
EDO. MONAGAS,MP. CARIPE,PQ. TERESEN,ESCUELA BASICA ESTADAL UNITARIA 217,554,1,3,400,352,397,0,1,2,0,42,400
EDO. MONAGAS,MP. CARIPE,PQ. TERESEN,ESCUELA PRIMARIA ESTADAL LAS ACACIAS,321,1,9,290,245,281,0,0,0,0,36,290
EDO. MONAGAS,MP. CARIPE,PQ. SABANA DE PIEDRA,ESCUELA BÁSICA ARMANDO ZULOAGA BLANCO,1572,3,36,1111,536,1075,0,2,1,0,536,1111
EDO. MONAGAS,MP. CARIPE,PQ. SABANA DE PIEDRA,ESCUELA BASICA NACIONAL 2505,192,1,2,131,71,129,0,0,0,0,58,131
EDO. MONAGAS,MP. CARIPE,PQ. EL GUACHARO,UNIDAD EDUCATIVA NUMERO 37 49 16 59 PERIQUITO,792,2,12,536,245,524,0,1,0,0,278,536
EDO. MONAGAS,MP. CARIPE,PQ. EL GUACHARO,ESCUELA PRIMARIA BOLIVARIANA LA PLACETA,294,1,1,273,186,272,1,2,1,0,82,273
EDO. MONAGAS,MP. CARIPE,PQ. EL GUACHARO,ESCUELA BÁSICA BOLIVARIANA EL GUACHARO,2403,5,26,1829,1111,1803,0,5,0,1,686,1829
EDO. MONAGAS,MP. URACOA,CM. URACOA,ESCUELA UNITARIA NUMERO 315,355,1,8,283,180,275,0,1,0,0,94,283
EDO. MONAGAS,MP. URACOA,CM. URACOA,ESCUELA BASICA BOLIVARIANA PASO NUEVO,720,2,19,569,304,550,0,1,1,0,244,569
EDO. MONAGAS,MP. URACOA,CM. URACOA,ESCUELA UNITARIA NUMERO 318 319,387,1,4,291,146,287,0,2,0,1,138,291
EDO. MONAGAS,MP. URACOA,CM. URACOA,ESCUELA BASICA UNITARIA 423,357,1,5,256,112,251,0,1,0,0,138,256
EDO. MONAGAS,MP. URACOA,CM. URACOA,MEDICATURA RURAL PALOMA DE CHAMBERY,214,1,7,159,62,152,0,1,0,0,89,159
EDO. MONAGAS,MP. URACOA,CM. URACOA,ESCUELA UNITARIA 1026 1017,496,1,5,392,199,387,0,0,0,0,188,392
EDO. MONAGAS,MP. URACOA,CM. URACOA,ESCUELA BASICA BOLIVARIANA CHAIMA,3061,6,72,2483,1092,2411,1,7,2,0,1309,2483
EDO. MONAGAS,MP. URACOA,CM. URACOA,JARDIN DE INFANCIA BOLIVARIANO JOSE FELIX RIVAS,696,2,26,539,199,513,0,5,0,0,309,539
EDO. MONAGAS,MP. URACOA,CM. URACOA,JARDIN DE INFANCIA BOLIVARIANO LOMAS DEL VIENTO,1118,2,25,917,463,892,0,6,1,0,422,917
EDO. MONAGAS,CE. MATURIN,PQ. SAN SIMON,CENTRO EDUCATIVO ESTADAL GIGFREDO RIOS,940,2,15,710,624,695,1,4,2,1,63,710
EDO. MONAGAS,CE. MATURIN,PQ. SAN SIMON,BIBLIOTECA PUBLICA JULIAN PADRON,1337,3,13,1141,472,1128,0,3,2,2,649,1141
EDO. MONAGAS,CE. MATURIN,PQ. SAN SIMON,UNIVERSIDAD PEDAGOGICA EXPERIMENTAL LIBERTADOR  PEDAGOGICO DE MATURIN,3071,6,63,2513,1749,2450,0,17,1,1,682,2513
EDO. MONAGAS,CE. MATURIN,PQ. SAN SIMON,UNIDAD EDUCATIVA MARIA TERESA RODRIGUEZ DEL TORO,768,2,13,618,420,605,0,1,0,2,182,618
EDO. MONAGAS,CE. MATURIN,PQ. SAN SIMON,ESCUELA BASICA BOLIVARIANA EL CARUTO,156,1,3,140,124,137,0,0,0,0,13,140
EDO. MONAGAS,CE. MATURIN,PQ. SAN SIMON,COMPLEJO EDUCATIVO NACIONAL EL SALTO DE MORICHAL,1463,3,36,1303,1063,1267,0,8,1,0,195,1303
EDO. MONAGAS,CE. MATURIN,PQ. SAN SIMON,ESCUELA BÁSICA BOLIVARIANA ALTAMIRA,171,1,2,154,127,152,0,0,0,0,25,154
EDO. MONAGAS,CE. MATURIN,PQ. SAN SIMON,COMPLEJO EDUCATIVO NACIONAL  LA CENTELLITA,249,1,4,221,185,217,1,0,1,0,30,221
EDO. MONAGAS,CE. MATURIN,PQ. SAN SIMON,ESCUELA BÁSICA VILLA HERÓICA SUR,849,2,28,711,561,683,2,2,0,0,118,711
EDO. MONAGAS,CE. MATURIN,PQ. SAN SIMON,LICEO NACIONAL MIGUEL JOSE SANZ,3136,6,22,2526,656,2504,0,14,3,0,1831,2526
EDO. MONAGAS,CE. MATURIN,PQ. SAN SIMON,ESCUELA BASICA CONCENTRADA LOS ACEITES DE GUANIPA
EDO. MONAGAS,CE. MATURIN,PQ. SAN SIMON,COMPLEJO EDUCATIVO MANUELA SAENZ,359,1,5,322,216,317,0,1,0,0,100,322
EDO. MONAGAS,CE. MATURIN,PQ. SAN SIMON,COMPLEJO EDUCATIVO ESTADAL ROSA ADELA DE HERNÁNDEZ,1027,2,22,816,423,794,0,10,0,2,359,816
EDO. MONAGAS,CE. MATURIN,PQ. SAN SIMON,ESCUELA PRIMARIA NACIONAL JUAN FRANCISCO MILA DE LA ROCA,3481,6,55,2460,1454,2405,1,24,2,2,922,2460
EDO. MONAGAS,CE. MATURIN,PQ. SAN SIMON,UNIDAD EDUCATVA RAFAEL CELESTINO ARRIOJAS,754,2,40,561,369,521,0,1,0,0,151,561
EDO. MONAGAS,CE. MATURIN,PQ. SAN SIMON,UNIDAD EDUCATIVA PRIVADA CECILO ACOSTA,1825,4,10,1469,360,1459,0,6,0,1,1092,1469
EDO. MONAGAS,CE. MATURIN,PQ. SAN SIMON,ESCUELA BASICA MANUEL PIAR,1985,4,28,1695,722,1667,2,7,4,1,931,1695
EDO. MONAGAS,CE. MATURIN,PQ. SAN SIMON,ESCUELA BASICA CONCENTRADA EL PECHON,264,1,3,191,131,188,0,1,0,0,56,191
EDO. MONAGAS,CE. MATURIN,PQ. SAN SIMON,COMPLEJO EDUCATIVO ESTADAL SANTA BARBARA DE SOTILLO,188,1,2,167,154,165,0,0,0,0,11,167
EDO. MONAGAS,CE. MATURIN,PQ. SAN SIMON,ESCUELA BASICA ISABEL PADRINO DE CAMPOS,3177,6,33,2697,1330,2664,1,17,2,2,1312,2697
EDO. MONAGAS,CE. MATURIN,PQ. SAN SIMON,ESCUELA TECNICA ROBINSONIANA COMERCIAL FELIX ANGEL LOZADA,1460,3,20,1259,520,1239,1,14,0,2,702,1259
EDO. MONAGAS,CE. MATURIN,PQ. SAN SIMON,LICEO NACIONAL  DOCTOR MANUEL NUÑEZ TOVAR,2262,4,26,1753,989,1727,0,12,0,0,726,1753
EDO. MONAGAS,CE. MATURIN,PQ. SAN SIMON,ESCUELA BASICA SANTA INES,1549,3,22,1254,968,1232,0,11,0,0,253,1254
EDO. MONAGAS,CE. MATURIN,PQ. SAN SIMON,ESCUELA DE ARTES PLASTICAS ELOY PALACIOS,2653,5,18,2154,737,2136,1,13,0,1,1384,2154
EDO. MONAGAS,CE. MATURIN,PQ. SAN SIMON,UNIDAD EDUCATIVA PRIVADA SANTA EDUVIGIS,317,1,3,287,126,284,0,3,0,0,155,287
EDO. MONAGAS,CE. MATURIN,PQ. SAN SIMON,COMPLEJO EDUCATIVO NACIONAL  LA CARBONERA,522,1,16,469,293,453,0,4,1,0,155,469
EDO. MONAGAS,CE. MATURIN,PQ. SAN SIMON,UNIDAD EDUCATIVA LA PUENTE DE AGUA NEGRA,294,1,5,225,151,220,0,2,0,0,67,225
EDO. MONAGAS,CE. MATURIN,PQ. SAN SIMON,LICEO NACIONAL FRANCISCO ISNARDI,3169,6,46,2694,1028,2648,0,18,1,1,1600,2694
EDO. MONAGAS,CE. MATURIN,PQ. SAN SIMON,ESCUELA BASICA JOSE DAMIAN RAMIREZ LABRADOR,2095,4,27,1724,807,1697,0,4,2,1,883,1724
EDO. MONAGAS,CE. MATURIN,PQ. SAN SIMON,ESCUELA BASICA PARARE,464,1,8,431,324,423,0,2,0,0,97,431
EDO. MONAGAS,CE. MATURIN,PQ. SAN SIMON,CENTRO DE EDUCACION INICIAL IRMA SAEZ MERIDA DE GRISANTI,938,2,17,726,375,709,0,7,2,0,325,726
EDO. MONAGAS,CE. MATURIN,PQ. SAN SIMON,ESCUELA PRIMARIA NACIONAL VENTURA VARGAS,3071,6,32,2401,1043,2369,0,14,1,0,1311,2401
EDO. MONAGAS,CE. MATURIN,PQ. SAN SIMON,ESCUELA PRIMARIA NACIONAL  FELIX ANTONIO CALDERON,3605,7,34,2987,1227,2953,1,17,0,2,1706,2987
EDO. MONAGAS,CE. MATURIN,PQ. SAN SIMON,ESCUELA PRIMARIA NACIONAL LOS ARAGUANEYES,84,1,1,60,38,59,0,0,0,0,21,60
EDO. MONAGAS,CE. MATURIN,PQ. SAN SIMON,UNIDAD EDUCATIVA BOLIVARIANA SAN JOSE DE BUJA,991,2,7,643,468,636,0,1,0,0,167,643
EDO. MONAGAS,CE. MATURIN,PQ. SAN SIMON,COMPLEJO NACIONAL EDUCATICO CECILIA ELENA NARANJA PRECILLA,594,1,6,423,256,417,0,2,0,0,159,423
EDO. MONAGAS,CE. MATURIN,PQ. SAN SIMON,UNIDAD EDUCATIVA COLEGIO PRIVADO MATURÍN,1485,3,13,1297,461,1284,0,1,0,0,822,1297
EDO. MONAGAS,CE. MATURIN,PQ. SAN SIMON,ESCUELA PRIMARIA NACIONAL ALEJANDRO DE HUMBOLT,2966,6,19,2393,1092,2374,1,15,2,0,1264,2393
EDO. MONAGAS,CE. MATURIN,PQ. SAN SIMON,ESCUELA BASICA BOLIVARIANA EL RESPIRO,626,2,8,436,302,428,0,2,0,0,124,436
EDO. MONAGAS,CE. MATURIN,PQ. SAN SIMON,COMPLEJO EDUCATIVO NACIONAL EL SILENCIO DE MORICHAL LARGO,919,2,21,701,588,680,0,4,0,0,88,701
EDO. MONAGAS,CE. MATURIN,PQ. SAN SIMON,UNIVERSIDAD BOLIVARIANA DE VENEZUELA,2736,5,24,2253,1021,2229,0,8,0,0,1200,2253
EDO. MONAGAS,CE. MATURIN,PQ. SAN SIMON,UNIDAD EDUCATIVA LUIS PADRINO,3303,6,25,2814,559,2789,0,7,0,2,2221,2814
EDO. MONAGAS,CE. MATURIN,PQ. SAN SIMON,ESCUELA BASICA EL BLANQUERO,376,1,10,271,235,261,0,0,1,0,25,271
EDO. MONAGAS,CE. MATURIN,PQ. SAN SIMON,ESCUELA PRIMARIA ESTADAL MARCOS SERRES PADILLA,1236,3,22,1064,740,1042,1,14,0,0,287,1064
EDO. MONAGAS,CE. MATURIN,PQ. SAN SIMON,COMPLEJO EDUCATIVO ANTONIO JOSE DE SUCRE,1344,3,27,967,634,940,1,3,0,0,302,967
EDO. MONAGAS,CE. MATURIN,PQ. SAN SIMON,ESCUELA PRIMARIA NACIONAL   BOLIVARIANA PAULA BASTARDO,2820,5,37,2153,938,2116,0,12,0,2,1164,2153
EDO. MONAGAS,CE. MATURIN,PQ. SAN SIMON,ESCUELA INICIAL NACIONAL AÑO INTERNACIONAL DEL NIÑO,1624,3,24,1322,567,1298,0,8,1,0,722,1322
EDO. MONAGAS,CE. MATURIN,PQ. SAN SIMON,JARDIN DE INFANCIA MONAGAS,2574,5,41,2324,1042,2283,0,9,2,1,1229,2324
EDO. MONAGAS,CE. MATURIN,PQ. SAN SIMON,ESCUELA NACIONAL PERICOCO DE ARIBI,230,1,4,190,149,186,1,3,0,0,33,190
EDO. MONAGAS,CE. MATURIN,PQ. SAN SIMON,ESCUELA PRIMARIA CARATAL DEL TIGRE
EDO. MONAGAS,CE. MATURIN,PQ. SAN SIMON,UNIDAD EDUCATIVA DOCTORA LIA IMBER DE CORONIL ALBERGUE,2749,5,11,2411,497,2400,0,14,1,0,1888,2411
EDO. MONAGAS,CE. MATURIN,PQ. SAN SIMON,ESCUELA PRIMARIA ESTADAL BOYACA,2111,4,21,1842,791,1821,0,19,2,1,1008,1842
EDO. MONAGAS,CE. MATURIN,PQ. SAN SIMON,ESCUELA BASICA SAN MIGUEL,385,1,3,325,232,322,0,3,0,0,87,325
EDO. MONAGAS,CE. MATURIN,PQ. SAN SIMON,ESCUELA BASICA REPUBLICA DEL URUGUAY,3232,6,34,2629,1123,2595,1,12,0,1,1458,2629
EDO. MONAGAS,CE. MATURIN,PQ. SAN SIMON,ESCUELA BASICA UNITARIA EL CHISPERO,123,1,0,86,75,86,0,0,0,0,11,86
EDO. MONAGAS,CE. MATURIN,PQ. SAN SIMON,CASA DE NIÑOS MARIA EVA DE LISCANO,1307,3,13,1042,478,1029,0,7,0,1,543,1042
EDO. MONAGAS,CE. MATURIN,PQ. SAN SIMON,LICEO NACIONAL IDELFONSO NUÑEZ MARES,2466,5,32,1926,781,1894,0,12,1,0,1100,1926
EDO. MONAGAS,CE. MATURIN,PQ. SAN SIMON,ESCUELA BASICA NICOLAS LOPEZ,1015,2,22,671,405,649,0,4,1,0,239,671
EDO. MONAGAS,CE. MATURIN,PQ. SAN SIMON,COMPLEJO EDUCATIVO NACIONAL AGUA NEGRA,159,1,9,142,106,133,0,0,0,0,27,142
EDO. MONAGAS,CE. MATURIN,PQ. SAN SIMON,ANEXO DE LA ESCUELA BÁSICA JOSÉ TADEO MONAGAS,393,1,1,357,290,356,0,0,1,0,65,357
EDO. MONAGAS,CE. MATURIN,PQ. SAN SIMON,ESCUELA BASICA BOLIVARIANA CURIEPE,340,1,7,245,140,238,0,3,0,0,95,245
EDO. MONAGAS,CE. MATURIN,PQ. SAN SIMON,LICEO NACIONAL MARCO ANTONIO SALUZZO,3188,6,42,2616,1148,2574,0,18,0,1,1407,2616
EDO. MONAGAS,CE. MATURIN,PQ. SAN SIMON,ESCUELA BASICA JOSE TADEO MONAGAS,1698,3,26,1225,811,1199,0,7,1,0,380,1225
EDO. MONAGAS,CE. MATURIN,PQ. SAN SIMON,EDUCACION INICIAL NACIONAL EL LIBERTADOR,1132,2,8,918,347,910,0,6,1,0,556,918
EDO. MONAGAS,CE. MATURIN,PQ. SAN SIMON,COMPLEJO EDUCATIVO NACIONAL INDIGENA YABINOKO,310,1,2,135,125,133,0,0,0,0,8,135
EDO. MONAGAS,CE. MATURIN,PQ. SAN SIMON,ESCUELA BÁSICA VICENTE SALIAS,3652,7,47,3020,885,2973,0,15,0,1,2072,3020
EDO. MONAGAS,CE. MATURIN,PQ. SAN SIMON,COMPLEJO EDUCATIVO ESTADAL  LOS POZOS DE GUANIPA,125,1,5,112,82,107,0,0,1,0,24,112
EDO. MONAGAS,CE. MATURIN,PQ. SAN SIMON,UNIDAD EDUCATIVA EL RINCON DE MONAGAS,883,2,25,708,566,683,0,2,1,0,114,708
EDO. MONAGAS,CE. MATURIN,PQ. EL COROZO,ESCUELA BASICA BOLIVARIANA AMARILIS,696,2,25,585,372,560,0,4,0,0,184,585
EDO. MONAGAS,CE. MATURIN,PQ. EL COROZO,UNIDAD EDUCATIVA JOSÉ GREGORIO MONAGAS,2749,5,58,2157,1287,2099,0,12,2,3,795,2157
EDO. MONAGAS,CE. MATURIN,PQ. EL COROZO,ESCUELA BASICA BOLIVARIANA CAMILO VILLANUEVA,582,1,15,510,389,495,0,2,0,0,104,510
EDO. MONAGAS,CE. MATURIN,PQ. SANTA CRUZ,CENTRO DE EDUCACION INICIAL MARTHA LAMAS DE RENGEL,461,1,7,406,231,399,0,0,0,1,167,406
EDO. MONAGAS,CE. MATURIN,PQ. SANTA CRUZ,ESCUELA BASICA CASTOR GUEVARA,3261,6,37,2572,1456,2535,2,10,0,0,1067,2572
EDO. MONAGAS,CE. MATURIN,PQ. SANTA CRUZ,ESCUELA BASICA CARMEN EBELIA DOUGLAS,3744,7,52,3460,1490,3408,1,20,1,0,1896,3460
EDO. MONAGAS,CE. MATURIN,PQ. SANTA CRUZ,COMPLEJO EDUCACIONAL NACIONAL LAS CAROLINAS,2029,4,26,1848,982,1822,0,8,0,2,830,1848
EDO. MONAGAS,CE. MATURIN,PQ. SANTA CRUZ,UNIDAD EDUCATIVA  DIEGO SIFONTE SOSA,3173,6,43,2592,1367,2549,0,17,0,1,1164,2592
EDO. MONAGAS,CE. MATURIN,PQ. SANTA CRUZ,ESCUELA BÁSICA CARIPE,3761,7,58,2989,1542,2931,1,15,2,1,1370,2989
EDO. MONAGAS,CE. MATURIN,PQ. SANTA CRUZ,CENTRO BOLIVARIANO DE INFORMATICA Y TELEMATICA (CEBIT),1260,3,25,1026,567,1001,0,7,2,0,425,1026
EDO. MONAGAS,CE. MATURIN,PQ. SANTA CRUZ,UNIDAD EDUCATIVA JEAN FIRMIN,2334,4,33,2077,948,2044,0,17,4,1,1074,2077
EDO. MONAGAS,CE. MATURIN,PQ. SANTA CRUZ,ESCUELA BASICA ALBERTO LOVERA,513,1,7,426,292,419,0,8,0,0,119,426
EDO. MONAGAS,CE. MATURIN,PQ. SANTA CRUZ,COMPLEJO EDUCATIVO NACIONAL PADRE JUAN VIVES SURIA,1516,3,48,1387,755,1339,0,5,1,0,578,1387
EDO. MONAGAS,CE. MATURIN,PQ. SANTA CRUZ,ESCUELA BASICA SAN JAIME,1617,3,21,1342,719,1321,0,5,1,0,596,1342
EDO. MONAGAS,CE. MATURIN,PQ. SAN VICENTE,ESCUELA BÁSICA BOLIVARIANA ISMAEL SALAZAR,2861,5,41,2183,1331,2142,0,13,1,0,797,2183
EDO. MONAGAS,CE. MATURIN,PQ. SAN VICENTE,ESCUELA INICIAL NACIONAL ISMAEL SALAZAR,538,1,9,395,238,386,1,2,0,0,145,395
EDO. MONAGAS,CE. MATURIN,PQ. SAN VICENTE,CASA DE LA CULTURA SIMON BOLIVAR,1102,2,18,913,666,895,0,3,0,0,226,913
EDO. MONAGAS,CE. MATURIN,PQ. SAN VICENTE,LICEO NACIONAL BOLIVARIANO SAN VICENTE FERRER,520,1,9,407,289,398,0,3,1,0,105,407
EDO. MONAGAS,CE. MATURIN,PQ. SAN VICENTE,ESCUELA BASICA BOLIVARIANA PUEBLO LIBRE,1350,3,12,1083,769,1071,0,10,0,1,291,1083
EDO. MONAGAS,CE. MATURIN,PQ. ALTO DE LOS GODOS,CENTRO DEL NIÑO Y LA FAMILIA BOLIVARIANO PRADO DEL SUR,1580,3,26,1226,878,1200,0,7,1,0,314,1226
EDO. MONAGAS,CE. MATURIN,PQ. ALTO DE LOS GODOS,ESCUELA PRIMERIA NACIONAL BOLIVARIANA PINTO SALINAS,2134,4,30,1755,1285,1725,0,13,2,0,425,1755
EDO. MONAGAS,CE. MATURIN,PQ. ALTO DE LOS GODOS,ESCUELA BASICA VICTORIA RAMIREZ MOLINOS,3173,6,27,2845,774,2818,2,8,0,0,2034,2845
EDO. MONAGAS,CE. MATURIN,PQ. ALTO DE LOS GODOS,LICEO NACIONAL LOS GUARITOS,4075,8,42,3549,1734,3507,0,36,2,1,1734,3549
EDO. MONAGAS,CE. MATURIN,PQ. ALTO DE LOS GODOS,ESCUELA BASICA  CACIQUE PARAMACONI,3525,7,63,2698,1715,2635,2,15,1,1,901,2698
EDO. MONAGAS,CE. MATURIN,PQ. ALTO DE LOS GODOS,COMPLEJO EDUCATIVO NACIONAL LA NEGRA MATEA,1340,3,24,1199,966,1175,0,5,1,0,203,1199
EDO. MONAGAS,CE. MATURIN,PQ. ALTO DE LOS GODOS,CENTRO DE FORMACION INTEGRAL PARA EL TRABAJO,1767,3,9,1519,718,1510,0,7,2,0,783,1519
EDO. MONAGAS,CE. MATURIN,PQ. ALTO DE LOS GODOS,CV MOVIL CANCHA DEPORTIVA LA MURALLITA,462,1,5,395,244,390,0,4,0,0,142,395
EDO. MONAGAS,CE. MATURIN,PQ. ALTO DE LOS GODOS,ESCUELA PRIMARIA  JUANA RAMIREZ,1752,3,30,1467,1056,1437,1,9,1,1,369,1467
EDO. MONAGAS,CE. MATURIN,PQ. ALTO DE LOS GODOS,JARDIN DE INFANCIA CARMEN VERONICA CUELLO,1279,3,20,1120,496,1100,0,7,1,0,596,1120
EDO. MONAGAS,CE. MATURIN,PQ. ALTO DE LOS GODOS,CV MOVIL CANCHA DEPORTIVA EL CARO DE LA PUENTE,300,1,8,245,159,237,0,1,0,0,77,245
EDO. MONAGAS,CE. MATURIN,PQ. ALTO DE LOS GODOS,ESCUELA BASICA MARIO BRICEÑO IRAGORRI,2925,5,30,2538,1273,2508,0,10,0,2,1223,2538
EDO. MONAGAS,CE. MATURIN,PQ. ALTO DE LOS GODOS,CENTRO NACIONAL EDUCATIVO CRUZ FIGUERA,3260,6,30,2516,1681,2486,0,13,1,1,790,2516
EDO. MONAGAS,CE. MATURIN,PQ. ALTO DE LOS GODOS,ESCUELA PRIMARIA NACIONAL CACIQUE GUANAGUANAI,696,2,8,652,577,644,0,3,1,0,63,652
EDO. MONAGAS,CE. MATURIN,PQ. ALTO DE LOS GODOS,LICEO BOLIVARIANO GILDA RAMIREZ,1519,3,26,1309,784,1283,0,12,0,0,487,1309
EDO. MONAGAS,CE. MATURIN,PQ. ALTO DE LOS GODOS,COLEGIO BOLIVARIANO DOCTOR ARTURO USLAR PIETRI,1809,4,28,1551,1018,1523,0,16,0,2,487,1551
EDO. MONAGAS,CE. MATURIN,PQ. ALTO DE LOS GODOS,CV MOVIL LOS PINOS,230,1,4,178,133,174,0,1,0,0,40,178
EDO. MONAGAS,CE. MATURIN,PQ. ALTO DE LOS GODOS,CENTRO DE EDUCACIÓN INICIAL ALTO DE LOS GODOS I,1172,2,12,1036,252,1024,0,3,0,0,769,1036
EDO. MONAGAS,CE. MATURIN,PQ. ALTO DE LOS GODOS,PREESCOLAR DORA TEOTISTE DE GALLEGOS,1066,2,9,819,451,810,0,4,1,0,354,819
EDO. MONAGAS,CE. MATURIN,PQ. ALTO DE LOS GODOS,ESCUELA PRIMARIA NACIONAL  ALI PRIMERA,246,1,5,210,178,205,0,1,0,0,26,210
EDO. MONAGAS,CE. MATURIN,PQ. ALTO DE LOS GODOS,ESCUELA BASICA PRIMARIA ARTURO USLAR PIETRI,236,1,2,197,136,195,0,3,0,0,56,197
EDO. MONAGAS,CE. MATURIN,PQ. ALTO DE LOS GODOS,ESCUELA PRIMARIA NACIONAL ADRIANA RENGEL DE SEQUERA,3541,7,32,2931,1502,2899,1,15,0,1,1380,2931
EDO. MONAGAS,CE. MATURIN,PQ. ALTO DE LOS GODOS,CENTRO DEL NIÑO Y LA FAMILIA SIMONCITO MOSCU,522,1,3,455,350,452,0,4,0,0,98,455
EDO. MONAGAS,CE. MATURIN,PQ. ALTO DE LOS GODOS,COMPLEJO EDUCATIVO NACIONAL FRANCISCO VERDE,3258,6,43,2665,1696,2622,1,15,2,0,908,2665
EDO. MONAGAS,CE. MATURIN,PQ. ALTO DE LOS GODOS,COMPLEJO EDUCATIVO NACIONAL JOSE ANGEL MEZA VERDE,2885,5,58,2499,1268,2441,1,17,1,1,1153,2499
EDO. MONAGAS,CE. MATURIN,PQ. ALTO DE LOS GODOS,LICEO NACIONAL BATALLA DE LA VICTORIA,1932,4,34,1761,1497,1727,0,13,0,0,217,1761
EDO. MONAGAS,CE. MATURIN,PQ. ALTO DE LOS GODOS,CENTRO DEL NIÑO Y LA FAMILIA BOLIVARIANO BELLOS HORIZONTES,780,2,7,601,496,594,0,6,1,0,91,601
EDO. MONAGAS,CE. MATURIN,PQ. ALTO DE LOS GODOS,UNIDAD EDUCATIVA BOLIVAR,808,2,9,729,513,720,0,6,0,0,201,729
EDO. MONAGAS,CE. MATURIN,PQ. ALTO DE LOS GODOS,ESCUELA BASICA ANTONIO JOSE DE SUCRE,2805,5,27,2243,1349,2216,0,16,1,1,849,2243
EDO. MONAGAS,CE. MATURIN,PQ. ALTO DE LOS GODOS,ESCUELA BASICA SAN SIMON,2616,5,40,2034,1094,1994,0,21,0,2,877,2034
EDO. MONAGAS,CE. MATURIN,PQ. ALTO DE LOS GODOS,CENTRO DE EDUCACIÓN INICIAL ALTO DE LOS GODOS 2,924,2,4,808,204,804,0,5,0,0,595,808
EDO. MONAGAS,CE. MATURIN,PQ. ALTO DE LOS GODOS,ESCUELA PRIMARIA NACIONAL CRUZ HERNANDEZ QUIJADA,739,2,18,656,394,638,0,5,0,0,239,656
EDO. MONAGAS,CE. MATURIN,PQ. ALTO DE LOS GODOS,LICEO NACIONAL FELIX ARMANDO NUÑEZ BEAPERTHUY,2596,5,15,2303,1089,2288,0,15,0,1,1183,2303
EDO. MONAGAS,CE. MATURIN,PQ. ALTO DE LOS GODOS,ESCUELA PRIMARIA NACIONAL BATALLA DE LOS GODOS,1739,3,20,1389,1130,1369,0,3,1,0,235,1389
EDO. MONAGAS,CE. MATURIN,PQ. ALTO DE LOS GODOS,ESCUELA PRIMARIA  APOLINAR CANTOR,2944,6,57,2365,1441,2308,0,8,0,2,857,2365
EDO. MONAGAS,CE. MATURIN,PQ. ALTO DE LOS GODOS,CENTRO DE EDUCACIÓN INICIAL SAN JUDAS TADEO,678,2,13,492,302,479,1,3,1,0,172,492
EDO. MONAGAS,CE. MATURIN,PQ. ALTO DE LOS GODOS,ESCUELA PRIMARIA NACIONAL  MIGUEL EDUARDO TURMERO,4872,9,50,4317,2098,4267,1,32,0,1,2135,4317
EDO. MONAGAS,CE. MATURIN,PQ. ALTO DE LOS GODOS,UNIDAD EDUCATIVA PADRE LUIS ORMIERES FE Y ALEGRIA,2594,5,32,2075,1027,2043,0,13,1,1,1001,2075
EDO. MONAGAS,CE. MATURIN,PQ. ALTO DE LOS GODOS,ESCUELA BASICA MARLENE SEQUEA DE CAMPOS,1670,3,29,1410,965,1381,0,4,2,0,410,1410
EDO. MONAGAS,CE. MATURIN,PQ. ALTO DE LOS GODOS,ESCUELA INICIAL NACIONAL BRISAS DEL MORICHAL,1067,2,19,881,617,862,0,7,0,1,237,881
EDO. MONAGAS,CE. MATURIN,PQ. ALTO DE LOS GODOS,MODULO COMUNAL LA MURALLA,1636,3,25,1353,689,1328,0,4,1,0,634,1353
EDO. MONAGAS,CE. MATURIN,PQ. ALTO DE LOS GODOS,JARDIN DE INFANCIA NACIONAL ADRIANA RENGEL DE SEQUERA,1900,4,23,1626,808,1603,0,6,0,0,789,1626
EDO. MONAGAS,CE. MATURIN,PQ. ALTO DE LOS GODOS,JARDIN DE INFANCIA LOS PINOS,1393,3,14,1161,663,1147,0,8,0,0,476,1161
EDO. MONAGAS,CE. MATURIN,PQ. ALTO DE LOS GODOS,COMPLEJO EDUCATIVO NACIONAL MANOLA LUNA SILVA,2583,5,39,2204,1042,2165,0,20,1,0,1102,2204
EDO. MONAGAS,CE. MATURIN,PQ. ALTO DE LOS GODOS,ESCUELA BASICA COLINAS DEL PARAMACONI,420,1,4,356,238,352,0,1,0,0,113,356
EDO. MONAGAS,CE. MATURIN,PQ. ALTO DE LOS GODOS,UNIDAD EDUCATIVA COLEGIO PRIVADO DOCTOR JOSÉ GIL FORTOUL,1685,3,16,1484,562,1468,0,9,0,2,895,1484
EDO. MONAGAS,CE. MATURIN,PQ. ALTO DE LOS GODOS,CENTRO DEL NIÑO Y LA FAMILIA BOLIVARIANO NUEVO HORIZONTE,2352,4,34,1923,1154,1889,0,13,0,0,722,1923
EDO. MONAGAS,CE. MATURIN,PQ. ALTO DE LOS GODOS,CV MOVIL PARQUESITO LOS GUARITOS III,356,1,8,332,165,324,0,1,0,0,158,332
EDO. MONAGAS,CE. MATURIN,PQ. BOQUERON,ESCUELA PUBLICA NACIONAL GABRIELA MISTRAL,409,1,5,346,296,341,0,3,0,0,42,346
EDO. MONAGAS,CE. MATURIN,PQ. BOQUERON,LICEO SIMÓN BOLIVAR,4976,9,58,4166,2039,4108,1,21,1,1,2045,4166
EDO. MONAGAS,CE. MATURIN,PQ. BOQUERON,ESCUELA BASICA LUISA TERESA SOSA,3363,6,40,2846,804,2806,0,8,1,3,1990,2846
EDO. MONAGAS,CE. MATURIN,PQ. BOQUERON,UNIDAD EDUCATIVA LUISA JIMENEZ DE CANELON,2053,4,59,1634,940,1575,1,10,1,0,623,1634
EDO. MONAGAS,CE. MATURIN,PQ. BOQUERON,ESCUELA BASICA BOLIVARIANA GUAYABAL,1021,2,33,828,598,795,0,5,0,0,192,828
EDO. MONAGAS,CE. MATURIN,PQ. BOQUERON,ESCUELA BÁSICA EL RINCÓN DEL COSTO,666,2,12,558,361,546,0,7,1,1,176,558
EDO. MONAGAS,CE. MATURIN,PQ. BOQUERON,ESCUELA BASICA FELIX ARMANDO NUÑEZ BEAPERTHUY,2667,5,43,2057,1065,2014,0,21,1,0,927,2057
EDO. MONAGAS,CE. MATURIN,PQ. BOQUERON,ESCUELA BASICA LUISA BELTRANA DE FIGUEROA,3306,6,50,2596,1718,2546,1,19,3,0,805,2596
EDO. MONAGAS,CE. MATURIN,PQ. BOQUERON,ESCUELA PRIMARIA NACIONAL BOLIVARIANA LA SABANA DEL ZORRO,862,2,18,722,549,704,0,7,1,0,147,722
EDO. MONAGAS,CE. MATURIN,PQ. BOQUERON,ESCUELA RURAL BOLIVARIANA SAN LUIS,505,1,7,452,234,445,0,3,0,0,208,452
EDO. MONAGAS,CE. MATURIN,PQ. BOQUERON,CV MOVIL CANCHA DEPORTIVA DOÑA MENCA 2,114,1,0,97,68,97,0,0,0,0,29,97
EDO. MONAGAS,CE. MATURIN,PQ. BOQUERON,ESCUELA PRIMERIA NACIONAL DOÑA MENCA DE LEONI,3440,7,43,2783,1738,2740,1,23,1,0,977,2783
EDO. MONAGAS,CE. MATURIN,PQ. BOQUERON,ESCUELA BASICA ANDRES BELLO,2561,5,57,1915,1088,1858,0,10,2,1,757,1915
EDO. MONAGAS,CE. MATURIN,PQ. BOQUERON,UNIDAD EDUCATIVA BOLIVARIANA TIPURO 2,572,1,3,493,243,490,0,4,0,0,243,493
EDO. MONAGAS,CE. MATURIN,PQ. BOQUERON,ESCUELA BASICA RURAL SANTA ELENA DE VIBORAL,2805,5,23,2515,835,2492,0,11,0,2,1644,2515
EDO. MONAGAS,CE. MATURIN,PQ. BOQUERON,ESCUELA BASICA BOLIVARIANA LA SARRAPIA,745,2,18,671,337,653,0,3,2,0,311,671
EDO. MONAGAS,CE. MATURIN,PQ. BOQUERON,ESCUELA BASICA AGUA CLARA,408,1,9,348,256,339,0,3,0,0,80,348
EDO. MONAGAS,CE. MATURIN,PQ. BOQUERON,LICEO NACIONAL SALVADOR ALLENDE,1199,3,17,1077,729,1060,0,6,0,0,325,1077
EDO. MONAGAS,CE. MATURIN,PQ. BOQUERON,ESCUELA BASICA ELSA BIONDI DE RIVERO,1648,3,44,1267,945,1223,0,7,0,0,271,1267
EDO. MONAGAS,CE. MATURIN,PQ. BOQUERON,ESCUELA PRIMARIA NACIONAL EL AMBIENTE,588,1,4,513,301,509,0,2,0,1,205,513
EDO. MONAGAS,CE. MATURIN,PQ. BOQUERON,ESCUELA BASICA DOCTOR. LUIS BELTRAN PRIETO FIGUEROA,822,2,17,706,380,689,1,4,0,0,304,706
EDO. MONAGAS,CE. MATURIN,PQ. BOQUERON,ESCUELA BASICA CARMEN HERNANDEZ DE MILANO,835,2,21,640,442,619,1,4,2,0,170,640
EDO. MONAGAS,CE. MATURIN,PQ. BOQUERON,ESCUELA BASICA BOLIVARIANA DEL ZAMURO,717,2,16,563,429,547,0,2,0,0,116,563
EDO. MONAGAS,CE. MATURIN,PQ. JUSEPIN,ESCUELA BASICA BOLIVARIANA SANTIAGO MARIÑO,593,1,8,466,285,458,0,3,0,0,170,466
EDO. MONAGAS,CE. MATURIN,PQ. JUSEPIN,ESCUELA BÁSICA BOLIVARIANA DOCTOR JOSE MARIA VARGAS,2626,5,42,2150,1515,2108,0,12,0,0,581,2150
EDO. MONAGAS,CE. MATURIN,PQ. JUSEPIN,ESCUELA BASICA PLACIDO MANEIRO,3116,6,39,2663,1947,2624,1,15,0,0,661,2663
EDO. MONAGAS,CE. MATURIN,PQ. JUSEPIN,ESCUELA BÁSICA BOLIVARIANA BARRANCAS,838,2,17,661,471,644,0,8,0,0,165,661
EDO. MONAGAS,CE. MATURIN,PQ. JUSEPIN,CENTRO DE EDUCACION INICIAL ANEXO DOCTOR JOSE MARIA VARGAS,719,2,18,630,469,612,1,3,0,1,138,630
EDO. MONAGAS,CE. MATURIN,PQ. JUSEPIN,UNIDAD EDUCATIVA ANATILDE SALCEDO FE Y ALEGRIA,553,1,5,484,420,479,0,1,1,0,57,484
EDO. MONAGAS,CE. MATURIN,PQ. LA PICA,CENTRO DEL NIÑO Y LA FAMILIA LA PICA,208,1,4,188,120,184,0,3,0,0,61,188
EDO. MONAGAS,CE. MATURIN,PQ. LA PICA,COMPLEJO EDUCATIVO FANNY CENTENO,1629,3,40,1199,740,1159,0,5,0,1,413,1199
EDO. MONAGAS,CE. MATURIN,PQ. LA PICA,LICEO NACIONAL JOSE FELIX RIBAS,1380,3,45,1037,612,992,0,10,1,0,369,1037
EDO. MONAGAS,CE. MATURIN,PQ. LA PICA,ESCUELA BASICA BOLIVARIANA LA HORMIGA,526,1,7,456,318,449,0,2,0,0,129,456
EDO. MONAGAS,CE. MATURIN,PQ. LA PICA,ESCUELA BASICA BOLIVARIANA LA LOCACION,228,1,7,203,149,196,0,1,0,0,46,203
EDO. MONAGAS,CE. MATURIN,PQ. LA PICA,ESCUELA BÁSICA BOLIVARIANA LA ESPERANZA,519,1,10,374,220,364,0,1,1,0,142,374
EDO. MONAGAS,CE. MATURIN,PQ. LA PICA,ESCUELA PRIMARIA ESTADAL FELIX ANGEL LOZADA,2976,6,45,2286,1343,2241,2,17,1,2,876,2286
EDO. MONAGAS,CE. MATURIN,PQ. LA PICA,LICEO BOLIVARIANO FELIX ANGEL LOZADA,526,1,4,448,296,444,0,1,0,1,146,448
EDO. MONAGAS,CE. MATURIN,PQ. LA PICA,INTERNADO JUDICIAL DE MONAGAS,498,1,8,116,87,108,0,1,0,0,20,116
EDO. MONAGAS,CE. MATURIN,PQ. LA PICA,COMPLEJO EDUCATIVO NACIONAL EL BARRIL,266,1,3,224,176,221,0,0,0,0,45,224
EDO. MONAGAS,CE. MATURIN,PQ. LA PICA,CENTRO EDUCACION INICIAL BOLIVARIANO NUESTRA SEÑORA DE LOURDES,421,1,16,371,272,355,1,3,0,0,79,371
EDO. MONAGAS,CE. MATURIN,PQ. LA PICA,UNIDAD EDUCATIVA BOLIVARIANA VUELTA LARGA,737,2,8,580,392,572,1,1,0,0,178,580
EDO. MONAGAS,CE. MATURIN,PQ. EL FURRIAL,ESCUELA BÁSICA RAFAEL MARIA BARALT,2179,4,36,1739,1104,1703,0,7,3,0,589,1739
EDO. MONAGAS,CE. MATURIN,PQ. EL FURRIAL,COMPLEJO CULTURAL JESUS JARAMILLO,1019,2,26,900,615,874,0,5,1,3,250,900
EDO. MONAGAS,CE. MATURIN,PQ. EL FURRIAL,CICLO BASICO EL FURRIAL,1524,3,27,1170,717,1143,0,10,0,1,415,1170
EDO. MONAGAS,CE. MATURIN,PQ. EL FURRIAL,CENTRO DE EDUCACIÓN INICIAL FELICIA RONDON DE CABELLO,592,1,7,507,385,500,0,4,0,0,111,507
EDO. MONAGAS,CE. MATURIN,PQ. EL FURRIAL,ESCUELA BÁSICA ROBERTO GÓMEZ DOFOURT,1436,3,32,1226,695,1194,0,8,0,0,491,1226
EDO. MONAGAS,CE. MATURIN,PQ. LAS COCUIZAS,LICEO RAFAEL MARIA PEÑA SAAVEDRA,1235,3,14,1083,420,1069,0,7,2,0,640,1083
EDO. MONAGAS,CE. MATURIN,PQ. LAS COCUIZAS,JARDIN DE INFANCIA SOLEDAD CLAVIER,1677,3,22,1386,588,1364,0,8,0,1,767,1386
EDO. MONAGAS,CE. MATURIN,PQ. LAS COCUIZAS,ESCUELA BASICA CECILIO ACOSTA,3013,6,48,2343,1373,2295,0,15,1,0,906,2343
EDO. MONAGAS,CE. MATURIN,PQ. LAS COCUIZAS,MODULO DE SERVICIOS LOS CORTIJOS,1850,4,33,1535,882,1502,0,11,1,1,607,1535
EDO. MONAGAS,CE. MATURIN,PQ. LAS COCUIZAS,COMPLEJO EDUCATIVO NACIONAL ANDRES BELLO,3539,7,72,2842,1758,2770,0,22,1,2,987,2842
EDO. MONAGAS,CE. MATURIN,PQ. LAS COCUIZAS,COMPLEJO EDUCATIVO NACIONAL LEONARDO INFANTE,4888,9,66,4310,1425,4244,0,21,0,0,2798,4310
EDO. MONAGAS,CE. MATURIN,PQ. LAS COCUIZAS,COMPLEJO EDUCATIVO GENERAL EZEQUIEL ZAMORA,715,2,24,614,432,590,0,5,1,0,152,614
EDO. MONAGAS,CE. MATURIN,PQ. LAS COCUIZAS,MODULO POLICIAL DEL PARQUE PADILLA RON,540,1,6,473,286,467,0,4,0,0,177,473
EDO. MONAGAS,CE. MATURIN,PQ. LAS COCUIZAS,INSTITUTO NACIONAL DE COOPERACIÓN EDUCATIVA (INCES),1883,4,28,1516,810,1488,0,9,0,1,668,1516
EDO. MONAGAS,CE. MATURIN,PQ. LAS COCUIZAS,ESCUELA PRIMARIA NACIONAL MEREYAL,1295,3,30,1080,713,1050,1,10,0,1,325,1080
EDO. MONAGAS,CE. MATURIN,PQ. LAS COCUIZAS,COMPLEJO EDUCATIVO  ANGEL DE LA GUARDA FE Y ALEGRÍA,3628,7,42,2704,1864,2662,0,25,3,2,768,2704
EDO. MONAGAS,CE. MATURIN,PQ. LAS COCUIZAS,ESCUELA NACIONAL INICIAL SIMONCITO LA FLORECITA,483,1,20,416,251,396,1,4,0,1,139,416
EDO. MONAGAS,CE. MATURIN,PQ. LAS COCUIZAS,COMPLEJO EDUCATIVO CREACION EL PARQUECITO,916,2,16,788,512,772,0,7,0,0,253,788
EDO. MONAGAS,CE. MATURIN,PQ. LAS COCUIZAS,CENTRO DE SERVICIO SOCIAL RESIDENCIAL Y AMBULATORIO DOCTOR MARCOS SERRES PADILLA,405,1,7,370,269,363,0,2,1,1,90,370
EDO. MONAGAS,CE. MATURIN,PQ. LAS COCUIZAS,CV MOVIL CANCHA DEPORTIVA LA BATEA,230,1,4,208,116,204,0,2,0,0,86,208
EDO. MONAGAS,CE. MATURIN,PQ. LAS COCUIZAS,CENTRO DE EDUCACIÓN INICIAL BOLIVARIANO CECILIA NÚÑEZ SUCRE,1225,3,25,937,449,912,0,6,0,1,456,937
EDO. MONAGAS,CE. MATURIN,PQ. LAS COCUIZAS,CENTRO DE NIÑO Y FAMILIA AGUSTIN SALAZAR,1079,2,18,903,625,885,0,6,0,0,254,903
EDO. MONAGAS,CE. MATURIN,PQ. LAS COCUIZAS,CASA BOLIVARIANA DE LA MUJER LA CONSTITUYENTE,642,2,11,501,410,490,0,3,0,0,77,501
EDO. MONAGAS,CE. MATURIN,PQ. LAS COCUIZAS,ESCUELA BASICA FEDERICO HANDS,2891,5,24,2219,1078,2195,2,10,2,3,1100,2219
EDO. MONAGAS,CE. MATURIN,PQ. LAS COCUIZAS,UNIDAD EDUCATIVA JESUS DE NAZARETH,2020,4,38,1660,1235,1622,1,13,3,0,370,1660
EDO. MONAGAS,CE. MATURIN,PQ. LAS COCUIZAS,ESCUELA TECNICA AGROPECUARIA ROBINSONIANA SIMON BOLIVAR,326,1,6,290,199,284,0,2,0,0,83,290
EDO. MONAGAS,CE. MATURIN,PQ. LAS COCUIZAS,LICEO NACIONAL PABLO NERUDA,341,1,11,289,170,278,0,2,0,0,106,289
EDO. MONAGAS,CE. MATURIN,PQ. LAS COCUIZAS,ESCUELA BASICA INES BALCENA DE MOTA,1012,2,19,741,435,722,0,4,0,0,283,741
EDO. MONAGAS,CE. MATURIN,PQ. LAS COCUIZAS,ESCUELA BASICA PRIMERO DE MAYO,4007,7,66,3213,2138,3147,1,23,2,1,982,3213
EDO. MONAGAS,CE. MATURIN,PQ. LAS COCUIZAS,CASA DE ABRIGO JOSE MERCEDES SANTELIZ,665,2,13,589,398,576,0,3,0,2,173,589
EDO. MONAGAS,CE. MATURIN,PQ. LAS COCUIZAS,ESCUELA BASICA PABLO EMILIO CASTILLO,3503,6,44,2860,1398,2816,1,19,2,2,1394,2860
EDO. MONAGAS,CE. MATURIN,PQ. LAS COCUIZAS,COMPLEJO EDUCATIVO NACIONAL 4 DE FEBRERO,361,1,5,303,251,298,0,7,0,0,40,303
EDO. MONAGAS,CE. MATURIN,PQ. LAS COCUIZAS,ESCUELA BASICA FRANCISCO DE MIRANDA,1441,3,19,1182,702,1163,0,8,0,0,453,1182
EDO. MONAGAS,CE. MATURIN,PQ. LAS COCUIZAS,ESCUELA BASICA SIMON RODRIGUEZ,2023,4,31,1639,1015,1608,0,9,3,0,581,1639
EDO. MONAGAS,CE. MATURIN,PQ. LAS COCUIZAS,ESCUELA BÁSICA GREGORIO RONDÓN,3298,6,56,2579,1411,2523,0,20,1,1,1090,2579
EDO. MONAGAS,CE. MATURIN,PQ. LAS COCUIZAS,TALLER DE EDUCACION LABORAL BOLIVARIANO AYACUCHO,268,1,3,240,140,237,0,3,0,0,94,240
EDO. MONAGAS,CE. MATURIN,PQ. LAS COCUIZAS,ESCUELA BASICA BOLIVARIANA PEDRO MAXIMO CAMPOS,1543,3,23,1210,717,1187,0,6,2,0,462,1210
EDO. MONAGAS,CE. MATURIN,PQ. LAS COCUIZAS,ESCUELA TECNICA INDUSTRIAL (ETI),1279,3,20,1069,587,1049,0,11,0,1,450,1069
EDO. MONAGAS,CE. MATURIN,PQ. LAS COCUIZAS,CENTRO DE EDUCACIÓN INICIAL DOÑA FAUSTINA SAEZ DE ALFARO,1532,3,26,1247,583,1221,0,4,0,0,634,1247
EDO. MONAGAS,CE. MATURIN,PQ. LAS COCUIZAS,COMPLEJO EDUCATIVO NACIONAL DOCTOR ERNESTO CHE GUEVARA,304,1,4,257,224,253,0,0,0,0,29,257
EDO. MONAGAS,CE. MATURIN,PQ. LAS COCUIZAS,ESCUELA BASICA DANILO ANDERSON,311,1,5,260,219,255,0,0,0,0,36,260
EDO. MONAGAS,MP. EZEQUIEL ZAMORA,CM. PUNTA DE MATA,CENTRO DE EDUCACION INICIAL JUAN JOSE LANDAETA,622,2,7,539,471,532,0,3,0,0,58,539
EDO. MONAGAS,MP. EZEQUIEL ZAMORA,CM. PUNTA DE MATA,ESCUELA BASICA MUSIPAN,816,2,30,684,509,654,0,1,0,1,143,684
EDO. MONAGAS,MP. EZEQUIEL ZAMORA,CM. PUNTA DE MATA,SIMONCITO INTERNO 24 DE JUNIO,572,1,15,510,452,495,0,1,0,0,42,510
EDO. MONAGAS,MP. EZEQUIEL ZAMORA,CM. PUNTA DE MATA,LICEO BOLIVARIANO GENERAL RAFAEL URDANETA,566,1,9,473,320,464,0,0,0,0,144,473
EDO. MONAGAS,MP. EZEQUIEL ZAMORA,CM. PUNTA DE MATA,ESCUELA BASICA CENTURION,1752,3,39,1439,749,1400,0,11,1,0,639,1439
EDO. MONAGAS,MP. EZEQUIEL ZAMORA,CM. PUNTA DE MATA,UNIDAD EDUCATIVA BOLIVARIANA DON ANDRES BELLO,271,1,9,213,176,204,0,0,0,0,28,213
EDO. MONAGAS,MP. EZEQUIEL ZAMORA,CM. PUNTA DE MATA,ESCUELA BASICA NICOLAS ARANGUREN,2658,5,54,2235,1440,2181,0,13,3,0,725,2235
EDO. MONAGAS,MP. EZEQUIEL ZAMORA,CM. PUNTA DE MATA,UNIDAD EDUCATIVA EZEQUIEL ZAMORA,1548,3,33,1267,725,1234,1,6,1,0,501,1267
EDO. MONAGAS,MP. EZEQUIEL ZAMORA,CM. PUNTA DE MATA,ESCUELA BASICA 19 DE ABRIL,2118,4,49,1744,1153,1695,0,11,1,2,528,1744
EDO. MONAGAS,MP. EZEQUIEL ZAMORA,CM. PUNTA DE MATA,ESCUELA BASICA MENCA DE LEONI,2418,5,53,2066,1074,2013,0,9,1,1,928,2066
EDO. MONAGAS,MP. EZEQUIEL ZAMORA,CM. PUNTA DE MATA,ESCUELA BASICA ALBERTO RAVELL,3014,6,50,2382,1345,2332,0,15,1,1,970,2382
EDO. MONAGAS,MP. EZEQUIEL ZAMORA,CM. PUNTA DE MATA,ESCUELA BASICA BOLIVARIANA FRANCISCO DE MIRANDA,882,2,13,767,561,754,2,8,0,0,183,767
EDO. MONAGAS,MP. EZEQUIEL ZAMORA,CM. PUNTA DE MATA,UNIDAD EDUCATIVA PRIVADA CAYETANO FARIAS,622,2,6,553,365,547,0,3,0,0,179,553
EDO. MONAGAS,MP. EZEQUIEL ZAMORA,CM. PUNTA DE MATA,ESCUELA BASICA CREACION LAS PARCELAS,2500,5,61,2056,1323,1995,1,16,1,0,654,2056
EDO. MONAGAS,MP. EZEQUIEL ZAMORA,CM. PUNTA DE MATA,ESCUELA BASICA VIRGEN DEL VALLE,1354,3,33,1152,814,1119,0,5,0,0,300,1152
EDO. MONAGAS,MP. EZEQUIEL ZAMORA,CM. PUNTA DE MATA,UNIDAD EDUCATIVA PRIVADA NUESTRA SANTA PATRONA,1071,2,10,951,466,941,1,5,0,0,469,951
EDO. MONAGAS,MP. EZEQUIEL ZAMORA,CM. PUNTA DE MATA,ESCUELA BASICA JOSE GREGORIO MONAGAS,1567,3,29,1328,717,1299,1,6,0,0,575,1328
EDO. MONAGAS,MP. EZEQUIEL ZAMORA,CM. PUNTA DE MATA,GRUPO ESCOLAR RAFAEL VILLAVICENCIO,2933,5,57,2336,1209,2279,1,13,0,2,1054,2336
EDO. MONAGAS,MP. EZEQUIEL ZAMORA,CM. PUNTA DE MATA,ESCUELA BASICA BOLIVARIANA ILAPECA,2245,4,34,1782,1083,1748,1,14,1,1,648,1782
EDO. MONAGAS,MP. EZEQUIEL ZAMORA,CM. PUNTA DE MATA,ESCUELA BASICA BOLIVARIANA EL POTRERO,547,1,14,470,323,456,0,2,0,0,131,470
EDO. MONAGAS,MP. EZEQUIEL ZAMORA,CM. PUNTA DE MATA,ESCUELA BASICA 18 DE MAYO,2884,6,46,2347,1441,2301,0,15,2,0,843,2347
EDO. MONAGAS,MP. EZEQUIEL ZAMORA,PQ. EL TEJERO,COMPLEJO EDUCATIVO NACIONAL SANTA BARBARA,775,2,25,692,461,667,1,1,0,0,204,692
EDO. MONAGAS,MP. EZEQUIEL ZAMORA,PQ. EL TEJERO,UNIDAD EDUCATIVA LUIS BELTRAN PRIETO FIGUEROA,2141,4,48,1715,1019,1667,0,8,2,1,637,1715
EDO. MONAGAS,MP. EZEQUIEL ZAMORA,PQ. EL TEJERO,ESCUELA BASICA CREACION EL TEJERO II,1874,4,43,1506,998,1463,1,4,0,0,460,1506
EDO. MONAGAS,MP. EZEQUIEL ZAMORA,PQ. EL TEJERO,ESCUELA BÁSICA LISANDRO RIVERO,2727,5,68,2247,1393,2179,0,11,0,0,775,2247
EDO. MONAGAS,MP. AGUASAY,CM. AGUASAY,CENTRO CULTURAL AGUASAY,1693,3,27,1351,752,1324,0,9,1,0,562,1351
EDO. MONAGAS,MP. AGUASAY,CM. AGUASAY,ESCUELA NACIONAL ANTONIO CILIBERTO PEREZ,2387,5,46,1957,1154,1911,0,18,1,0,738,1957
EDO. MONAGAS,MP. AGUASAY,CM. AGUASAY,ESCUELA BASICA CONCENTRADA BOCAS DE TONORO,356,1,5,281,193,276,0,5,0,0,78,281
EDO. MONAGAS,MP. AGUASAY,CM. AGUASAY,ESCUELA BASICA BOLIVARIANA ALTAMIRA,1224,3,51,967,653,916,0,2,0,0,261,967
EDO. MONAGAS,MP. AGUASAY,CM. AGUASAY,ESCUELA BASICA CONCENTRADA LA INGLESA,582,1,7,432,266,425,0,1,0,0,158,432
EDO. MONAGAS,MP. AGUASAY,CM. AGUASAY,ESCUELA BASICA UNITARIA SAN JOSE DE ÑATO,582,1,10,452,257,442,0,2,0,0,183,452
EDO. MONAGAS,MP. AGUASAY,CM. AGUASAY,ESCUELA BASICA BOLIVARIANA ORITUPANO,241,1,8,215,186,207,0,0,0,0,21,215
EDO. MONAGAS,MP. AGUASAY,CM. AGUASAY,UNIDAD EDUCATIVA FE Y ALEGRIA,1386,3,22,1108,675,1086,1,10,2,0,398,1108
EDO. MONAGAS,MP. AGUASAY,CM. AGUASAY,ESCUELA PRIMARIA NACIONAL  PERIQUITO,515,1,9,410,181,401,0,2,0,0,218,410
EDO. MONAGAS,MP. AGUASAY,CM. AGUASAY,ESCUELA PRIMARIA NACIONAL BOLIVARIANA EL CARO,710,2,9,543,368,534,0,2,0,0,164,543
EDO. MONAGAS,MP. AGUASAY,CM. AGUASAY,ESCUELA BASICA BOLIVARIANA LAS GAVIOTAS,459,1,5,361,290,356,0,2,0,0,64,361
EDO. MONAGAS,MP. AGUASAY,CM. AGUASAY,ESCUELA BASICA CONCENTRADA LA PULVIA,549,1,13,440,301,427,0,6,0,0,120,440
