Estado,Municipio,Parroquia,Centro,Número de Electores escrutados.,Número de Actas Procesadas.,Número total de Votos Nulos.,Número Total de Votantes que votaron realmente.,HUGO CHAVEZ,Número total de Votos Válidos.,ORLANDO CHIRINO,REINA SEQUERA,LUIS REYES,MARIA BOLIVAR,HENRIQUE CAPRILES RADONSKI,Número de Votos Escrutados.
EDO. YARACUY,MP. INDEPENDENCIA,CM. INDEPENDENCIA,CENTRO DE EDUCACION INICIAL INDEPENDENCIA,1618,3,30,1284,480,1254,0,17,1,0,756,1284
EDO. YARACUY,MP. INDEPENDENCIA,CM. INDEPENDENCIA,ESCUELA INTEGRAL BOLIVARIANA MARIA EVA DE LISCANO,2781,5,55,2345,1029,2290,2,12,2,2,1243,2345
EDO. YARACUY,MP. INDEPENDENCIA,CM. INDEPENDENCIA,INSTITUTO UNIVERSITARIO DE TECNOLOGIA DEL YARACUY IUTY,2956,6,46,2567,755,2521,0,5,1,0,1760,2567
EDO. YARACUY,MP. INDEPENDENCIA,CM. INDEPENDENCIA,CENTRO DE EDUCACION INICIAL DON JUANCHO,345,1,4,316,223,312,0,0,0,1,88,316
EDO. YARACUY,MP. INDEPENDENCIA,CM. INDEPENDENCIA,ESCUELA BASICA RAFAEL ANDRADE,1607,3,41,1381,573,1340,0,7,0,0,760,1381
EDO. YARACUY,MP. INDEPENDENCIA,CM. INDEPENDENCIA,ESCUELA INTEGRAL BOLIVARIANA LA NEGRITA,505,1,19,407,307,388,0,3,0,0,78,407
EDO. YARACUY,MP. INDEPENDENCIA,CM. INDEPENDENCIA,INTERNADO JUDICIAL,664,2,15,463,236,448,0,3,0,0,209,463
EDO. YARACUY,MP. INDEPENDENCIA,CM. INDEPENDENCIA,CENTRO DE EDUCACION INICIAL CUERPO DE BOMBEROS,602,2,16,532,260,516,0,1,1,0,254,532
EDO. YARACUY,MP. INDEPENDENCIA,CM. INDEPENDENCIA,OFICINA DE TRANSPORTE BOLIVARIANO,1219,3,29,942,602,913,0,6,0,0,305,942
EDO. YARACUY,MP. INDEPENDENCIA,CM. INDEPENDENCIA,CENTRO DE EDUCACION INICIAL  CONVENCIONAL DOCTOR RUBEN VILLALBA,1039,2,30,858,373,828,1,5,0,0,449,858
EDO. YARACUY,MP. INDEPENDENCIA,CM. INDEPENDENCIA,ESCUELA BASICA ANA ELISA LOPEZ,2923,6,68,2415,1028,2347,0,2,1,1,1315,2415
EDO. YARACUY,MP. INDEPENDENCIA,CM. INDEPENDENCIA,GIMNASIO CUBIERTO JESUS PIMPO ELORZA,1262,3,26,1145,468,1119,0,6,1,1,643,1145
EDO. YARACUY,MP. INDEPENDENCIA,CM. INDEPENDENCIA,ALDEA UNIVERSITARIA MISION SUCRE INDEPENDENCIA,1425,3,37,1321,644,1284,0,6,4,0,630,1321
EDO. YARACUY,MP. INDEPENDENCIA,CM. INDEPENDENCIA,UNIVERSIDAD SIMON RODRIGUEZ,28,1,1,25,11,24,0,0,0,0,13,25
EDO. YARACUY,MP. INDEPENDENCIA,CM. INDEPENDENCIA,ESCUELA BOLIVARIANA IGNACIO GREGORIO MENDEZ,1664,3,62,1339,586,1277,0,13,2,2,674,1339
EDO. YARACUY,MP. INDEPENDENCIA,CM. INDEPENDENCIA,ESCUELA INTEGRAL BOLIVARIANA TAMANAVARE,189,1,20,168,105,148,0,4,0,0,39,168
EDO. YARACUY,MP. INDEPENDENCIA,CM. INDEPENDENCIA,CENTRO DE EDUCACION  INICIAL BOLIVARIANO  IGNACIO GREGORIO MENDEZ,989,2,29,802,395,773,0,5,1,1,371,802
EDO. YARACUY,MP. INDEPENDENCIA,CM. INDEPENDENCIA,ESCUELA INTEGRAL BOLIVARIANA CAÑAVERAL,1462,3,33,1218,689,1185,0,4,0,0,492,1218
EDO. YARACUY,MP. INDEPENDENCIA,CM. INDEPENDENCIA,CENTRO DE EDUCACION INICIAL RAFAEL ANTONIO REYES ZUMETA,378,1,6,318,106,312,0,1,0,0,205,318
EDO. YARACUY,MP. INDEPENDENCIA,CM. INDEPENDENCIA,TALLER DE EDUCACION LABORAL BOLIVARIANO PILAR DE KREUBELL,345,1,7,301,143,294,0,2,0,0,149,301
EDO. YARACUY,MP. INDEPENDENCIA,CM. INDEPENDENCIA,ESCUELA INTEGRAL BOLIVARIANA VIJAGUAL,501,1,12,409,187,397,0,0,0,0,210,409
EDO. YARACUY,MP. INDEPENDENCIA,CM. INDEPENDENCIA,ESCUELA INTEGRAL BOLIVARIANA CASCABEL,2466,5,56,2089,803,2033,2,12,2,2,1212,2089
EDO. YARACUY,MP. INDEPENDENCIA,CM. INDEPENDENCIA,ESCUELA BASICA  BOLIVARIANA INDEPENDENCIA,3379,6,111,2735,1016,2624,0,14,1,3,1590,2735
EDO. YARACUY,MP. INDEPENDENCIA,CM. INDEPENDENCIA,CENTRO DE EDUCACION INICIAL VALLE DE LAS FLORES,823,2,8,694,251,686,0,8,1,0,426,694
EDO. YARACUY,MP. INDEPENDENCIA,CM. INDEPENDENCIA,LICEO BOLIVARIANO COMUNITARIO CASA TALLER CECILIA MUJICA,6,352,444
EDO. YARACUY,MP. INDEPENDENCIA,CM. INDEPENDENCIA,CENTRO DE EDUCACION  INICIAL YURUBI,1015,2,13,895,375,882,0,6,0,0,501,895
EDO. YARACUY,MP. INDEPENDENCIA,CM. INDEPENDENCIA,GIMNASIO CUBIERTO NICOLAS OJEDA PARRA,825,2,17,710,278,693,0,2,1,1,411,710
EDO. YARACUY,MP. INDEPENDENCIA,CM. INDEPENDENCIA,ESCUELA INTEGRAL BOLIVARIANA EZEQUIEL ZAMORA,975,2,23,811,511,788,0,8,1,0,268,811
EDO. YARACUY,MP. INDEPENDENCIA,CM. INDEPENDENCIA,CENTRO DE EDUCACION INICIAL MENCA DE LEONI,302,1,6,236,154,230,0,1,0,0,75,236
EDO. YARACUY,MP. INDEPENDENCIA,CM. INDEPENDENCIA,ESCUELA INTEGRAL BOLIVARIANA ADOLFO NAVAS CORONADO,2207,4,40,1814,780,1774,1,14,0,0,979,1814
EDO. YARACUY,MP. INDEPENDENCIA,CM. INDEPENDENCIA,ESCUELA BASICA SAN RAFAEL. NER 298,605,2,11,550,284,539,0,5,0,0,250,550
EDO. YARACUY,MP.JOSE ANTONIO PAEZ,CM. SABANA DE PARRA,ESCUELA BASICA MIGUEL ANTONIO FLORES,2450,5,46,2097,1443,2051,0,17,1,1,589,2097
EDO. YARACUY,MP.JOSE ANTONIO PAEZ,CM. SABANA DE PARRA,ESCUELA INTEGRAL BOLIVARIANA MAYURUPI,1540,3,32,1236,709,1204,0,11,1,0,483,1236
EDO. YARACUY,MP.JOSE ANTONIO PAEZ,CM. SABANA DE PARRA,ESCUELA BASICA JOSE ANTONIO PAEZ,746,2,12,646,452,634,1,2,0,0,179,646
EDO. YARACUY,MP.JOSE ANTONIO PAEZ,CM. SABANA DE PARRA,ESCUELA INTEGRAL BOLIVARIANA COPA REDONDA,2071,4,60,1719,1238,1659,1,14,0,0,406,1719
EDO. YARACUY,MP.JOSE ANTONIO PAEZ,CM. SABANA DE PARRA,ESCUELA INTEGRAL BOLIVARIANA RAFAEL CALDERA,884,2,20,746,596,726,0,2,1,0,127,746
EDO. YARACUY,MP.JOSE ANTONIO PAEZ,CM. SABANA DE PARRA,ESCUELA INTRGRAL BOLIVARIANA LA LIMA,337,1,4,302,259,298,0,1,0,0,38,302
EDO. YARACUY,MP.JOSE ANTONIO PAEZ,CM. SABANA DE PARRA,ESCUELA INTEGRAL BOLIVARIANA LA BLANQUERA,624,2,9,565,378,556,0,3,1,0,174,565
EDO. YARACUY,MP.JOSE ANTONIO PAEZ,CM. SABANA DE PARRA,ESCUELA INTEGRAL BOLIVARIANA LEOPOLDO TORREZ,912,2,28,789,617,761,0,4,2,0,138,789
EDO. YARACUY,MP.JOSE ANTONIO PAEZ,CM. SABANA DE PARRA,CENTRO DE EDUCACION INICIAL BOLIVARIANO MAYURUPI,1052,2,15,825,494,810,0,8,1,0,307,825
EDO. YARACUY,MP.JOSE ANTONIO PAEZ,CM. SABANA DE PARRA,ESCUELA INTEGRAL BOLIVARIANA PROFESORA REINA PARRA,1564,3,21,1298,812,1277,0,10,0,1,454,1298
EDO. YARACUY,MP.JOSE ANTONIO PAEZ,CM. SABANA DE PARRA,JARDIN DE INFANCIA SABANA DE PARRA,533,1,10,455,307,445,0,5,0,0,133,455
EDO. YARACUY,MP. NIRGUA,CM. NIRGUA,UNIDAD EDUCATIVA CAMPO AMOR,125,1,0,69,40,69,0,1,0,0,28,69
EDO. YARACUY,MP. NIRGUA,CM. NIRGUA,ESCUELA RURAL LAGUNA VERDE,324,1,4,245,188,241,0,3,0,0,50,245
EDO. YARACUY,MP. NIRGUA,CM. NIRGUA,ESCUELA INTEGRAL BOLIVARIANA  MIGUEL ANGEL GRANADO,2754,5,57,2265,1179,2208,1,8,2,1,1017,2265
EDO. YARACUY,MP. NIRGUA,CM. NIRGUA,ESCUELA INTEGRAL BOLIVARIANA PANCHITO,216,1,5,196,135,191,0,0,0,0,56,196
EDO. YARACUY,MP. NIRGUA,CM. NIRGUA,CASA COMUNAL DE GUERRERO,126,1,0,86,75,86,0,0,0,0,11,86
EDO. YARACUY,MP. NIRGUA,CM. NIRGUA,SEMILLERO CULTURAL AIRE LIBRE,391,1,13,369,203,356,0,0,0,0,153,369
EDO. YARACUY,MP. NIRGUA,CM. NIRGUA,ESCUELA  INTEGRAL BOLIVARIANA  LAS CAOBAS,119,1,3,92,79,89,0,1,0,0,9,92
EDO. YARACUY,MP. NIRGUA,CM. NIRGUA,ESCUELA CONCENTRADA LA MIEL CINCO LOMAS,277,1,4,196,163,192,0,0,0,0,29,196
EDO. YARACUY,MP. NIRGUA,CM. NIRGUA,ESCUELA INTEGRAL BOLIVARIANA LAS PIEDRITAS,631,2,11,545,400,534,0,2,0,2,130,545
EDO. YARACUY,MP. NIRGUA,CM. NIRGUA,ESCUELA INTEGRAL BOLIVARIANA SAN VICENTE,359,1,7,286,235,279,0,0,1,0,43,286
EDO. YARACUY,MP. NIRGUA,CM. NIRGUA,CENTRO DE EDUCACON INTEGRAL  NIRGUA,1369,3,33,1091,629,1058,0,4,0,0,425,1091
EDO. YARACUY,MP. NIRGUA,CM. NIRGUA,ESCUELA INTEGRAL BOLIVARIANA CEDEÑO,134,1,0,71,58,71,1,0,1,0,11,71
EDO. YARACUY,MP. NIRGUA,CM. NIRGUA,ESCUELA BASICA SAN LUIS,65,1,2,54,52,52,0,0,0,0,0,54
EDO. YARACUY,MP. NIRGUA,CM. NIRGUA,CENTRO DE EDUCACION INICIAL BOLIVARIANO MIGUEL ANGEL GRANADOS,1246,3,24,1013,528,989,1,8,0,1,451,1013
EDO. YARACUY,MP. NIRGUA,CM. NIRGUA,LICEO BOLIVARIANO HERIBERTO NUÑEZ OLIVEROS,1835,4,37,1505,878,1468,0,9,1,0,580,1505
EDO. YARACUY,MP. NIRGUA,CM. NIRGUA,NUCLEO ESCOLAR RURAL PALMARITO,159,1,0,126,123,126,0,0,0,0,3,126
EDO. YARACUY,MP. NIRGUA,CM. NIRGUA,TALLER DE EDUCACION LABORAL BOLIVARIANO NIRGUA,884,2,16,707,271,691,0,2,1,1,416,707
EDO. YARACUY,MP. NIRGUA,CM. NIRGUA,ESCUELA BASICA SANTA CRUZ NER 206,41,1,1,37,33,36,0,0,0,0,3,37
EDO. YARACUY,MP. NIRGUA,CM. NIRGUA,ESCUELA CONCENTRADA VAQUIRA,223,1,1,187,125,186,0,0,0,0,61,187
EDO. YARACUY,MP. NIRGUA,CM. NIRGUA,CENTRO DE EDUCACION INICIAL BOLIVARIANO DOCTOR HUMBERTO CUENCA ( EL MOSCU),191,1,4,173,133,169,0,3,0,0,33,173
EDO. YARACUY,MP. NIRGUA,CM. NIRGUA,ESCUELA BASICA PALO SOLO,294,1,2,255,226,253,0,1,0,0,26,255
EDO. YARACUY,MP. NIRGUA,CM. NIRGUA,ESCUELA INTEGRAL BOLIVARIANA CERRO DE PAJA,65,1,1,47,18,46,0,0,1,0,27,47
EDO. YARACUY,MP. NIRGUA,CM. NIRGUA,ESCUELA INTEGRAL BOLIVARIANA SANTA ROSA DE TEJERIAS,341,1,1,260,241,259,0,1,0,0,17,260
EDO. YARACUY,MP. NIRGUA,CM. NIRGUA,UNIDAD EDUCATIVA BURIA,1880,4,38,1465,964,1427,1,10,1,0,451,1465
EDO. YARACUY,MP. NIRGUA,CM. NIRGUA,ALDEA UNIVERSITARIA BOLIVARIANA MISION SUCRE,311,1,4,262,163,258,0,1,0,0,94,262
EDO. YARACUY,MP. NIRGUA,CM. NIRGUA,ESCUELA RURAL LAS GLORIAS,208,1,5,170,95,165,0,0,1,0,69,170
EDO. YARACUY,MP. NIRGUA,CM. NIRGUA,CENTRO DE EDUCACION INICIAL ANDRES BELLO,974,2,17,782,506,765,0,3,0,0,256,782
EDO. YARACUY,MP. NIRGUA,CM. NIRGUA,ESCUELA RURAL NUARITO,341,1,4,270,231,266,0,0,0,0,35,270
EDO. YARACUY,MP. NIRGUA,CM. NIRGUA,ESCUELA INTEGRAL BOLIVARIANA CABUY,1107,2,26,885,677,859,5,3,1,1,172,885
EDO. YARACUY,MP. NIRGUA,CM. NIRGUA,CENTRO DE EDUCACION INCIAL FRANCISCO JAVIER USTARIZ,950,2,11,762,389,751,0,2,1,2,357,762
EDO. YARACUY,MP. NIRGUA,CM. NIRGUA,ESCUELA RURAL ORUBAL,79,1,0,49,45,49,0,0,0,0,4,49
EDO. YARACUY,MP. NIRGUA,CM. NIRGUA,ESCUELA INTEGRAL BOLIVARIANA LOS COGOLLOS,515,1,12,344,201,332,0,5,0,0,126,344
EDO. YARACUY,MP. NIRGUA,CM. NIRGUA,ESCUELA BASICA EL PICACHO,317,1,4,254,212,250,0,0,0,0,38,254
EDO. YARACUY,MP. NIRGUA,CM. NIRGUA,ESCUELAINTEGRAL BOLIVARIANA PARACAJE,279,1,4,203,179,199,0,0,0,0,20,203
EDO. YARACUY,MP. NIRGUA,CM. NIRGUA,CENTRO DE EDUCACIÓN INICIAL BOLIVARIANO SIMONCITO DOCTOR ARTURO USLAR PIETRI,249,1,6,229,167,223,0,1,0,0,55,229
EDO. YARACUY,MP. NIRGUA,CM. NIRGUA,ESCUELA BOLIVARIANA EL CHARAY,150,1,1,113,90,112,0,1,0,1,20,113
EDO. YARACUY,MP. NIRGUA,CM. NIRGUA,ESCUELA RURAL LA LAGUNITA,81,1,0,50,45,50,0,1,0,0,4,50
EDO. YARACUY,MP. NIRGUA,CM. NIRGUA,ESCUELA BASICA LOS PINOS,971,2,22,830,536,808,0,6,0,0,266,830
EDO. YARACUY,MP. NIRGUA,CM. NIRGUA,ESCUELA INTEGRAL BOLIVARIANA GUAYABAL,129,1,0,115,108,115,0,0,1,0,6,115
EDO. YARACUY,MP. NIRGUA,CM. NIRGUA,ESCUELA BASICA FRANCISCO JAVIER USTARIZ,4156,8,96,3356,1342,3260,3,20,2,1,1892,3356
EDO. YARACUY,MP. NIRGUA,CM. NIRGUA,ESCUELA ESTADAL GRADUADA NIEVES ENTRENA,1238,3,25,1025,670,1000,0,8,0,3,319,1025
EDO. YARACUY,MP. NIRGUA,CM. NIRGUA,ESCUELA RURAL LA CANDELARIA,380,1,7,298,223,291,0,1,0,0,67,298
EDO. YARACUY,MP. NIRGUA,CM. NIRGUA,CENTRO DE EDUCACION INICIAL BOLIVARIANO SIMONCITO POZO DE LA VACA,224,1,2,195,161,193,1,1,0,0,30,195
EDO. YARACUY,MP. NIRGUA,CM. NIRGUA,ESCUELA BASICA LA CHAPA,1855,4,37,1479,808,1442,0,9,1,1,623,1479
EDO. YARACUY,MP. NIRGUA,CM. NIRGUA,ESCUELA BOLIVARIANA EL CHORRO,175,1,4,140,125,136,0,0,1,0,10,140
EDO. YARACUY,MP. NIRGUA,CM. NIRGUA,ESCUELA RURAL SANTA ANA O LA JOSEFINA,184,1,2,123,74,121,0,2,0,0,45,123
EDO. YARACUY,MP. NIRGUA,CM. NIRGUA,ESCUELA RURAL SANTA LUCIA,172,1,1,119,100,118,0,0,0,0,18,119
EDO. YARACUY,MP. NIRGUA,CM. NIRGUA,ESCUELA INTEGRAL BOLIVARIANA GARCI GONZALEZ,100,1,3,92,64,89,0,1,1,0,23,92
EDO. YARACUY,MP. NIRGUA,PQ. SALOM,ESCUELA INTEGRAL BOLIVARIANA ARAGUATA,842,2,17,689,524,672,0,6,1,1,140,689
EDO. YARACUY,MP. NIRGUA,PQ. SALOM,ESCUELA INTEGRAL BOLIVARIANA MURACHI,1088,2,12,857,501,845,1,5,0,2,336,857
EDO. YARACUY,MP. NIRGUA,PQ. SALOM,ESCUELA INTEGRAL BOLIVARIANA CORUMBO,303,1,6,263,159,257,0,3,1,0,94,263
EDO. YARACUY,MP. NIRGUA,PQ. SALOM,ESCUELA CONCENTRADA LAS MARGARITAS,495,1,10,414,313,404,0,2,0,0,89,414
EDO. YARACUY,MP. NIRGUA,PQ. SALOM,ESCUELA INTEGRAL BOLIVARIANA TAYA,514,1,3,428,329,425,0,1,0,0,95,428
EDO. YARACUY,MP. NIRGUA,PQ. SALOM,ESCUELA INTEGRAL BOLIVARIANA LA HERRERA,358,1,4,296,208,292,0,0,0,0,84,296
EDO. YARACUY,MP. NIRGUA,PQ. SALOM,ESCUELA INTEGRAL BOLIVARIANA LAS LAGUNAS,1612,3,22,1217,733,1195,0,12,2,1,447,1217
EDO. YARACUY,MP. NIRGUA,PQ. SALOM,ESCUELA INTEGRAL BOLIVARIANA MADERA,646,2,5,506,361,501,0,1,0,0,139,506
EDO. YARACUY,MP. NIRGUA,PQ. SALOM,ESCUELA INTEGRAL BOLIVARIANA PEDRO MARIA SOSA,2136,4,35,1759,997,1724,0,5,3,0,719,1759
EDO. YARACUY,MP. NIRGUA,PQ. SALOM,UNIDAD EDUCATIVA FRAY MARCELINO DE SAN VICENTE,196,1,3,158,146,155,0,0,0,0,9,158
EDO. YARACUY,MP. NIRGUA,PQ. SALOM,ESCUELA INTEGRAL BOLIVARIANA LOS POTREROS,475,1,16,382,300,366,0,1,0,1,64,382
EDO. YARACUY,MP. NIRGUA,PQ. SALOM,ESCUELA RURAL QUIRIQUIRE,309,1,3,237,200,234,0,2,0,0,32,237
EDO. YARACUY,MP. NIRGUA,PQ. SALOM,ESCUELA RURAL SAN RAFAEL,175,1,1,124,58,123,0,0,0,0,65,124
EDO. YARACUY,MP. NIRGUA,PQ. SALOM,ESCUELA RURAL LAS PARCHAS,285,1,9,225,152,216,0,1,0,0,63,225
EDO. YARACUY,MP. NIRGUA,PQ. SALOM,ESCUELA INTEGRAL BOLIVARIANA LA TRINIDAD
EDO. YARACUY,MP. NIRGUA,PQ. TEMERLA,ESCUELA CONCENTRADA LAS VEGAS,185,1,3,120,93,117,0,1,0,0,23,120
EDO. YARACUY,MP. NIRGUA,PQ. TEMERLA,ESCUELA INTEGRAL BOLIVARIANA RAFAEL RANGEL,1083,2,20,838,624,818,0,3,0,1,190,838
EDO. YARACUY,MP. NIRGUA,PQ. TEMERLA,ESCUELA RURAL ESCONDIDO,174,1,6,143,94,137,0,0,0,0,43,143
EDO. YARACUY,MP. NIRGUA,PQ. TEMERLA,ESCUELA BASICA RIO GRANDE NER 300,79,1,0,70,67,70,0,0,0,0,3,70
EDO. YARACUY,MP. NIRGUA,PQ. TEMERLA,ESCUELA INTEGRAL BOLIVARIANA VALLECITO,141,1,2,125,113,123,0,0,0,0,10,125
EDO. YARACUY,MP. NIRGUA,PQ. TEMERLA,ESCUELA PRIMARIA  RURAL SANTA ROSA,259,1,4,224,181,220,0,2,0,0,37,224
EDO. YARACUY,MP. NIRGUA,PQ. TEMERLA,ESCUELA UNITARIA EL CAMBUR,50,1,1,40,28,39,0,1,0,0,10,40
EDO. YARACUY,MP. NIRGUA,PQ. TEMERLA,ESCUELA UNITARIA COCOTE,77,1,3,54,40,51,0,0,0,0,11,54
EDO. YARACUY,MP. LA TRINIDAD,CM. BORAURE,ESCUELA INTEGRAL BOLIVARIANA  DURUTE NER 177,143,1,1,129,82,128,0,0,0,0,46,129
EDO. YARACUY,MP. LA TRINIDAD,CM. BORAURE,ESCUELA INTEGRAL BOLIVARIANA GUARATIBANA,483,1,8,380,276,372,0,3,1,0,92,380
EDO. YARACUY,MP. LA TRINIDAD,CM. BORAURE,ESCUELA INTEGRAL BOLIVARIANA OBONTE,476,1,10,410,277,400,0,1,0,0,122,410
EDO. YARACUY,MP. LA TRINIDAD,CM. BORAURE,ESCUELA BASICA BUENA VISTA,1846,4,55,1569,851,1514,0,8,0,1,654,1569
EDO. YARACUY,MP. LA TRINIDAD,CM. BORAURE,CENTRO DE RECUPERACION NUTRICIONAL MELITON CAMBERO.,932,2,11,856,568,845,0,8,1,0,268,856
EDO. YARACUY,MP. LA TRINIDAD,CM. BORAURE,ESCUELA BASICA JOSE ANTONIO PAEZ,2181,4,41,1728,832,1687,0,5,1,2,847,1728
EDO. YARACUY,MP. LA TRINIDAD,CM. BORAURE,CENTRO DE EDUCACION INICIAL BOLIVARIANO SIMON RODRIGUEZ,363,1,12,339,214,327,0,2,0,0,111,339
EDO. YARACUY,MP. LA TRINIDAD,CM. BORAURE,ESCUELA INTEGRAL LA PAULA,63,1,2,56,52,54,0,0,0,0,2,56
EDO. YARACUY,MP. LA TRINIDAD,CM. BORAURE,ESCUELA INTEGRAL BOLIVARIANA OBONTICO,286,1,10,261,158,251,0,1,0,0,92,261
EDO. YARACUY,MP. LA TRINIDAD,CM. BORAURE,UNIDAD EDUCATIVA DOCTOR JOSE MARIA VARGAS,862,2,21,780,456,759,0,5,0,0,298,780
EDO. YARACUY,MP. LA TRINIDAD,CM. BORAURE,ESCUELA BASICA ELBA ROSA SANTANA,937,2,12,806,405,794,0,2,0,0,387,806
EDO. YARACUY,MP. LA TRINIDAD,CM. BORAURE,ESCUELA INTEGRAL BOLIVARIANA JOSE ANTONIO SOSA GUILLEN,2181,4,63,1814,911,1751,2,10,0,0,828,1814
EDO. YARACUY,MP. LA TRINIDAD,CM. BORAURE,CENTRO DE EDUCACION INICIAL BORAURE,365,1,7,304,171,297,0,1,0,0,125,304
EDO. YARACUY,MP. VEROES,CM. FARRIAR,ESCUELA INTEGRAL BOLIVARIANA LA HOYA,542,1,2,432,311,430,0,0,1,0,118,432
EDO. YARACUY,MP. VEROES,CM. FARRIAR,ESCUELA  INTEGRAL BOLIVARIANA  MERCEDES MORO DE FUENTES,738,2,16,598,447,582,1,3,0,0,131,598
EDO. YARACUY,MP. VEROES,CM. FARRIAR,ESCUELA INTEGRAL BOLIVARIANA JOSE JOAQUIN VEROES,418,1,6,368,310,362,0,1,0,0,51,368
EDO. YARACUY,MP. VEROES,CM. FARRIAR,UNIDAD EDUCATIVA  ABIGAIL LOZANO,1823,4,33,1386,1054,1353,0,6,0,0,293,1386
EDO. YARACUY,MP. VEROES,CM. FARRIAR,ESCUELA INTEGRAL BOLIVARIANA LOS CAÑIZOS,924,2,14,794,736,780,0,0,1,0,43,794
EDO. YARACUY,MP. VEROES,CM. FARRIAR,ESCUELA  INTEGRAL BOLIVARIANA LA PICA,662,2,29,557,463,528,0,2,1,0,62,557
EDO. YARACUY,MP. VEROES,CM. FARRIAR,ESCUELA BASICA VISTA ALEGRE,203,1,2,177,133,175,0,0,0,0,42,177
EDO. YARACUY,MP. VEROES,CM. FARRIAR,ESCUELA INTEGRAL BOLIVARIANA CARBONERO,646,2,9,491,395,482,0,2,0,1,84,491
EDO. YARACUY,MP. VEROES,CM. FARRIAR,ESCUELA INTEGRAL BOLIVARIANA GRAN MARISCAL DE AYACUCHO,1031,2,26,848,692,822,0,1,0,0,129,848
EDO. YARACUY,MP. VEROES,CM. FARRIAR,ESCUELA INTEGRAL BOLIVARIANA PALO QUEMAO,414,1,8,343,212,335,0,1,0,0,122,343
EDO. YARACUY,MP. VEROES,CM. FARRIAR,CENTRO DE EDUCACION INICIAL BOLIVARIANO ABIGAIL LOZANO,455,1,13,409,350,396,0,2,0,0,44,409
EDO. YARACUY,MP. VEROES,CM. FARRIAR,ESCUELA BOLIVARIANA KILOMETRO 26,111,1,1,88,79,87,0,0,0,0,8,88
EDO. YARACUY,MP. VEROES,CM. FARRIAR,ESCUELA INTEGRAL BOLIVARIANA PALMAREJO,842,2,25,688,595,663,0,9,0,0,59,688
EDO. YARACUY,MP. VEROES,PQ. EL GUAYABO,CENTROS DE EDUCACION INICIAL BOLIVARIANO EL GUAYABO,213,1,5,193,178,188,0,0,0,0,10,193
EDO. YARACUY,MP. VEROES,PQ. EL GUAYABO,ESCUELA   MIXTA GUABINITA,54,1,0,38,20,38,0,0,0,0,18,38
EDO. YARACUY,MP. VEROES,PQ. EL GUAYABO,ESCUELA  BASICA  GABRIEL MARIA  REYES ZUMETA.,1249,3,29,975,741,946,0,7,2,0,196,975
EDO. YARACUY,MP. VEROES,PQ. EL GUAYABO,ESCUELA INTEGRAL BOLIVARIANA EL TORITO,221,1,1,192,153,191,0,0,0,0,38,192
EDO. YARACUY,MP. VEROES,PQ. EL GUAYABO,ESCUELA CONCENTRADA PEÑAS DE TARIA,432,1,1,327,203,326,0,0,1,0,122,327
EDO. YARACUY,MP. VEROES,PQ. EL GUAYABO,ESCUELA BASICA  PEÑAS DE CABRIAS NER 036,92,1,5,77,66,72,0,0,0,0,6,77
EDO. YARACUY,MP. VEROES,PQ. EL GUAYABO,ESCUELA BASICA GENERAL CRUZ CARRILLO,794,2,22,658,509,636,0,6,0,0,121,658
EDO. YARACUY,MP. VEROES,PQ. EL GUAYABO,ESCUELA BASICA  RIO CHIQUITO NER 036
EDO. YARACUY,MP. VEROES,PQ. EL GUAYABO,CENTRO DE EDUCACION INICIAL   LA GRUTA NER 036,150,1,1,136,103,135,0,2,0,0,30,136
EDO. YARACUY,MP. VEROES,PQ. EL GUAYABO,ESCUELA INTEGRAL BOLIVARIANA ANTONIO JOSE DE SUCRE,471,1,6,375,258,369,0,2,0,0,109,375
EDO. YARACUY,MP. VEROES,PQ. EL GUAYABO,JARDIN DE INFANCIA BOLIVARIANO MORITA CARRILLO 2,252,1,3,229,187,226,0,3,0,0,36,229
EDO. YARACUY,MP. VEROES,PQ. EL GUAYABO,ESCUELA  INTEGRAL BOLIVARIANA LA LLANADA,211,1,1,173,147,172,0,0,0,0,25,173
EDO. YARACUY,MP. VEROES,PQ. EL GUAYABO,ESCUELA INTEGRAL BOLIVARIANA TULIPAN,205,1,5,184,158,179,0,0,0,0,21,184
EDO. YARACUY,MP. VEROES,PQ. EL GUAYABO,LICEO BOLIVARIANO FRANCISCO HERRERA VEGA,1764,3,54,1457,1112,1403,2,3,2,0,284,1457
EDO. YARACUY,MP. VEROES,PQ. EL GUAYABO,ESCUELA INTEGRAL BOLIVARIANA LA RAYA,738,2,14,613,442,599,0,1,0,0,156,613
EDO. YARACUY,MP. VEROES,PQ. EL GUAYABO,ESCUELA INTEGRAL BOLIVARIANA ANTONIO FIGUEROA,673,2,13,556,390,543,0,1,0,1,151,556
EDO. YARACUY,MP. VEROES,PQ. EL GUAYABO,ESCUELA INTEGRAL BOLIVARIANA BELLA VISTA,731,2,32,533,290,501,0,2,0,0,209,533
EDO. YARACUY,MP. VEROES,PQ. EL GUAYABO,ESCUELA INTEGRAL BOLIVARIANA MAPORITA,409,1,6,350,311,344,0,0,0,0,33,350
EDO. YARACUY,MP. VEROES,PQ. EL GUAYABO,ESUELA INTEGRAL BOLIVARIANA PEDRO JOSE PADILLA,450,1,7,338,223,331,0,0,0,1,107,338
EDO. YARACUY,MP. ARISTIDES BASTID,CM. SAN PABLO,ESCUELA BASICA CARRIZALITO,594,1,9,508,380,499,0,3,0,0,116,508
EDO. YARACUY,MP. ARISTIDES BASTID,CM. SAN PABLO,ESCUELA INTEGRAL BOLIVARIANA RAFAEL ANTONIO MUJICA,1234,3,31,1003,681,972,1,7,3,0,280,1003
EDO. YARACUY,MP. ARISTIDES BASTID,CM. SAN PABLO,CENTRO DE EDUCACION INICIAL BOLIVARIANO CARRIZALES,326,1,9,294,225,285,0,2,0,0,58,294
EDO. YARACUY,MP. ARISTIDES BASTID,CM. SAN PABLO,ESCUELA NACIONAL LA MATA,194,1,3,148,104,145,0,0,0,0,41,148
EDO. YARACUY,MP. ARISTIDES BASTID,CM. SAN PABLO,ESCUELA BASICA RURAL SABANA LARGA,540,1,7,420,310,413,0,1,1,0,101,420
EDO. YARACUY,MP. ARISTIDES BASTID,CM. SAN PABLO,CENTRO DE EDUCACION INICIAL ESTADAL SAN PABLO,278,1,4,258,177,254,0,2,0,0,75,258
EDO. YARACUY,MP. ARISTIDES BASTID,CM. SAN PABLO,LICEO BOLIVARIANO CREACION SAN PABLO,1708,3,28,1347,806,1319,1,9,0,0,503,1347
EDO. YARACUY,MP. ARISTIDES BASTID,CM. SAN PABLO,CENTRO DE EDUCACION INICIAL BOLIVARIANO LUISA DE MORALES,164,1,4,159,106,155,0,1,0,0,48,159
EDO. YARACUY,MP. ARISTIDES BASTID,CM. SAN PABLO,ESCUELA INTEGRAL BOLIVARIANA LA CUMBRE,56,1,1,47,45,46,0,0,0,0,1,47
EDO. YARACUY,MP. ARISTIDES BASTID,CM. SAN PABLO,ESCUELA INTEGRAL BOLIVARIANA CAMINO ATRAVESADO,269,1,4,245,165,241,0,2,0,0,74,245
EDO. YARACUY,MP. ARISTIDES BASTID,CM. SAN PABLO,GUARDERIA INFANTIL MARIA ANGELICA LUSINCHI,1065,2,21,878,520,857,0,3,1,0,333,878
EDO. YARACUY,MP. ARISTIDES BASTID,CM. SAN PABLO,ESCUELA INTEGRAL BOLIVARIANA EL DIVIDIVE,497,1,13,414,264,401,0,2,0,0,135,414
EDO. YARACUY,MP. ARISTIDES BASTID,CM. SAN PABLO,ESCUELA CONCENTRADA TARTAGAL,660,2,11,565,409,554,0,5,0,0,140,565
EDO. YARACUY,MP. ARISTIDES BASTID,CM. SAN PABLO,ESCUELA INTEGRAL BOLIVARIANA CAMUNARE,711,2,4,600,426,596,1,5,1,0,163,600
EDO. YARACUY,MP. ARISTIDES BASTID,CM. SAN PABLO,ESCUELA BASICA SAN PABLO,950,2,19,760,417,741,0,7,0,0,317,760
EDO. YARACUY,MP. ARISTIDES BASTID,CM. SAN PABLO,ESCUELA CONCENTRADA LA PICA,675,2,12,579,425,567,0,1,0,0,141,579
EDO. YARACUY,MP. ARISTIDES BASTID,CM. SAN PABLO,ESCUELA BASICA VICENTE EMILIO SOJO,751,2,22,621,443,599,0,3,0,0,153,621
EDO. YARACUY,MP. ARISTIDES BASTID,CM. SAN PABLO,ESCUELA BASICA LA CARRETERA,224,1,3,186,127,183,0,0,0,0,56,186
EDO. YARACUY,MP. ARISTIDES BASTID,CM. SAN PABLO,ESCUELA ESTADAL CONCENTRADA  LA GOTERA,934,2,22,756,454,734,0,6,0,0,274,756
EDO. YARACUY,MP. ARISTIDES BASTID,CM. SAN PABLO,ESCUELA BASICA LUISA DE MORALES,1911,4,44,1447,829,1403,1,7,0,2,564,1447
EDO. YARACUY,MP. ARISTIDES BASTID,CM. SAN PABLO,ESCUELA  BASICA  HIGUERON,87,1,2,78,73,76,0,0,0,0,3,78
EDO. YARACUY,MP. PE#A,PQ. SAN ANDRES,CENTRO DE EDUCACION INICIAL BOLIVARIANO REINALDO REYES,1234,3,26,994,545,968,1,7,0,0,415,994
EDO. YARACUY,MP. PE#A,PQ. SAN ANDRES,ESCUELA INTEGRAL BOLIVARIANA TACARIGUITA,138,1,2,129,96,127,0,1,0,0,30,129
EDO. YARACUY,MP. PE#A,PQ. SAN ANDRES,ESCUELA BASICA  LA ENSENADA,885,2,11,699,422,688,0,2,0,2,262,699
EDO. YARACUY,MP. PE#A,PQ. SAN ANDRES,ESCUELA BASICA  SABANA DE TIQUIRE NER 231,78,1,1,70,39,69,0,2,1,0,27,70
EDO. YARACUY,MP. PE#A,PQ. SAN ANDRES,ESCUELA BASICA  EL CARDON,463,1,21,365,298,344,0,0,1,0,45,365
EDO. YARACUY,MP. PE#A,PQ. SAN ANDRES,ESCUELA INTEGRAL  BOLIVARIANA REINALDO REYES,1762,3,28,1375,744,1347,0,18,4,1,580,1375
EDO. YARACUY,MP. PE#A,PQ. SAN ANDRES,ESCUELA BOLIVARIANA JORNADA COMPLETA TACARIGUA.,100,1,2,92,72,90,0,2,0,0,16,92
EDO. YARACUY,MP. PE#A,PQ. SAN ANDRES,ESCUELA INTEGRAL BOLIVARIANA CUJIZAL,597,1,10,459,330,449,0,1,0,0,118,459
EDO. YARACUY,MP. PE#A,PQ. SAN ANDRES,ESCUELA BASICA CONCENTRADA MIXTA LA MAPORITA. NER 231,369,1,8,309,213,301,0,1,0,0,87,309
EDO. YARACUY,MP. PE#A,CM. YARITAGUA,ESCUELA INTEGRAL  BOLIVARIANA  AGUA VIVA,353,1,4,242,190,238,1,3,2,0,42,242
EDO. YARACUY,MP. PE#A,CM. YARITAGUA,ESCUELA TECNICA ROBINSONIANA CARLOS JOSE MUJICA,2703,5,44,2210,1401,2166,2,11,4,0,748,2210
EDO. YARACUY,MP. PE#A,CM. YARITAGUA,CENTRO DE EDUCACION INICIAL BOLIVARIANO MARIA LUISA DE GARRIDO,157,1,2,149,127,147,0,0,0,0,20,149
EDO. YARACUY,MP. PE#A,CM. YARITAGUA,ESCUELA BASICA JUAN MIGUEL ROO,2372,5,33,1899,1242,1866,1,5,0,0,618,1899
EDO. YARACUY,MP. PE#A,CM. YARITAGUA,ESCUELA BASICA CARMEN FERNANDEZ DE LEONI,2759,5,67,2211,1516,2144,1,20,4,2,601,2211
EDO. YARACUY,MP. PE#A,CM. YARITAGUA,UNIDAD EDUCATIVA LAUREANO VILLANUEVA,2618,5,41,2142,1170,2101,0,14,3,1,913,2142
EDO. YARACUY,MP. PE#A,CM. YARITAGUA,ESCUELA NACIONAL ARENALES,265,1,8,240,216,232,0,3,0,0,13,240
EDO. YARACUY,MP. PE#A,CM. YARITAGUA,CENTRO DE EDUCACION INICIAL BOLIVARIANA JUAN MIGUEL ROO,333,1,5,308,222,303,0,2,0,0,79,308
EDO. YARACUY,MP. PE#A,CM. YARITAGUA,CENTRO DE DIOS AMOR DE CRISTO,126,1,5,113,72,108,0,0,0,0,36,113
EDO. YARACUY,MP. PE#A,CM. YARITAGUA,ESCUELA BASICA JESUS MILLAN,2402,5,58,1960,1042,1902,1,11,1,0,847,1960
EDO. YARACUY,MP. PE#A,CM. YARITAGUA,ESCUELA BASICA MATILDE LUCIA GONZALEZ,1572,3,25,1301,875,1276,0,10,1,0,390,1301
EDO. YARACUY,MP. PE#A,CM. YARITAGUA,UNIDAD EDUCATIVA NIRGUA,2078,4,41,1673,1058,1632,2,6,2,0,564,1673
EDO. YARACUY,MP. PE#A,CM. YARITAGUA,ESCUELA INTEGRAL BOLIVARIANA  ARENALES,455,1,7,410,351,403,1,2,0,0,49,410
EDO. YARACUY,MP. PE#A,CM. YARITAGUA,ESCUELA INTEGRAL BOLIVARIANA LAS ANIMAS NER 231,96,1,2,83,71,81,0,1,0,1,8,83
EDO. YARACUY,MP. PE#A,CM. YARITAGUA,CENTRO DE EDUCATION INICIAL BOLIVARIANO SIMONCITO MATILDE LUCIA GONZALEZ,204,1,1,191,140,190,0,1,0,0,49,191
EDO. YARACUY,MP. PE#A,CM. YARITAGUA,ESCUELA BASICA MARIA TERESA SANZ,1538,3,40,1304,769,1264,0,14,0,0,481,1304
EDO. YARACUY,MP. PE#A,CM. YARITAGUA,ESCUELA BASICA CONSUELO DE RODRIGUEZ,2534,5,41,2093,1021,2052,0,4,1,0,1026,2093
EDO. YARACUY,MP. PE#A,CM. YARITAGUA,CENTRO DE EDUCACION INICIAL BOLIVARIANO SABANITA,1386,3,49,1160,794,1111,0,12,1,0,304,1160
EDO. YARACUY,MP. PE#A,CM. YARITAGUA,CENTRO DE EDUCACION INICIAL  BOLIVARIANO MANUEL CEDEÑO.,1131,2,24,936,328,912,0,3,0,0,581,936
EDO. YARACUY,MP. PE#A,CM. YARITAGUA,ESCUELA INTEGRAL  BOLIVARIANA EL SALTO,475,1,7,371,254,364,0,1,0,2,107,371
EDO. YARACUY,MP. PE#A,CM. YARITAGUA,ESCUELA BASICA ROSARIO MONTERO DE MORON,1565,3,34,1285,885,1251,0,8,1,0,357,1285
EDO. YARACUY,MP. PE#A,CM. YARITAGUA,ESCUELA INTEGRAL BOLIVARIANA  YUMARITO,187,1,3,173,149,170,0,1,0,0,20,173
EDO. YARACUY,MP. PE#A,CM. YARITAGUA,ESCUELA BASICA ANTONIO PINTO SALINAS,791,2,17,585,418,568,0,6,2,0,142,585
EDO. YARACUY,MP. PE#A,CM. YARITAGUA,ESCUELA ESTATAL UNITARIA URIBEQUE,51,1,3,42,37,39,0,0,0,0,2,42
EDO. YARACUY,MP. PE#A,CM. YARITAGUA,ESCUELA BASICA JOSE ATANACIO GONZALEZ,1831,4,22,1458,1107,1436,0,7,1,1,320,1458
EDO. YARACUY,MP. PE#A,CM. YARITAGUA,ESCUELA BASICA  CAMBURITO. NER 231,87,1,0,79,74,79,0,2,0,0,3,79
EDO. YARACUY,MP. PE#A,CM. YARITAGUA,ESCUELA BASICA MANUEL CEDEÑO,2708,5,33,2226,849,2193,0,10,5,2,1327,2226
EDO. YARACUY,MP. PE#A,CM. YARITAGUA,CENTRO DE EDUCACION INICIAL BOLIVARIANO MARIA DOLORES MOSQUERA,723,2,24,626,508,602,0,1,0,0,93,626
EDO. YARACUY,MP. PE#A,CM. YARITAGUA,CENTRO DE EDUCACION INICIAL LOS ROSALES,1469,3,26,1277,914,1251,0,7,1,0,329,1277
EDO. YARACUY,MP. PE#A,CM. YARITAGUA,LICEO COCOROTE,2831,5,52,2242,1140,2190,1,11,2,1,1035,2242
EDO. YARACUY,MP. PE#A,CM. YARITAGUA,JARDIN DE INFANCIA YARITAGUA,942,2,10,765,428,755,0,2,0,0,325,765
EDO. YARACUY,MP. PE#A,CM. YARITAGUA,CENTRO DE ALIMENTACION EZEQUIEL ZAMORA,56,1,1,52,48,51,0,0,1,0,2,52
EDO. YARACUY,MP. PE#A,CM. YARITAGUA,ESCUELA CONCENTRADA LOS TUBOS,123,1,1,102,79,101,0,0,0,0,22,102
EDO. YARACUY,MP. PE#A,CM. YARITAGUA,ESCUELA INTEGRAL BOLIVARIANA PUEBLO NUEVO,323,1,4,294,234,290,0,0,0,1,55,294
EDO. YARACUY,MP. PE#A,CM. YARITAGUA,ESCUELA INTEGRAL BOLIVARIANA  BARRIO NUEVO,435,1,7,400,376,393,0,1,0,0,16,400
EDO. YARACUY,MP. PE#A,CM. YARITAGUA,ESCUELA BASICA TOTUMILLO HERMINIA FARIAS,2239,4,44,1797,1320,1753,0,10,1,0,422,1797
EDO. YARACUY,MP. PE#A,CM. YARITAGUA,ESCUELA BASICA YOCASTA DE CALISTRI,1047,2,15,932,517,917,0,3,0,0,397,932
EDO. YARACUY,MP. PE#A,CM. YARITAGUA,ESCUELA INTEGRAL  BOLIVARIANA GUAREMAL,419,1,5,330,289,325,0,2,0,1,33,330
EDO. YARACUY,MP. PE#A,CM. YARITAGUA,ESCUELA INTEGRAL BOLIVARIANA  EL POZON,341,1,4,294,222,290,0,4,1,1,62,294
EDO. YARACUY,MP. PE#A,CM. YARITAGUA,CENTRO DE EDUCACION INICIAL BOLIVARIANO JESUS MILLAN NUCLEO EL PEGON,422,1,5,351,318,346,0,0,0,0,28,351
EDO. YARACUY,MP. PE#A,CM. YARITAGUA,CENTRO DE EDUCACION INICIAL BOLIVARIANO JESUS MILLAN,1463,3,27,1209,705,1182,0,6,1,0,470,1209
EDO. YARACUY,MP. PE#A,CM. YARITAGUA,ESCUELA BASICA MARIA CLEMENTINA DE BONILLA,1132,2,33,862,671,829,0,3,0,0,155,862
EDO. YARACUY,MP. PE#A,CM. YARITAGUA,ESCUELA INTEGRAL BOLIVARIANA CAÑAVERAL,727,2,9,598,438,589,0,2,0,0,149,598
EDO. YARACUY,MP. PE#A,CM. YARITAGUA,JARDIN DE INFANCIA BOLIVARIANO LAUREANO VILLANUEVA,880,2,14,723,390,709,1,6,0,0,312,723
EDO. YARACUY,MP. PE#A,CM. YARITAGUA,ESCUELA BASICA AMERICA YUDITH IBARRA,2938,5,95,2397,1619,2302,0,10,0,2,671,2397
EDO. YARACUY,MP. PE#A,CM. YARITAGUA,COLEGIO SANTA LUCIA,2984,6,34,2568,880,2534,0,8,0,2,1644,2568
EDO. YARACUY,MP. PE#A,CM. YARITAGUA,CENTRO  INICIAL  BOLIVARIANO CAMINO NUEVO,807,2,17,721,487,704,1,3,0,0,213,721
EDO. YARACUY,MP. PE#A,CM. YARITAGUA,ESCUELA BASICA CORONEL JOSE VICENTE PEÑA,1341,3,19,1121,827,1102,2,9,2,0,262,1121
EDO. YARACUY,MP. PE#A,CM. YARITAGUA,ESCUELA INTEGRAL  BOLIVARIANA AGUA NEGRA,1411,3,18,1147,889,1129,0,5,1,0,234,1147
EDO. YARACUY,MP. SUCRE,CM. GUAMA,JARDIN DE INFANCIA JOSE TOMAS GONZALEZ,315,1,7,290,129,283,0,3,0,0,151,290
EDO. YARACUY,MP. SUCRE,CM. GUAMA,ESCUELA INTEGRAL BOLIVARIANA ANTONIO JOSE DE SUCRE,521,1,3,458,254,455,0,1,0,0,200,458
EDO. YARACUY,MP. SUCRE,CM. GUAMA,ESCUELA PRIMARIA CALLEJON DE QUIGUA,223,1,2,208,192,206,0,1,0,0,13,208
EDO. YARACUY,MP. SUCRE,CM. GUAMA,ESCUELA BASICA NICANORA TRAVIEZO,1604,3,43,1357,882,1314,0,5,1,1,425,1357
EDO. YARACUY,MP. SUCRE,CM. GUAMA,CENTRO DE EDUCACION INICIAL CONVENCIONAL DOCTOR PEDRO CORDIDO WONHSIDLER,997,2,32,811,294,779,0,10,1,1,473,811
EDO. YARACUY,MP. SUCRE,CM. GUAMA,ESCUELA BASICA DOCTOR PEDRO SATURNO CANELON,448,1,8,406,245,398,0,3,0,0,150,406
EDO. YARACUY,MP. SUCRE,CM. GUAMA,ESCUELA BASICA BOLIVARIANA JOSE TOMAS GONZALEZ,1702,3,32,1389,498,1357,1,10,0,0,848,1389
EDO. YARACUY,MP. SUCRE,CM. GUAMA,ESCUELA INTEGRAL BOLIVARIANA CONCEPCION DE CARVAJAL,1143,2,19,943,546,924,1,6,0,0,371,943
EDO. YARACUY,MP. SUCRE,CM. GUAMA,ESCUELA INTEGRAL BOLIVARIANA FRANCISCO CAMACHO,975,2,18,803,523,785,0,6,1,0,255,803
EDO. YARACUY,MP. SUCRE,CM. GUAMA,ESCUELA BASICA RURAL ISAIAS ANTONIO BLASCO,695,2,9,559,339,550,0,1,0,0,210,559
EDO. YARACUY,MP. SUCRE,CM. GUAMA,MINISTERIO DE AGRICULTURA Y TIERRAS. AREA SUCRE,712,2,10,673,425,663,2,2,1,0,233,673
EDO. YARACUY,MP. SUCRE,CM. GUAMA,ESCUELA PRIMARIA BOLIVARIANA  EL CEMENTERIO,713,2,13,646,376,633,0,6,0,1,250,646
EDO. YARACUY,MP. SUCRE,CM. GUAMA,ESCUELA CONCENTRADA MIXTA ESTATAL FALTRIQUERA,307,1,5,286,225,281,0,1,0,0,55,286
EDO. YARACUY,MP. SUCRE,CM. GUAMA,LICEO BOLIVARIANO CARMELO FERNANDEZ,1419,3,32,1228,606,1196,0,4,0,0,586,1228
EDO. YARACUY,MP. SUCRE,CM. GUAMA,ESCUELA CONCENTRADA MIXTA ESTADAL CAICARA,460,1,5,392,315,387,0,1,0,0,71,392
EDO. YARACUY,MP. SUCRE,CM. GUAMA,ESCUELA BASICA ALIDA CASULLO DE ZERPA,1377,3,35,1211,575,1176,0,7,0,0,594,1211
EDO. YARACUY,MP. SUCRE,CM. GUAMA,LICEO BOLIVARIANO MERCEDEZ CORDIDO,219,1,5,194,129,189,0,0,0,0,60,194
EDO. YARACUY,MP. SUCRE,CM. GUAMA,HOGAIN COMUNITARIO SONRRIENDO DE NUEVO,348,1,9,309,193,300,0,1,0,0,106,309
EDO. YARACUY,MP. URACHICHE,CM. URACHICHE,ESCUELA BASICA JACINTO GUTIERREZ COLL,1634,3,36,1318,708,1282,0,12,1,0,561,1318
EDO. YARACUY,MP. URACHICHE,CM. URACHICHE,CENTRO DE EDUCACION INICIAL BOLIVARIANO CURAZAO I,1217,3,24,969,764,945,0,6,0,1,174,969
EDO. YARACUY,MP. URACHICHE,CM. URACHICHE,ESCUELA BASICA NICOLASA GARCIA,1680,3,31,1391,1201,1360,0,7,1,1,150,1391
EDO. YARACUY,MP. URACHICHE,CM. URACHICHE,ESCUELA INTEGRAL BOLIVARIANA RIO ARRIBA,287,1,3,206,143,203,0,2,0,0,58,206
EDO. YARACUY,MP. URACHICHE,CM. URACHICHE,ESCUELA BASICA OMAR GARCIA,1032,2,26,852,531,826,0,4,0,0,291,852
EDO. YARACUY,MP. URACHICHE,CM. URACHICHE,ESCUELA INTEGRAL BOLIVARIANA AGUARUCA,526,1,10,428,293,418,1,2,0,0,122,428
EDO. YARACUY,MP. URACHICHE,CM. URACHICHE,ESCUELA INTEGRAL BOLIVARIANA EL COPEY,342,1,2,258,228,256,1,0,0,0,27,258
EDO. YARACUY,MP. URACHICHE,CM. URACHICHE,UNIDAD EDUCATIVA FEDERICO QUIROZ,737,2,31,631,412,600,0,1,0,0,187,631
EDO. YARACUY,MP. URACHICHE,CM. URACHICHE,GIMNACIO CUBIERTO URACHICHE,1057,2,13,884,517,871,0,4,0,0,350,884
EDO. YARACUY,MP. URACHICHE,CM. URACHICHE,JARDIN DE INFANCIA LAS PAVAS,98,1,1,87,78,86,0,1,0,0,7,87
EDO. YARACUY,MP. URACHICHE,CM. URACHICHE,ESCUELA BASICA  LAS VEGAS NER 134,161,1,4,157,151,153,0,0,0,0,2,157
EDO. YARACUY,MP. URACHICHE,CM. URACHICHE,CENTRO DE EDUCACION INCIAL URACHICHE,779,2,20,625,349,605,1,4,0,0,251,625
EDO. YARACUY,MP. URACHICHE,CM. URACHICHE,ESCUELA INTEGRAL BOLIVARIANA EL PICURE,331,1,19,298,192,279,0,0,0,0,87,298
EDO. YARACUY,MP. URACHICHE,CM. URACHICHE,ESCUELA BASICA ELBA SALESSI,1173,2,22,942,608,920,0,6,1,0,305,942
EDO. YARACUY,MP. URACHICHE,CM. URACHICHE,CENTRO DE EDUCACION INICIAL BOLIVARIANO SIMON BOLIVAR,1530,3,44,1211,721,1167,0,6,1,0,439,1211
EDO. YARACUY,MP. URACHICHE,CM. URACHICHE,CASA DE LOS NIÑOS LOS MANGUITOS,358,1,4,312,247,308,0,1,0,0,60,312
EDO. YARACUY,MP. URACHICHE,CM. URACHICHE,ESCUELA INTEGRAL BOLIVARIANA MANUELITA SAENZ,512,1,11,440,347,429,0,3,0,0,79,440
EDO. YARACUY,MP. URACHICHE,CM. URACHICHE,ESCUELA NACIONAL UNITARIA BUCARITO,103,1,1,93,89,92,0,0,0,0,3,93
EDO. YARACUY,MP. URACHICHE,CM. URACHICHE,ESCUELA INTEGRAL BOLIVARIANA BUENOS AIRES,347,1,3,267,251,264,1,0,0,0,12,267
EDO. YARACUY,MP. URACHICHE,CM. URACHICHE,ESCUELA PRIMARIA  EL JUNCO,148,1,4,127,113,123,0,0,1,0,9,127
EDO. YARACUY,MP. URACHICHE,CM. URACHICHE,ESCUELA BASICA LA VICTORIA,352,1,9,323,277,314,2,2,0,0,33,323
EDO. YARACUY,MP. BOLIVAR,CM. AROA,ESCUELA BASICA CHIVACURE,428,1,8,363,310,355,0,1,1,0,43,363
EDO. YARACUY,MP. BOLIVAR,CM. AROA,ESCUELA BASICA GUARATARO,126,1,1,105,95,104,0,0,0,0,9,105
EDO. YARACUY,MP. BOLIVAR,CM. AROA,ESCUELA INTEGRAL BOLIVARIANA QUEBRADA SECA,659,2,17,532,399,515,0,5,0,0,111,532
EDO. YARACUY,MP. BOLIVAR,CM. AROA,MULTIHOGAR ELOISA MASTRANGELO,470,1,7,396,224,389,0,2,0,0,163,396
EDO. YARACUY,MP. BOLIVAR,CM. AROA,ESCUELA BASICA EL ABRIGO,210,1,1,186,175,185,0,2,0,0,8,186
EDO. YARACUY,MP. BOLIVAR,CM. AROA,ESCUELA INTEGRAL BOLIVARIANA  CARARAPA
EDO. YARACUY,MP. BOLIVAR,CM. AROA,ESCUELA BASICA ESTATAL DIAMANTE II,164,1,5,134,120,129,0,0,0,0,9,134
EDO. YARACUY,MP. BOLIVAR,CM. AROA,CENTRO DE EDUCACION INICIAL BOLIVARIANO NATIVIDAD DE CORSO,1539,3,45,1323,835,1278,0,2,0,0,441,1323
EDO. YARACUY,MP. BOLIVAR,CM. AROA,ESCUELA BASICA JOSE MANUEL SISO MARTINEZ,1750,3,21,1466,795,1445,0,13,1,0,636,1466
EDO. YARACUY,MP. BOLIVAR,CM. AROA,ESCUELA CONCENTRADA EL REFUGIO,596,1,7,483,367,476,0,6,0,1,102,483
EDO. YARACUY,MP. BOLIVAR,CM. AROA,ESCUELA INTEGRAL BOLIVARIANA SAN JOSE,492,1,6,336,239,330,0,0,0,0,91,336
EDO. YARACUY,MP. BOLIVAR,CM. AROA,ESCUELA PRIMARIA  ATASCADERO,366,1,3,278,213,275,0,1,1,0,60,278
EDO. YARACUY,MP. BOLIVAR,CM. AROA,ESCUELA INTEGRAL BOLIVARIANA LOS ROSALES,435,1,2,361,218,359,0,1,0,0,140,361
EDO. YARACUY,MP. BOLIVAR,CM. AROA,ESCUELA INTEGRAL BOLIVARIANA LOS UREROS,497,1,3,438,243,435,0,0,0,0,192,438
EDO. YARACUY,MP. BOLIVAR,CM. AROA,CENTRO DE EDUCACION INICIAL AROA,1013,2,24,850,503,826,0,0,0,1,322,850
EDO. YARACUY,MP. BOLIVAR,CM. AROA,LICEO BOLIVARIANO SIMON BOLIVAR,889,2,21,753,417,732,0,3,0,0,312,753
EDO. YARACUY,MP. BOLIVAR,CM. AROA,ESCUELA BASICA NACIONAL GUAYABONAL,185,1,3,166,152,163,0,1,0,0,10,166
EDO. YARACUY,MP. BOLIVAR,CM. AROA,ESCUELA BASICA CONCENTRADA CAYURE,118,1,4,104,64,100,0,2,0,0,34,104
EDO. YARACUY,MP. BOLIVAR,CM. AROA,ESCUELA PRIMARIA  AGUA FRIA,324,1,3,214,114,211,0,1,0,0,96,214
EDO. YARACUY,MP. BOLIVAR,CM. AROA,ESCUELA BASICA UNITARIA LAGUNITA,162,1,3,144,123,141,0,1,0,0,17,144
EDO. YARACUY,MP. BOLIVAR,CM. AROA,ESCUELA UNITARIA PARDILLAL DE CUPA.,104,1,2,85,83,83,0,0,0,0,0,85
EDO. YARACUY,MP. BOLIVAR,CM. AROA,ESCUELA BASICA LOS VACOS,219,1,5,182,166,177,0,0,0,0,11,182
EDO. YARACUY,MP. BOLIVAR,CM. AROA,ESCUELA INTEGRAL BOLIVARIANA TIERRA FRIA,535,1,1,404,225,403,0,3,0,0,175,404
EDO. YARACUY,MP. BOLIVAR,CM. AROA,ESCUELA INTEGRAL BOLIVARIANA EL HACHA,478,1,3,381,280,378,0,1,0,1,96,381
EDO. YARACUY,MP. BOLIVAR,CM. AROA,CENTRO DE EDUCACION INICIAL LA MORA,492,1,16,449,271,433,0,2,0,0,160,449
EDO. YARACUY,MP. BOLIVAR,CM. AROA,ESCUELA BARLOVENTO,192,1,2,182,139,180,0,0,0,0,41,182
EDO. YARACUY,MP. BOLIVAR,CM. AROA,ESCUELA .BASICA JOSE JOAQUIN VEROES,1353,3,26,1088,641,1062,2,2,0,0,417,1088
EDO. YARACUY,MP. BOLIVAR,CM. AROA,ESCUELA BASICA ROSARIO DE MERCADEZ,816,2,16,660,558,644,2,2,0,0,82,660
EDO. YARACUY,MP. BOLIVAR,CM. AROA,ESCUELA PRIMARIA BOLIVARIANA EL CUPIDO,117,1,0,112,101,112,0,0,0,0,11,112
EDO. YARACUY,MP. BOLIVAR,CM. AROA,ESCUELA INTEGRAL BOLIVARIANA SANTA ANA,366,1,3,288,228,285,0,3,0,0,54,288
EDO. YARACUY,MP. BOLIVAR,CM. AROA,ESCUELA BASICA CARMELO FERNANDEZ,2172,4,50,1685,863,1635,1,11,2,0,758,1685
EDO. YARACUY,MP. BOLIVAR,CM. AROA,ESCUELA NACIONAL LOS CANELITOS,258,1,3,211,194,208,0,2,0,0,12,211
EDO. YARACUY,MP. BOLIVAR,CM. AROA,ESCUELA INTEGRAL BOLIVARIANA LA LUZ,629,2,17,481,306,464,0,4,0,0,154,481
EDO. YARACUY,MP. BOLIVAR,CM. AROA,ESCUELA INTEGRAL BOLIVARIANA KILOMETRO 58,410,1,9,333,192,324,1,0,1,0,130,333
EDO. YARACUY,MP. BOLIVAR,CM. AROA,ESCUELA  BASICA CUPA,91,1,2,81,66,79,0,1,0,0,12,81
EDO. YARACUY,MP. BOLIVAR,CM. AROA,ESCUELA INTEGRAL BOLIVARIANA LAS PLANETAS,126,1,0,110,103,110,0,0,0,0,7,110
EDO. YARACUY,MP. BOLIVAR,CM. AROA,ESCUELA TECNICA AGROPECUARIA MINAS DE AROA,1275,3,36,1029,524,993,1,4,0,0,464,1029
EDO. YARACUY,MP. BOLIVAR,CM. AROA,ESCUELA PRIMARIA GUSANILLAL.,312,1,6,250,177,244,0,1,0,0,66,250
EDO. YARACUY,MP. BOLIVAR,CM. AROA,ESCUELA BASICA CERRO NEGRO,376,1,7,289,175,282,0,1,0,0,106,289
EDO. YARACUY,MP. BRUZUAL,PQ. CAMPO ELIAS,ESCUELA INTEGRAL BOLIVARIANA COCUAIMA,386,1,6,314,231,308,0,0,0,0,77,314
EDO. YARACUY,MP. BRUZUAL,PQ. CAMPO ELIAS,ESCUELA BASICA JUAN VICENTE GONZALEZ,1328,3,27,1011,721,984,1,1,1,0,260,1011
EDO. YARACUY,MP. BRUZUAL,PQ. CAMPO ELIAS,ESCUELA BASICA RURAL SANTA ELENA NER 205,86,1,2,83,76,81,0,0,0,0,5,83
EDO. YARACUY,MP. BRUZUAL,PQ. CAMPO ELIAS,ESCUELA CONCENTRADA SAN RAMON,1197,2,29,927,579,898,0,4,0,0,315,927
EDO. YARACUY,MP. BRUZUAL,PQ. CAMPO ELIAS,ESCUELA INTEGRAL BOLIVARIANA POA POA,551,1,4,445,348,441,1,2,0,0,90,445
EDO. YARACUY,MP. BRUZUAL,PQ. CAMPO ELIAS,ESCUELA INTEGRAL BOLIVARIANA EL COPEY,224,1,1,205,192,204,1,2,0,0,9,205
EDO. YARACUY,MP. BRUZUAL,PQ. CAMPO ELIAS,ESCUELA INTEGRAL BOLIVARIANA ALTO DEL RIO,551,1,16,424,290,408,0,4,0,0,114,424
EDO. YARACUY,MP. BRUZUAL,PQ. CAMPO ELIAS,ESCUELA INTEGRAL BOLIVARIANA  LA LAGUNA,350,1,9,288,199,279,0,1,1,0,78,288
EDO. YARACUY,MP. BRUZUAL,PQ. CAMPO ELIAS,ESCUELA INTEGRAL BOLIVARIANA TETEIBA,391,1,6,332,209,326,1,2,1,2,111,332
EDO. YARACUY,MP. BRUZUAL,PQ. CAMPO ELIAS,ESCUELA INTEGRAL BOLIVARIANA PALO GRANDE,615,2,11,519,412,508,0,3,2,0,91,519
EDO. YARACUY,MP. BRUZUAL,PQ. CAMPO ELIAS,ESCUELA INTEGRAL BOLIVARIANA LA VIRGEN,996,2,14,833,662,819,0,2,1,0,154,833
EDO. YARACUY,MP. BRUZUAL,PQ. CAMPO ELIAS,CENTRO DE EDUCACION INICIAL JUAN VICENTE GONZALEZ,391,1,8,340,267,332,0,3,0,0,62,340
EDO. YARACUY,MP. BRUZUAL,PQ. CAMPO ELIAS,UNIDAD EDUCATIVA  CAMPO ELIAS,814,2,13,647,432,634,1,2,0,0,199,647
EDO. YARACUY,MP. BRUZUAL,PQ. CAMPO ELIAS,ESCUELA BASCA MARIO BRICEÑO IRAGORRI,907,2,15,750,643,735,0,3,0,0,89,750
EDO. YARACUY,MP. BRUZUAL,CM. CHIVACOA,JARDIN DE INFANCIA ESCALONA Y CALATAYUD,998,2,8,749,307,741,2,5,0,0,427,749
EDO. YARACUY,MP. BRUZUAL,CM. CHIVACOA,ESCUELA BASICA EL CALICHE,627,2,18,525,320,507,1,1,2,0,183,525
EDO. YARACUY,MP. BRUZUAL,CM. CHIVACOA,ESCUELA NUDE SANTA LUCIA,126,1,2,123,120,121,0,0,0,0,1,123
EDO. YARACUY,MP. BRUZUAL,CM. CHIVACOA,CENTRO DE EDUCACION INICIAL BOLIVARIANO EL ESTADIUM,1029,2,19,880,617,861,0,4,0,2,238,880
EDO. YARACUY,MP. BRUZUAL,CM. CHIVACOA,ESCUELA INTEGRAL BOLIVARIANA LAS MULITAS,224,1,4,158,101,154,0,2,1,0,50,158
EDO. YARACUY,MP. BRUZUAL,CM. CHIVACOA,ESCUELA BASICA RURAL GREGORIA DIAZ,1687,3,45,1380,989,1335,1,9,0,0,336,1380
EDO. YARACUY,MP. BRUZUAL,CM. CHIVACOA,UNIDAD EDUCATIVA COLEGIO SANTA MARIA,2393,4,26,2066,719,2040,1,13,1,2,1304,2066
EDO. YARACUY,MP. BRUZUAL,CM. CHIVACOA,CENTRO DE EDUCACION INICIAL INTEGRAL SIMONCITO CARLOS JOSE MUJICA,915,2,20,755,457,735,1,2,0,1,274,755
EDO. YARACUY,MP. BRUZUAL,CM. CHIVACOA,CENTRO DE EDUCACION INICIAL  BOLIVARIANO LA PEÑITA,1691,3,30,1392,914,1362,0,5,0,0,443,1392
EDO. YARACUY,MP. BRUZUAL,CM. CHIVACOA,ESCUELA BASICA LAS DELICIAS,104,1,1,88,75,87,0,2,0,0,10,88
EDO. YARACUY,MP. BRUZUAL,CM. CHIVACOA,ALDEA UNIVERSITARIA BOLIVARIANA MISION SUCRE,610,2,10,550,361,540,0,4,0,0,175,550
EDO. YARACUY,MP. BRUZUAL,CM. CHIVACOA,ESCUELA INTEGRAL BOLIVARIANA LA BARTOLA,815,2,12,686,527,674,0,2,0,0,145,686
EDO. YARACUY,MP. BRUZUAL,CM. CHIVACOA,ESCUELA INTEGRAL BOLIVARIANA CECILIA BAZAN DE  SEGURA,2370,4,51,1886,1225,1835,2,10,2,2,594,1886
EDO. YARACUY,MP. BRUZUAL,CM. CHIVACOA,ESCUELA CONCENTRADA LA CAÑERIA,1060,2,26,814,567,788,0,7,2,0,212,814
EDO. YARACUY,MP. BRUZUAL,CM. CHIVACOA,ESCUELA INTEGRAL BOLIVARIANA CUMARIPA,846,2,12,687,438,675,1,8,0,0,228,687
EDO. YARACUY,MP. BRUZUAL,CM. CHIVACOA,ESCUELA BASICA  MARIA LEONOR DE SALAS,1219,3,20,1041,770,1021,0,4,0,0,247,1041
EDO. YARACUY,MP. BRUZUAL,CM. CHIVACOA,ESCUELA INTEGRAL BOLIVARIANA LA LIBERTAD,1457,3,24,1237,906,1213,0,7,1,0,299,1237
EDO. YARACUY,MP. BRUZUAL,CM. CHIVACOA,ESCUELA INTEGRAL BOLIVARIANA LOS HORCONES,261,1,2,227,175,225,0,2,0,1,47,227
EDO. YARACUY,MP. BRUZUAL,CM. CHIVACOA,CENTRO DE EDUCACION INICIAL CECILIA BAZAN DE SEGURA,812,2,7,627,421,620,0,4,0,0,195,627
EDO. YARACUY,MP. BRUZUAL,CM. CHIVACOA,ESCUELA INTEGRAL BOLIVARIANA CATALINA DE BOLIVAR,2931,5,50,2363,1470,2313,1,15,3,2,822,2363
EDO. YARACUY,MP. BRUZUAL,CM. CHIVACOA,CENTRO DE EDUCACION INICIAL BOLIVARIANO PEGUAIMA,1144,2,36,937,677,901,0,3,1,0,220,937
EDO. YARACUY,MP. BRUZUAL,CM. CHIVACOA,UNIDAD EDUCATIVA CARLOS JOSE MUJICA,2828,5,43,2319,1413,2276,0,12,2,0,849,2319
EDO. YARACUY,MP. BRUZUAL,CM. CHIVACOA,ESCUELA BASICA TRIBU JIRAHARA,538,1,10,486,255,476,0,2,0,2,217,486
EDO. YARACUY,MP. BRUZUAL,CM. CHIVACOA,INSTITUTO DE EDUCACION ESPECIAL BOLIVARIANO CHIVACOA,625,2,17,571,375,554,3,2,0,1,173,571
EDO. YARACUY,MP. BRUZUAL,CM. CHIVACOA,LICEO BOLIVARIANO PADRE VICENTE,805,2,17,718,433,701,0,1,0,3,264,718
EDO. YARACUY,MP. BRUZUAL,CM. CHIVACOA,CASA DE LOS NINOS EL ARAGUANEY,192,1,3,181,144,178,0,2,0,0,32,181
EDO. YARACUY,MP. BRUZUAL,CM. CHIVACOA,ESCUELA INTEGRAL BOLIVARIANA ESCALONA Y CALATAYUD,2548,5,36,2092,900,2056,1,7,2,0,1146,2092
EDO. YARACUY,MP. BRUZUAL,CM. CHIVACOA,UNIDAD EDUCATIVA DOCTOR RAUL RAMOS GIMENEZ,1698,3,27,1361,896,1334,0,4,2,0,432,1361
EDO. YARACUY,MP. BRUZUAL,CM. CHIVACOA,CENTRO DE EDUCACION INICIAL FRANCOISE LABECA,1934,4,24,1647,756,1623,1,13,2,0,851,1647
EDO. YARACUY,MP. BRUZUAL,CM. CHIVACOA,ESCUELA BASICA SILA MOTA DE ROJAS,2131,4,43,1626,1098,1583,1,8,2,1,473,1626
EDO. YARACUY,CE. SAN FELIPE,CM. SAN FELIPE,ESCUELA BASICA CECILIO ACOSTA,2382,4,51,1862,752,1811,1,3,0,2,1053,1862
EDO. YARACUY,CE. SAN FELIPE,CM. SAN FELIPE,CENTRO DE EDUCACION INICIAL REPUBLICA DE NICARAGUA,1111,2,17,883,292,866,0,4,0,1,569,883
EDO. YARACUY,CE. SAN FELIPE,CM. SAN FELIPE,JARDIN DE INFANCIA JUAN JOSE DE MAYA,934,2,6,818,219,812,0,2,0,0,591,818
EDO. YARACUY,CE. SAN FELIPE,CM. SAN FELIPE,CENTRO DE EDUCACION INICIAL HIGUERON.,554,1,11,457,246,446,0,4,0,0,196,457
EDO. YARACUY,CE. SAN FELIPE,CM. SAN FELIPE,ESCUELA BASICA CECILIA MUJICA,1328,3,22,1114,293,1092,0,5,0,3,791,1114
EDO. YARACUY,CE. SAN FELIPE,CM. SAN FELIPE,ESCUELA INTEGRAL BOLIVARIANA LA MARROQUINA,611,2,11,485,310,474,1,2,1,0,160,485
EDO. YARACUY,CE. SAN FELIPE,CM. SAN FELIPE,ESCUELA BASICA SIMON TORRES,1254,3,39,1026,681,987,0,6,1,0,299,1026
EDO. YARACUY,CE. SAN FELIPE,CM. SAN FELIPE,CENTRO DE EDUCACION INICIAL BOLIVARIANO LAS TAPIAS II,1639,3,15,1400,1042,1385,1,12,2,0,328,1400
EDO. YARACUY,CE. SAN FELIPE,CM. SAN FELIPE,ESCUELA INTEGRAL BOLIVARIANA  EL COROZO,443,1,10,372,209,362,1,0,1,0,151,372
EDO. YARACUY,CE. SAN FELIPE,CM. SAN FELIPE,LICEO BOLIVARIANO JUAN JOSE DE MAYA,2501,5,31,2190,549,2159,0,7,1,1,1601,2190
EDO. YARACUY,CE. SAN FELIPE,CM. SAN FELIPE,CASA HOGAR  DOCTOR LUIS LIZARRAGA,523,1,8,416,181,408,0,1,0,1,225,416
EDO. YARACUY,CE. SAN FELIPE,CM. SAN FELIPE,UNIDAD EDUCATIVA TRINIDAD FIGUEIRA,878,2,26,761,268,735,0,6,0,0,461,761
EDO. YARACUY,CE. SAN FELIPE,CM. SAN FELIPE,ESCUELA CONCENTRADA YARACUY,991,2,33,828,531,795,0,10,2,0,252,828
EDO. YARACUY,CE. SAN FELIPE,CM. SAN FELIPE,ESCUELA BASICA CARMEN DE RAMIREZ,3214,6,83,2657,1542,2574,1,14,2,0,1015,2657
EDO. YARACUY,CE. SAN FELIPE,CM. SAN FELIPE,ESCUELA INTEGRAL BOLIVARIANA   ALBERTO RAVELL,2930,6,38,2425,782,2387,0,3,1,1,1600,2425
EDO. YARACUY,CE. SAN FELIPE,CM. SAN FELIPE,LICEO BOLIVARIANO ROMULO BETANCOURT,1497,3,14,1355,415,1341,0,2,2,1,921,1355
EDO. YARACUY,CE. SAN FELIPE,CM. SAN FELIPE,INSTITUTO NACIONAL DE TIERRAS,1986,4,45,1701,823,1656,0,11,1,0,821,1701
EDO. YARACUY,CE. SAN FELIPE,CM. SAN FELIPE,ESCUELA BASICA REPUBLICA DE NICARAGUA,2197,4,36,1766,537,1730,0,11,2,1,1179,1766
EDO. YARACUY,CE. SAN FELIPE,CM. SAN FELIPE,COMISIONADURIA GENERAL DE SALUD,1550,3,25,1299,401,1274,0,4,1,2,866,1299
EDO. YARACUY,CE. SAN FELIPE,CM. SAN FELIPE,LICEO BOLIVARIANO ARISTIDES ROJAS,498,1,6,441,161,435,0,3,1,0,270,441
EDO. YARACUY,CE. SAN FELIPE,CM. SAN FELIPE,JARDIN DE INFANCIA BOLIVARIANO HIGUERON II,916,2,13,784,430,771,0,8,0,0,333,784
EDO. YARACUY,CE. SAN FELIPE,CM. SAN FELIPE,CENTRO DE EDUCACION INICIAL BOLIVARIANO LAS TAPIAS I,790,2,16,667,485,651,0,1,0,1,164,667
EDO. YARACUY,CE. SAN FELIPE,CM. SAN FELIPE,CENTRO DE FORMACION SOCIAL  PABLO VI,1852,4,34,1498,515,1464,0,4,5,0,940,1498
EDO. YARACUY,CE. SAN FELIPE,CM. SAN FELIPE,ESCUELA TECNICA  ROBINSONIANA ROMULO GALLEGOS,2522,5,49,2150,587,2101,0,11,0,0,1503,2150
EDO. YARACUY,CE. SAN FELIPE,CM. SAN FELIPE,UNIDAD EDUCATIVA COLEGIO FRAY LUIS AMIGO,2492,5,17,2196,280,2179,0,7,0,2,1890,2196
EDO. YARACUY,CE. SAN FELIPE,CM. SAN FELIPE,INSTITUTO DE PREVICION Y ASISTENCIA SOCIAL DEL MINISTERIO DE EDUCACION IPASME,59,1,1,58,20,57,0,0,0,0,37,58
EDO. YARACUY,CE. SAN FELIPE,CM. SAN FELIPE,ESCUELA BASICA LA MOSCA,537,1,17,456,216,439,0,1,0,0,222,456
EDO. YARACUY,CE. SAN FELIPE,CM. SAN FELIPE,UNIDAD EDUCATIVA  PADRE DELGADO,1982,4,19,1630,622,1611,1,9,0,0,979,1630
EDO. YARACUY,CE. SAN FELIPE,CM. SAN FELIPE,CENTRO DE EDUCACION INICIAL BOLIVARIANO STTE CARLOS A. COLMENAREZ YANEZ,673,2,13,589,415,576,0,4,0,0,157,589
EDO. YARACUY,CE. SAN FELIPE,PQ. SAN JAVIER,JARDIN DE INFANCIA BOLIVARIANO TIUNA,1865,4,39,1506,995,1467,0,2,0,0,470,1506
EDO. YARACUY,CE. SAN FELIPE,PQ. SAN JAVIER,CENTRO DE EDUCACION INICIAL BOLIVARIANO RURAL ANDRES ELOY BLANCO,129,1,2,119,88,117,0,1,0,0,28,119
EDO. YARACUY,CE. SAN FELIPE,PQ. SAN JAVIER,ESCUELA BASICA GRACIELA DE GAMARRA,1172,2,23,898,583,875,0,9,1,1,281,898
EDO. YARACUY,CE. SAN FELIPE,PQ. SAN JAVIER,CENTRO DE EDUCACION INICIAL BOLIVARIANO RURAL ORASIL HERNANDEZ,32,1,1,27,17,26,0,1,0,0,8,27
EDO. YARACUY,CE. SAN FELIPE,PQ. SAN JAVIER,ESCUELA CONCENTRADA EL GUARATARO,669,2,19,528,343,509,1,4,0,0,161,528
EDO. YARACUY,CE. SAN FELIPE,PQ. SAN JAVIER,ESCUELA INTEGRAL BOLIVARIANA EL PEÑON,557,1,10,433,277,423,1,2,0,0,143,433
EDO. YARACUY,CE. SAN FELIPE,PQ. SAN JAVIER,CENTRO DE EDUCACION INICIAL BOLIVARIANO SIMONCITO EL PAUJI,1026,2,18,898,512,880,0,4,1,0,363,898
EDO. YARACUY,CE. SAN FELIPE,PQ. SAN JAVIER,ESCUELA BASICA ANDRES ELOY BLANCO,1139,2,12,920,614,908,1,5,1,0,287,920
EDO. YARACUY,CE. SAN FELIPE,PQ. SAN JAVIER,ESCUELA INTEGRAL BOLIVARIANA MARIN,1152,2,28,967,662,939,0,2,0,0,275,967
EDO. YARACUY,CE. SAN FELIPE,PQ. SAN JAVIER,ESCUELA BASICA HORASIL HERNANDEZ,1325,3,27,1118,683,1091,0,14,1,1,392,1118
EDO. YARACUY,CE. SAN FELIPE,PQ. SAN JAVIER,ESCUELA BASICA LINARES,74,1,0,60,49,60,0,0,0,0,11,60
EDO. YARACUY,CE. SAN FELIPE,PQ. ALBARICO,ESCUELA BASICA TEOTISTE DE GALLEGOS,1324,3,22,1079,776,1057,1,8,0,4,268,1079
EDO. YARACUY,CE. SAN FELIPE,PQ. ALBARICO,ESCUELA BASICA PABLO MENDOZA REYES,1600,3,23,1266,614,1243,0,8,0,2,619,1266
EDO. YARACUY,CE. SAN FELIPE,PQ. ALBARICO,UNIDAD EDUCATIVA TIUNA,1555,3,31,1004,549,973,3,11,0,0,410,1004
EDO. YARACUY,CE. SAN FELIPE,PQ. ALBARICO,CENTRO DE EDUCACION INICIAL BOLIVARIANO SAN GERONIMO,438,1,10,376,243,366,0,2,1,0,120,376
EDO. YARACUY,CE. SAN FELIPE,PQ. ALBARICO,LICEO BOLIVARIANO JOSE RAFAEL VILLAREAL,673,2,12,497,294,485,0,2,0,0,189,497
EDO. YARACUY,CE. SAN FELIPE,PQ. ALBARICO,ESCUELA BASICA EL CUBE,213,1,3,136,99,133,0,1,0,0,33,136
EDO. YARACUY,CE. SAN FELIPE,PQ. ALBARICO,CENTRO DE EDUCACION INICIAL BOLIVARIANO LA SEMBRADORA,572,1,14,507,317,493,0,8,0,0,168,507
EDO. YARACUY,CE. SAN FELIPE,PQ. ALBARICO,CENTRO DE EDUCACION INICIAL  MONTES DE ORO,1065,2,18,863,614,845,0,10,0,1,220,863
EDO. YARACUY,CE. SAN FELIPE,PQ. ALBARICO,ESCUELA BASICA APOLONIA PALAVICINI,1625,3,33,1305,733,1272,0,8,1,0,530,1305
EDO. YARACUY,CE. SAN FELIPE,PQ. ALBARICO,ESCUELA ESTADAL CONCENTRADA  NUMERO 167,392,1,7,332,210,325,0,2,0,0,113,332
EDO. YARACUY,CE. SAN FELIPE,PQ. ALBARICO,ESCUELA INTEGRAL BOLIVARIANA SAMUEL ROBINSON,748,2,24,609,449,585,0,1,2,0,133,609
EDO. YARACUY,CE. SAN FELIPE,PQ. ALBARICO,JARDIN DE INFANCIA JOSE GRAGORIO HERNANDEZ,346,1,6,311,210,305,0,1,0,1,93,311
EDO. YARACUY,CE. SAN FELIPE,PQ. ALBARICO,CENTRO DE EDUCACION INICIAL BOLIVARIANO YARACUY,1132,2,20,892,494,872,1,3,1,0,373,892
EDO. YARACUY,CE. SAN FELIPE,PQ. ALBARICO,ESCUELA BASICA.FERMIN ABDON RAMIREZ,682,2,15,539,347,524,0,1,1,0,175,539
EDO. YARACUY,CE. SAN FELIPE,PQ. ALBARICO,UNIDAD EDUCATIVA  YARACUY,2383,4,51,1871,1032,1820,0,9,0,0,779,1871
EDO. YARACUY,CE. SAN FELIPE,PQ. ALBARICO,CENTRO DE EDUCACION INICIAL BOLIVARIANO GENERAL ROGELIO FREYTEZ (MARINCITO),45,1,1,45,34,44,0,0,0,0,10,45
EDO. YARACUY,CE. SAN FELIPE,PQ. ALBARICO,ESCUELA BASICA RAMON GUILLERMO ORELLANA,1368,3,21,1162,743,1141,0,9,0,1,388,1162
EDO. YARACUY,CE. SAN FELIPE,PQ. ALBARICO,ESCUELA BASICA KILOMETRO 21,143,1,3,131,110,128,0,1,0,0,17,131
EDO. YARACUY,CE. SAN FELIPE,PQ. ALBARICO,ESCUELA  INTEGRAL TESORERO,419,1,9,350,233,341,0,0,0,0,108,350
EDO. YARACUY,CE. SAN FELIPE,PQ. ALBARICO,CENTRO DE EDUCACION INICIAL BOLIVARIANO JUANA MARTI FUENTES,215,1,4,196,147,192,0,0,0,0,45,196
EDO. YARACUY,CE. SAN FELIPE,PQ. ALBARICO,ESCUELA BASICA ALICIA PIETRI DE CALDERA,1836,4,46,1442,1050,1396,0,14,3,0,329,1442
EDO. YARACUY,MP. MANUEL MONGE,CM. YUMARE,ESCUELA INTEGRAL BOLIVARIANA MANUELITO,577,1,3,469,375,466,0,1,0,0,90,469
EDO. YARACUY,MP. MANUEL MONGE,CM. YUMARE,ESCUELA BASICA ELIO FRANCISCO TOVAR PRADO,481,1,2,385,250,383,0,2,0,0,131,385
EDO. YARACUY,MP. MANUEL MONGE,CM. YUMARE,ESCUELA INTEGRAL BOLIVARIANA CARRETERA 18,205,1,2,177,163,175,0,0,1,0,11,177
EDO. YARACUY,MP. MANUEL MONGE,CM. YUMARE,ESCUELA INTEGRAL BOLIVARIANA CARRETERA LA 22,548,1,7,422,315,415,0,3,0,0,97,422
EDO. YARACUY,MP. MANUEL MONGE,CM. YUMARE,ESCUELA INTEGRAL BOLIVARIANA AROA,576,1,15,450,358,435,1,1,0,0,75,450
EDO. YARACUY,MP. MANUEL MONGE,CM. YUMARE,ESCUELA INTEGRAL BOLIVARIANA YUMARITO,498,1,7,402,348,395,0,1,0,0,46,402
EDO. YARACUY,MP. MANUEL MONGE,CM. YUMARE,CENTRO DE EDUCACION INICIAL SAN AMAYA NER 112,137,1,7,127,74,120,0,1,0,0,45,127
EDO. YARACUY,MP. MANUEL MONGE,CM. YUMARE,ESCUELA INTEGRAL BOLIVARIANA CARRETERA LA 8,924,2,21,782,594,761,0,6,0,0,161,782
EDO. YARACUY,MP. MANUEL MONGE,CM. YUMARE,ESCUELA BASICA MONSEÑOR BALDOMERO CILLERO,757,2,24,611,333,587,1,1,0,0,252,611
EDO. YARACUY,MP. MANUEL MONGE,CM. YUMARE,ESCUELA BASICA LOS LIRIOS,150,1,2,140,130,138,0,0,0,0,8,140
EDO. YARACUY,MP. MANUEL MONGE,CM. YUMARE,ESCUELA INTEGRAL BOLIVARIANA CARRETERA LA 38,414,1,0,325,274,325,0,1,0,0,50,325
EDO. YARACUY,MP. MANUEL MONGE,CM. YUMARE,ESCUELA INTEGRAL BOLIVARIANA CARRETERA 14,506,1,7,416,235,409,0,1,0,0,173,416
EDO. YARACUY,MP. MANUEL MONGE,CM. YUMARE,ESCUELA INTEGRAL BOLIVARIANA CARRTERA LA 32,290,1,7,217,168,210,0,0,1,0,41,217
EDO. YARACUY,MP. MANUEL MONGE,CM. YUMARE,ESCUELA INTEGRAL BOLIVARIANA PLACA DE CEDRO,119,1,3,91,82,88,0,0,1,0,5,91
EDO. YARACUY,MP. MANUEL MONGE,CM. YUMARE,ESCUELA INTEGRAL BOLIVARIANA KILOMETRO 39,600,1,6,489,367,483,0,0,0,1,115,489
EDO. YARACUY,MP. MANUEL MONGE,CM. YUMARE,ESCUELA INTEGRAL BOLIVARIANA KILOMETRO 63,141,1,1,120,107,119,0,0,0,0,12,120
EDO. YARACUY,MP. MANUEL MONGE,CM. YUMARE,ESCUELA BASICA TOMAS GIMENEZ.,2848,5,63,2315,1517,2252,3,10,1,2,719,2315
EDO. YARACUY,MP. MANUEL MONGE,CM. YUMARE,ESCUELA INTEGRAL BOLIVARIANA SIMON BOLIVAR,1259,3,29,1054,732,1025,2,4,0,0,287,1054
EDO. YARACUY,MP. MANUEL MONGE,CM. YUMARE,ESCUELA INTEGRAL BOLIVARIANA CARRETERA LA 13,463,1,6,403,286,397,0,1,1,0,109,403
EDO. YARACUY,MP. COCOROTE,CM. COCOROTE,ESCUELA INTEGRAL BOLIVARIANA LAS FLORES,874,2,10,630,314,620,0,1,0,0,305,630
EDO. YARACUY,MP. COCOROTE,CM. COCOROTE,ESCUELA INTEGRAL BOLIVARIANA LA HERMITA,500,1,9,411,197,402,0,3,0,1,201,411
EDO. YARACUY,MP. COCOROTE,CM. COCOROTE,ESCUELA BASICA BOLIVARIANA SAN GERONIMO,2132,4,64,1809,910,1745,1,9,0,1,824,1809
EDO. YARACUY,MP. COCOROTE,CM. COCOROTE,COMPLEJO DEPORTIVO PABLO EMILIO FERNANDEZ,509,1,11,402,208,391,0,3,1,0,179,402
EDO. YARACUY,MP. COCOROTE,CM. COCOROTE,LICEO BOLIVARIANO  JOSE GABRIEL ALVAREZ DE LUGO,942,2,25,775,460,750,0,3,0,0,287,775
EDO. YARACUY,MP. COCOROTE,CM. COCOROTE,ESCUELA BASICA GUAYUREBO NUCLEO ESCOLAR RURAL,946,2,17,762,387,745,1,3,1,0,353,762
EDO. YARACUY,MP. COCOROTE,CM. COCOROTE,CASA COMUNAL BARRIO LA LIBERTAD,202,1,3,182,101,179,0,3,0,0,75,182
EDO. YARACUY,MP. COCOROTE,CM. COCOROTE,INSTITUTO NACIONAL DE ATENCION Y SERVICIO SOCIAL (INASS),473,1,13,408,255,395,1,2,0,0,137,408
EDO. YARACUY,MP. COCOROTE,CM. COCOROTE,CENTRO EDUCACION INICIAL BOLIVARIANO TOVAR Y TOVAR,1385,3,33,1113,421,1080,0,4,1,1,653,1113
EDO. YARACUY,MP. COCOROTE,CM. COCOROTE,LICEO BOLIVARIANO SANTA MARIA,1093,2,60,873,595,813,0,5,1,2,210,873
EDO. YARACUY,MP. COCOROTE,CM. COCOROTE,CENTRO DE EDUCACION INICIAL BOLIVARIANO  LA MORITA,641,2,8,523,314,515,1,5,1,0,194,523
EDO. YARACUY,MP. COCOROTE,CM. COCOROTE,CENTRO DE EDUCACION INICIAL BOLIVARIANO ELIGIO MARTINEZ,1132,2,29,973,417,944,0,2,0,0,525,973
EDO. YARACUY,MP. COCOROTE,CM. COCOROTE,CENTRO DE EDUCACION INICIAL BOLIVARIANO CARMEN EULALIA RIVERO DE VERASTEGUI,624,2,20,576,270,556,0,2,0,0,284,576
EDO. YARACUY,MP. COCOROTE,CM. COCOROTE,ESCUELA BASICA DOCTOR LEON TRUJILLO. III ETAPA,364,1,10,315,152,305,1,0,0,0,152,315
EDO. YARACUY,MP. COCOROTE,CM. COCOROTE,ESCUELA BASICA LEONOR BERNABO,2409,5,57,1992,915,1935,1,14,2,1,1002,1992
EDO. YARACUY,MP. COCOROTE,CM. COCOROTE,ESCUELA BASICA TOVAR Y TOVAR,2852,5,75,2270,824,2195,0,10,0,2,1359,2270
EDO. YARACUY,MP. COCOROTE,CM. COCOROTE,LICEO BOLIVARIANO DOCTOR RAFAEL CALDERA IZGUIRRE,2741,5,56,2215,1225,2159,1,10,1,1,921,2215
EDO. YARACUY,MP. COCOROTE,CM. COCOROTE,ESCUELA BASICA DOCTOR LEON TRUJILLO,3625,7,91,2980,1126,2889,0,16,2,3,1742,2980
EDO. YARACUY,MP. COCOROTE,CM. COCOROTE,ESCUELA BASICA PARQUE LEONOR BERNABO,1064,2,16,868,340,852,0,2,1,0,509,868
EDO. YARACUY,MP. COCOROTE,CM. COCOROTE,FUNDACION ESCUELA DANZAS COCOROTE,589,1,10,529,200,519,0,1,0,2,316,529
EDO. YARACUY,MP. COCOROTE,CM. COCOROTE,ESCUELA INTEGRAL BOLIVARIANA TACARTE,304,1,15,274,153,259,0,1,0,0,105,274
EDO. YARACUY,MP. COCOROTE,CM. COCOROTE,UNIDAD EDUCATIVA JAIME,471,1,14,403,248,389,0,1,0,0,140,403
EDO. YARACUY,MP. COCOROTE,CM. COCOROTE,ALDEA UNIVERSITARIA MISION SUCRE COCOROTE,1013,2,14,927,423,913,0,6,0,0,484,927
