Estado,Municipio,Parroquia,Centro,Número de Electores escrutados.,Número de Actas Procesadas.,Número total de Votos Nulos.,Número Total de Votantes que votaron realmente.,HUGO CHAVEZ,Número total de Votos Válidos.,ORLANDO CHIRINO,REINA SEQUERA,LUIS REYES,MARIA BOLIVAR,HENRIQUE CAPRILES RADONSKI,Número de Votos Escrutados.
EDO. ARAGUA,MP.OCUMARE D L COSTA,PQ. OCUMARE DE LA COSTA,CONCENTRACION ESCOLAR NUMERO 54,731,2,17,542,428,525,0,1,0,0,96,542
EDO. ARAGUA,MP.OCUMARE D L COSTA,PQ. OCUMARE DE LA COSTA,ESCUELA CUYAGUA,513,1,5,419,307,414,0,1,0,0,106,419
EDO. ARAGUA,MP.OCUMARE D L COSTA,PQ. OCUMARE DE LA COSTA,ESCUELA BASICA ESTADAL JESUS IGNACIO ITURZAETA,2233,4,36,1691,840,1655,0,7,0,1,807,1691
EDO. ARAGUA,MP.OCUMARE D L COSTA,PQ. OCUMARE DE LA COSTA,UNIDAD EDUCATIVA ESTADAL CONCENTRADA LAS MONJAS,215,1,2,184,132,182,0,1,0,0,49,184
EDO. ARAGUA,MP.OCUMARE D L COSTA,PQ. OCUMARE DE LA COSTA,UNIDAD EDUCATIVA NACIONAL BOLIVARIANA CATA,809,2,11,633,500,622,1,1,0,0,120,633
EDO. ARAGUA,MP.OCUMARE D L COSTA,PQ. OCUMARE DE LA COSTA,ESCUELA BASICA DELUYAR,2692,5,45,2053,1052,2008,0,10,2,1,943,2053
EDO. ARAGUA,MP.OCUMARE D L COSTA,PQ. OCUMARE DE LA COSTA,ESCUELA ESTADAL UNITARIA Nº 40,389,1,5,300,216,295,0,0,0,0,79,300
EDO. ARAGUA,MP.OCUMARE D L COSTA,PQ. OCUMARE DE LA COSTA,INCES OCUMARE DE LA COSTA DE ORO,1003,2,19,839,582,820,1,5,0,0,232,839
EDO. ARAGUA,MP. SANTOS MICHELENA,PQ. TIARA,ESCUELA BASICA ESTADAL TIARA,1330,3,28,1071,872,1043,0,5,0,0,166,1071
EDO. ARAGUA,MP. SANTOS MICHELENA,PQ. TIARA,UNIDAD EDUCATIVA ESTADAL RURAL CAGUA DE LAS MERCEDES,239,1,7,217,185,210,0,0,0,0,25,217
EDO. ARAGUA,MP. SANTOS MICHELENA,PQ. TIARA,UNIDAD EDUCATIVA ESTADAL CONCENTRADA LA ESPERANZA,1199,3,65,922,627,857,0,3,1,1,225,922
EDO. ARAGUA,MP. SANTOS MICHELENA,PQ. TIARA,UNIDAD EDUCATIVA ESTADAL CONCENTRADA LAS DOLORES DE ARAGUA,225,1,2,154,116,152,0,1,0,0,35,154
EDO. ARAGUA,MP. SANTOS MICHELENA,CM. LAS TEJERIAS,ESCUELA BASICA MADRE MARIA DE SAN JOSE,2870,5,55,2401,1922,2346,2,3,1,0,418,2401
EDO. ARAGUA,MP. SANTOS MICHELENA,CM. LAS TEJERIAS,ESCUELA BASICA ESTADAL TINAPUEY,1386,3,20,1219,1085,1199,0,4,1,0,109,1219
EDO. ARAGUA,MP. SANTOS MICHELENA,CM. LAS TEJERIAS,UNIDAD EDUCATIVA ESTADAL RAMON GARCIA DE SENA,2411,5,44,1893,1600,1849,1,4,0,0,244,1893
EDO. ARAGUA,MP. SANTOS MICHELENA,CM. LAS TEJERIAS,UNIDAD EDUCATIVA ESCOLAR CONCENTRADA EL JABILLAR NER 004 B,1945,4,55,1578,1210,1523,0,7,1,0,305,1578
EDO. ARAGUA,MP. SANTOS MICHELENA,CM. LAS TEJERIAS,ESCUELA GRADUADA JULIO PAEZ,2506,5,43,1982,1470,1939,3,6,3,0,457,1982
EDO. ARAGUA,MP. SANTOS MICHELENA,CM. LAS TEJERIAS,ESCUELA BASICA ENCARNACION DE NIEVES,2445,5,73,1899,1408,1826,0,5,2,0,411,1899
EDO. ARAGUA,MP. SANTOS MICHELENA,CM. LAS TEJERIAS,UNIDAD EDUCATIVA SERGIO MEDINA,2177,4,29,1714,1075,1685,1,4,0,3,602,1714
EDO. ARAGUA,MP. SANTOS MICHELENA,CM. LAS TEJERIAS,ESCUELA BASICA NACIONAL LEONARDO RUIZ PINEDA,434,1,7,413,348,406,0,1,0,0,57,413
EDO. ARAGUA,MP. SANTOS MICHELENA,CM. LAS TEJERIAS,ESCUELA BASICA JACOB PEREZ CARBALLO,3015,6,51,2422,1548,2371,0,13,0,1,809,2422
EDO. ARAGUA,MP. SANTOS MICHELENA,CM. LAS TEJERIAS,FUNDACION PARA EL DESARROLLO DE LAS ARTES Y LA CULTURA,947,2,23,847,624,824,0,2,1,0,197,847
EDO. ARAGUA,MP. SANTOS MICHELENA,CM. LAS TEJERIAS,UNIDAD EDUCATIVA CONCRENTRADA RURAL ARAIZA,204,1,3,173,153,170,1,0,0,0,16,173
EDO. ARAGUA,MP. SANTOS MICHELENA,CM. LAS TEJERIAS,UNIDAD EDUCATIVA ESTADAL NUESTRA SEÑORA DE BELEN,949,2,31,827,698,796,0,2,0,0,96,827
EDO. ARAGUA,MP. ZAMORA,PQ. VALLES DE TUCUTUNEMO,ESCUELA CONCENTRADA SIMONA ACACIO,3043,6,61,2418,2025,2357,4,16,3,0,309,2418
EDO. ARAGUA,MP. ZAMORA,PQ. VALLES DE TUCUTUNEMO,ESCUELA ESTADAL TEOTISTE DE GALLEGOS,2450,5,83,2002,1522,1919,1,15,3,3,375,2002
EDO. ARAGUA,MP. ZAMORA,PQ. VALLES DE TUCUTUNEMO,UNIDAD EDUCATIVA ESTADAL RURAL LOS CHORROS,498,1,12,464,408,452,0,1,0,0,43,464
EDO. ARAGUA,MP. ZAMORA,PQ. PQ AUGUSTO MIJARES,UNIDAD EDUCATIVA NACIONAL JOSE NUNEZ TENORIO,289,1,6,251,216,245,0,0,0,0,29,251
EDO. ARAGUA,MP. ZAMORA,PQ. PQ AUGUSTO MIJARES,PREESCOLAR NACIONAL CANDIDO ROSENDO PRADO,516,1,10,453,329,443,0,1,0,0,113,453
EDO. ARAGUA,MP. ZAMORA,PQ. PQ AUGUSTO MIJARES,ESCUELA BASICA JUAN BAUTISTA PLAZA,2770,5,65,2199,1575,2134,0,18,0,0,541,2199
EDO. ARAGUA,MP. ZAMORA,PQ. PQ AUGUSTO MIJARES,CARCEL PUBLICA TOCORON,436,1,7,227,168,220,0,3,1,1,47,227
EDO. ARAGUA,MP. ZAMORA,PQ. PQ AUGUSTO MIJARES,UNIDAD EDUCATIVA NACIONAL BOLIVARIANA MARIA LUISA PARISCA,682,2,25,588,509,563,0,0,0,0,54,588
EDO. ARAGUA,MP. ZAMORA,PQ. SAN FRANCISCO DE ASIS,UNIDAD EDUCATIVA NACIONAL VIRGEN DE FATIMA,327,1,5,290,250,285,0,2,0,0,33,290
EDO. ARAGUA,MP. ZAMORA,PQ. SAN FRANCISCO DE ASIS,UNIDAD EDUACATIVA NACIONAL BOLIVARIANA PEDRO RAFAEL COBOS,1339,3,35,1176,823,1141,1,7,1,0,309,1176
EDO. ARAGUA,MP. ZAMORA,PQ. SAN FRANCISCO DE ASIS,ESCUELA VICENTE VELASQUEZ,645,2,5,593,446,588,0,8,0,0,134,593
EDO. ARAGUA,MP. ZAMORA,PQ. SAN FRANCISCO DE ASIS,LICEO AIME BONPLAND,3249,6,64,2688,1622,2624,0,7,1,2,992,2688
EDO. ARAGUA,MP. ZAMORA,PQ. SAN FRANCISCO DE ASIS,UNIDAD EDUCATIVA NACIONAL TACASURUMA,3857,7,83,3099,1840,3016,2,18,2,2,1152,3099
EDO. ARAGUA,MP. ZAMORA,PQ. SAN FRANCISCO DE ASIS,UNIDAD EDUCATIVA MARIA TERESA GARCIA,3144,6,58,2555,1551,2497,0,12,1,2,931,2555
EDO. ARAGUA,MP. ZAMORA,PQ. SAN FRANCISCO DE ASIS,ESCUELA BASICA NACIONAL NUEVA VENEZUELA.,942,2,21,814,682,793,0,5,0,0,106,814
EDO. ARAGUA,MP. ZAMORA,PQ. SAN FRANCISCO DE ASIS,UNIDAD EDUCATIVA NACIONAL VIRGEN DEL VALLE,221,1,9,202,174,193,0,1,0,0,18,202
EDO. ARAGUA,MP. ZAMORA,PQ. MAGDALENO,UNIDAD EDUCATIVA PRIVADA FE Y ALEGRIA EUGENIO MENDOZA GOITICOA,2494,5,46,2009,1368,1963,0,8,1,1,585,2009
EDO. ARAGUA,MP. ZAMORA,PQ. MAGDALENO,ESCUELA BASICAMAGDALENO,1954,4,39,1534,1065,1495,0,11,1,0,418,1534
EDO. ARAGUA,MP. ZAMORA,PQ. MAGDALENO,CASA DE LOS NIÑOS JUAN DE DIOS AGRAZ,662,2,20,570,475,550,0,4,0,0,71,570
EDO. ARAGUA,MP. ZAMORA,PQ. MAGDALENO,ESCUELA BASICA NACIONAL PANAQUIRE,4150,8,90,3283,2251,3193,2,18,4,1,917,3283
EDO. ARAGUA,MP. ZAMORA,PQ. MAGDALENO,UNIDAD EDUCATIVA NACIONAL LA ESPERANZA(BIBLIOTECA VIRTUAL MAGDALENO),1112,2,31,927,722,896,0,2,0,0,172,927
EDO. ARAGUA,MP. ZAMORA,PQ. MAGDALENO,PREESCOLAR ESTADAL ZORAIDA JOSEFINA CAMPOS,672,2,14,603,488,589,0,2,1,0,98,603
EDO. ARAGUA,MP. ZAMORA,PQ. MAGDALENO,ESCUELA BASICA GUACAMAYA,1030,2,22,753,465,731,1,9,3,1,252,753
EDO. ARAGUA,MP. ZAMORA,PQ. MAGDALENO,CASA DE MISIONES (ANTIGUA SEDE DE U.E.N. LA ESPERANZA),783,2,32,627,446,595,0,5,0,0,144,627
EDO. ARAGUA,MP. ZAMORA,CM. VILLA DE CURA,UNIDAD EDUCATIVA ESTADAL  VINICIO ADAMES,732,2,14,655,439,641,0,1,0,1,200,655
EDO. ARAGUA,MP. ZAMORA,CM. VILLA DE CURA,UNIDAD EDUCATIVA ESTADAL PRISCO PEREZ MONASTERIOS,784,2,22,707,584,685,2,3,5,0,91,707
EDO. ARAGUA,MP. ZAMORA,CM. VILLA DE CURA,UNIDAD EDUCATIVA CARIDAD VILLASANA,3170,6,38,2565,1842,2527,0,17,4,1,663,2565
EDO. ARAGUA,MP. ZAMORA,CM. VILLA DE CURA,PREESCOLAR NACIONAL BOLIVARIANO TERESA CARREÑO.,575,1,20,486,328,466,0,3,0,1,134,486
EDO. ARAGUA,MP. ZAMORA,CM. VILLA DE CURA,CEICO MAESTRO SIMON RODRIGUEZ,159,1,5,135,111,130,0,0,0,0,19,135
EDO. ARAGUA,MP. ZAMORA,CM. VILLA DE CURA,INSTITUTO EDUCACIONAL ESPECIAL VILLA DE CURA,1549,3,45,1349,795,1304,2,3,2,1,501,1349
EDO. ARAGUA,MP. ZAMORA,CM. VILLA DE CURA,UNIDAD EDUCATIVA AMANDA FLORES,1649,3,37,1389,851,1352,0,13,2,0,486,1389
EDO. ARAGUA,MP. ZAMORA,CM. VILLA DE CURA,UNIDAD EDUCATIVA LEONCIO MARTINEZ,1791,4,23,1470,780,1447,0,3,0,2,662,1470
EDO. ARAGUA,MP. ZAMORA,CM. VILLA DE CURA,RESIDENCIAS MEDICAS,306,1,4,269,187,265,0,1,0,0,77,269
EDO. ARAGUA,MP. ZAMORA,CM. VILLA DE CURA,ESCUELA BASICA MELICIA NIEVES DE TEJADA,3552,7,35,2864,2058,2829,1,20,1,0,749,2864
EDO. ARAGUA,MP. ZAMORA,CM. VILLA DE CURA,ESCUELA BASICA INOCENCIO UTRERA,3135,6,63,2634,2103,2571,0,14,5,1,448,2634
EDO. ARAGUA,MP. ZAMORA,CM. VILLA DE CURA,INCES CENTRO DE FORMACION SOCIALISTA DE VILLA DE CURA,2631,5,31,2193,1429,2162,2,14,2,1,714,2193
EDO. ARAGUA,MP. ZAMORA,CM. VILLA DE CURA,ESCUELA BASICA ESTADAL RURAL CREACION GAMARA,573,1,17,502,451,485,0,1,0,0,33,502
EDO. ARAGUA,MP. ZAMORA,CM. VILLA DE CURA,UNIDAD EDUCATIVA NACIONAL ALBERTO SMITH,3351,6,53,2705,1465,2652,1,15,3,2,1166,2705
EDO. ARAGUA,MP. ZAMORA,CM. VILLA DE CURA,ESCUELA PROVISIONAL PARROQUIAL SAN LUIS DE CURA,1673,3,34,1365,783,1331,1,5,2,1,539,1365
EDO. ARAGUA,MP. ZAMORA,CM. VILLA DE CURA,PREESCOLAR NACIONAL BOLIVARIANO EZEQUIEL ZAMORA,492,1,4,442,340,438,0,2,0,0,96,442
EDO. ARAGUA,MP. ZAMORA,CM. VILLA DE CURA,ESCUELA ESTADAL CONCENTRADA Nº 70 Y 320,464,1,9,372,196,363,0,1,0,0,166,372
EDO. ARAGUA,MP. ZAMORA,CM. VILLA DE CURA,CENTRO DE EDUCACION INICIAL BOLIVARIANO FRANCISCO DE MIRANDA,1145,2,28,1025,747,997,0,5,0,0,245,1025
EDO. ARAGUA,MP. ZAMORA,CM. VILLA DE CURA,PREESCOLAR NACIONAL BOLIVARIANO LA REPRESA,443,1,12,384,261,372,0,2,1,0,108,384
EDO. ARAGUA,MP. ZAMORA,CM. VILLA DE CURA,UNIDAD EDUCATIVA ESTADAL CONCENTRADA NER 426 EL CHINO,186,1,2,98,79,96,0,2,0,0,15,98
EDO. ARAGUA,MP. ZAMORA,CM. VILLA DE CURA,GRUPO ESCOLAR LEOPOLDO TOSTA,2878,5,35,2330,1414,2295,2,19,1,5,854,2330
EDO. ARAGUA,MP. ZAMORA,CM. VILLA DE CURA,UNIDAD EDUCATIVA ESTADAL DOCTOR JOSE CASANOVA GODOY,3218,6,59,2640,2068,2581,0,10,5,1,497,2640
EDO. ARAGUA,MP. ZAMORA,CM. VILLA DE CURA,ESCUELA BASICA ESTADAL JULIETA HERNANDEZ PARRA,1717,3,16,1388,1111,1372,0,8,0,0,253,1388
EDO. ARAGUA,MP. ZAMORA,CM. VILLA DE CURA,ESCUELA BASICA SALOMON MORALES,3856,7,81,3127,2375,3046,0,17,4,2,648,3127
EDO. ARAGUA,MP. ZAMORA,CM. VILLA DE CURA,JARDIN DE INFANCIA ARISTIDES ROJAS,887,2,14,794,428,780,0,5,1,1,345,794
EDO. ARAGUA,MP. ZAMORA,CM. VILLA DE CURA,UNIDAD EDUCATIVA ESTADAL SIMON RODRIGUEZ,852,2,5,760,497,755,1,2,0,0,255,760
EDO. ARAGUA,MP. ZAMORA,CM. VILLA DE CURA,PREESCOLAR NACIONAL LAS MERCEDES,352,1,10,308,217,298,0,2,0,0,79,308
EDO. ARAGUA,MP. ZAMORA,CM. VILLA DE CURA,UNIDAD EDUCATIVA ESTADAL CONCENTRADA PIRITU,1070,2,17,857,653,840,1,1,0,0,185,857
EDO. ARAGUA,MP. ZAMORA,CM. VILLA DE CURA,GRUPO ESCOLAR ESCUELA VICTOR PADILLA,2563,5,50,2187,1339,2137,0,14,2,2,780,2187
EDO. ARAGUA,MP. ZAMORA,CM. VILLA DE CURA,BIBLIOTECA VIRTUAL,298,1,2,262,164,260,1,1,0,0,94,262
EDO. ARAGUA,MP. ZAMORA,CM. VILLA DE CURA,UNIDAD EDUCATIVA ESTADAL RURAL   CHAGUARAMA,323,1,3,286,248,283,0,1,0,0,34,286
EDO. ARAGUA,MP. ZAMORA,CM. VILLA DE CURA,PREESCOLAR NACIONAL CUYAGUA,548,1,6,473,358,467,0,1,2,0,106,473
EDO. ARAGUA,MP. ZAMORA,CM. VILLA DE CURA,ESCUELA BASICA MANUEL MORALES CARABAÑO,1148,2,19,1043,554,1024,0,3,0,0,467,1043
EDO. ARAGUA,MP. ZAMORA,CM. VILLA DE CURA,UNIDAD EDUCATIVA ESTADAL JUAN ANTONIO PEREZ BONALDE,489,1,2,447,277,445,0,5,0,1,162,447
EDO. ARAGUA,MP. ZAMORA,CM. VILLA DE CURA,ESCUELA BASICA ARISTIDES ROJAS,4567,8,56,3758,1611,3702,2,18,1,2,2068,3758
EDO. ARAGUA,MP. ZAMORA,CM. VILLA DE CURA,ESCUELA BASICA TERESA CARREÑO,2855,5,50,2344,1549,2294,1,18,4,0,722,2344
EDO. ARAGUA,MP. JOSE ANGEL LAMAS,CM. SANTA CRUZ,UNIDAD EDUCATIVA NACIONAL CARLOS RAMON APONTE,648,2,13,596,361,583,0,2,0,0,220,596
EDO. ARAGUA,MP. JOSE ANGEL LAMAS,CM. SANTA CRUZ,DON FRANCISCO CASTILLO,1543,3,23,1396,962,1373,0,3,1,1,406,1396
EDO. ARAGUA,MP. JOSE ANGEL LAMAS,CM. SANTA CRUZ,UNIDAD EDUCATIVA NACIONAL LA CANDELARIA,758,2,11,698,552,687,0,2,1,0,132,698
EDO. ARAGUA,MP. JOSE ANGEL LAMAS,CM. SANTA CRUZ,ESCUELA BASICA SANTOS ANIBAL DOMINICE,854,2,7,806,391,799,0,4,0,2,402,806
EDO. ARAGUA,MP. JOSE ANGEL LAMAS,CM. SANTA CRUZ,ESCUELA BASICA NACIONAL BOLIVARIANA SANTA CRUZ,2910,6,34,2363,1262,2329,0,7,2,0,1058,2363
EDO. ARAGUA,MP. JOSE ANGEL LAMAS,CM. SANTA CRUZ,CENTRO DE PARALISIS CEREBRAL JOSE ANGEL LAMAS,616,2,7,573,435,566,0,0,2,0,129,573
EDO. ARAGUA,MP. JOSE ANGEL LAMAS,CM. SANTA CRUZ,PREESCOLAR LOS MANGOS,725,2,10,684,460,674,0,7,0,0,207,684
EDO. ARAGUA,MP. JOSE ANGEL LAMAS,CM. SANTA CRUZ,UNIDAD EDUCATIVA NACIONAL RESIDENCIAS SANTA CRUZ,2036,4,30,1758,870,1728,0,12,2,1,843,1758
EDO. ARAGUA,MP. JOSE ANGEL LAMAS,CM. SANTA CRUZ,ESCUELA BASICA RAFAEL BRICEO ORTEGA,4004,7,33,3325,1719,3292,2,21,2,3,1545,3325
EDO. ARAGUA,MP. JOSE ANGEL LAMAS,CM. SANTA CRUZ,CENTRO DE EDUCACION INICIAL JOSE ANGEL LAMAS,621,2,7,573,442,566,0,2,0,0,122,573
EDO. ARAGUA,MP. JOSE ANGEL LAMAS,CM. SANTA CRUZ,ESCUELA BASICA ANDRES ELOY BLANCO,3658,7,60,2936,1859,2876,0,18,0,0,999,2936
EDO. ARAGUA,MP. JOSE ANGEL LAMAS,CM. SANTA CRUZ,ESCUELA BASICA DOCTOR PATROCINIO P RUIZ,3149,6,47,2596,1613,2549,2,10,1,1,922,2596
EDO. ARAGUA,MP. JOSE ANGEL LAMAS,CM. SANTA CRUZ,CASA DE LA CULTURA CLAUDIO CASTILLO,1199,3,20,1050,559,1030,0,6,4,1,460,1050
EDO. ARAGUA,MP. CAMATAGUA,CM. CAMATAGUA,CICLO BASICO FRANCISCO LINARES ALCANTARA,1936,4,37,1504,987,1467,0,9,0,1,470,1504
EDO. ARAGUA,MP. CAMATAGUA,CM. CAMATAGUA,ESCUELA BASICA ESTADAL CAMATAGUA,3258,6,47,2521,1548,2474,0,18,1,0,907,2521
EDO. ARAGUA,MP. CAMATAGUA,CM. CAMATAGUA,SIMONCITO ATENCION EDUCATIVA NO CONVENCIONAL JOSE GREGORIO HERNANDEZ,212,1,2,192,166,190,1,0,0,0,23,192
EDO. ARAGUA,MP. CAMATAGUA,CM. CAMATAGUA,PRE ESCOLAR CARIDAD DE ESPAÑA,247,1,2,224,185,222,0,1,0,0,36,224
EDO. ARAGUA,MP. CAMATAGUA,CM. CAMATAGUA,CASA COMUNAL BRISAS DE LA CALIFORNIA,138,1,2,125,118,123,0,0,2,0,3,125
EDO. ARAGUA,MP. CAMATAGUA,CM. CAMATAGUA,ESCUELA BASICA PASTOR RODRIGUEZ MANZO,2150,4,38,1710,1187,1672,0,16,0,0,469,1710
EDO. ARAGUA,MP. CAMATAGUA,CM. CAMATAGUA,ESCUELA BASICA ESTADAL LA CANDELARIA,690,2,3,584,506,581,0,3,0,0,72,584
EDO. ARAGUA,MP. CAMATAGUA,PQ. CARMEN DE CURA,ESCUELA UNITARIA  MARIA DE NAZARET,314,1,9,272,175,263,0,1,0,0,87,272
EDO. ARAGUA,MP. CAMATAGUA,PQ. CARMEN DE CURA,UNIDAD EDUCATIVA ESTADAL CARUTICO NUCLEO EDUCATIVO RURAL Nº 184 A,310,1,1,254,210,253,0,0,0,0,43,254
EDO. ARAGUA,MP. CAMATAGUA,PQ. CARMEN DE CURA,ESCUELA BASICA ESTADAL 15 DE ENERO,2571,5,67,1928,1071,1861,0,13,1,0,776,1928
EDO. ARAGUA,MP.FRANCISCO LINARES,PQ. FRANCISCO DE MIRANDA,ESCUELA BASICA ARTURO SARCO VILLENA,2110,4,28,1745,931,1717,0,5,1,1,779,1745
EDO. ARAGUA,MP.FRANCISCO LINARES,PQ. FRANCISCO DE MIRANDA,CENTRO DE ATENCION VECINAL MARIA GARCIA,332,1,11,266,190,255,0,1,0,0,64,266
EDO. ARAGUA,MP.FRANCISCO LINARES,PQ. FRANCISCO DE MIRANDA,ESCUELA BASICAJORGE SEMIDEY,2478,5,53,2039,1357,1986,3,13,1,0,612,2039
EDO. ARAGUA,MP.FRANCISCO LINARES,PQ. FRANCISCO DE MIRANDA,CENTRO DE CAPACITACION LABORAL VIRGEN DEL ROSARIO VENANCIO AZPIROZ,480,1,6,426,285,420,0,0,0,2,133,426
EDO. ARAGUA,MP.FRANCISCO LINARES,PQ. FRANCISCO DE MIRANDA,CENTRO DE ABSTECIMIENTO FAMILIAR,1617,3,32,1309,848,1277,0,8,0,2,419,1309
EDO. ARAGUA,MP.FRANCISCO LINARES,PQ. FRANCISCO DE MIRANDA,ESCUELA BASICA FRANCISCO DE MIRANDA,3851,7,57,3197,1961,3140,2,21,2,3,1151,3197
EDO. ARAGUA,MP.FRANCISCO LINARES,PQ. FRANCISCO DE MIRANDA,UE PRIVADA NUEVA REPUBLICA,2118,4,42,1735,1092,1693,0,7,0,2,592,1735
EDO. ARAGUA,MP.FRANCISCO LINARES,PQ. FRANCISCO DE MIRANDA,ESCUELA BASICA 18 DE MAYO,3480,6,80,2744,1881,2664,1,10,2,2,768,2744
EDO. ARAGUA,MP.FRANCISCO LINARES,PQ. FRANCISCO DE MIRANDA,UNIDAD EDUCATIVA NACIONAL CREACION VENEZUELA,730,2,14,628,406,614,0,0,0,0,208,628
EDO. ARAGUA,MP.FRANCISCO LINARES,PQ. FRANCISCO DE MIRANDA,CENTRO COMUNITARIO DE USOS MULTIPLES SIMON RODRIGUEZ,508,1,9,444,340,435,0,2,1,0,92,444
EDO. ARAGUA,MP.FRANCISCO LINARES,CM. SANTA RITA,ESCUELA BASICA LOS PROCERES,756,2,20,663,461,643,0,2,0,2,178,663
EDO. ARAGUA,MP.FRANCISCO LINARES,CM. SANTA RITA,UNIDAD EDUCATIVA ESTADAL SANTIAGO MARI O,2224,4,37,1829,1305,1792,0,12,4,0,471,1829
EDO. ARAGUA,MP.FRANCISCO LINARES,CM. SANTA RITA,TALLER DE EDUCACION ESPECIAL TELSUR,1060,2,34,907,709,873,0,2,1,0,161,907
EDO. ARAGUA,MP.FRANCISCO LINARES,CM. SANTA RITA,SIMONCITO COMUNITARIO ALBERTO SOLANO,529,1,8,462,394,454,0,4,0,0,56,462
EDO. ARAGUA,MP.FRANCISCO LINARES,CM. SANTA RITA,UNIDAD EDUCATIVA PRIVADA MIS SAGRADOS PRINCIPIOS,474,1,6,424,317,418,0,3,0,0,98,424
EDO. ARAGUA,MP.FRANCISCO LINARES,CM. SANTA RITA,INSTITUTO DE EDUCACION ESPECIAL BOLIVARIANO MANUELITA SAEZ,617,2,8,569,414,561,0,2,1,0,144,569
EDO. ARAGUA,MP.FRANCISCO LINARES,CM. SANTA RITA,CENTRO DE PARALISIS CEREBRAL LINARES ALCANTARA,1032,2,11,905,669,894,0,3,1,0,221,905
EDO. ARAGUA,MP.FRANCISCO LINARES,CM. SANTA RITA,ESPACIO EDUCATIVO COMUNITARIO EZEQUIEL ZAMORA,426,1,4,351,299,347,0,1,0,1,46,351
EDO. ARAGUA,MP.FRANCISCO LINARES,CM. SANTA RITA,UNIDAD EDUCATIVA INTEGRAL AYACUCHO,368,1,17,321,221,304,0,1,2,0,80,321
EDO. ARAGUA,MP.FRANCISCO LINARES,CM. SANTA RITA,ESCUELA BASICA NACIONAL COROPO,3542,7,65,2873,2172,2808,1,17,3,2,613,2873
EDO. ARAGUA,MP.FRANCISCO LINARES,CM. SANTA RITA,PREESCOLA ALVARO MARTINEZ PAIVA,776,2,15,681,517,666,0,6,0,0,143,681
EDO. ARAGUA,MP.FRANCISCO LINARES,CM. SANTA RITA,UNIDAD EDUCATIVA PRIVADA MANUEL FELIPE DE TOVAR,455,1,9,395,216,386,0,0,0,0,170,395
EDO. ARAGUA,MP.FRANCISCO LINARES,CM. SANTA RITA,ESCUELA BASICA ESTADAL JULIAN LANDAETA ROBLES,2022,4,40,1751,1261,1711,0,9,1,1,439,1751
EDO. ARAGUA,MP.FRANCISCO LINARES,CM. SANTA RITA,GALPON DE SANTA INES,966,2,25,809,583,784,2,4,0,0,195,809
EDO. ARAGUA,MP.FRANCISCO LINARES,CM. SANTA RITA,ESCUELA BASICA PARMANACAY,4427,8,58,3587,2481,3529,0,16,3,3,1026,3587
EDO. ARAGUA,MP.FRANCISCO LINARES,CM. SANTA RITA,UNIDAD EDUCATIVA PRIVADA REPUBLICA DE VENEZUELA,1014,2,16,848,615,832,0,1,0,0,216,848
EDO. ARAGUA,MP.FRANCISCO LINARES,CM. SANTA RITA,U E LEONARDO RUIZ PINEDA,4893,9,82,4085,2783,4003,0,32,1,2,1185,4085
EDO. ARAGUA,MP.FRANCISCO LINARES,CM. SANTA RITA,ESCUELA BASICA PRIVADA SIMON RODRIGUEZ,2206,4,44,1808,1078,1764,0,8,0,4,674,1808
EDO. ARAGUA,MP.FRANCISCO LINARES,CM. SANTA RITA,ESCUELA BASICA 24 DE OCTUBRE,2985,6,70,2424,1656,2354,1,11,4,4,678,2424
EDO. ARAGUA,MP.FRANCISCO LINARES,CM. SANTA RITA,UNIVERSIDAD DE CARABOBO MORITA II,7920,15,154,6501,3753,6347,1,35,5,4,2549,6501
EDO. ARAGUA,MP.FRANCISCO LINARES,CM. SANTA RITA,UNIDAD EDUCATIVA PRIVADA ANTONIO JOSE DE SUCRE,348,1,8,315,167,307,0,0,0,0,140,315
EDO. ARAGUA,MP.FRANCISCO LINARES,CM. SANTA RITA,INSTITUTO DE EDUCACION ESPECIAL LINARES ALCANTARA,563,1,8,475,294,467,1,4,2,0,166,475
EDO. ARAGUA,MP.FRANCISCO LINARES,CM. SANTA RITA,UNIDAD EDUCATIVA NACIONAL SAN FRANCISCO DE PAULA,1107,2,16,917,647,901,0,5,0,0,249,917
EDO. ARAGUA,MP.FRANCISCO LINARES,CM. SANTA RITA,UNIDAD EDUCATIVA PRIVADA GRANDES LIBERTADORES,851,2,22,758,547,736,0,5,0,1,183,758
EDO. ARAGUA,MP.FRANCISCO LINARES,CM. SANTA RITA,ESCUELA BASICA NAC SANTA RITA,2821,5,58,2261,1494,2203,0,15,2,3,689,2261
EDO. ARAGUA,MP.FRANCISCO LINARES,CM. SANTA RITA,PREESCOLAR NACIONAL  SANTA BARBARA,689,2,7,581,458,574,0,0,0,1,115,581
EDO. ARAGUA,MP.FRANCISCO LINARES,CM. SANTA RITA,UNIDAD EDUCATIVA NACIONAL COROPO III,555,1,14,443,356,429,0,2,0,0,71,443
EDO. ARAGUA,MP.FRANCISCO LINARES,CM. SANTA RITA,UNIDAD EDUCATIVA ESTADAL ANDRES BELLO,902,2,16,764,596,748,0,3,2,0,147,764
EDO. ARAGUA,MP.FRANCISCO LINARES,CM. SANTA RITA,UESCUELA BASICA 24 DE JUNIO,1518,3,29,1242,840,1213,0,6,0,0,367,1242
EDO. ARAGUA,MP.FRANCISCO LINARES,CM. SANTA RITA,UNIDAD EDUCATIVA PRIVADA VIRGEN DEL ROSARIO FE Y ALEGRIA,720,2,14,635,358,621,0,3,2,0,258,635
EDO. ARAGUA,MP.FRANCISCO LINARES,CM. SANTA RITA,ESCUELA BASICA COSTA DE RIO,3288,6,48,2723,1932,2675,0,10,4,1,728,2723
EDO. ARAGUA,MP.FRANCISCO LINARES,CM. SANTA RITA,UNIDAD EDUCATIVA PRIVADA NUESTRA SEÑORA DE COROMOTO,1057,2,29,922,674,893,0,7,1,1,210,922
EDO. ARAGUA,MP.FRANCISCO LINARES,CM. SANTA RITA,SIMONCITO COMUNITARIO MIS NINOS Y NINAS,467,1,5,420,320,415,0,1,0,0,94,420
EDO. ARAGUA,MP.FRANCISCO LINARES,PQ. MONS FELICIANO G,ESCUELA BASICA REYNA DE VAZQUEZ,4545,8,51,3708,2752,3657,0,22,0,1,882,3708
EDO. ARAGUA,MP.FRANCISCO LINARES,PQ. MONS FELICIANO G,ESCUELA BASICA  PARAPARAL II,3795,7,64,3070,2313,3006,0,14,3,3,673,3070
EDO. ARAGUA,MP.FRANCISCO LINARES,PQ. MONS FELICIANO G,CIELO ABIERTO SIMON BOLIVAR II,545,1,6,466,368,460,0,5,0,1,86,466
EDO. ARAGUA,MP.FRANCISCO LINARES,PQ. MONS FELICIANO G,UNIDAD EDUCATIVA ESTADAL VICENTE TOVAR,786,2,9,642,504,633,0,1,0,0,128,642
EDO. ARAGUA,MP.FRANCISCO LINARES,PQ. MONS FELICIANO G,PREESCOLAR NACIONAL MARACAY I.,772,2,8,672,519,664,0,2,0,0,143,672
EDO. ARAGUA,MP.FRANCISCO LINARES,PQ. MONS FELICIANO G,PREESCOLAR LUIS BELTRAN PRIETO FIGUEROA,564,1,4,481,419,477,0,3,0,0,55,481
EDO. ARAGUA,MP. JOSE R REVENGA,CM. EL CONSEJO,UNIDAD EDUCATIVA ESTADAL RURAL MOROCOPO ALTO,692,2,20,511,341,491,0,2,1,0,147,511
EDO. ARAGUA,MP. JOSE R REVENGA,CM. EL CONSEJO,ESCUELA BASICA ESTADAL RURAL LA GRUTA NER004A,322,1,6,311,282,305,0,2,0,0,21,311
EDO. ARAGUA,MP. JOSE R REVENGA,CM. EL CONSEJO,UNIDAD EDUCATIVA NACIONAL  BOLIVARIANA SANTA ROSALIA,453,1,2,425,370,423,1,5,0,0,47,425
EDO. ARAGUA,MP. JOSE R REVENGA,CM. EL CONSEJO,ESCUELA BASICA JOSE LEONARDO CHIRINOS,2224,4,61,1818,1520,1757,1,5,5,0,226,1818
EDO. ARAGUA,MP. JOSE R REVENGA,CM. EL CONSEJO,UNIDAD EDUCATIVA NACIONAL TASAJERA,481,1,12,390,200,378,0,1,0,1,176,390
EDO. ARAGUA,MP. JOSE R REVENGA,CM. EL CONSEJO,PREESCOLAR NACIONAL BOLIVARIANO SABANETA EL CONSEJO,532,1,9,482,412,473,0,2,0,0,59,482
EDO. ARAGUA,MP. JOSE R REVENGA,CM. EL CONSEJO,UNIDAD EDUCATIVA NACIONAL MANUEL CIPRIANO PEREZ,2830,5,70,2385,1665,2315,0,7,2,0,641,2385
EDO. ARAGUA,MP. JOSE R REVENGA,CM. EL CONSEJO,CASA DE LA CULTURA POETA PEDRO BUZNEGO,2299,4,47,1972,1210,1925,0,12,0,1,702,1972
EDO. ARAGUA,MP. JOSE R REVENGA,CM. EL CONSEJO,ESCUELA BASICA ESTADAL RURAL QUEBRADA SECA,1056,2,9,903,770,894,0,6,1,0,117,903
EDO. ARAGUA,MP. JOSE R REVENGA,CM. EL CONSEJO,PREESCOLAR LA CASONA ESPACIO ALTERNATIVO,313,1,3,298,256,295,0,3,0,0,36,298
EDO. ARAGUA,MP. JOSE R REVENGA,CM. EL CONSEJO,ESCUELA BASICA FRANCISCO JARAMILLO,638,2,10,593,499,583,1,0,1,0,82,593
EDO. ARAGUA,MP. JOSE R REVENGA,CM. EL CONSEJO,UNIDAD EDUCATIVA ESTADAL RURAL EL CONDE,756,2,10,651,500,641,1,0,0,2,138,651
EDO. ARAGUA,MP. JOSE R REVENGA,CM. EL CONSEJO,ALDEA UNIVERSITARIA JOSE RAFAEL REVENGA,1003,2,15,927,471,912,0,3,1,0,437,927
EDO. ARAGUA,MP. JOSE R REVENGA,CM. EL CONSEJO,ESCUELA BASICA NACIONAL ALIDA PEREZ MATOS,1056,2,5,884,762,879,1,5,1,0,110,884
EDO. ARAGUA,MP. JOSE R REVENGA,CM. EL CONSEJO,ESCUELA BASICA CREACION CALLE PAEZ,2110,4,31,1832,1454,1801,0,9,2,0,336,1832
EDO. ARAGUA,MP. JOSE R REVENGA,CM. EL CONSEJO,SIMONCITO COMUNITARIO CAMINO REAL,204,1,8,198,172,190,0,1,1,0,16,198
EDO. ARAGUA,MP. JOSE R REVENGA,CM. EL CONSEJO,UNIDAD EDUCATIVA NACIONAL MANUELA PERDOMO DE ALMEIDA,31,1,0,24,19,24,0,0,0,0,5,24
EDO. ARAGUA,MP. JOSE R REVENGA,CM. EL CONSEJO,CASA DE LA CULTURA JOSEFA PIPA RAMIREZ.,555,1,3,479,405,476,0,2,0,0,69,479
EDO. ARAGUA,MP. JOSE R REVENGA,CM. EL CONSEJO,ESCUELA BASICA LUISA CACERES DE ARISMENDI,1954,4,35,1659,1315,1624,1,6,0,0,302,1659
EDO. ARAGUA,MP. JOSE R REVENGA,CM. EL CONSEJO,ESCUELA BASICA JUAN USLAR,3655,7,38,2939,1912,2901,3,9,1,2,974,2939
EDO. ARAGUA,MP. JOSE R REVENGA,CM. EL CONSEJO,UNIDAD EDUCATIVA ESTADAL ELENA TORRES,2219,4,41,1876,1063,1835,2,7,2,3,758,1876
EDO. ARAGUA,MP. JOSE R REVENGA,CM. EL CONSEJO,ESCUELA BASICA ESTADAL SOCORRO ACOSTA DE SANCHEZ,4841,9,80,3852,2918,3772,1,17,4,3,829,3852
EDO. ARAGUA,MP. JOSE R REVENGA,CM. EL CONSEJO,PREESCOLAR NACIONAL BARRIO EL CONSEJO,448,1,7,403,265,396,0,0,0,0,131,403
EDO. ARAGUA,MP. JOSE R REVENGA,CM. EL CONSEJO,UNIDAD EDUCATIVA NACIONAL DON SIMON RODRIGUEZ.,284,1,6,257,241,251,0,0,0,0,10,257
EDO. ARAGUA,MP. SUCRE,CM. CAGUA,ESCUELA BASICA AMELIA MIRANDA,4211,8,79,3462,2425,3383,0,18,0,0,940,3462
EDO. ARAGUA,MP. SUCRE,CM. CAGUA,ESCUELA BASICA LUIS ALEJANDRO ALVARADO,3296,6,44,2665,1418,2621,3,19,0,0,1181,2665
EDO. ARAGUA,MP. SUCRE,CM. CAGUA,ESCUELA BASICA MEREGOTO,3084,6,58,2525,1060,2467,0,14,2,2,1389,2525
EDO. ARAGUA,MP. SUCRE,CM. CAGUA,ESCUELA BASICA MANUELITA SAENZ,3121,6,50,2631,1982,2581,1,15,0,2,581,2631
EDO. ARAGUA,MP. SUCRE,CM. CAGUA,ESCUELA BASICA  LUCIO ANTONIO FIGUERA,3322,6,53,2784,1893,2731,1,16,0,3,818,2784
EDO. ARAGUA,MP. SUCRE,CM. CAGUA,UNIDAD EDUCATIVA COLEGIO ARAGUA ESTUDIANTIL,3708,7,78,3426,1314,3348,0,20,0,5,2009,3426
EDO. ARAGUA,MP. SUCRE,CM. CAGUA,ESCUELA BASICA NACIONAL FELIPE LARRAZABAL,1761,3,26,1625,540,1599,0,3,1,1,1054,1625
EDO. ARAGUA,MP. SUCRE,CM. CAGUA,ESCUELA BASICA ALIDA PEREZ MATOS,3490,7,53,2784,1850,2731,2,15,1,2,861,2784
EDO. ARAGUA,MP. SUCRE,CM. CAGUA,UNIDAD EDUCATIVA AMPARO MONROY POWER,1233,3,21,1033,613,1012,0,2,1,0,396,1033
EDO. ARAGUA,MP. SUCRE,CM. CAGUA,UNIDAD EDUCATIVA NACIONAL RAFAEL BOLIVAR,874,2,32,784,546,752,0,2,0,0,204,784
EDO. ARAGUA,MP. SUCRE,CM. CAGUA,CICLO DIVERSIFICADO MARIANO FERNANDEZ FORTIQUE,3950,7,57,3277,1448,3220,1,14,1,3,1753,3277
EDO. ARAGUA,MP. SUCRE,CM. CAGUA,UNIDAD EDUCATIVA ESTADAL PADRE FRANCISCO AMIGO,1339,3,32,1173,984,1141,0,9,0,0,148,1173
EDO. ARAGUA,MP. SUCRE,CM. CAGUA,ESCUELA BASICA TAGUANES,3056,6,39,2481,1684,2442,1,16,1,4,736,2481
EDO. ARAGUA,MP. SUCRE,CM. CAGUA,ESCUELA BASICA ANDRES BELLO,2756,5,58,2245,1271,2187,0,9,5,0,902,2245
EDO. ARAGUA,MP. SUCRE,CM. CAGUA,UNIDAD EDUCATIVA NACIONAL MANUEL MANZO GORESTEGUI,1551,3,38,1377,940,1339,0,3,0,1,395,1377
EDO. ARAGUA,MP. SUCRE,CM. CAGUA,UNIDAD EDUCATIVA JOSE HELIMENAS BARRIOS,1298,3,18,1167,500,1149,1,8,0,1,639,1167
EDO. ARAGUA,MP. SUCRE,CM. CAGUA,UNIDAD EDUCATIVA PRIVADA CECILIO ACOSTA,2557,5,53,2119,1117,2066,0,17,0,1,931,2119
EDO. ARAGUA,MP. SUCRE,CM. CAGUA,UNIDAD EDUCATIVA NACIONAL SUCRE,813,2,22,684,493,662,0,1,0,0,168,684
EDO. ARAGUA,MP. SUCRE,CM. CAGUA,INSTITUTO TECNOLÓGICO PASCAL,3611,7,60,2789,982,2729,1,12,1,1,1732,2789
EDO. ARAGUA,MP. SUCRE,CM. CAGUA,CICLO DIVERSIFICADO RAFAEL HERNANDEZ LEON,4222,8,53,3418,2038,3365,2,24,1,2,1298,3418
EDO. ARAGUA,MP. SUCRE,CM. CAGUA,UNIDAD EDUCATIVA NACIONAL SOTERO ARTEAGA MIGUELENA,2804,5,76,2340,1542,2264,0,10,0,2,710,2340
EDO. ARAGUA,MP. SUCRE,CM. CAGUA,ESCUELA BASICA CESAR ZUMETA,3823,7,66,3095,1146,3029,1,16,1,0,1865,3095
EDO. ARAGUA,MP. SUCRE,CM. CAGUA,PREESCOLAR NACIONAL BOLIVARIANO ANTONIO JOSE DE SUCRE,795,2,9,703,491,694,0,5,0,1,197,703
EDO. ARAGUA,MP. SUCRE,CM. CAGUA,PREESCOLAR LUIS ALEJANDRO ALVARADO,2149,4,39,1916,915,1877,1,8,3,1,949,1916
EDO. ARAGUA,MP. SUCRE,CM. CAGUA,COLEGIO EL CARMELO,3975,7,31,3408,956,3377,1,15,0,2,2403,3408
EDO. ARAGUA,MP. SUCRE,CM. CAGUA,UNIDAD EDUCATIVA SANTISIMO SALVADOR,4844,9,41,4356,1181,4315,0,5,2,7,3120,4356
EDO. ARAGUA,MP. SUCRE,CM. CAGUA,CENTRO MOVIL CANCHA RAFAEL URDANETA,1077,2,20,950,648,930,1,7,0,1,273,950
EDO. ARAGUA,MP. SUCRE,PQ. BELLA VISTA,UNIDAD EDUCATIVA NACIONAL  CREACION BELLA VISTA,2109,4,46,1666,1155,1620,1,7,1,1,455,1666
EDO. ARAGUA,MP. SUCRE,PQ. BELLA VISTA,PREESCOLAR NACIONAL BOLIVARIANO BELLA VISTA II,600,1,12,529,384,517,0,1,0,0,132,529
EDO. ARAGUA,MP. SUCRE,PQ. BELLA VISTA,ESCUELA BASICA CIRO MALDONADO ZERPA,2944,6,55,2343,1708,2288,1,8,3,2,566,2343
EDO. ARAGUA,MP. SUCRE,PQ. BELLA VISTA,NUESTRA SENORA DEL VALLE,799,2,32,673,508,641,0,1,2,0,130,673
EDO. ARAGUA,MP. LIBERTADOR,CM. PALO NEGRO,PREESCOLAR NUESTRA SENORA DEL CARMEN,762,2,20,671,426,651,0,5,0,0,220,671
EDO. ARAGUA,MP. LIBERTADOR,CM. PALO NEGRO,ESCUELA BASICA NAC CACIQUE CHARAIMA,2550,5,40,1955,1169,1915,0,11,1,1,733,1955
EDO. ARAGUA,MP. LIBERTADOR,CM. PALO NEGRO,ESCUELA FUERZAS AEREAS VENEZOLANA N° 1 DE NUESTR SEÑORA LORETO,2231,4,31,1816,1512,1785,0,4,2,0,267,1816
EDO. ARAGUA,MP. LIBERTADOR,CM. PALO NEGRO,LICEO NACIONAL BOLIVARIANO  LUIS BELTRAN PRIETO FIGUEROA,530,1,3,469,316,466,0,3,0,1,146,469
EDO. ARAGUA,MP. LIBERTADOR,CM. PALO NEGRO,LICEO BOLIVARIANO NACIONAL TRINOCELIS RIOS,2088,4,37,1697,1034,1660,0,6,0,0,620,1697
EDO. ARAGUA,MP. LIBERTADOR,CM. PALO NEGRO,CTRO DE CAPACITACION CHARAIMA,1517,3,12,1222,697,1210,0,2,0,2,509,1222
EDO. ARAGUA,MP. LIBERTADOR,CM. PALO NEGRO,UNIDAD EDUCACIONAL INSTITUTO ANDRES BELLO,1621,3,25,1358,714,1333,0,5,1,1,612,1358
EDO. ARAGUA,MP. LIBERTADOR,CM. PALO NEGRO,UNIDAD EDUCATIVA PRIVADA  INSTITUTO PROCERES DE AMERICA,762,2,15,699,392,684,0,1,0,0,291,699
EDO. ARAGUA,MP. LIBERTADOR,CM. PALO NEGRO,ESCUELA BASICA ESTADO GUARICO,3548,6,42,2843,1531,2801,1,16,2,2,1249,2843
EDO. ARAGUA,MP. LIBERTADOR,CM. PALO NEGRO,PREESCOLAR NACIONAL BOLIVARIANO CACIQUE CHARAIMA SEDE SAN ANTONIO,468,1,7,429,317,422,0,2,0,1,102,429
EDO. ARAGUA,MP. LIBERTADOR,CM. PALO NEGRO,CASA DE LOS ABUELOS MUNICIPIO LIBERTADOR,595,1,20,542,415,522,0,2,0,0,105,542
EDO. ARAGUA,MP. LIBERTADOR,CM. PALO NEGRO,ESCUELA BASICA ESTADAL EL LIBERTADOR,3864,7,62,3161,1972,3099,2,19,0,6,1100,3161
EDO. ARAGUA,MP. LIBERTADOR,CM. PALO NEGRO,UNIDAD EDUCATIVA NACIONAL BOLIVARIANA ISIDRO RAMON MORENO,1461,3,19,1326,986,1307,0,9,1,1,310,1326
EDO. ARAGUA,MP. LIBERTADOR,CM. PALO NEGRO,ESCUELA BASICA ECARLOS GARCIA BARRERA,2063,4,40,1729,948,1689,0,11,0,3,727,1729
EDO. ARAGUA,MP. LIBERTADOR,PQ. SAN MARTIN DE PORRES,UNIDAD EDUCATIVA ESTADAL FLORINDA GALINDEZ DE ESCORCHE,1472,3,28,1363,538,1335,0,6,0,2,789,1363
EDO. ARAGUA,MP. LIBERTADOR,PQ. SAN MARTIN DE PORRES,ESCUELA BASICA ESTADAL ANDRES ELOY LEON MORATINOS,1436,3,18,1194,932,1176,1,6,0,0,237,1194
EDO. ARAGUA,MP. LIBERTADOR,PQ. SAN MARTIN DE PORRES,PREESCOLAR MADRE DE JESUS,2886,5,32,2363,1801,2331,1,19,2,1,507,2363
EDO. ARAGUA,MP. LIBERTADOR,PQ. SAN MARTIN DE PORRES,ESCUELA BASICA LA OVALLERA,4238,8,61,3606,2455,3545,0,16,4,1,1069,3606
EDO. ARAGUA,MP. LIBERTADOR,PQ. SAN MARTIN DE PORRES,UNIDAD EDUCATIVA NACIONAL REPUBLICA DE COLOMBIA,1058,2,31,909,723,878,0,4,1,0,150,909
EDO. ARAGUA,MP. LIBERTADOR,PQ. SAN MARTIN DE PORRES,ESCUELA BASICA J M SISO MARTINEZ (PRIVADA),2527,5,31,2231,809,2200,0,4,2,1,1384,2231
EDO. ARAGUA,MP. LIBERTADOR,PQ. SAN MARTIN DE PORRES,ESCUELA BASICA SAN ISIDRO LABRADOR,4909,9,103,3915,2594,3812,1,21,8,7,1181,3915
EDO. ARAGUA,MP. LIBERTADOR,PQ. SAN MARTIN DE PORRES,ESCUELA BASICA NACIONAL BASE AEREA LIBERTADOR,1665,3,21,1389,1015,1368,0,12,0,0,341,1389
EDO. ARAGUA,MP. LIBERTADOR,PQ. SAN MARTIN DE PORRES,UNIDAD EDUCATIVA PRIVADA  ARTURO USLAR PIETRI,622,2,11,555,414,544,0,3,0,0,127,555
EDO. ARAGUA,MP. LIBERTADOR,PQ. SAN MARTIN DE PORRES,PRESCOLAR ESTADAL JULIA ELVIRA ROMERO DE MOLINA,3049,6,74,2441,1924,2367,1,11,1,4,426,2441
EDO. ARAGUA,MP. LIBERTADOR,PQ. SAN MARTIN DE PORRES,UNIDA EDUCATIVA PRIVADA MENCA DE LEONI,984,2,18,800,524,782,0,2,0,0,256,800
EDO. ARAGUA,MP. LIBERTADOR,PQ. SAN MARTIN DE PORRES,UNIDAD EDUCATIVA NACIONAL  SIMON RODRIGUEZ,809,2,6,730,510,724,1,1,0,0,212,730
EDO. ARAGUA,MP. LIBERTADOR,PQ. SAN MARTIN DE PORRES,CENTRO COMUNITARIO CIELO ABIERTO LA PICA,816,2,13,705,514,692,0,4,0,0,174,705
EDO. ARAGUA,MP. LIBERTADOR,PQ. SAN MARTIN DE PORRES,PREESCOLAR NACIONAL LOS HORNOS,724,2,14,624,513,610,0,2,1,1,93,624
EDO. ARAGUA,MP. LIBERTADOR,PQ. SAN MARTIN DE PORRES,ESCUELA BASICA JOSE ANGEL LAMAS,4895,9,89,4097,2067,4008,2,19,3,3,1914,4097
EDO. ARAGUA,MP. LIBERTADOR,PQ. SAN MARTIN DE PORRES,UNIDAD EDUCATIVA NACIONAL SIMON BOLIVAR,599,1,7,548,257,541,0,0,0,0,284,548
EDO. ARAGUA,MP. LIBERTADOR,PQ. SAN MARTIN DE PORRES,ESCUELA BASICA ESTADAL MARIA CAROLINA OLMO DE SULBARAN,617,2,12,535,408,523,0,3,2,0,110,535
EDO. ARAGUA,MP. LIBERTADOR,PQ. SAN MARTIN DE PORRES,UNIDAD EDUCATIVA ESTADAL MADRE TERESA DE CALCUTA,1065,2,23,882,735,859,0,8,0,0,116,882
EDO. ARAGUA,MP. LIBERTADOR,PQ. SAN MARTIN DE PORRES,LICEO NACIONAL BOLIVARIANO BASE AEREA EL LIBERTADOR,1389,3,28,1286,973,1258,0,4,0,1,280,1286
EDO. ARAGUA,MP. LIBERTADOR,PQ. SAN MARTIN DE PORRES,UNIDAD EDUCATIVA ADULTOS BAEL,321,1,4,284,264,280,0,0,0,0,16,284
EDO. ARAGUA,MP. TOVAR,CM. COLONIA TOVAR,UNIDAD EDUCATIVA LA LOMA,83,1,1,72,56,71,0,0,1,0,14,72
EDO. ARAGUA,MP. TOVAR,CM. COLONIA TOVAR,UNIDAD EDUCATIVA ESTADAL LAS HERNANDEZ,224,1,2,189,160,187,0,2,1,0,24,189
EDO. ARAGUA,MP. TOVAR,CM. COLONIA TOVAR,ESCUELA BASICA PEON DE GAVANTE,565,1,4,453,334,449,0,3,1,0,111,453
EDO. ARAGUA,MP. TOVAR,CM. COLONIA TOVAR,ESCUELA BASICA EL ROBLE
EDO. ARAGUA,MP. TOVAR,CM. COLONIA TOVAR,UNIDAD EDUCATICA LA CIENAGA,233,1,4,184,156,180,0,1,0,0,23,184
EDO. ARAGUA,MP. TOVAR,CM. COLONIA TOVAR,ESCUELA BASICA ROTARY CLUB,155,1,2,107,74,105,0,3,1,0,27,107
EDO. ARAGUA,MP. TOVAR,CM. COLONIA TOVAR,UNIDAD EDUCATIVA ESTADAL CUMBOTE,175,1,4,157,64,153,0,1,1,0,87,157
EDO. ARAGUA,MP. TOVAR,CM. COLONIA TOVAR,UNIDAD EDUCATIVA NACIONAL ELIZABET VONKELLER,2204,4,56,1729,490,1673,0,2,0,1,1180,1729
EDO. ARAGUA,MP. TOVAR,CM. COLONIA TOVAR,UNIDAD EDUCATIVA NACIONAL MARTIN TOVAR,432,1,8,343,184,335,0,0,0,0,151,343
EDO. ARAGUA,MP. TOVAR,CM. COLONIA TOVAR,PRESCOLAR MARTIN TOVAR Y TOVAR,2292,4,36,1738,517,1702,1,6,1,0,1177,1738
EDO. ARAGUA,MP. TOVAR,CM. COLONIA TOVAR,ESCUELA BASICA ESTADAL LAS LUISAS NUMERO 583,345,1,6,243,210,237,1,3,0,0,23,243
EDO. ARAGUA,MP. TOVAR,CM. COLONIA TOVAR,ESCUELA BASICA ESTADAL RURAL EL CEDRAL,814,2,22,593,459,571,1,5,1,1,104,593
EDO. ARAGUA,MP. TOVAR,CM. COLONIA TOVAR,UNIDAD EDUCATIVA LUIS LAPENTA,1387,3,16,1128,347,1112,0,3,0,0,762,1128
EDO. ARAGUA,MP. TOVAR,CM. COLONIA TOVAR,UNIDAD EDUCATIVA ESTADAL PUERTO DE MAYA NUMERO 583,359,1,1,285,272,284,1,1,0,0,10,285
EDO. ARAGUA,MP. TOVAR,CM. COLONIA TOVAR,ESCUELA BASICA ESTADAL DOMINGO BORGES,564,1,7,437,198,430,1,1,0,0,230,437
EDO. ARAGUA,MP. TOVAR,CM. COLONIA TOVAR,UNIDAD EDUCATIVA ESTADAL RURAL CUCURUCHO,216,1,7,189,70,182,0,1,0,0,111,189
EDO. ARAGUA,MP. TOVAR,CM. COLONIA TOVAR,ESCUELA BASICA Nº 488,605,2,20,470,378,450,0,2,0,1,69,470
EDO. ARAGUA,MP. TOVAR,CM. COLONIA TOVAR,ESCUELA LOURDES FRIGO,542,1,12,355,258,343,0,1,1,0,83,355
EDO. ARAGUA,MP. TOVAR,CM. COLONIA TOVAR,UNIDAD EDUCATIVA ESTADAL MONTE OSCURO,248,1,10,216,165,206,1,2,0,1,37,216
EDO. ARAGUA,MP. TOVAR,CM. COLONIA TOVAR,UNIDAD EDUCATIVA ESTADAL RURAL CONCENTRADA LOS ANAUCOS NUMERO 583,453,1,15,351,255,336,0,1,1,0,79,351
EDO. ARAGUA,MP. TOVAR,CM. COLONIA TOVAR,UNIDAD EDUCATIVA CURTIDOR,138,1,3,122,51,119,0,0,0,0,68,122
EDO. ARAGUA,MP. TOVAR,CM. COLONIA TOVAR,ESCUELA CONCENT Nº 3301,262,1,1,191,176,190,1,2,0,0,11,191
EDO. ARAGUA,MP. BOLIVAR,CM. SAN MATEO,COLEGIO PRIVADO LAZO MARTI,149,1,2,131,98,129,0,1,0,0,30,131
EDO. ARAGUA,MP. BOLIVAR,CM. SAN MATEO,UNIDAD EDUCATIVA ESTADAL EZEQUIEL ZAMORA,2501,5,58,1968,1423,1910,0,11,2,1,473,1968
EDO. ARAGUA,MP. BOLIVAR,CM. SAN MATEO,ESCUELA BASICA NAC RICAURTE,2342,4,39,1787,1222,1748,0,9,2,0,515,1787
EDO. ARAGUA,MP. BOLIVAR,CM. SAN MATEO,UNIDAD EDUCATIVA ESTADAL DON ROMULO GALLEGOS,818,2,30,715,587,685,0,5,0,0,93,715
EDO. ARAGUA,MP. BOLIVAR,CM. SAN MATEO,CENTRO MOVIL,1281,3,24,982,731,958,0,3,0,0,224,982
EDO. ARAGUA,MP. BOLIVAR,CM. SAN MATEO,ESCUELA BASICA FELIX MARIA PAREDES,2808,5,103,2177,1471,2074,0,8,2,1,592,2177
EDO. ARAGUA,MP. BOLIVAR,CM. SAN MATEO,ESCUELA BASICA CARMELINA BEJARANO,2311,4,59,1894,1435,1835,0,5,1,0,394,1894
EDO. ARAGUA,MP. BOLIVAR,CM. SAN MATEO,PROYECTO INICIAL BOLIVARIANO.AÑO BICENTENARIO II.,332,1,15,282,190,267,0,4,0,0,73,282
EDO. ARAGUA,MP. BOLIVAR,CM. SAN MATEO,ESCUELA BASICA SAN MATEO,1716,3,27,1350,744,1323,1,5,2,0,571,1350
EDO. ARAGUA,MP. BOLIVAR,CM. SAN MATEO,ESCUELA BASICA NACIONAL PRESIDENTE MEDINA ANGARITA,3302,6,74,2617,1709,2543,0,11,1,1,821,2617
EDO. ARAGUA,MP. BOLIVAR,CM. SAN MATEO,CENTRO DE CAPACITACION DE ADULTO ESCUELA DE ARTE Y OFICIO,872,2,21,721,543,700,0,6,0,0,151,721
EDO. ARAGUA,MP. BOLIVAR,CM. SAN MATEO,UNIDAD EDUCATIVA PRIVADA  LA SAGRADA FAMILIA,285,1,5,265,198,260,0,0,0,0,62,265
EDO. ARAGUA,MP. BOLIVAR,CM. SAN MATEO,ESCUELA ESTADAL UNITARIA Nº 753,1260,3,46,952,757,906,1,2,0,0,146,952
EDO. ARAGUA,MP. BOLIVAR,CM. SAN MATEO,SIMONCITO COMUNITARIO SAN MATEO,353,1,7,302,229,295,0,0,0,0,66,302
EDO. ARAGUA,MP. BOLIVAR,CM. SAN MATEO,MODULO DE SERVICIO ILIAN AGUILAR,388,1,5,355,308,350,1,1,1,0,39,355
EDO. ARAGUA,MP. BOLIVAR,CM. SAN MATEO,PRE ESSCOLAR MARIA ALVARADO,532,1,10,467,344,457,0,0,0,0,113,467
EDO. ARAGUA,MP. BOLIVAR,CM. SAN MATEO,UNIDAD EDUCATIVA ALBERTO CARNEVALLI,1125,2,32,895,723,863,1,5,1,1,132,895
EDO. ARAGUA,MP. BOLIVAR,CM. SAN MATEO,UNIDAD EDUCATIVA NACIONAL DANIEL MENDOZA,573,1,16,471,393,455,0,0,0,0,62,471
EDO. ARAGUA,MP. BOLIVAR,CM. SAN MATEO,COLEGIO NTRA SEÑORA DE BELEN,2241,4,65,1850,945,1785,0,4,1,0,835,1850
EDO. ARAGUA,MP. BOLIVAR,CM. SAN MATEO,ESCUELA BASICA NACIONAL 25 DE MARZO,3754,7,96,3090,2022,2994,0,21,0,2,949,3090
EDO. ARAGUA,MP. MARIO B IRAGORRY,CM. EL LIMON,ESCUELA BASICA NACIONAL 6 DE SEPTIEMBRE,1880,4,16,1560,611,1544,0,1,1,1,930,1560
EDO. ARAGUA,MP. MARIO B IRAGORRY,CM. EL LIMON,ESCUELA BASICA EL PROGRESO,3084,6,61,2571,1373,2510,0,11,2,2,1122,2571
EDO. ARAGUA,MP. MARIO B IRAGORRY,CM. EL LIMON,UNIDAD EDUCATIVA NACIONAL  EL LIMON,7185,13,97,5908,2216,5811,0,23,5,6,3561,5908
EDO. ARAGUA,MP. MARIO B IRAGORRY,CM. EL LIMON,U.E.E  HIPOLITO BONILLA,1596,3,19,1356,626,1337,0,3,1,0,707,1356
EDO. ARAGUA,MP. MARIO B IRAGORRY,CM. EL LIMON,UNIDAD EDUCATIVA NACIONAL JULIO MORALES LARA,3377,6,36,2743,972,2707,2,11,4,2,1716,2743
EDO. ARAGUA,MP. MARIO B IRAGORRY,CM. EL LIMON,COLEGIO CRISTO REY,1614,3,34,1431,687,1397,2,5,0,0,703,1431
EDO. ARAGUA,MP. MARIO B IRAGORRY,CM. EL LIMON,UNIDA EDUCATIVA ESTADAL DOCTOR JOSE FRANCISCO TORREALBA,4103,8,37,3427,1194,3390,1,12,3,2,2178,3427
EDO. ARAGUA,MP. MARIO B IRAGORRY,CM. EL LIMON,CASA DEL PODER POPULAR EL PASEO,2251,4,36,2010,1062,1974,0,5,1,4,902,2010
EDO. ARAGUA,MP. MARIO B IRAGORRY,CM. EL LIMON,COLEGIO DECROLY,4293,8,37,3699,910,3662,0,6,4,6,2736,3699
EDO. ARAGUA,MP. MARIO B IRAGORRY,PQ. CA A DE AZUCAR,UNIDAD EDUCATIVA NACIONAL BOLIVARIANA CANA DE AZUCAR,2618,5,52,2206,1166,2154,3,12,2,4,967,2206
EDO. ARAGUA,MP. MARIO B IRAGORRY,PQ. CA A DE AZUCAR,UNIDAD EDUCATIVA COLEGIO LOS ANGELES,924,2,11,828,458,817,1,3,1,0,354,828
EDO. ARAGUA,MP. MARIO B IRAGORRY,PQ. CA A DE AZUCAR,PREESCOLAR NACIONAL BOLIVARIANO ANDRES ELOY BLANCO.,463,1,4,395,247,391,0,0,0,0,144,395
EDO. ARAGUA,MP. MARIO B IRAGORRY,PQ. CA A DE AZUCAR,UNIDAD EDUCATIVA NACIONAL PEDRO JOSE MUGUERZA,3294,6,26,2861,1392,2835,0,4,2,3,1434,2861
EDO. ARAGUA,MP. MARIO B IRAGORRY,PQ. CA A DE AZUCAR,UNIDA EDUCATIVA NACIONAL  SANTOS MICHELENA,3446,6,37,2991,1432,2954,1,13,2,1,1505,2991
EDO. ARAGUA,MP. MARIO B IRAGORRY,PQ. CA A DE AZUCAR,CICLO DIVERSIFICADO OSWALDO TORRES VIÑA,768,2,10,679,405,669,1,3,0,0,260,679
EDO. ARAGUA,MP. MARIO B IRAGORRY,PQ. CA A DE AZUCAR,JARDIN DE INFANCIA INAVI,966,2,24,809,446,785,0,2,1,0,336,809
EDO. ARAGUA,MP. MARIO B IRAGORRY,PQ. CA A DE AZUCAR,ESCUELA BASICA PADRE ANTONIO LEYH,3442,6,52,2933,1570,2881,0,10,1,4,1296,2933
EDO. ARAGUA,MP. MARIO B IRAGORRY,PQ. CA A DE AZUCAR,PREESCOLAR ROMULO GALLEGOS,1337,3,29,1120,601,1091,0,7,2,0,481,1120
EDO. ARAGUA,MP. MARIO B IRAGORRY,PQ. CA A DE AZUCAR,UNIVERSIDAD SIMON RODRIGUEZ,3484,6,55,3081,1557,3026,0,8,1,6,1454,3081
EDO. ARAGUA,MP. MARIO B IRAGORRY,PQ. CA A DE AZUCAR,ESCUELA BASICA JOSE FELIX RIBAS,3746,7,38,3262,1939,3224,0,21,2,1,1261,3262
EDO. ARAGUA,MP. MARIO B IRAGORRY,PQ. CA A DE AZUCAR,UNIDAD EDUCACATIVA AUTONOMA MARIA LUISA PAREDES DE ANTONINI.,879,2,11,807,507,796,0,4,1,0,284,807
EDO. ARAGUA,MP. MARIO B IRAGORRY,PQ. CA A DE AZUCAR,INSTITUTO DE EDUCACION ESPECIAL ROMULO GALLEGOS,2624,5,31,2335,1128,2304,2,13,1,0,1160,2335
EDO. ARAGUA,MP. MARIO B IRAGORRY,PQ. CA A DE AZUCAR,CENTRO EXPERIMENTAL DE ARTES Y CIENCIAS ARAGUA PROGRAMA TALENTO,1262,3,14,1108,551,1094,0,4,0,0,539,1108
EDO. ARAGUA,MP. MARIO B IRAGORRY,PQ. CA A DE AZUCAR,TALLER DE EDUCACION LABORAL MARACAY,1327,3,16,1122,587,1106,0,7,0,0,512,1122
EDO. ARAGUA,MP. MARIO B IRAGORRY,PQ. CA A DE AZUCAR,ESCUELA BOLIVARIANA MARIA MAYOR RODRIGUEZ,2110,4,24,1786,1034,1762,0,2,0,3,723,1786
EDO. ARAGUA,MP. MARIO B IRAGORRY,PQ. CA A DE AZUCAR,CENTRO DE EDUCACION INTEGRAL ANTONIO PEREZ BONALDE,352,1,0,322,228,322,0,2,0,0,92,322
EDO. ARAGUA,MP. MARIO B IRAGORRY,PQ. CA A DE AZUCAR,INCE TEXTIL,2187,4,27,1879,957,1852,0,5,2,0,888,1879
EDO. ARAGUA,MP. MARIO B IRAGORRY,PQ. CA A DE AZUCAR,UNIDAD EDUCATIVA NACIONAL BOLIVARIANA DOCTOR ALBERTO JOSE FERNANDEZ,3842,7,47,3266,1607,3219,1,8,4,3,1596,3266
EDO. ARAGUA,MP. MARIO B IRAGORRY,PQ. CA A DE AZUCAR,ESCUELA BASICA MONSEOR FELICIANO GONZALEZ,2345,5,42,2041,1037,1999,0,12,2,0,948,2041
EDO. ARAGUA,MP. MARIO B IRAGORRY,PQ. CA A DE AZUCAR,UNIDAD EDUCATIVA  EDUARDO ASSEF RAIDI,3924,7,58,3354,1910,3296,1,15,1,5,1364,3354
EDO. ARAGUA,MP. MARIO B IRAGORRY,PQ. CA A DE AZUCAR,PREESCOLAR EXPERIMENTAL COLIBRI 1,1447,3,16,1253,660,1237,0,3,0,0,574,1253
EDO. ARAGUA,MP. MARIO B IRAGORRY,PQ. CA A DE AZUCAR,UNIDAD EDUCATIVA PRIVADA SAN VICENTE DE PAUL.,748,2,8,686,374,678,0,4,2,0,298,686
EDO. ARAGUA,MP. URDANETA,PQ. TAGUAY,ESCUELA BASICA MAESTRO LUIS JOSE BRAVO,1838,4,42,1510,955,1468,0,10,0,2,501,1510
EDO. ARAGUA,MP. URDANETA,PQ. TAGUAY,ESCUELA BASICA ESTADAL DOS MONTES,632,2,7,563,499,556,1,8,0,0,48,563
EDO. ARAGUA,MP. URDANETA,PQ. TAGUAY,UNIDAD EDUCATIVA ESTADAL NARE,329,1,3,279,214,276,0,1,0,0,61,279
EDO. ARAGUA,MP. URDANETA,PQ. TAGUAY,ESCUELA BASICA ESTADAL CONCENTRADA LA SUAREÑA,522,1,15,404,320,389,0,0,1,0,68,404
EDO. ARAGUA,MP. URDANETA,PQ. SAN FRANCISCO DE CARA,ESCUELA ESTADAL GUANAYEN,341,1,6,311,277,305,0,0,0,0,28,311
EDO. ARAGUA,MP. URDANETA,PQ. SAN FRANCISCO DE CARA,UNIDAD EDUCATIVA NACIONAL SAN FRANCISCO DE CARA,1627,3,35,1299,822,1264,0,4,0,0,438,1299
EDO. ARAGUA,MP. URDANETA,CM. BARBACOAS,UNIDAD EDUCATIVA FRANCISCO SALDIVIA LANDAETA,1725,3,50,1369,790,1319,0,11,1,1,516,1369
EDO. ARAGUA,MP. URDANETA,CM. BARBACOAS,ESCUELA UNITARIA SAMANITO,488,1,9,425,382,416,0,0,1,0,33,425
EDO. ARAGUA,MP. URDANETA,CM. BARBACOAS,ESCUELA BASICA ESTADAL JOSE RAFAEL CARBALLO,444,1,15,389,310,374,0,3,2,0,59,389
EDO. ARAGUA,MP. URDANETA,CM. BARBACOAS,ESCUELA BASICA ESTADAL CECILIO ACOSTA,871,2,18,752,511,734,0,3,0,0,220,752
EDO. ARAGUA,MP. URDANETA,CM. BARBACOAS,ESCUELA UNITARIA Nº 403,748,2,20,630,516,610,0,1,0,0,93,630
EDO. ARAGUA,MP. URDANETA,CM. BARBACOAS,ESCUELA BASICA ESTADAL UNITARIA EL COROZO,302,1,1,246,232,245,0,1,0,0,12,246
EDO. ARAGUA,MP. URDANETA,CM. BARBACOAS,ESCUELA BASICA MIGUEL ZAMORA BOLIVAR,797,2,32,658,552,626,0,3,0,0,71,658
EDO. ARAGUA,MP. URDANETA,CM. BARBACOAS,ESCUELA BASICA RAFAEL BOLIVAR CORONADO,2069,4,54,1688,930,1634,0,3,0,2,699,1688
EDO. ARAGUA,MP. URDANETA,CM. BARBACOAS,PREESCOLAR NACIONAL BOLIVARIANO BARBACOAS,1177,2,32,988,603,956,0,7,0,1,345,988
EDO. ARAGUA,MP. URDANETA,PQ. LAS PE#ITAS,ESCUELA BASICA ESTADAL CONCENTRADA EL MEDANO,316,1,11,249,181,238,0,2,0,0,55,249
EDO. ARAGUA,MP. URDANETA,PQ. LAS PE#ITAS,UNIDAD EDUCATIVA ESTADAL JUAN RAMOS,1062,2,28,860,545,832,1,2,1,1,282,860
EDO. ARAGUA,MP. URDANETA,PQ. LAS PE#ITAS,UNIDAD EDUCATIVA ESTADAL CONCENTRADA PAN DE AZUCAR,319,1,8,262,211,254,0,1,0,0,42,262
EDO. ARAGUA,MP. JOSE FELIX RIVAS,PQ. CASTOR NIEVES RIOS,UNIDAD EDUCATIVA NACIONAL VICENTE EMILIO SOJO,2515,5,30,2188,1140,2158,0,10,0,2,1006,2188
EDO. ARAGUA,MP. JOSE FELIX RIVAS,PQ. CASTOR NIEVES RIOS,ESCUELA BASICA LUIS AUGUSTO MACHADO,5176,9,91,4452,1594,4361,1,16,3,2,2745,4452
EDO. ARAGUA,MP. JOSE FELIX RIVAS,PQ. CASTOR NIEVES RIOS,ESCUELA BASICA NACIONAL LA MORA (A.I),3458,6,42,2952,1575,2910,0,19,1,2,1313,2952
EDO. ARAGUA,MP. JOSE FELIX RIVAS,PQ. CASTOR NIEVES RIOS,UNIDAD EDUCATIVA NACIONAL  MIGUEL ALVAREZ,3712,7,60,3176,1649,3116,0,13,1,3,1450,3176
EDO. ARAGUA,MP. JOSE FELIX RIVAS,PQ. CASTOR NIEVES RIOS,ESCUELA BASICA ELBA GONZALEZ DE GIL,2522,5,39,2195,1153,2156,0,5,0,2,996,2195
EDO. ARAGUA,MP. JOSE FELIX RIVAS,PQ. CASTOR NIEVES RIOS,UNIDAD EDUCATIVA NACIONAL LA VICTORIA,2808,5,31,2398,1148,2367,0,2,1,4,1212,2398
EDO. ARAGUA,MP. JOSE FELIX RIVAS,PQ. CASTOR NIEVES RIOS,COLEGIO MARIANO MONTILLA,1325,3,12,1110,530,1098,0,5,2,0,561,1110
EDO. ARAGUA,MP. JOSE FELIX RIVAS,PQ. CASTOR NIEVES RIOS,ESCUELA BASICA NACIONAL MARIA LUISA ANTONINI DE PAREDES,2652,5,56,2300,1138,2244,0,13,1,3,1089,2300
EDO. ARAGUA,MP. JOSE FELIX RIVAS,PQ. CASTOR NIEVES RIOS,UNIDAD EDUCATIVA NACIONAL RAMON GARCIA DE SENA,4111,8,107,3588,1854,3481,0,24,2,3,1598,3588
EDO. ARAGUA,MP. JOSE FELIX RIVAS,PQ. CASTOR NIEVES RIOS,SERVICIO AUTONOMO CENTRO EUROVENEZOLANO DE DESARROLLO EMPRESARIAL,1519,3,30,1406,634,1376,0,1,0,1,740,1406
EDO. ARAGUA,MP. JOSE FELIX RIVAS,PQ. CASTOR NIEVES RIOS,CENTRO CAPACITACION ADULTOS ESTADAL CARMEN PILAR FERNANDEZ,3701,7,38,3275,1620,3237,1,10,1,1,1604,3275
EDO. ARAGUA,MP. JOSE FELIX RIVAS,PQ. ZUATA,PREESCOLAR BOLIVARIANO 12 DE FEBRERO,586,1,9,521,444,512,0,2,0,0,66,521
EDO. ARAGUA,MP. JOSE FELIX RIVAS,PQ. ZUATA,LICEO BOLIVARIANO ZUATA,2990,6,65,2344,1619,2279,1,12,2,0,645,2344
EDO. ARAGUA,MP. JOSE FELIX RIVAS,PQ. ZUATA,UNIDAD EDUCATIVA ESTADAL CONCENTRADA PUNTA DEL MONTE,162,1,4,138,120,134,0,0,0,0,14,138
EDO. ARAGUA,MP. JOSE FELIX RIVAS,PQ. ZUATA,UNIDAD EDUCATIVA ESTADAL RURAL CONCENTRADA SAN JOSE,1404,3,34,1175,905,1141,0,3,0,1,232,1175
EDO. ARAGUA,MP. JOSE FELIX RIVAS,PQ. ZUATA,UNIDAD EDUCATIVA ESTADAL NEGRA MATEA,3233,6,46,2378,1809,2332,2,15,1,0,505,2378
EDO. ARAGUA,MP. JOSE FELIX RIVAS,PQ. ZUATA,PREESCOLAR BOLIVARIANO BELLO MONTE II,761,2,20,665,511,645,0,4,0,0,130,665
EDO. ARAGUA,MP. JOSE FELIX RIVAS,PQ. ZUATA,UNIDAD EDUCATIVA PRIVADA NUESTRA SEÑORA DEL ROSARIO,765,2,11,665,532,654,0,5,3,0,114,665
EDO. ARAGUA,MP. JOSE FELIX RIVAS,PQ. ZUATA,UNIDAD EDUCATIVA ESTADAL PRIMITIVO DE JESUS,1543,3,20,1368,1166,1348,0,4,0,0,178,1368
EDO. ARAGUA,MP. JOSE FELIX RIVAS,PQ. ZUATA,UNIDAD EDUCATIVA NACIONAL CREACION JOBALITO,723,2,19,622,513,603,0,2,1,0,87,622
EDO. ARAGUA,MP. JOSE FELIX RIVAS,PQ. ZUATA,UNIDAD EDUCATIVA NACIONAL ZUATA NUEVA SEDE,3067,6,62,2483,1775,2421,0,20,0,3,623,2483
EDO. ARAGUA,MP. JOSE FELIX RIVAS,PQ. ZUATA,UNIDAD EDUCATIVA NACIONAL SIMON BOLIVAR,3020,6,40,2629,2293,2589,0,4,1,1,290,2629
EDO. ARAGUA,MP. JOSE FELIX RIVAS,PQ. ZUATA,CASA HOGAR MONSEÑOR LOPEZ AVELEDO,241,1,4,226,183,222,0,1,0,1,37,226
EDO. ARAGUA,MP. JOSE FELIX RIVAS,PQ. PAO DE ZARATE,UNIDAD EDUCATIVA ESTADAL RURAL CRUZ GUEVARA,2280,4,33,1840,1466,1807,1,6,3,2,329,1840
EDO. ARAGUA,MP. JOSE FELIX RIVAS,PQ. LAS GUACAMAYAS,CENTRO MOVIL ESTADIUM DEL POBLADO LAS GUACAMAYAS.,669,2,20,568,426,548,0,1,0,0,121,568
EDO. ARAGUA,MP. JOSE FELIX RIVAS,PQ. LAS GUACAMAYAS,ESCUELA GRADUADA RICARDO MONTILLA,3136,6,64,2462,1577,2398,2,9,1,1,808,2462
EDO. ARAGUA,MP. JOSE FELIX RIVAS,PQ. LAS GUACAMAYAS,CASA DE INTEGRACION ESCUELITA VIEJA,667,2,12,591,427,579,0,7,0,0,145,591
EDO. ARAGUA,MP. JOSE FELIX RIVAS,CM. JUAN VICENTE BOLIVAR,CENTRO LA CASONA,843,2,29,726,499,697,0,5,1,0,192,726
EDO. ARAGUA,MP. JOSE FELIX RIVAS,CM. JUAN VICENTE BOLIVAR,ESCUELA BASICA NACIONAL CECILIO ACOSTA,3423,6,78,2725,1778,2647,0,19,2,0,848,2725
EDO. ARAGUA,MP. JOSE FELIX RIVAS,CM. JUAN VICENTE BOLIVAR,ESCUELA BASICA ESTADAL JOSE MARIA ALVAREZ JARAMILLO,3207,6,36,2619,810,2583,0,12,1,0,1760,2619
EDO. ARAGUA,MP. JOSE FELIX RIVAS,CM. JUAN VICENTE BOLIVAR,UNIDAD EDUCATIVA ESTADAL RURAL PIE DE CERRO,794,2,9,609,404,600,1,3,0,1,191,609
EDO. ARAGUA,MP. JOSE FELIX RIVAS,CM. JUAN VICENTE BOLIVAR,UNIDAD EDUCATIVA ESTADAL 23 DE ENERO,2061,4,25,1713,1320,1688,0,10,1,1,356,1713
EDO. ARAGUA,MP. JOSE FELIX RIVAS,CM. JUAN VICENTE BOLIVAR,UNIDAD EDUCATIVA COLEGIO MARIA DE LA PAZ,1454,3,13,1322,336,1309,0,1,0,0,972,1322
EDO. ARAGUA,MP. JOSE FELIX RIVAS,CM. JUAN VICENTE BOLIVAR,ESCUELA TECNICA INDUSTRIAL,2882,5,38,2291,973,2253,1,5,2,2,1270,2291
EDO. ARAGUA,MP. JOSE FELIX RIVAS,CM. JUAN VICENTE BOLIVAR,UNIDAD EDUCATIVA NACIONAL FRANCISCO JAVIER USTARIZ,798,2,9,723,530,714,0,2,1,1,180,723
EDO. ARAGUA,MP. JOSE FELIX RIVAS,CM. JUAN VICENTE BOLIVAR,ESCUELA BASICA SERGIO MEDINA,3917,7,63,3179,2116,3116,1,20,4,2,973,3179
EDO. ARAGUA,MP. JOSE FELIX RIVAS,CM. JUAN VICENTE BOLIVAR,ESCUELA BASICA BRITO,3090,6,52,2640,1549,2588,2,13,2,4,1018,2640
EDO. ARAGUA,MP. JOSE FELIX RIVAS,CM. JUAN VICENTE BOLIVAR,ESCUELA BASICA ESTADAL RUDENCINDO CANELON,1297,3,32,1150,948,1118,1,2,1,1,165,1150
EDO. ARAGUA,MP. JOSE FELIX RIVAS,CM. JUAN VICENTE BOLIVAR,UNIDAD EDUCATIVA NACIONAL RUBEN DARIO,2233,4,31,1780,819,1749,1,7,0,1,921,1780
EDO. ARAGUA,MP. JOSE FELIX RIVAS,CM. JUAN VICENTE BOLIVAR,UNIDAD EDUCATIVA PRIVADA COLEGIO FRANCISCO MIGUEL JAIME OCHOA,744,2,8,669,299,661,0,3,0,1,358,669
EDO. ARAGUA,MP. JOSE FELIX RIVAS,CM. JUAN VICENTE BOLIVAR,BIBLIOTECA VIRTUAL DE LA VICTORIA,717,2,5,659,253,654,1,3,1,2,394,659
EDO. ARAGUA,MP. JOSE FELIX RIVAS,CM. JUAN VICENTE BOLIVAR,CICLO DIVERSIFICADO JOSE FELIX RIVAS,4440,8,53,3513,1084,3460,0,18,1,5,2352,3513
EDO. ARAGUA,MP. JOSE FELIX RIVAS,CM. JUAN VICENTE BOLIVAR,ESCUELA BASICA ESTADAL AMERICA FERNANDEZ DE LEONI,5220,10,132,4393,3193,4261,1,27,5,1,1034,4393
EDO. ARAGUA,MP. JOSE FELIX RIVAS,CM. JUAN VICENTE BOLIVAR,UNIDAD EDUCATIVA NACIONAL 12 DE FEBRERO,2010,4,26,1571,701,1545,3,8,0,0,833,1571
EDO. ARAGUA,MP. JOSE FELIX RIVAS,CM. JUAN VICENTE BOLIVAR,COLEGIO MADRE EMILIA,2736,5,58,2231,1290,2173,1,13,3,1,865,2231
EDO. ARAGUA,MP. JOSE FELIX RIVAS,CM. JUAN VICENTE BOLIVAR,ESCUELA BASICA NACIONAL LA QUEBRADA,994,2,34,849,728,815,0,7,2,0,78,849
EDO. ARAGUA,MP. SAN SEBASTIAN,CM. SAN SEBASTIAN,UNIDAD EDUCATIVA NACIONAL BRISAS DE MOSOCO,251,1,4,218,188,214,0,0,0,0,26,218
EDO. ARAGUA,MP. SAN SEBASTIAN,CM. SAN SEBASTIAN,ESCUELA ESTADAL UNITARIA Nº 256,307,1,10,229,172,219,1,1,1,0,44,229
EDO. ARAGUA,MP. SAN SEBASTIAN,CM. SAN SEBASTIAN,ESCUELA UNITARIA Nº 131,69,1,0,40,24,40,0,0,1,0,15,40
EDO. ARAGUA,MP. SAN SEBASTIAN,CM. SAN SEBASTIAN,CICLO BASICO ELICEO ACOSTA,2926,5,33,2383,1361,2350,2,10,2,0,975,2383
EDO. ARAGUA,MP. SAN SEBASTIAN,CM. SAN SEBASTIAN,CENTRO DE EDUCACION INICIAL PEDRO ALDAO,466,1,9,414,287,405,0,1,0,0,117,414
EDO. ARAGUA,MP. SAN SEBASTIAN,CM. SAN SEBASTIAN,UNIDAD EDUCATIVA NACIONAL WENCESLAO CASADO FONSECA,3313,6,42,2695,1443,2653,0,7,1,2,1200,2695
EDO. ARAGUA,MP. SAN SEBASTIAN,CM. SAN SEBASTIAN,ESCUELA UNITARIA Nº 95,549,1,10,414,321,404,0,1,1,0,81,414
EDO. ARAGUA,MP. SAN SEBASTIAN,CM. SAN SEBASTIAN,ESCUELA BASICA ESTADAL ANDRES RODRIGUEZ RAMIREZ,460,1,6,411,275,405,0,0,0,0,130,411
EDO. ARAGUA,MP. SAN SEBASTIAN,CM. SAN SEBASTIAN,CASA DE LOS NIÑOS MADRE MARIA DE SAN JOSE,570,1,11,511,370,500,0,0,0,0,130,511
EDO. ARAGUA,MP. SAN SEBASTIAN,CM. SAN SEBASTIAN,MODULO DE SERV CUATRICENTENARIO,1913,4,47,1591,898,1544,0,5,1,0,640,1591
EDO. ARAGUA,MP. SAN SEBASTIAN,CM. SAN SEBASTIAN,ESCUELA ESTADAL Nº 509,293,1,3,227,166,224,0,1,2,0,55,227
EDO. ARAGUA,MP. SAN SEBASTIAN,CM. SAN SEBASTIAN,ESCUELA BASICA PEDRO ALDAO,3682,7,46,2917,1829,2871,0,11,1,2,1028,2917
EDO. ARAGUA,MP. SAN SEBASTIAN,CM. SAN SEBASTIAN,ESCUELA ESPECIAL GUARATE,67,1,1,34,24,33,0,0,0,0,9,34
EDO. ARAGUA,MP. SAN SEBASTIAN,CM. SAN SEBASTIAN,ESCUELA CONCENTRADA LA GUAMA,1370,3,22,1129,704,1107,0,2,1,1,399,1129
EDO. ARAGUA,MP. SAN CASIMIRO,CM. SAN CASIMIRO,ESCUELA COMPLETA Nº 476 253,1093,2,20,886,629,866,0,3,0,0,234,886
EDO. ARAGUA,MP. SAN CASIMIRO,CM. SAN CASIMIRO,UNIDAD EDUCATIVA ESTADAL RURAL COGOLLAL,570,1,5,472,292,467,0,2,0,0,173,472
EDO. ARAGUA,MP. SAN CASIMIRO,CM. SAN CASIMIRO,ESCUELA BASICA ESTADAL AUGUSTA CARABALLO DE BLANCO,835,2,17,731,560,714,0,2,1,0,151,731
EDO. ARAGUA,MP. SAN CASIMIRO,CM. SAN CASIMIRO,UNIDAD ESTADAL GOLFO TRISTE,105,1,1,95,80,94,1,0,0,0,13,95
EDO. ARAGUA,MP. SAN CASIMIRO,CM. SAN CASIMIRO,ESCUELA EL LORO,1113,2,23,880,721,857,0,1,0,1,134,880
EDO. ARAGUA,MP. SAN CASIMIRO,CM. SAN CASIMIRO,ESCUELA ESTADAL UNITARIA Nº 572,300,1,5,238,220,233,0,0,0,0,13,238
EDO. ARAGUA,MP. SAN CASIMIRO,CM. SAN CASIMIRO,INSTITUTO DE EDUCACION ESPECIAL,465,1,2,414,316,412,0,0,0,0,96,414
EDO. ARAGUA,MP. SAN CASIMIRO,CM. SAN CASIMIRO,GRUPO ESCOLAR FRANCISCO ISNARDY,3388,6,73,2721,1603,2648,0,9,5,1,1030,2721
EDO. ARAGUA,MP. SAN CASIMIRO,CM. SAN CASIMIRO,ESCUELA BASICA ANDRES BELLO,982,2,25,811,520,786,0,4,0,0,262,811
EDO. ARAGUA,MP. SAN CASIMIRO,CM. SAN CASIMIRO,UNIDAD EDUCATIVA ESTADAL EL MAMON,669,2,10,594,467,584,0,3,0,0,114,594
EDO. ARAGUA,MP. SAN CASIMIRO,CM. SAN CASIMIRO,ESCUELA BOCA DE ZUATA 435 553,519,1,8,392,294,384,0,0,1,0,89,392
EDO. ARAGUA,MP. SAN CASIMIRO,CM. SAN CASIMIRO,UNIDAD EDUCATIVA ESTADAL SANTA ANA,1553,3,60,1273,713,1213,1,8,0,1,490,1273
EDO. ARAGUA,MP. SAN CASIMIRO,CM. SAN CASIMIRO,ESCUELA ESTADAL UNITARIA Nº 137 528,288,1,2,226,164,224,0,0,0,0,60,226
EDO. ARAGUA,MP. SAN CASIMIRO,CM. SAN CASIMIRO,UNIDAD EDUCATIVA LAS COCUIZAS,1293,3,21,1094,595,1073,1,2,0,0,475,1094
EDO. ARAGUA,MP. SAN CASIMIRO,CM. SAN CASIMIRO,CICLO BASICO SAN CASIMIRO,1636,3,52,1308,786,1256,1,8,1,1,459,1308
EDO. ARAGUA,MP. SAN CASIMIRO,PQ. VALLE MORIN,ESCUELA BASICA NACIONAL BELEN MARTINEZ,90,1,4,86,74,82,0,0,0,0,8,86
EDO. ARAGUA,MP. SAN CASIMIRO,PQ. VALLE MORIN,ESCUELA BASICA VALLE MORIN,1107,2,17,886,596,869,1,10,0,2,260,886
EDO. ARAGUA,MP. SAN CASIMIRO,PQ. OLLAS DE CARAMACATE,ESCUELA CONCENTRADA Nº 88 383 387 467 537,652,2,10,483,391,473,0,3,1,0,78,483
EDO. ARAGUA,MP. SAN CASIMIRO,PQ. OLLAS DE CARAMACATE,ESCUELA BASICA ESTADAL CONCENTRADA LOS MANIRE,82,1,2,69,52,67,0,2,0,0,13,69
EDO. ARAGUA,MP. SAN CASIMIRO,PQ. OLLAS DE CARAMACATE,ESCUELA UNITARIA Nº 109,209,1,2,157,108,155,0,1,0,0,46,157
EDO. ARAGUA,MP. SAN CASIMIRO,PQ. GUIRIPA,ESCUELA NACIONAL CONCENTRADA Nº 227 3020,1137,2,28,920,590,892,0,1,2,0,299,920
EDO. ARAGUA,MP. SAN CASIMIRO,PQ. GUIRIPA,UNIDAD EDUCATIVA RURAL CARUTICO,177,1,1,159,145,158,0,1,0,0,12,159
EDO. ARAGUA,MP. SAN CASIMIRO,PQ. GUIRIPA,ESCUELA BASICA ESTADAL GUAMBRA,165,1,3,156,134,153,0,0,0,0,19,156
EDO. ARAGUA,MP. SANTIAGO MARI#O,PQ. ALFREDO PACHECO M,UNIDAD EDUCATIVA DOCTORA PRISILA LOPEZ,2469,5,32,2026,1373,1994,0,10,1,2,608,2026
EDO. ARAGUA,MP. SANTIAGO MARI#O,PQ. ALFREDO PACHECO M,PREESCOLAR NACIONAL BOLIVARIANO EL TIERRAL.,661,2,18,572,442,554,0,1,0,0,111,572
EDO. ARAGUA,MP. SANTIAGO MARI#O,PQ. ALFREDO PACHECO M,PREESCOLAR BOLIVARIANO EL TIERRAL,502,1,2,331,243,329,0,2,0,0,84,331
EDO. ARAGUA,MP. SANTIAGO MARI#O,PQ. ALFREDO PACHECO M,UNIDAD EDUCATIVA ESTADAL LAURA PACHECO MONSERRAT,3136,6,40,2629,1785,2589,1,13,0,3,787,2629
EDO. ARAGUA,MP. SANTIAGO MARI#O,PQ. ALFREDO PACHECO M,ESCUELA BASICA FRANCISCO LINARES ALCANTARA,5035,9,88,4136,2638,4048,0,32,3,1,1374,4136
EDO. ARAGUA,MP. SANTIAGO MARI#O,PQ. ALFREDO PACHECO M,ESCUELA BASICA ROMULO BETANCOURT,2666,5,50,2273,1418,2223,2,11,1,5,786,2273
EDO. ARAGUA,MP. SANTIAGO MARI#O,PQ. CHUAO,UNIDAD EDUCATIVA ESTADAL JOSE CASANOVA GODOY,995,2,10,789,679,779,0,3,0,0,97,789
EDO. ARAGUA,MP. SANTIAGO MARI#O,PQ. CHUAO,ESCUELA BASICA CONCENTRADA CEPE,134,1,0,111,90,111,0,0,1,0,20,111
EDO. ARAGUA,MP. SANTIAGO MARI#O,PQ. AREVALO APONTE,UNIDAD EDUCATIVA ESTADAL BALBINO BLANCO SANCHEZ,2814,5,68,2203,1636,2135,0,6,1,0,492,2203
EDO. ARAGUA,MP. SANTIAGO MARI#O,PQ. AREVALO APONTE,ESCUELA GUARAUGUTA,2625,5,46,2046,1314,2000,2,8,1,2,673,2046
EDO. ARAGUA,MP. SANTIAGO MARI#O,PQ. AREVALO APONTE,ESCUELA BASICA NACIONAL PEDRO AREVALO APONTE,558,1,7,408,335,401,0,1,1,0,64,408
EDO. ARAGUA,MP. SANTIAGO MARI#O,PQ. AREVALO APONTE,ESCUELA BASICA ESTADAL CONCENTRADA ROSA BARRETO,245,1,2,130,95,128,0,0,0,1,32,130
EDO. ARAGUA,MP. SANTIAGO MARI#O,PQ. AREVALO APONTE,ESCUELA BASICA SANTIAGO MARI O,1785,4,26,1461,934,1435,0,9,0,3,489,1461
EDO. ARAGUA,MP. SANTIAGO MARI#O,PQ. AREVALO APONTE,UNIDAD EDUCATIVA ESTADAL CONCENTRADA EL PEDREGAL,494,1,15,411,241,396,0,2,0,0,153,411
EDO. ARAGUA,MP. SANTIAGO MARI#O,PQ. AREVALO APONTE,ESCUELA BASICA DOCTOR RAFAEL SEIJAS,4684,9,49,3559,2627,3510,1,20,4,0,858,3559
EDO. ARAGUA,MP. SANTIAGO MARI#O,PQ. AREVALO APONTE,UNIDAD EDUCATIVA ESTADAL ROSELIANO BLANCO SANCHEZ,1069,2,16,843,643,827,0,5,0,1,178,843
EDO. ARAGUA,MP. SANTIAGO MARI#O,PQ. AREVALO APONTE,UNIDAD EDUCATIVA ESTADAL RAFAEL TAYLHADAT,4663,9,97,3576,2721,3479,2,17,2,2,735,3576
EDO. ARAGUA,MP. SANTIAGO MARI#O,PQ. AREVALO APONTE,UNIDAD EDUCATIVA ESTADAL RURAL ALFONZO RIVAS,746,2,23,573,468,550,0,2,0,0,80,573
EDO. ARAGUA,MP. SANTIAGO MARI#O,PQ. AREVALO APONTE,INSTITUTO  ESCUELA ESPECIALROSARIO DE PAYA,875,2,17,663,488,646,0,1,0,0,157,663
EDO. ARAGUA,MP. SANTIAGO MARI#O,PQ. AREVALO APONTE,UNIDAD EDUCATIVA ESTADAL RURAL CONCENTRADA LAS MERCEDES DE PAYA,420,1,0,189,169,189,0,1,0,0,19,189
EDO. ARAGUA,MP. SANTIAGO MARI#O,PQ. AREVALO APONTE,LICEO BOLIVARIANO ROSARIO DE PAYA.,1472,3,23,1162,934,1139,0,8,0,0,197,1162
EDO. ARAGUA,MP. SANTIAGO MARI#O,PQ. AREVALO APONTE,UNIDAD EDUCATIVA RURAL FELIX MANUEL LUCES,1283,3,17,989,814,972,0,2,1,0,155,989
EDO. ARAGUA,MP. SANTIAGO MARI#O,PQ. AREVALO APONTE,ESCUELA ESTADAL UNITARIA Nº 184,225,1,1,135,129,134,0,0,0,0,5,135
EDO. ARAGUA,MP. SANTIAGO MARI#O,PQ. AREVALO APONTE,ESCUELA LA MARCELOTA,778,2,10,635,450,625,0,9,1,1,164,635
EDO. ARAGUA,MP. SANTIAGO MARI#O,PQ. SAMAN DE GUERE,ESCUELA BASICA ROSA AMELIA FLORES,5908,11,85,4874,2904,4789,0,28,1,4,1852,4874
EDO. ARAGUA,MP. SANTIAGO MARI#O,PQ. SAMAN DE GUERE,CICLO COMBINADO GONZALITO,2590,5,64,2128,1369,2064,0,9,6,1,679,2128
EDO. ARAGUA,MP. SANTIAGO MARI#O,PQ. SAMAN DE GUERE,ESCUELA PRACTICA DE AGRICULTURA LA PROVIDENCIA INCE,2737,5,42,2260,1385,2218,2,13,0,1,817,2260
EDO. ARAGUA,MP. SANTIAGO MARI#O,PQ. SAMAN DE GUERE,ESCUELA BASICA ESTADAL  ABIGAIL LOZANO,841,2,10,732,467,722,0,2,1,0,252,732
EDO. ARAGUA,MP. SANTIAGO MARI#O,PQ. SAMAN DE GUERE,ESCUELA BASICA IVON GONZALEZ MARCANO,3654,7,51,3265,1027,3214,0,11,2,1,2173,3265
EDO. ARAGUA,MP. SANTIAGO MARI#O,PQ. SAMAN DE GUERE,ESCUELA BASICA NACIONAL  CREACION SOROCAIMA,536,1,1,417,299,416,0,2,0,2,113,417
EDO. ARAGUA,MP. SANTIAGO MARI#O,PQ. SAMAN DE GUERE,CENTRO SOCIAL MARACAY SOS,1413,3,24,1041,763,1017,0,7,1,0,246,1041
EDO. ARAGUA,MP. SANTIAGO MARI#O,PQ. SAMAN DE GUERE,ESCUELA PEDRO VILLACASTIN,3165,6,81,2674,1760,2593,1,14,0,0,818,2674
EDO. ARAGUA,MP. SANTIAGO MARI#O,PQ. SAMAN DE GUERE,ESCUELA BASICA JOSEFINA BOLIVAR DE GONZALEZ,2914,5,59,2438,1459,2379,0,23,1,2,894,2438
EDO. ARAGUA,MP. SANTIAGO MARI#O,PQ. SAMAN DE GUERE,ATENCIÓN NO CONVENCIONAL NACIONAL SOROCAIMA I.,1113,2,15,910,667,895,0,4,0,0,224,910
EDO. ARAGUA,MP. SANTIAGO MARI#O,PQ. SAMAN DE GUERE,CICLO BASICO MARIÑO,5292,10,119,4411,2619,4292,0,23,2,2,1646,4411
EDO. ARAGUA,MP. SANTIAGO MARI#O,PQ. SAMAN DE GUERE,ESPACIO  ALTERNATIVO NO CONVENCIONALES LA CASONA II,1490,3,42,1308,949,1266,0,7,2,1,307,1308
EDO. ARAGUA,MP. SANTIAGO MARI#O,PQ. SAMAN DE GUERE,ESCUELA BASICA ESTADAL CRISTINA BATISTA,4679,8,69,3853,2671,3784,2,20,6,1,1084,3853
EDO. ARAGUA,MP. SANTIAGO MARI#O,PQ. SAMAN DE GUERE,ESCUELA BASICA PROFESORA ARGELIA LAYA,4686,9,154,3937,2637,3783,1,18,0,0,1127,3937
EDO. ARAGUA,MP. SANTIAGO MARI#O,PQ. SAMAN DE GUERE,UNIDAD EDUCATIVA ESTADAL  ANDRES PACHECO MIRANDA,645,2,11,540,439,529,0,3,0,0,87,540
EDO. ARAGUA,MP. SANTIAGO MARI#O,PQ. SAMAN DE GUERE,ESCUELA BASICA ESTADAL CESAR RODRIGUEZ PALENCIA,3781,7,45,3242,1675,3197,0,9,2,1,1510,3242
EDO. ARAGUA,MP. SANTIAGO MARI#O,PQ. SAMAN DE GUERE,UNIDAD EDUCATIVA NACIONAL  SAMAN DE GUERE.,4053,7,58,3218,2027,3160,2,10,1,0,1120,3218
EDO. ARAGUA,MP. SANTIAGO MARI#O,CM. TURMERO,UNIDAD EDUCATIVA NACIONAL  NUESTRA SEÑORA DE LA CARIDAD DEL COBRE,1349,3,28,1036,617,1008,0,2,0,1,388,1036
EDO. ARAGUA,MP. SANTIAGO MARI#O,CM. TURMERO,UNIDAD EDUCATIVA PRIVADA BICENTENARIO DE LA INDEPENDENCIA,5318,10,39,4710,1390,4671,1,16,3,3,3258,4710
EDO. ARAGUA,MP. SANTIAGO MARI#O,CM. TURMERO,CICLO COMBINADO RAMON BASTIDAS,2994,6,28,2388,939,2360,4,8,0,1,1408,2388
EDO. ARAGUA,MP. SANTIAGO MARI#O,CM. TURMERO,ESCUELA BASICA NACIONAL TURMERO,5878,11,88,4686,3088,4598,0,23,3,3,1481,4686
EDO. ARAGUA,MP. SANTIAGO MARI#O,CM. TURMERO,CENTRO SUPERIOR EDUCACION ESPECIAL ARTURO SARCO VILLENA,3382,6,27,2915,987,2888,0,13,2,5,1881,2915
EDO. ARAGUA,MP. SANTIAGO MARI#O,CM. TURMERO,ESCUELA BASICA LA CANDELARIA,3709,7,21,3032,1106,3011,0,10,4,0,1891,3032
EDO. ARAGUA,MP. SANTIAGO MARI#O,CM. TURMERO,ESCUELA GRADUADA MARIANO PICON SALAS,4373,8,46,3723,1911,3677,0,13,2,2,1749,3723
EDO. ARAGUA,MP. SANTIAGO MARI#O,CM. TURMERO,UNIDAD EDUCATIVA LIBERTADOR,3500,7,23,2911,1011,2888,0,2,3,4,1868,2911
EDO. ARAGUA,MP. SANTIAGO MARI#O,CM. TURMERO,ESCUELA BASICA JOSE RAFAEL REVENGA,5747,11,61,4806,1570,4745,3,19,5,4,3144,4806
EDO. ARAGUA,MP. SANTIAGO MARI#O,CM. TURMERO,ESCUELA BASICA ESTADO MIRANDA,4357,8,58,3599,1573,3541,2,20,0,3,1943,3599
EDO. ARAGUA,CE. GIRARDOT,PQ. LOS TACARIGUAS,BIBLIOTECA VIRTUAL SAN VICENTE,546,1,2,433,333,431,0,1,0,1,96,433
EDO. ARAGUA,CE. GIRARDOT,PQ. LOS TACARIGUAS,ESCUELA BASICA PRIVADA ESCUELA TALLER SAN MARCELINO CHAMPAGNAT,904,2,27,782,665,755,0,7,0,0,83,782
EDO. ARAGUA,CE. GIRARDOT,PQ. LOS TACARIGUAS,ESCUELA BASICA ANIBAL CASTILLO,3599,7,41,2938,1735,2897,2,13,3,2,1142,2938
EDO. ARAGUA,CE. GIRARDOT,PQ. LOS TACARIGUAS,FUNDACION ORQUESTA  JUVENIL E INFANTIL DE ARAGUA,325,1,6,270,213,264,0,1,0,0,50,270
EDO. ARAGUA,CE. GIRARDOT,PQ. LOS TACARIGUAS,UNIDAD EDUCATIVA GRAN MARISCAL DE AYACUCHO,3748,7,38,3257,2116,3219,0,14,1,6,1082,3257
EDO. ARAGUA,CE. GIRARDOT,PQ. LOS TACARIGUAS,TALLER DE EDUCACION LABORAL NACIONAL SAN VICENTE EDUCACION ESPECIAL,337,1,8,297,225,289,0,2,0,0,62,297
EDO. ARAGUA,CE. GIRARDOT,PQ. LOS TACARIGUAS,UNIDAD EDUCATIVA DE ADULTO ESCUELA TALLER MONSEÑOR ARIAS BLANCO,945,2,16,800,588,784,0,3,0,1,192,800
EDO. ARAGUA,CE. GIRARDOT,PQ. LOS TACARIGUAS,UNIDAD EDUCATIVA LUIS BELTRAN PRIETO FIGUEROA,991,2,16,846,526,830,0,4,0,3,297,846
EDO. ARAGUA,CE. GIRARDOT,PQ. LOS TACARIGUAS,ESCUELA BASICA ATANACIO GIRARDOT,3179,6,33,2594,1397,2561,1,12,3,0,1148,2594
EDO. ARAGUA,CE. GIRARDOT,PQ. LOS TACARIGUAS,ESCUELA BASICA CIRO MALDONADO ZERPA,1757,3,14,1480,499,1466,0,6,0,1,960,1480
EDO. ARAGUA,CE. GIRARDOT,PQ. LOS TACARIGUAS,UNIDAD EDUCATIVA NACIONAL ALFREDO EMILIO BERROTERAN,1717,3,18,1383,674,1365,2,6,0,0,683,1383
EDO. ARAGUA,CE. GIRARDOT,PQ. LOS TACARIGUAS,ESCUELA BASICA NACIONAL.BALBINA GALVIS  DE RODRIGUEZ,289,1,6,245,168,239,0,3,0,0,68,245
EDO. ARAGUA,CE. GIRARDOT,PQ. LOS TACARIGUAS,ESCUELA BASICA ESTADAL ARMANDO REVERON,3157,6,47,2474,1761,2427,1,12,3,1,649,2474
EDO. ARAGUA,CE. GIRARDOT,PQ. LOS TACARIGUAS,UNIDAD EDUCATIVA NACIONAL EL VIÑEDO,1146,2,18,927,813,909,0,2,1,2,91,927
EDO. ARAGUA,CE. GIRARDOT,PQ. LOS TACARIGUAS,ESCUELA ESTADAL 24 DE JULIO,474,1,4,342,284,338,0,0,1,0,53,342
EDO. ARAGUA,CE. GIRARDOT,PQ. LOS TACARIGUAS,CASA DE LOS NINOS MAESTRO JOSE VICENTE GONZALEZ,122,1,3,105,88,102,0,0,0,0,14,105
EDO. ARAGUA,CE. GIRARDOT,PQ. LOS TACARIGUAS,UNIDAD EDUCATIVA PRIVADA PEDRO EMILIO COLL,407,1,10,324,209,314,0,1,0,2,102,324
EDO. ARAGUA,CE. GIRARDOT,PQ. LOS TACARIGUAS,ESCUELA BASICA AGUSTIN AVELEDO,3469,6,48,2789,1674,2741,3,12,1,1,1050,2789
EDO. ARAGUA,CE. GIRARDOT,PQ. LOS TACARIGUAS,PREESCOLAR SIMON BOLIVAR,3229,6,79,2610,1916,2531,2,13,2,1,597,2610
EDO. ARAGUA,CE. GIRARDOT,PQ. LOS TACARIGUAS,CENTRO DE EDUCACIÓN INICIAL   JABILIO REYES OCHOA.,243,1,5,207,119,202,0,0,0,0,83,207
EDO. ARAGUA,CE. GIRARDOT,PQ. LOS TACARIGUAS,ESCUELA BASICA FEDERICO GARCIA ARIAS,1709,3,16,1300,962,1284,0,3,1,1,317,1300
EDO. ARAGUA,CE. GIRARDOT,PQ. LOS TACARIGUAS,ESCUELA BASICA JOSE MARIA BENITEZ,3922,7,83,3370,1650,3287,0,25,0,2,1610,3370
EDO. ARAGUA,CE. GIRARDOT,PQ. LOS TACARIGUAS,UNIDAD EDUCATIVA .ESTADAL GENERAL JOSE DE SAN MARTIN,728,2,5,644,439,639,0,0,0,0,200,644
EDO. ARAGUA,CE. GIRARDOT,PQ. LOS TACARIGUAS,UNIDAD EDUCATIVA NACIONAL  ANTONIO GARCIA ROJO,4982,9,56,4034,3222,3978,1,24,0,0,731,4034
EDO. ARAGUA,CE. GIRARDOT,PQ. LOS TACARIGUAS,ESCUELA BASICA ELIODORO BETANCOURT,4210,8,74,3455,1794,3381,1,18,0,1,1567,3455
EDO. ARAGUA,CE. GIRARDOT,PQ. LOS TACARIGUAS,ESCUELA BASICA CONCENTRADA SAN VICENTE,1881,4,27,1474,1091,1447,2,8,0,0,346,1474
EDO. ARAGUA,CE. GIRARDOT,PQ. LOS TACARIGUAS,UNIDAD EDUCATIVA PADRE JUAN JOSE ZUGARRAMUNDI (FE Y ALEGRIA),983,2,26,791,637,765,0,5,1,0,122,791
EDO. ARAGUA,CE. GIRARDOT,PQ. LOS TACARIGUAS,ESCUELA TECNICA INDUSTRIAL JOAQUIN AVELLAN,2226,4,36,1799,747,1763,3,3,2,1,1007,1799
EDO. ARAGUA,CE. GIRARDOT,PQ. LOS TACARIGUAS,UNIDAD EDUCATIVA PRIVADA JESUS CAUTIVO.,410,1,4,381,205,377,0,3,0,1,168,381
EDO. ARAGUA,CE. GIRARDOT,PQ. LOS TACARIGUAS,UNIVERSIDAD POLITECNICA TERRITORIAL DE ARAGUA EXTENCION MARACAY,474,1,6,372,314,366,1,2,0,0,49,372
EDO. ARAGUA,CE. GIRARDOT,PQ. LOS TACARIGUAS,ESCUELA BASICA PADRE LOPEZ AVELEDO,4158,8,51,3371,2225,3320,2,15,1,0,1077,3371
EDO. ARAGUA,CE. GIRARDOT,PQ. LOS TACARIGUAS,UNIDAD EDUCATIVA PRIVADA. JUAN ANTONIO PEREZ BONALDE,301,1,4,271,186,267,0,1,0,0,80,271
EDO. ARAGUA,CE. GIRARDOT,PQ. MADRE MA DE SAN JOSE,ALDEA UNIVERSITARIA ANTONIO JOSE DE SUCRE,2267,4,30,1736,472,1706,0,6,1,1,1226,1736
EDO. ARAGUA,CE. GIRARDOT,PQ. MADRE MA DE SAN JOSE,CENTRO DE DESARROLLO INFANTIL ARAGUA,2118,4,11,1953,363,1942,2,7,1,0,1569,1953
EDO. ARAGUA,CE. GIRARDOT,PQ. MADRE MA DE SAN JOSE,CONSERVATORIO DE MUSICA,5247,10,30,4073,464,4043,0,6,0,2,3571,4073
EDO. ARAGUA,CE. GIRARDOT,PQ. MADRE MA DE SAN JOSE,CICLO BASICO  CARLOS ARRIETA,4925,9,34,4264,968,4230,3,10,2,3,3244,4264
EDO. ARAGUA,CE. GIRARDOT,PQ. MADRE MA DE SAN JOSE,ESCUELA BASICA ANTONIA ESTELLER,3585,7,51,2880,1451,2829,1,11,3,2,1361,2880
EDO. ARAGUA,CE. GIRARDOT,PQ. MADRE MA DE SAN JOSE,CICLO BASICO ARAGUA,1011,2,9,756,250,747,0,5,0,0,492,756
EDO. ARAGUA,CE. GIRARDOT,PQ. MADRE MA DE SAN JOSE,ESCUELA BASICA ESTADAL  JULIO MORALES LARA,2530,5,34,2110,940,2076,0,8,0,1,1127,2110
EDO. ARAGUA,CE. GIRARDOT,PQ. MADRE MA DE SAN JOSE,BIBLIOTECA VIRTUAL,2848,5,18,2363,388,2345,0,5,1,0,1951,2363
EDO. ARAGUA,CE. GIRARDOT,PQ. MADRE MA DE SAN JOSE,SAPANA,731,2,18,590,238,572,0,2,0,0,332,590
EDO. ARAGUA,CE. GIRARDOT,PQ. MADRE MA DE SAN JOSE,ESCUELA BASICA JUSTINA GUERRA,3417,6,51,2960,1617,2909,1,10,3,2,1276,2960
EDO. ARAGUA,CE. GIRARDOT,PQ. MADRE MA DE SAN JOSE,HOGAIN ATANACIO GIRARDOT (PARQUE DE EXPOSICION DE FERIAS),2881,6,17,2382,501,2365,0,6,2,0,1856,2382
EDO. ARAGUA,CE. GIRARDOT,PQ. MADRE MA DE SAN JOSE,CASA DE LA CULTURA,1263,3,11,1102,327,1091,0,2,0,0,762,1102
EDO. ARAGUA,CE. GIRARDOT,PQ. MADRE MA DE SAN JOSE,SEDE DEL COLEGIO DE PROFESORES DEL ESTADO ARAGUA,677,2,3,621,81,618,0,0,1,0,536,621
EDO. ARAGUA,CE. GIRARDOT,PQ. MADRE MA DE SAN JOSE,UNIDAD EDUCATIVA NACIONAL  LUIS MARIANO RIVERA,3735,7,32,3306,1589,3274,0,13,0,1,1671,3306
EDO. ARAGUA,CE. GIRARDOT,PQ. MADRE MA DE SAN JOSE,ESCUELA DE ARTE DRAMATICO SEDE ARAGUA,835,2,9,732,310,723,0,2,1,2,408,732
EDO. ARAGUA,CE. GIRARDOT,PQ. MADRE MA DE SAN JOSE,ESCUELA BASICA GREGORIA DIAZ,2942,5,31,2401,1281,2370,0,10,1,1,1077,2401
EDO. ARAGUA,CE. GIRARDOT,PQ. MADRE MA DE SAN JOSE,COLEGIO HUMBOLT,1666,3,4,1314,215,1310,0,1,0,2,1092,1314
EDO. ARAGUA,CE. GIRARDOT,PQ. MADRE MA DE SAN JOSE,UNIDAD EDUCATIVA NACIONAL BOLIVARIANO FELIPE GUEVARA ROJAS,2086,4,32,1611,750,1579,0,4,1,2,822,1611
EDO. ARAGUA,CE. GIRARDOT,PQ. MADRE MA DE SAN JOSE,LICEO AGUSTIN CODAZZI,4703,9,39,3765,575,3726,1,11,0,4,3135,3765
EDO. ARAGUA,CE. GIRARDOT,PQ. MADRE MA DE SAN JOSE,COLEGIO PRIVADO NUESTRA SEÑORA DE LAS MERCEDES DE ARAGUA,581,1,21,510,280,489,0,1,0,0,208,510
EDO. ARAGUA,CE. GIRARDOT,PQ. MADRE MA DE SAN JOSE,PRESCOLAR NACIONAL BOLIVARIANO MARIA TERESA TORO,898,2,5,743,299,738,0,1,1,0,437,743
EDO. ARAGUA,CE. GIRARDOT,PQ. MADRE MA DE SAN JOSE,ESCUELA BASICA VICTOR MANUEL PATIO,3551,7,35,2962,1130,2927,1,13,0,2,1781,2962
EDO. ARAGUA,CE. GIRARDOT,PQ. PEDRO JOSE OVALLES,ESCUELA BASICA NACIONAL SAN PEDRO ALEJANDRINO,448,1,6,398,293,392,0,1,0,0,98,398
EDO. ARAGUA,CE. GIRARDOT,PQ. PEDRO JOSE OVALLES,CASA USOS MULTIPLES LOS SAMANES,1511,3,13,1270,466,1257,0,7,1,1,782,1270
EDO. ARAGUA,CE. GIRARDOT,PQ. PEDRO JOSE OVALLES,PRE ESCOLAR BOLIVARIANO NACIONAL EDMUNDO ARENCIBIA,522,1,8,456,333,448,0,1,1,0,113,456
EDO. ARAGUA,CE. GIRARDOT,PQ. PEDRO JOSE OVALLES,ESCUELA BASICA ESTADAL ANTONIO JOSE DE SUCRE,886,2,7,788,640,781,0,5,0,0,136,788
EDO. ARAGUA,CE. GIRARDOT,PQ. PEDRO JOSE OVALLES,ESCUELA BASICA EDMUNDO ARENCIBIA,3988,7,56,3291,2316,3235,1,6,1,2,909,3291
EDO. ARAGUA,CE. GIRARDOT,PQ. PEDRO JOSE OVALLES,CICLO BASICA ATANACIO GIRARDOT,1080,2,16,912,618,896,0,4,0,1,273,912
EDO. ARAGUA,CE. GIRARDOT,PQ. PEDRO JOSE OVALLES,UNIDAD EDUCATIVA NACIONAL  LOS SAMANES,3060,6,38,2605,985,2567,0,17,3,2,1560,2605
EDO. ARAGUA,CE. GIRARDOT,PQ. PEDRO JOSE OVALLES,ESCUELA BASICA JULIO PAEZ,3139,6,44,2581,1848,2537,1,11,4,0,673,2581
EDO. ARAGUA,CE. GIRARDOT,PQ. PEDRO JOSE OVALLES,ESCUELA BASICA LETICIA MUDARRA DE LOPEZ,3829,7,60,3101,2109,3041,2,21,2,2,905,3101
EDO. ARAGUA,CE. GIRARDOT,PQ. PEDRO JOSE OVALLES,UNIDAD EDUCATIVA NACIONAL JOSE MARTI,311,1,5,261,195,256,0,0,0,0,61,261
EDO. ARAGUA,CE. GIRARDOT,PQ. PEDRO JOSE OVALLES,ESCUELA BASICA JOSE ANTONIO PAEZ,3457,6,40,2815,1987,2775,1,22,2,2,761,2815
EDO. ARAGUA,CE. GIRARDOT,PQ. PEDRO JOSE OVALLES,ESCUELA BASICA ISABEL TERESA RANGEL,2448,5,29,1932,1426,1903,0,10,1,4,462,1932
EDO. ARAGUA,CE. GIRARDOT,PQ. PEDRO JOSE OVALLES,UNIDAD EDUCATIVA ESTADAL ENRIQUE VASQUEZ FERMIN,3785,7,45,3204,1279,3159,0,10,3,1,1866,3204
EDO. ARAGUA,CE. GIRARDOT,PQ. PEDRO JOSE OVALLES,UNIDAD EDUCATIVA PRIVADA SANTA MARTA.,830,2,14,756,229,742,0,1,1,0,511,756
EDO. ARAGUA,CE. GIRARDOT,PQ. PEDRO JOSE OVALLES,ESCUELA BASICA SAN RAFAEL,1503,3,28,1260,833,1232,0,4,1,1,393,1260
EDO. ARAGUA,CE. GIRARDOT,PQ. PEDRO JOSE OVALLES,ESCUELA BASICA NACIONAL ANA FERNANDEZ RAMIREZ,2489,5,44,1959,1381,1915,2,13,2,3,514,1959
EDO. ARAGUA,CE. GIRARDOT,PQ. PEDRO JOSE OVALLES,JARDIN DE INFANCIA RIO BLANCO I,3433,6,78,2739,1891,2661,0,13,2,2,753,2739
EDO. ARAGUA,CE. GIRARDOT,PQ. PEDRO JOSE OVALLES,ESCUELA BASICA ARNOLDO GABALDON,3321,6,49,2728,1882,2679,0,16,3,3,775,2728
EDO. ARAGUA,CE. GIRARDOT,PQ. PEDRO JOSE OVALLES,PREESCOLAR NACIONAL JOSE GREGORIO HERNANDEZ,371,1,5,316,225,311,0,1,1,0,84,316
EDO. ARAGUA,CE. GIRARDOT,PQ. PEDRO JOSE OVALLES,UNIDAD EDUCATIVA PRIVADA DOCTOR LUIS RAZETTI,670,2,17,577,374,560,0,3,0,0,183,577
EDO. ARAGUA,CE. GIRARDOT,PQ. PEDRO JOSE OVALLES,UNIDAD EDUCATIVA COOPERATIVA LAS NIEVES,2449,5,26,2131,752,2105,1,9,3,1,1339,2131
EDO. ARAGUA,CE. GIRARDOT,PQ. JOAQUIN CRESPO,GRUPO ESCOLAR JESUS PACHECO ROJAS,4667,9,61,3612,1644,3551,2,20,3,5,1877,3612
EDO. ARAGUA,CE. GIRARDOT,PQ. JOAQUIN CRESPO,CENTRO DE ATENCION INTEGRAL A NIÑOS Y NIÑAS DE LA SEGUNDA INFANCIA DE MARACAY,1524,3,14,1254,498,1240,2,5,0,2,733,1254
EDO. ARAGUA,CE. GIRARDOT,PQ. JOAQUIN CRESPO,CENTRO JUVENIL PIÑONAL,2373,5,53,1906,928,1853,0,11,1,2,911,1906
EDO. ARAGUA,CE. GIRARDOT,PQ. JOAQUIN CRESPO,CASA DE USOS MULTIPLES GUASIMAL,883,2,11,788,680,777,1,3,0,0,93,788
EDO. ARAGUA,CE. GIRARDOT,PQ. JOAQUIN CRESPO,ESCUELA BASICA VENEZUELA,963,2,19,850,280,831,1,4,0,1,545,850
EDO. ARAGUA,CE. GIRARDOT,PQ. JOAQUIN CRESPO,CENTRO DE EDUCACION DE ADULTOS CACIQUE CHARAIMA,852,2,4,783,347,779,0,2,1,2,427,783
EDO. ARAGUA,CE. GIRARDOT,PQ. JOAQUIN CRESPO,PREESCOLAR PIOÑAL,2086,4,25,1688,809,1663,0,10,0,0,844,1688
EDO. ARAGUA,CE. GIRARDOT,PQ. JOAQUIN CRESPO,GRUPO ESCOLAR JESUS HERNANDEZ PRADO,6473,12,84,5415,2775,5331,0,27,4,3,2522,5415
EDO. ARAGUA,CE. GIRARDOT,PQ. JOAQUIN CRESPO,ESCUELA GRADUADA SANTOS MICHELENA,4015,7,41,3291,1468,3250,2,11,0,1,1768,3291
EDO. ARAGUA,CE. GIRARDOT,PQ. JOAQUIN CRESPO,ESCUELA BASICA JOSEFINA BRITO,1871,4,34,1606,911,1572,0,10,0,1,650,1606
EDO. ARAGUA,CE. GIRARDOT,PQ. JOAQUIN CRESPO,ESCUELA BASICA LAS ACACIAS,753,2,6,678,263,672,0,2,1,3,403,678
EDO. ARAGUA,CE. GIRARDOT,PQ. JOAQUIN CRESPO,LICEO JOSE LUIS RAMOS,5285,10,56,4393,1387,4337,1,17,2,3,2927,4393
EDO. ARAGUA,CE. GIRARDOT,PQ. JOAQUIN CRESPO,ESCUELA BASICA NACIONAL BOLIVARIANA MARACAY,3101,6,42,2618,1264,2576,0,15,0,0,1297,2618
EDO. ARAGUA,CE. GIRARDOT,PQ. JOAQUIN CRESPO,ESCUELA BASICA ARAGUA,3544,7,48,2936,1037,2888,1,10,1,2,1837,2936
EDO. ARAGUA,CE. GIRARDOT,PQ. JOAQUIN CRESPO,GRUPO ESCOLAR MIGUEL JOSE SANZ,2887,5,35,2413,926,2378,0,10,1,1,1440,2413
EDO. ARAGUA,CE. GIRARDOT,PQ. JOAQUIN CRESPO,ESCUELA GRADUADA JACOB PEREZ CARBALLO,2996,6,26,2552,934,2526,0,9,1,2,1580,2552
EDO. ARAGUA,CE. GIRARDOT,PQ. LAS DELICIAS,UNIVERSIDAD PEDAGOGICA MARACAY,2668,5,34,2010,636,1976,0,6,2,2,1330,2010
EDO. ARAGUA,CE. GIRARDOT,PQ. LAS DELICIAS,CICLO BASICO ANDRES BELLO,4919,9,46,3818,1514,3772,1,21,3,0,2233,3818
EDO. ARAGUA,CE. GIRARDOT,PQ. LAS DELICIAS,UNIDAD EDUCATIVA PRIVADA COLEGIO DOCTOR GUSTAVO H MACHADO,1708,3,17,1310,554,1293,2,7,0,2,728,1310
EDO. ARAGUA,CE. GIRARDOT,PQ. LAS DELICIAS,ESCUELA BASICA NACIONAL BOLIVARIANA SILANIA PERAZA UDDIS,1133,2,15,1003,663,988,0,3,1,3,318,1003
EDO. ARAGUA,CE. GIRARDOT,PQ. LAS DELICIAS,COLEGIO BELLA VISTA,2520,5,31,2137,1075,2106,1,4,4,1,1021,2137
EDO. ARAGUA,CE. GIRARDOT,PQ. LAS DELICIAS,FUNDACOMUN,1459,3,26,1159,606,1133,0,5,0,0,522,1159
EDO. ARAGUA,CE. GIRARDOT,PQ. LAS DELICIAS,UNIDAD EDUCATIVA ESTADAL DOLORES MENDOZA DE OSORIO,5348,10,102,4360,1826,4258,0,17,3,4,2408,4360
EDO. ARAGUA,CE. GIRARDOT,PQ. LAS DELICIAS,ESCUELA BASICA CRISTOBAL MENDOZA,3996,8,51,3272,1666,3221,1,22,1,1,1530,3272
EDO. ARAGUA,CE. GIRARDOT,PQ. LAS DELICIAS,UNIDAD EDUCATIVA PRIVADA INTERNACIONAL,3202,6,26,2696,710,2670,0,7,1,3,1949,2696
EDO. ARAGUA,CE. GIRARDOT,PQ. LAS DELICIAS,UNIDAD EDUCATIVA NACIONAL  FRANCISCO GUEDEZ COLMENARES,2974,6,40,2400,1066,2360,1,16,2,4,1271,2400
EDO. ARAGUA,CE. GIRARDOT,PQ. LAS DELICIAS,UNIDAD EDUCATIVA ESTADAL DOCTOR EMILIO MEDINA,1234,3,23,1076,650,1053,0,7,1,1,394,1076
EDO. ARAGUA,CE. GIRARDOT,PQ. LAS DELICIAS,ESCUELA BASICA NACIONAL LAS DELICIAS,3941,7,51,3150,1505,3099,0,7,0,1,1586,3150
EDO. ARAGUA,CE. GIRARDOT,PQ. LAS DELICIAS,CORPOSALUD,1915,4,23,1505,447,1482,1,5,0,0,1029,1505
EDO. ARAGUA,CE. GIRARDOT,PQ. LAS DELICIAS,UNIDAD EDUCATIVA NACIONAL BOLIVARIANA LOS NARAJOS I.,479,1,10,425,269,415,0,0,1,0,145,425
EDO. ARAGUA,CE. GIRARDOT,PQ. LAS DELICIAS,ESCUELA BASICA ANTONIO ARRAIZ,5467,10,69,4544,1863,4475,1,19,6,4,2582,4544
EDO. ARAGUA,CE. GIRARDOT,PQ. ANDRES ELOY BLANCO,ESCUELA BASICA EUTIMIO RIVAS,4412,8,60,3600,1720,3540,0,15,0,4,1801,3600
EDO. ARAGUA,CE. GIRARDOT,PQ. ANDRES ELOY BLANCO,ESCUELA BASICA ESTADAL TRINO CELIS RIOS,2737,5,25,2270,858,2245,0,9,1,0,1377,2270
EDO. ARAGUA,CE. GIRARDOT,PQ. ANDRES ELOY BLANCO,INSTITUTO TECNOLOGICO CARLOS SOUBLETTE,1820,4,13,1465,560,1452,2,8,1,1,880,1465
EDO. ARAGUA,CE. GIRARDOT,PQ. ANDRES ELOY BLANCO,ESCUELA BASICA PILAR PELGRON,1770,3,9,1517,389,1508,0,4,0,2,1113,1517
EDO. ARAGUA,CE. GIRARDOT,PQ. ANDRES ELOY BLANCO,ESCUELA BASICA ESTADAL  JOSE RAMON GONZALEZ BAQUERO,3182,6,47,2606,1679,2559,1,11,3,0,865,2606
EDO. ARAGUA,CE. GIRARDOT,PQ. ANDRES ELOY BLANCO,UNIDAD EDUCATIVA NACIONAL BASICA VALENTIN ESPINAL,2316,4,23,1880,728,1857,0,5,1,1,1122,1880
EDO. ARAGUA,CE. GIRARDOT,PQ. ANDRES ELOY BLANCO,COLEGIO LOPE DE VEGAS,1936,4,11,1526,449,1515,0,5,0,1,1060,1526
EDO. ARAGUA,CE. GIRARDOT,PQ. ANDRES ELOY BLANCO,ESCUELA BASICA NACIONAL BOLIVARIANA JACINTO FOMBONA PACHANO,1003,2,17,869,616,852,0,3,0,1,232,869
EDO. ARAGUA,CE. GIRARDOT,PQ. ANDRES ELOY BLANCO,ESCUELA BASICA INES ALFONSO DE PEREZ,1787,4,20,1451,967,1431,1,7,3,1,452,1451
EDO. ARAGUA,CE. GIRARDOT,PQ. ANDRES ELOY BLANCO,LICEO DON ROMULO GALLEGOS,2227,4,27,1816,810,1789,0,7,1,3,968,1816
EDO. ARAGUA,CE. GIRARDOT,PQ. ANDRES ELOY BLANCO,ESCUELA BASICA ARMANDO ZULUAGA BLANCO,1187,2,12,967,275,955,0,6,0,0,674,967
EDO. ARAGUA,CE. GIRARDOT,PQ. ANDRES ELOY BLANCO,INSTITUTO UNIVERSITARIO DE TECNOLOGIA ANTONIO RICAURTE,1221,3,12,1117,287,1105,0,1,2,1,814,1117
EDO. ARAGUA,CE. GIRARDOT,PQ. ANDRES ELOY BLANCO,ESCUELA BASICA REPUBLICA DE MEJICO,3197,6,22,2478,686,2456,0,9,2,1,1758,2478
EDO. ARAGUA,CE. GIRARDOT,PQ. ANDRES ELOY BLANCO,UNIDAD EDUCATIVA NACIONAL JOSE RIBAS BALBOA,937,2,7,751,581,744,0,1,0,0,162,751
EDO. ARAGUA,CE. GIRARDOT,PQ. ANDRES ELOY BLANCO,CICLO BASICO JUAN VICENTE BOLIVAR,3108,6,19,2486,664,2467,0,12,0,1,1790,2486
EDO. ARAGUA,CE. GIRARDOT,PQ. ANDRES ELOY BLANCO,UNIDAD EDUCATIVA ESPECIAL MARACAY,406,1,1,365,145,364,0,1,0,0,218,365
EDO. ARAGUA,CE. GIRARDOT,PQ. ANDRES ELOY BLANCO,MODULO DE SERVICIO BRISAS DEL LAGO,1148,2,11,925,624,914,2,7,1,0,280,925
EDO. ARAGUA,CE. GIRARDOT,PQ. ANDRES ELOY BLANCO,ESCUELA BASICA JOSE ANTONIO MAITIN,2238,4,16,1763,904,1747,0,7,4,1,831,1763
EDO. ARAGUA,CE. GIRARDOT,PQ. ANDRES ELOY BLANCO,ESCUELA BASICA ESTADAL LA DEMOCRACIA,3204,6,33,2525,918,2492,1,7,0,1,1565,2525
EDO. ARAGUA,CE. GIRARDOT,PQ. ANDRES ELOY BLANCO,ESCUELA BASICA VIRGINIA PEREZ DE ORAMAS,4784,9,92,3945,2679,3853,4,27,0,2,1141,3945
EDO. ARAGUA,CE. GIRARDOT,PQ. ANDRES ELOY BLANCO,ESCUELA BASICA NACIONAL BRISAS DEL LAGO,1097,2,15,888,616,873,0,1,1,1,254,888
EDO. ARAGUA,CE. GIRARDOT,PQ. JOSE CASANOVA GODOY,ESCUELA BASICA RAFAEL URDANETA,3434,6,73,2778,1436,2705,0,17,0,0,1252,2778
EDO. ARAGUA,CE. GIRARDOT,PQ. JOSE CASANOVA GODOY,ESCUELA BASICA VICTOR LINO GOMEZ,4654,8,68,3776,2585,3708,0,21,2,1,1099,3776
EDO. ARAGUA,CE. GIRARDOT,PQ. JOSE CASANOVA GODOY,INSTITUTO MARISCAL DE AYACUCHO,1442,3,26,1118,501,1092,0,9,0,0,582,1118
EDO. ARAGUA,CE. GIRARDOT,PQ. JOSE CASANOVA GODOY,ESCUELA BASICA MORAL Y LUCES,2927,5,33,2342,775,2309,0,9,0,0,1525,2342
EDO. ARAGUA,CE. GIRARDOT,PQ. JOSE CASANOVA GODOY,CENTRO DE EDUCACION INICIAL AQUILES NAZOA,470,1,7,418,309,411,0,2,0,0,100,418
EDO. ARAGUA,CE. GIRARDOT,PQ. JOSE CASANOVA GODOY,ESCUELA BASICA  PRIVADA VICENTE LECUNA,1113,2,4,927,233,923,0,3,0,1,686,927
EDO. ARAGUA,CE. GIRARDOT,PQ. JOSE CASANOVA GODOY,PREESCOLAR NACIONAL CAMPO ALEGRE,1359,3,26,1133,748,1107,0,6,2,2,349,1133
EDO. ARAGUA,CE. GIRARDOT,PQ. JOSE CASANOVA GODOY,ESCUELA BASICA NACIONAL ANDRES ELOY BLANCO,744,2,22,670,434,648,0,4,0,0,210,670
EDO. ARAGUA,CE. GIRARDOT,PQ. JOSE CASANOVA GODOY,UNIDAD EDUCATIVA PRIVADA INSTITUTO EDUCATIVO EL PRECURSOR,713,2,4,644,272,640,0,0,1,0,367,644
EDO. ARAGUA,CE. GIRARDOT,PQ. JOSE CASANOVA GODOY,ESCUELA BASICA MARY DIAZ DE ESPAA,3533,7,111,2853,1796,2742,0,15,5,2,924,2853
EDO. ARAGUA,CE. GIRARDOT,PQ. JOSE CASANOVA GODOY,CICLO BASICO MANUEL ANTONIO CARREÑO,3128,6,19,2637,523,2618,0,7,1,2,2085,2637
EDO. ARAGUA,CE. GIRARDOT,PQ. JOSE CASANOVA GODOY,CASA DE LOS NIÑOS SIMON CARREÑO RODRIGUEZ,760,2,14,657,397,643,0,3,2,0,241,657
EDO. ARAGUA,CE. GIRARDOT,PQ. JOSE CASANOVA GODOY,UNIDAD EDUCATIVA ESTADAL OLINTO MORA VASQUEZ,319,1,5,274,186,269,0,2,0,0,81,274
EDO. ARAGUA,CE. GIRARDOT,PQ. JOSE CASANOVA GODOY,ESCUELA PRIVADA ACADEMUS,3827,7,20,3312,553,3292,0,7,2,0,2730,3312
EDO. ARAGUA,CE. GIRARDOT,PQ. JOSE CASANOVA GODOY,ESCUELA BASICA LUCAS GUILLERMO CASTILLO,3856,7,28,3233,1041,3205,0,8,2,1,2153,3233
EDO. ARAGUA,CE. GIRARDOT,PQ. JOSE CASANOVA GODOY,CENTRO TALLER ASOCIACION PROMOCIÓN DE LA EDUCACIÓN POPULAR NUESTRA SEÑORA DE LOURDES,1709,3,31,1465,995,1434,1,7,1,2,428,1465
EDO. ARAGUA,CE. GIRARDOT,PQ. JOSE CASANOVA GODOY,UNIDAD EDUCATIVA NACIONAL AC CREACION CAMPO ALEGRE,3862,7,65,3145,2160,3080,0,12,2,1,905,3145
EDO. ARAGUA,CE. GIRARDOT,PQ. JOSE CASANOVA GODOY,CENTRO DE FORMACION INDUSTRIAL MARACAY INCE,3571,7,64,2850,1566,2786,1,11,1,2,1205,2850
EDO. ARAGUA,CE. GIRARDOT,PQ. JOSE CASANOVA GODOY,INCE INDUSTRIAL POLIVALENTE,1872,4,43,1539,682,1496,0,12,0,0,802,1539
EDO. ARAGUA,CE. GIRARDOT,PQ. JOSE CASANOVA GODOY,UNIDAD EDUCATIVA SIMON BOLIVAR,2752,5,28,2240,1247,2212,0,7,1,3,954,2240
EDO. ARAGUA,CE. GIRARDOT,PQ. JOSE CASANOVA GODOY,ESCUELA BASICA JUAN LOVERA,3515,7,60,2950,1358,2890,1,7,2,1,1521,2950
EDO. ARAGUA,CE. GIRARDOT,PQ. CHORONI,UNIDAD EDUCATIVA CHORONI,1061,2,11,825,486,814,0,6,0,0,322,825
EDO. ARAGUA,CE. GIRARDOT,PQ. CHORONI,UNIDAD EDUCATIVA NACIONAL BOLIVARIANA CHORONI,1621,3,25,1237,821,1212,0,2,1,0,388,1237
EDO. ARAGUA,CE. GIRARDOT,PQ. CHORONI,ESCUELA BASICA OSCAR ENRIQUE ORTEGA PALMA,1052,2,15,848,673,833,1,8,0,0,151,848
