Estado,Municipio,Parroquia,Centro,Número de Electores escrutados.,Número de Actas Procesadas.,Número total de Votos Nulos.,Número Total de Votantes que votaron realmente.,HUGO CHAVEZ,Número total de Votos Válidos.,ORLANDO CHIRINO,REINA SEQUERA,LUIS REYES,MARIA BOLIVAR,HENRIQUE CAPRILES RADONSKI,Número de Votos Escrutados.
EDO. CARABOBO,MP. SAN DIEGO,PQ. URB SAN DIEGO,ESCUELA BASICA BOLIVARIANA LA LUZ (NUCLEO ESCOLAR RURAL 49),472,1,6,415,190,409,0,1,0,0,218,415
EDO. CARABOBO,MP. SAN DIEGO,PQ. URB SAN DIEGO,COLEGIO UNIVERSITARIO MONSEÑOR DE TALAVERA,11722,22,109,10484,1960,10375,1,29,11,9,8365,10484
EDO. CARABOBO,MP. SAN DIEGO,PQ. URB SAN DIEGO,UNIDAD EDUCATIVA SAN DIEGO DE ALCALA,2456,5,26,2197,774,2171,1,8,0,0,1388,2197
EDO. CARABOBO,MP. SAN DIEGO,PQ. URB SAN DIEGO,GRUPO ESCOLAR QUEIPA,6738,12,77,5606,1631,5529,1,22,3,4,3868,5606
EDO. CARABOBO,MP. SAN DIEGO,PQ. URB SAN DIEGO,UNIDAD EDUCATIVA LA JOSEFINA,1175,2,25,1034,637,1009,0,3,0,0,369,1034
EDO. CARABOBO,MP. SAN DIEGO,PQ. URB SAN DIEGO,LICEO HIPOLITO CISNEROS,6384,12,47,5544,1369,5497,1,17,6,4,4100,5544
EDO. CARABOBO,MP. SAN DIEGO,PQ. URB SAN DIEGO,UNIDAD EDUCATIVA CREACION SAN DIEGO NORTE,3248,6,25,3052,807,3027,0,8,2,1,2209,3052
EDO. CARABOBO,MP. SAN DIEGO,PQ. URB SAN DIEGO,UNIDAD EDUCATIVA NACIONAL CAMPO SOLO,4296,8,57,3539,1989,3482,0,20,2,3,1468,3539
EDO. CARABOBO,MP. SAN DIEGO,PQ. URB SAN DIEGO,UNIDAD EDUCATIVA ESTADAL SANTIAGO MARIÑO,7330,13,47,6470,1240,6423,1,18,3,1,5160,6470
EDO. CARABOBO,MP. SAN DIEGO,PQ. URB SAN DIEGO,ESCUELA BASICA NACIONALCLORINDA AZCUÑES,3846,7,32,3546,706,3514,2,9,0,1,2796,3546
EDO. CARABOBO,MP. SAN DIEGO,PQ. URB SAN DIEGO,UNIDAD EDUCATIVA LOS MAGALLANES,2483,5,25,2009,1099,1984,1,16,1,1,866,2009
EDO. CARABOBO,MP. SAN DIEGO,PQ. URB SAN DIEGO,INSTITUTO UNIVERSITARIO DE TECNOLOGIA DE SEGURIDAD INDUSTRIAL,4872,9,50,4217,1247,4167,1,21,3,3,2892,4217
EDO. CARABOBO,MP. SAN DIEGO,PQ. URB SAN DIEGO,UNIDAD EDUCATIVA PRIVADO VIRGEN DE COROMOTO,4264,8,29,3724,640,3695,0,12,0,3,3040,3724
EDO. CARABOBO,MP. LOS GUAYOS,PQ. U LOS GUAYOS,CENTRO EDUCACION INICIAL GUAPARO,885,2,12,728,528,716,0,5,0,0,183,728
EDO. CARABOBO,MP. LOS GUAYOS,PQ. U LOS GUAYOS,ESCUELA BASICA NACIONAL BOLIVARIANA LOS CERRITOS,5692,10,73,4895,1857,4822,0,21,1,3,2940,4895
EDO. CARABOBO,MP. LOS GUAYOS,PQ. U LOS GUAYOS,UNIDAD EDUCATIVA SIMON JOSE GUEDEZ ORTIZ,837,2,9,693,521,684,0,4,0,0,159,693
EDO. CARABOBO,MP. LOS GUAYOS,PQ. U LOS GUAYOS,UNIDAD BASICA RAMONA DE ROMERO,2190,4,24,1809,848,1785,0,2,0,0,935,1809
EDO. CARABOBO,MP. LOS GUAYOS,PQ. U LOS GUAYOS,INSTITUTO DE EDUCACION ESPECIAL LAS AGUITAS,3095,6,37,2513,1476,2476,2,13,2,3,980,2513
EDO. CARABOBO,MP. LOS GUAYOS,PQ. U LOS GUAYOS,UNIDAD EDUCATIVA DIVINO NIÑO,1685,3,18,1277,767,1259,0,8,0,0,484,1277
EDO. CARABOBO,MP. LOS GUAYOS,PQ. U LOS GUAYOS,UNIDAD EDUCATIVA LUISA TERESA DE MONTEMAYOR,2433,5,29,1922,1575,1893,1,9,1,2,305,1922
EDO. CARABOBO,MP. LOS GUAYOS,PQ. U LOS GUAYOS,ESCUELA NACIONAL PIRITAL,1064,2,21,834,650,813,1,2,2,0,158,834
EDO. CARABOBO,MP. LOS GUAYOS,PQ. U LOS GUAYOS,GRUPO ESCOLAR LOS HIJOS DE BOLIVAR,2698,5,35,2166,1756,2131,2,20,3,0,350,2166
EDO. CARABOBO,MP. LOS GUAYOS,PQ. U LOS GUAYOS,JARDIN DE INFANCIA EL ROBLE,2287,4,24,1598,1184,1574,0,11,1,2,376,1598
EDO. CARABOBO,MP. LOS GUAYOS,PQ. U LOS GUAYOS,GRUPO ESCOLAR BATALLA DE AYACUCHO,4908,9,88,4123,2518,4035,3,31,1,3,1479,4123
EDO. CARABOBO,MP. LOS GUAYOS,PQ. U LOS GUAYOS,NAPIS DE GARCILLERA III,432,1,5,359,240,354,0,4,0,0,110,359
EDO. CARABOBO,MP. LOS GUAYOS,PQ. U LOS GUAYOS,ESCUELA BOLIVARIANA LOS CERRITOS,5248,9,72,4523,1970,4451,1,34,2,3,2441,4523
EDO. CARABOBO,MP. LOS GUAYOS,PQ. U LOS GUAYOS,ESCUELA TECNOLOGICA RURAL FRANCISCO DE MIRANDA,947,2,21,752,529,731,0,2,0,0,200,752
EDO. CARABOBO,MP. LOS GUAYOS,PQ. U LOS GUAYOS,ESCUELA BASICA LICENCIADA ELISA GUEVARA DE CACERES,3137,6,68,2476,1428,2408,0,14,0,2,964,2476
EDO. CARABOBO,MP. LOS GUAYOS,PQ. U LOS GUAYOS,UNIDAD EDUCATIVA JUAN PABLO PEREZ,714,2,17,595,415,578,1,2,0,0,160,595
EDO. CARABOBO,MP. LOS GUAYOS,PQ. U LOS GUAYOS,ESCUELA BASICA NACIONAL LAS AGUITAS I Y II JULIO GARMENDIA,2708,5,53,2242,1379,2189,0,9,1,0,800,2242
EDO. CARABOBO,MP. LOS GUAYOS,PQ. U LOS GUAYOS,ANEXO RURAL 6,3508,7,40,2508,1519,2468,0,21,2,2,924,2508
EDO. CARABOBO,MP. LOS GUAYOS,PQ. U LOS GUAYOS,MATERNAL PANCHITO MANDEFUA,892,2,14,776,590,762,0,3,0,1,168,776
EDO. CARABOBO,MP. LOS GUAYOS,PQ. U LOS GUAYOS,UNIDAD EDUCATIVA JACINTO LARA III,1715,3,35,1263,832,1228,0,6,0,2,388,1263
EDO. CARABOBO,MP. LOS GUAYOS,PQ. U LOS GUAYOS,ESCUELA BASICA JUAN VICENTE GONZALEZ DELGADO,491,1,7,428,382,421,0,1,0,0,38,428
EDO. CARABOBO,MP. LOS GUAYOS,PQ. U LOS GUAYOS,JARDIN DE INFANCIA CABRIALES,3126,6,59,2420,1690,2361,1,9,4,1,656,2420
EDO. CARABOBO,MP. LOS GUAYOS,PQ. U LOS GUAYOS,CENTRO EDUCACION INICIAL LIBERTADOR,638,2,14,467,348,453,0,2,0,0,103,467
EDO. CARABOBO,MP. LOS GUAYOS,PQ. U LOS GUAYOS,LICEO BOLIVARIANO COMUN ANDRES BELLO,1078,2,12,884,535,872,0,3,0,0,334,884
EDO. CARABOBO,MP. LOS GUAYOS,PQ. U LOS GUAYOS,UNIDAD EDUCATIVA ESTADAL SANTISIMA TRINIDAD,4214,8,76,3567,2050,3491,1,20,1,3,1416,3567
EDO. CARABOBO,MP. LOS GUAYOS,PQ. U LOS GUAYOS,ESCUELA BASICA ARTURO USLAR PIETRI,1684,3,20,1374,941,1354,0,4,0,2,407,1374
EDO. CARABOBO,MP. LOS GUAYOS,PQ. U LOS GUAYOS,ESCUELA. BASICA ESTADAL MIGUEL OTERO SILVA,560,1,10,455,350,445,0,2,1,0,92,455
EDO. CARABOBO,MP. LOS GUAYOS,PQ. U LOS GUAYOS,GRUPO ESCOLAR YORACO,6795,12,127,5415,3684,5288,2,35,2,2,1563,5415
EDO. CARABOBO,MP. LOS GUAYOS,PQ. U LOS GUAYOS,JARDIN DE INFANCIA LAS AGUITAS,3806,7,54,3058,2027,3004,1,13,2,2,959,3058
EDO. CARABOBO,MP. LOS GUAYOS,PQ. U LOS GUAYOS,LICEO NACIONAL BOLIVARIANO ANDRES BELLO,3845,7,55,3155,1876,3100,0,18,1,0,1205,3155
EDO. CARABOBO,MP. LOS GUAYOS,PQ. U LOS GUAYOS,LICEO NACIONAL PABLO NERUDA,534,1,8,442,310,434,0,1,0,0,123,442
EDO. CARABOBO,MP. LOS GUAYOS,PQ. U LOS GUAYOS,PRE ESCOLAR BATALLA DE JUNIN,6120,11,106,5082,3275,4976,2,30,4,6,1659,5082
EDO. CARABOBO,MP. LOS GUAYOS,PQ. U LOS GUAYOS,UNIDAD EDUCATIVA VICENTE EMPARAN,1025,2,23,835,575,812,0,5,0,0,232,835
EDO. CARABOBO,MP. LOS GUAYOS,PQ. U LOS GUAYOS,UNIDAD EDUCATIVA ESTADAL MARIA ESCAMILLO,857,2,16,717,525,701,0,2,0,0,174,717
EDO. CARABOBO,MP. LOS GUAYOS,PQ. U LOS GUAYOS,UNIDAD EDUCATIVA ANTONIO JOSE DE SUCRE,3398,6,37,2817,1717,2780,0,17,0,3,1043,2817
EDO. CARABOBO,MP. LOS GUAYOS,PQ. U LOS GUAYOS,UNIDAD EDUCATIVA LICEO BOLIVARIANO LA GLORIETA,775,2,16,607,406,591,0,3,1,0,181,607
EDO. CARABOBO,MP. LOS GUAYOS,PQ. U LOS GUAYOS,ESCUELA DE ESPECIALIDADES FEMENINAS,1060,2,17,851,541,834,0,3,0,1,289,851
EDO. CARABOBO,MP. LOS GUAYOS,PQ. U LOS GUAYOS,UNIDAD EDUCATIVA BOLIVARIANA RURAL LA DIOSA DE LOS TACARIGUAS,732,2,17,556,395,539,0,2,1,0,141,556
EDO. CARABOBO,MP. LOS GUAYOS,PQ. U LOS GUAYOS,MARIA FIDELA CHIRINOS,2139,4,34,1656,937,1622,0,6,1,2,676,1656
EDO. CARABOBO,MP. LOS GUAYOS,PQ. U LOS GUAYOS,ESCUELA BASICA NACIONAL BOLIVARIANA LAS AGUITAS III,3514,7,71,2822,1787,2751,1,14,1,2,946,2822
EDO. CARABOBO,MP. LOS GUAYOS,PQ. U LOS GUAYOS,LICEO BOLIVARIANO TIERRA DE ARAGUACO,927,2,9,763,473,754,0,6,0,0,275,763
EDO. CARABOBO,MP. LOS GUAYOS,PQ. U LOS GUAYOS,ESCUELA BOLIVARIANA NACIONAL LA UNIÓN,611,2,8,506,400,498,0,5,0,0,93,506
EDO. CARABOBO,MP. LOS GUAYOS,PQ. U LOS GUAYOS,PRE ESCOLAR TACARIGUA I,1647,3,15,1314,865,1299,0,6,1,0,427,1314
EDO. CARABOBO,MP. BEJUMA,PQ. CANOABO,ESCUELA TECNICA AGROPECUARIA CARLOS SANDA,559,1,8,445,210,437,1,1,1,2,222,445
EDO. CARABOBO,MP. BEJUMA,PQ. CANOABO,CENTRO DE EDUCACION INICIAL GUINEO,48,1,0,46,37,46,0,1,0,0,8,46
EDO. CARABOBO,MP. BEJUMA,PQ. CANOABO,JARDIN DE INFANCIA BOLIVARIANO PIMENTEL CORONEL,291,1,4,253,136,249,0,1,0,0,112,253
EDO. CARABOBO,MP. BEJUMA,PQ. CANOABO,ESCUELA BOLIVARIANA VALLE HONDO,467,1,7,336,221,329,0,0,1,0,107,336
EDO. CARABOBO,MP. BEJUMA,PQ. CANOABO,ESCUELA BASICA ESTADAL DON VIVIANO VARGAS,656,2,12,485,269,473,0,3,0,2,199,485
EDO. CARABOBO,MP. BEJUMA,PQ. CANOABO,ESCUELA BASICA LA BELEN NUMERO 74,944,2,15,747,531,732,1,4,0,0,196,747
EDO. CARABOBO,MP. BEJUMA,PQ. CANOABO,ESCUELA BASICA PIMENTEL CORONEL,1907,4,21,1520,664,1499,0,0,1,0,834,1520
EDO. CARABOBO,MP. BEJUMA,PQ. CANOABO,UNIDAD EDUCATIVA AGUA CLARA,71,1,2,63,52,61,0,0,0,0,9,63
EDO. CARABOBO,MP. BEJUMA,PQ. CANOABO,UNIDAD EDUCATIVA PALMICHAL NO 80,367,1,2,284,170,282,0,1,2,0,109,284
EDO. CARABOBO,MP. BEJUMA,PQ. SIMON BOLIVAR,UNIDAD EDUCATIVA SIMON RODRIGUEZ,621,2,10,542,299,532,0,1,0,0,232,542
EDO. CARABOBO,MP. BEJUMA,PQ. SIMON BOLIVAR,GRUPO ESCOLAR PARAMACONI,2170,4,36,1798,706,1762,1,4,1,1,1049,1798
EDO. CARABOBO,MP. BEJUMA,PQ. SIMON BOLIVAR,ESCUELA ESTATAL TORCUATO MANZO NUÑEZ,1186,2,12,981,578,969,0,2,0,0,389,981
EDO. CARABOBO,MP. BEJUMA,PQ. SIMON BOLIVAR,ESCUELA SARA DE MORENO,1052,2,7,892,431,885,1,5,0,0,448,892
EDO. CARABOBO,MP. BEJUMA,PQ. SIMON BOLIVAR,UNIDAD EDUCATIVA EDUARDO BLANCO,198,1,3,177,160,174,0,0,0,0,14,177
EDO. CARABOBO,MP. BEJUMA,PQ. SIMON BOLIVAR,UNIDAD EDUCATIVA CARIAPRIMA,611,2,11,460,247,449,0,2,0,0,200,460
EDO. CARABOBO,MP. BEJUMA,PQ. BEJUMA,ESCUELA ESTADAL GRADUADA JULIAN MELLADO,2855,5,35,2249,1115,2214,0,6,0,1,1092,2249
EDO. CARABOBO,MP. BEJUMA,PQ. BEJUMA,ESCUELA BASICA CRESPO GARROTE,2465,5,28,1973,1094,1945,1,9,0,2,839,1973
EDO. CARABOBO,MP. BEJUMA,PQ. BEJUMA,ESCUELA ESTADAL JOSE IGNACIO PULIDO,2278,4,34,1911,659,1877,1,9,0,0,1208,1911
EDO. CARABOBO,MP. BEJUMA,PQ. BEJUMA,NUCLEO ESCOLAR NO 79,34,1,0,14,13,14,0,0,0,0,1,14
EDO. CARABOBO,MP. BEJUMA,PQ. BEJUMA,PRE ESCOLAR EL RINCON,2832,5,22,2374,1619,2352,0,11,1,0,721,2374
EDO. CARABOBO,MP. BEJUMA,PQ. BEJUMA,JARDIN DE INFANCIA LOS GATICOS,1388,3,13,1038,799,1025,0,0,1,1,224,1038
EDO. CARABOBO,MP. BEJUMA,PQ. BEJUMA,UNIDAD EDUCATIVA EL NARANJAL NUCLEO ESCOLAR RURAL Nº 009,155,1,2,81,68,79,0,0,0,0,11,81
EDO. CARABOBO,MP. BEJUMA,PQ. BEJUMA,LICEO NACIONAL ARTURO MICHELENA,3412,6,41,2658,1344,2617,0,9,3,1,1260,2658
EDO. CARABOBO,MP. BEJUMA,PQ. BEJUMA,UNIDAD EDUCATIVA INSTITUTO SAN MARTIN,1496,3,29,1258,580,1229,0,5,0,1,643,1258
EDO. CARABOBO,MP. BEJUMA,PQ. BEJUMA,ESCUELA BASICA  MIGUEL MARIN,4764,9,49,3831,1474,3782,2,15,2,1,2288,3831
EDO. CARABOBO,MP. NAGUANAGUA,PQ. NAGUANAGUA,UNIDAD EDUCATIVA JUAN ESTEBAN RODRIGUEZ DE LAMAS,491,1,10,412,258,402,1,3,0,0,140,412
EDO. CARABOBO,MP. NAGUANAGUA,PQ. NAGUANAGUA,UNIDAD EDUCATIVA NACIONAL MANUEL ANTONIO MALPICA,5283,10,66,4445,1413,4379,2,19,1,2,2942,4445
EDO. CARABOBO,MP. NAGUANAGUA,PQ. NAGUANAGUA,ESCUELA BASICA GUERE,1478,3,20,1294,681,1274,0,2,1,2,588,1294
EDO. CARABOBO,MP. NAGUANAGUA,PQ. NAGUANAGUA,UNIDAD EDUCATIVA PRIVADO COLEGIO PARROQUIAL PADRE SEIJAS,5758,10,40,4973,725,4933,0,13,0,1,4194,4973
EDO. CARABOBO,MP. NAGUANAGUA,PQ. NAGUANAGUA,LICEO MONSEÑOR GREGORIO ADAMS,2664,5,42,2282,840,2240,1,10,1,2,1386,2282
EDO. CARABOBO,MP. NAGUANAGUA,PQ. NAGUANAGUA,HOGARES CREA TARAPIO,1163,2,11,896,471,885,1,3,0,0,410,896
EDO. CARABOBO,MP. NAGUANAGUA,PQ. NAGUANAGUA,ESCUELA BASICA  ESTADAL PROFESOR JESUS BERBIN LOPEZ,2936,6,28,2388,1358,2360,1,9,2,2,988,2388
EDO. CARABOBO,MP. NAGUANAGUA,PQ. NAGUANAGUA,ESCUELA ENRIQUE BARRIOS SANCHEZ,4015,7,54,3395,1151,3341,3,16,1,2,2168,3395
EDO. CARABOBO,MP. NAGUANAGUA,PQ. NAGUANAGUA,LICEO BOLIVARIANO CAYAURIMA,2532,5,46,1934,1214,1888,1,10,2,1,660,1934
EDO. CARABOBO,MP. NAGUANAGUA,PQ. NAGUANAGUA,GRUPO ESCOLAR ATANACIO GIRARDOT,3258,6,56,2628,1123,2572,0,7,1,3,1438,2628
EDO. CARABOBO,MP. NAGUANAGUA,PQ. NAGUANAGUA,ESCUELA BOLIVARIANA MONTALBAN,6267,11,50,5200,1876,5150,1,21,3,5,3244,5200
EDO. CARABOBO,MP. NAGUANAGUA,PQ. NAGUANAGUA,ESCUELA JOSE FELIX SOSA,7941,15,85,6595,2049,6510,0,18,3,4,4436,6595
EDO. CARABOBO,MP. NAGUANAGUA,PQ. NAGUANAGUA,UNIDAD EDUCATIVA NACIONAL NUESTRA SEÑORA DE COROMOTO,3280,6,26,2632,1272,2606,1,14,1,1,1317,2632
EDO. CARABOBO,MP. NAGUANAGUA,PQ. NAGUANAGUA,ESCUELA NACIONAL RAUL LEONI,2170,4,41,1762,1282,1721,0,9,0,0,430,1762
EDO. CARABOBO,MP. NAGUANAGUA,PQ. NAGUANAGUA,UNIDAD EDUCATIVA DOCTOR JOSE MARIA GIL,4350,8,34,3616,908,3582,2,18,0,1,2653,3616
EDO. CARABOBO,MP. NAGUANAGUA,PQ. NAGUANAGUA,UNIDAD EDUCATIVA NACIONAL ABDON CALDERON,4103,8,71,3363,1752,3292,3,8,3,2,1524,3363
EDO. CARABOBO,MP. NAGUANAGUA,PQ. NAGUANAGUA,UNIDAD EDUCATIVA  MARIBEL CABALLERO DE TIRADO,2859,5,23,2433,765,2410,2,11,3,0,1629,2433
EDO. CARABOBO,MP. NAGUANAGUA,PQ. NAGUANAGUA,UNIDAD EDUCATIVA ESTADAL MANUEL CEDEÑO,1077,2,13,923,454,910,1,8,0,1,446,923
EDO. CARABOBO,MP. NAGUANAGUA,PQ. NAGUANAGUA,ESCUELA NACIONAL BARBULA,4231,8,66,3497,1805,3431,1,15,3,0,1607,3497
EDO. CARABOBO,MP. NAGUANAGUA,PQ. NAGUANAGUA,UNIDAD EDUCATIVA LAS MARIAS,189,1,3,155,130,152,0,0,0,0,22,155
EDO. CARABOBO,MP. NAGUANAGUA,PQ. NAGUANAGUA,ESCUELA NACIONAL BATALLA DE BOMBONA,3649,7,41,2961,1504,2920,1,9,1,3,1402,2961
EDO. CARABOBO,MP. NAGUANAGUA,PQ. NAGUANAGUA,ESCUELA DOCTOR LISANDRO LECUNA,5932,11,50,4848,1350,4798,0,16,2,0,3430,4848
EDO. CARABOBO,MP. NAGUANAGUA,PQ. NAGUANAGUA,UNIDAD ESCOLAR SIMON BOLIVAR,7378,14,51,6447,1280,6396,1,13,5,7,5090,6447
EDO. CARABOBO,MP. NAGUANAGUA,PQ. NAGUANAGUA,UNIDAD EDUCATIVA ESTADAL AMBROSIO PLAZA,4090,8,69,3460,1638,3391,2,11,2,1,1737,3460
EDO. CARABOBO,MP. NAGUANAGUA,PQ. NAGUANAGUA,ESCUELA  BOLIVARIANA  BARBULA II,3279,6,53,2573,1278,2520,1,10,1,0,1230,2573
EDO. CARABOBO,MP. NAGUANAGUA,PQ. NAGUANAGUA,ESCUELA MARIA TERESA CORONEL,4856,9,59,3850,1823,3791,3,12,1,2,1950,3850
EDO. CARABOBO,MP. NAGUANAGUA,PQ. NAGUANAGUA,UNIDAD EDUCATIVA CRISPINA MERCADO,3103,6,65,2569,1700,2504,0,13,3,0,788,2569
EDO. CARABOBO,MP. CARLOS ARVELO,PQ. GUIGUE,ESCUELA HERMANO GASPAR,423,1,14,359,210,345,0,4,0,1,130,359
EDO. CARABOBO,MP. CARLOS ARVELO,PQ. GUIGUE,CENTRO DE EDUCACION INICIAL. EL TROMPO,508,1,7,288,218,281,0,0,0,0,63,288
EDO. CARABOBO,MP. CARLOS ARVELO,PQ. GUIGUE,ESCUELA ESTADAL ANTONIO FERNADEZ MOSQUEDA,220,1,4,187,139,183,0,0,0,0,44,187
EDO. CARABOBO,MP. CARLOS ARVELO,PQ. GUIGUE,ESCUELA ESTADAL CONCENTRADA FERNANDO FIGUEREDO,1590,3,47,1209,840,1162,0,9,0,0,313,1209
EDO. CARABOBO,MP. CARLOS ARVELO,PQ. GUIGUE,ESCUELA BASICA YUMA,1755,3,30,1344,970,1314,0,7,2,0,335,1344
EDO. CARABOBO,MP. CARLOS ARVELO,PQ. GUIGUE,UNIDAD EDUCATIVA LUIS BELTRAN PRIETO FIGUEROA,1090,2,15,919,618,904,0,2,0,0,284,919
EDO. CARABOBO,MP. CARLOS ARVELO,PQ. GUIGUE,UNIDAD EDUCATIVA  NACIONAL BOLIVARIANA COPETON,273,1,4,207,157,203,0,0,0,0,46,207
EDO. CARABOBO,MP. CARLOS ARVELO,PQ. GUIGUE,UNIDAD EDUCATIVA NACIONAL CONCENTRADA NACIONAL  COGOLLAL,491,1,6,381,300,375,2,3,1,2,67,381
EDO. CARABOBO,MP. CARLOS ARVELO,PQ. GUIGUE,UNIDAD EDUCATIVA ESTADAL CONCENTRADA LAS VEGAS,417,1,7,352,293,345,0,5,0,0,47,352
EDO. CARABOBO,MP. CARLOS ARVELO,PQ. GUIGUE,ESCUELA EL PIÑAL,715,2,11,591,380,580,0,3,0,1,196,591
EDO. CARABOBO,MP. CARLOS ARVELO,PQ. GUIGUE,UNIDAD EDUCATIVA SANTOS ANGEL DE CUSTODIOS,601,2,6,226,125,220,0,3,0,0,92,226
EDO. CARABOBO,MP. CARLOS ARVELO,PQ. GUIGUE,ESCUELA ESTADAL PATRICIO MARTINEZ,385,1,12,290,210,278,0,1,0,0,67,290
EDO. CARABOBO,MP. CARLOS ARVELO,PQ. GUIGUE,JARDIN DE INFANCIA LINO DE CLEMENTEII,723,2,5,389,269,384,0,1,0,0,114,389
EDO. CARABOBO,MP. CARLOS ARVELO,PQ. GUIGUE,ESCUELA EDAD DE ORO,681,2,10,392,312,382,0,2,0,0,68,392
EDO. CARABOBO,MP. CARLOS ARVELO,PQ. GUIGUE,ESCUELA NACIONAL EL TROMPILLO,1512,3,33,1187,789,1154,1,12,1,0,351,1187
EDO. CARABOBO,MP. CARLOS ARVELO,PQ. GUIGUE,ESCUELA GRADUADA FRANCISCO DE MIRANDA,1258,3,22,962,653,940,1,8,1,0,277,962
EDO. CARABOBO,MP. CARLOS ARVELO,PQ. GUIGUE,GRUPO ESCOLAR LINO CLEMENTE,3286,6,48,2623,1254,2575,0,16,1,2,1302,2623
EDO. CARABOBO,MP. CARLOS ARVELO,PQ. GUIGUE,ESCUELA ESTADAL TEOLINDA ROMERO DE DIAZ,2686,5,57,2154,1497,2097,0,13,3,1,583,2154
EDO. CARABOBO,MP. CARLOS ARVELO,PQ. GUIGUE,UNIDAD EDUCATIVA INICIALL BOLIVARIANA LORO PEDERNALES,344,1,7,187,139,180,0,0,0,0,41,187
EDO. CARABOBO,MP. CARLOS ARVELO,PQ. GUIGUE,ESCUELA BASICA ALTAMIRA,272,1,2,179,136,177,0,2,0,0,39,179
EDO. CARABOBO,MP. CARLOS ARVELO,PQ. GUIGUE,ESCUELA TECNICA AGROPECUARIA MIGUEL BORRAS,500,1,4,289,221,285,0,4,0,0,60,289
EDO. CARABOBO,MP. CARLOS ARVELO,PQ. GUIGUE,UNIDAD EDUCATIVA ESTADAL MONSEÑOR JESUS MARIA PELLIN,2817,5,90,2160,1525,2070,0,11,1,4,529,2160
EDO. CARABOBO,MP. CARLOS ARVELO,PQ. GUIGUE,CENTRO DE EDUCACION INICIAL BOLIVARIANO ESPECIAL 18,974,2,11,703,591,692,0,5,0,1,95,703
EDO. CARABOBO,MP. CARLOS ARVELO,PQ. GUIGUE,UNIDAD EDUCATIVA REQUENA,449,1,4,354,296,350,0,0,0,0,54,354
EDO. CARABOBO,MP. CARLOS ARVELO,PQ. GUIGUE,ESCUELA FRANCISCO ARAMENDI,3326,6,48,2618,1582,2570,2,15,2,2,967,2618
EDO. CARABOBO,MP. CARLOS ARVELO,PQ. GUIGUE,ESCUELA BOLIVARIANA BUENAVENTURA,1005,2,14,839,570,825,1,7,0,0,247,839
EDO. CARABOBO,MP. CARLOS ARVELO,PQ. GUIGUE,CENTRO DE EDUCACION INICIAL NACIONAL BOLIVARIANO TENIENTE PEDRO CAMEJO,4204,8,81,3220,2282,3139,1,19,3,1,833,3220
EDO. CARABOBO,MP. CARLOS ARVELO,PQ. GUIGUE,UNIDAD EDUCATIVA NACIONAL RURAL BOLIVARIANA SAN JUAN DE DIOS,2564,5,36,2068,1585,2032,1,7,1,1,437,2068
EDO. CARABOBO,MP. CARLOS ARVELO,PQ. GUIGUE,UNIDAD EDUCATIVA NACIONAL CONCENTRADA LA ADUANA,1942,4,34,1479,1067,1445,1,11,1,0,365,1479
EDO. CARABOBO,MP. CARLOS ARVELO,PQ. GUIGUE,LICEO CARLOS ARVELO,2795,5,68,2152,1511,2084,1,15,2,1,554,2152
EDO. CARABOBO,MP. CARLOS ARVELO,PQ. GUIGUE,UNIDAD EDUCATIVA ANTONIO RICAURTE,2324,4,38,1908,1164,1870,0,10,0,0,696,1908
EDO. CARABOBO,MP. CARLOS ARVELO,PQ. GUIGUE,ESCUELA CONCENTRADA 5 DE JULIO,2283,4,31,1805,1504,1774,0,15,2,0,253,1805
EDO. CARABOBO,MP. CARLOS ARVELO,PQ. GUIGUE,GRUPO ESCOLAR LANCASTER,3343,6,55,2754,1463,2699,0,25,1,0,1210,2754
EDO. CARABOBO,MP. CARLOS ARVELO,PQ. BELEN,FUNDACION ORFION BELEN,673,2,7,299,224,292,0,0,0,0,68,299
EDO. CARABOBO,MP. CARLOS ARVELO,PQ. BELEN,ESCUELA BASICA MANUARE,2198,4,20,1694,1397,1674,0,6,1,0,270,1694
EDO. CARABOBO,MP. CARLOS ARVELO,PQ. BELEN,UNIDAD EDUCATIVA MODULO RURAL DE BELEN,865,2,7,643,488,636,0,2,0,0,146,643
EDO. CARABOBO,MP. CARLOS ARVELO,PQ. BELEN,ESCUELA BASICA ESTADAL MANUARITO,263,1,0,196,191,196,0,0,0,0,5,196
EDO. CARABOBO,MP. CARLOS ARVELO,PQ. BELEN,ESCUELA ESTADAL GRADUADA CARABOBO,3461,6,58,2657,1521,2599,1,15,4,2,1056,2657
EDO. CARABOBO,MP. CARLOS ARVELO,PQ. BELEN,ESCUELA UNITARIA NO 155,271,1,5,203,180,198,0,2,1,0,15,203
EDO. CARABOBO,MP. CARLOS ARVELO,PQ. BELEN,UNIDAD EDUCATIVA NACIONAL MARIPA,382,1,6,300,234,294,0,1,0,0,59,300
EDO. CARABOBO,MP. CARLOS ARVELO,PQ. BELEN,ESCUELA BASICA ESTADAL CONCENTRADA SANTA ROSA DEL SUR,169,1,0,102,93,102,0,0,0,0,9,102
EDO. CARABOBO,MP. CARLOS ARVELO,PQ. BELEN,JARDIN DE INFANCIA NACIONAL DE BELEN,824,2,13,597,409,584,0,1,0,0,174,597
EDO. CARABOBO,MP. CARLOS ARVELO,PQ. BELEN,UNIDAD EDUCATIVA NACIONAL BOLIVARIANA VALLECITO,1178,2,7,881,800,874,0,2,0,0,72,881
EDO. CARABOBO,MP. CARLOS ARVELO,PQ. TACARIGUA,UNIDAD EDUCATIVA LAGO DE LOS TACARIGUAS,1230,3,19,1008,756,989,0,3,0,0,230,1008
EDO. CARABOBO,MP. CARLOS ARVELO,PQ. TACARIGUA,ESCUELA ESTADAL UNITARIA NUMERO 205,385,1,15,271,209,256,1,2,0,0,44,271
EDO. CARABOBO,MP. CARLOS ARVELO,PQ. TACARIGUA,UNIDAD EDUCATIVA VIRGEN MISIONERA ANEXO,875,2,8,285,196,277,0,3,0,0,78,285
EDO. CARABOBO,MP. CARLOS ARVELO,PQ. TACARIGUA,ESCUELA NACIONAL CONCENTRADA JAVILLAL,703,2,8,533,459,525,2,0,1,0,63,533
EDO. CARABOBO,MP. CARLOS ARVELO,PQ. TACARIGUA,ESCUELA CHAGUARAMOS II,1233,3,20,996,865,976,0,9,0,0,102,996
EDO. CARABOBO,MP. CARLOS ARVELO,PQ. TACARIGUA,ESCUELA BASICA NACIONAL LOS GARCIAS,1365,3,25,1077,833,1052,1,5,3,0,210,1077
EDO. CARABOBO,MP. CARLOS ARVELO,PQ. TACARIGUA,UNIDAD EDUCATIVA   MARIA VIRGEN MISIONERA,1920,4,37,1601,889,1564,0,10,0,1,664,1601
EDO. CARABOBO,MP. CARLOS ARVELO,PQ. TACARIGUA,UNIDAD EDUCATIVA ESTADAL  FELIPE CECILIO TOVAR,1801,4,18,1435,1061,1417,0,6,3,0,347,1435
EDO. CARABOBO,MP. CARLOS ARVELO,PQ. TACARIGUA,UNIDAD EDUCATIVA ANTONIO MINGUET LETTERON,1202,3,14,1004,677,990,0,10,2,0,301,1004
EDO. CARABOBO,MP. CARLOS ARVELO,PQ. TACARIGUA,CASA DE LA CULTURA LA VERDE CLARITA,585,1,12,300,217,288,0,3,0,0,68,300
EDO. CARABOBO,MP. CARLOS ARVELO,PQ. TACARIGUA,ESCUELA GRADUADA MANUEL GODOY,2696,5,48,2231,1386,2183,1,20,1,3,772,2231
EDO. CARABOBO,MP. CARLOS ARVELO,PQ. TACARIGUA,CENTRO DE EDUCACION INICIAL CACIQUE MARA,542,1,4,432,348,428,0,3,0,0,77,432
EDO. CARABOBO,MP. CARLOS ARVELO,PQ. TACARIGUA,ANEXO EL LAGO DE LOS TACARIGUA,262,1,5,183,128,178,0,0,0,0,50,183
EDO. CARABOBO,MP. CARLOS ARVELO,PQ. TACARIGUA,ESCUELA NACIONAL ALFREDO PIETRI,3692,7,64,2819,1955,2755,0,12,3,1,784,2819
EDO. CARABOBO,MP. CARLOS ARVELO,PQ. TACARIGUA,ESCUELA BASICA ISABEL TEREZA LEON GASIA,565,1,6,425,317,419,1,1,0,0,100,425
EDO. CARABOBO,MP. CARLOS ARVELO,PQ. TACARIGUA,ESCUELA BASICA PARIATA,1522,3,18,1253,929,1235,1,5,1,0,299,1253
EDO. CARABOBO,MP. CARLOS ARVELO,PQ. TACARIGUA,UNIDAD EDUCATIVA ESTADAL MIGUEL GONZALEZ Y PEREZ,1595,3,42,1188,814,1146,0,10,0,0,322,1188
EDO. CARABOBO,MP. CARLOS ARVELO,PQ. TACARIGUA,ESCUELA ESTADAL BOYER,753,2,16,599,489,583,0,1,1,0,92,599
EDO. CARABOBO,MP. CARLOS ARVELO,PQ. TACARIGUA,UNIDAD EDUCATIVA NACIONAL CONCENTRADA LAS TINAJAS,1600,3,39,1281,943,1242,1,7,1,4,286,1281
EDO. CARABOBO,MP. CARLOS ARVELO,PQ. TACARIGUA,CENTRO DE EDUCACION INICIAL FERNANDEZ SUARES,344,1,8,216,158,208,0,1,0,0,49,216
EDO. CARABOBO,MP. CARLOS ARVELO,PQ. TACARIGUA,CENTRO DE EDUCACION INICIAL  LOS ILUSTRE,987,2,13,753,620,740,0,4,0,0,116,753
EDO. CARABOBO,MP. CARLOS ARVELO,PQ. TACARIGUA,UNIDAD EDUCATIVA ESTADAL GHERMINA BARRAGAN,2760,5,51,2169,1536,2118,0,6,1,2,573,2169
EDO. CARABOBO,MP. CARLOS ARVELO,PQ. TACARIGUA,UNIDAD  EDUCATIVA NACIONAL  FRANCISCO JOSE CISNEROS,3396,6,80,2702,1464,2622,0,25,1,1,1131,2702
EDO. CARABOBO,MP. CARLOS ARVELO,PQ. TACARIGUA,ESCUELA NACIONAL ARTURO MICHELENA,3927,7,56,3051,2154,2995,4,18,1,0,818,3051
EDO. CARABOBO,MP. CARLOS ARVELO,PQ. TACARIGUA,ESCUELA ESTADAL GLORIA BERBECIA,324,1,5,262,193,257,1,1,0,0,62,262
EDO. CARABOBO,MP. CARLOS ARVELO,PQ. TACARIGUA,ESCUELA NACIONAL TOMAS FARRIAR,3169,6,52,2497,1857,2445,0,9,5,1,573,2497
EDO. CARABOBO,MP. CARLOS ARVELO,PQ. TACARIGUA,ESCUELA BASICA 325 EL NARANJITO,427,1,5,314,258,309,1,0,0,0,50,314
EDO. CARABOBO,MP. CARLOS ARVELO,PQ. TACARIGUA,CENTRO DE EDUCACION INICIAL CANA DULCE,483,1,5,332,230,327,0,1,0,2,94,332
EDO. CARABOBO,MP. LIBERTADOR,PQ. U INDEPENDENCIA,ESCUELA BASICA SABANITA NUCLEO ESCOLAR RURAL 148,301,1,8,255,224,247,0,1,2,0,20,255
EDO. CARABOBO,MP. LIBERTADOR,PQ. U INDEPENDENCIA,CENTRO DE EDUCACION INTEGRAL BOLIVARIANO SIMONCITO CAMPO DE CARABOBO,846,2,18,640,520,622,0,1,0,0,101,640
EDO. CARABOBO,MP. LIBERTADOR,PQ. U INDEPENDENCIA,UNIDAD EDUCATIVA LA CORTADORA NUCLEO ESCOLAR RURAL 148,437,1,6,355,306,349,2,1,2,0,38,355
EDO. CARABOBO,MP. LIBERTADOR,PQ. U INDEPENDENCIA,UNIDAD EDUCATIVA ESTADAL PADRE ALBERTO PANCIERA,1096,2,26,935,721,909,1,6,2,2,177,935
EDO. CARABOBO,MP. LIBERTADOR,PQ. U INDEPENDENCIA,UNIDAD EDUCATIVA ESTADAL JUANA GOMEZ,4264,8,62,3389,1857,3327,1,16,3,1,1449,3389
EDO. CARABOBO,MP. LIBERTADOR,PQ. U INDEPENDENCIA,UNIDAD EDUCATIVA JUAN RAMON GONZALEZ BAQUERO,3167,6,42,2635,1735,2593,2,13,1,4,838,2635
EDO. CARABOBO,MP. LIBERTADOR,PQ. U INDEPENDENCIA,UNIDAD EDUCATIVA AGUA LINDA,255,1,8,225,204,217,0,2,0,0,11,225
EDO. CARABOBO,MP. LIBERTADOR,PQ. U INDEPENDENCIA,ESCUELA BASICA NACIONAL BOLIVARIANA ALGARROBAL,882,2,13,704,555,691,1,1,1,0,133,704
EDO. CARABOBO,MP. LIBERTADOR,PQ. U INDEPENDENCIA,ESCUELA 24 DE JUNIO,2321,4,40,1841,1245,1801,0,11,1,0,544,1841
EDO. CARABOBO,MP. LIBERTADOR,PQ. U INDEPENDENCIA,ESCUELA RURAL BOLIVARIANA PIRA PIRA,1289,3,17,954,752,937,0,8,4,1,172,954
EDO. CARABOBO,MP. LIBERTADOR,PQ. U INDEPENDENCIA,ESCUELA BASICA BOLIVARIANA PUEBLO NUEVO,282,1,0,236,195,236,0,1,0,0,40,236
EDO. CARABOBO,MP. LIBERTADOR,PQ. U INDEPENDENCIA,CENTRO DE EDUCACION INICIAL ARCO DE CARABOBO,743,2,2,629,481,627,0,8,0,0,138,629
EDO. CARABOBO,MP. LIBERTADOR,PQ. U INDEPENDENCIA,UNIDAD EDUCATIVA NACIONAL BARRERITA,1324,3,18,1092,882,1074,2,4,3,0,183,1092
EDO. CARABOBO,MP. LIBERTADOR,PQ. U INDEPENDENCIA,UNIDAD EDUCATIVA EDUARDO ASSEF RAIDI,1772,4,16,1410,1111,1394,1,4,2,0,276,1410
EDO. CARABOBO,MP. LIBERTADOR,PQ. U INDEPENDENCIA,UNIDAD EDUCATIVA DIOS CON NOSOTROS,1024,2,12,760,581,748,0,4,1,0,162,760
EDO. CARABOBO,MP. LIBERTADOR,PQ. U INDEPENDENCIA,ESCUELA CAMPO DE CARABOBO,4325,8,69,3247,2330,3178,0,12,1,1,834,3247
EDO. CARABOBO,MP. LIBERTADOR,PQ. U INDEPENDENCIA,CENTRO DE EDUCACION INICIAL NACIONAL BARRERA,1262,3,13,1037,749,1024,0,6,4,1,264,1037
EDO. CARABOBO,MP. LIBERTADOR,PQ. U TOCUYITO,ESCUELA BASICA JOSE FRANCISCO FARIAS,779,2,11,626,462,615,0,5,0,1,147,626
EDO. CARABOBO,MP. LIBERTADOR,PQ. U TOCUYITO,UNIDAD EDUCATIVA PRIVADO MARISCAL AYACUCHO,2300,4,18,1980,363,1962,1,7,0,1,1590,1980
EDO. CARABOBO,MP. LIBERTADOR,PQ. U TOCUYITO,UNIDAD EDUCATIVA MUNICIPAL EL VIGIA,741,2,4,562,440,558,1,3,0,0,114,562
EDO. CARABOBO,MP. LIBERTADOR,PQ. U TOCUYITO,ESCUELA BASICA MARIA  DE NAZARETH,823,2,12,653,561,641,1,2,0,1,76,653
EDO. CARABOBO,MP. LIBERTADOR,PQ. U TOCUYITO,UNIDAD EDUCATIVA NACIONAL BATALLA DE CARABOBO,3198,6,48,2514,1461,2466,2,11,1,3,988,2514
EDO. CARABOBO,MP. LIBERTADOR,PQ. U TOCUYITO,UNIDAD EDUCATIVA FATIMA 1,1118,2,14,765,595,751,2,4,1,0,149,765
EDO. CARABOBO,MP. LIBERTADOR,PQ. U TOCUYITO,ESCUELA JUAN ESCALONA,6286,11,112,4900,3356,4788,4,19,4,2,1403,4900
EDO. CARABOBO,MP. LIBERTADOR,PQ. U TOCUYITO,UNIDAD EDUCATIVA NACIONAL SEBASTIAN ECHEVERIA LOZANO,6788,13,89,5257,2620,5168,0,24,4,2,2518,5257
EDO. CARABOBO,MP. LIBERTADOR,PQ. U TOCUYITO,ESCUELA BASICA ESTADAL BENIGNA REYES,2985,6,40,2323,1574,2283,0,5,1,0,703,2323
EDO. CARABOBO,MP. LIBERTADOR,PQ. U TOCUYITO,ESCUELA BASICA ESTADAL PEDRO BRICEÑO MENDEZ,5527,10,70,4191,2821,4121,5,23,1,6,1265,4191
EDO. CARABOBO,MP. LIBERTADOR,PQ. U TOCUYITO,ESCUELA BASICA ESTADAL JOSEFINA R MARTINEZ,2851,5,30,2260,1550,2230,2,8,2,3,665,2260
EDO. CARABOBO,MP. LIBERTADOR,PQ. U TOCUYITO,UNIDAD EDUCATIVA  ANEXO LA HONDA,1104,2,16,747,581,731,0,3,2,0,145,747
EDO. CARABOBO,MP. LIBERTADOR,PQ. U TOCUYITO,ESCUELA BASICA ESTADAL PROFESORA OFELIA MATUTE,3541,7,37,2974,1349,2937,0,14,2,0,1572,2974
EDO. CARABOBO,MP. LIBERTADOR,PQ. U TOCUYITO,ESCUELA BASICA NACIONAL PRESBITERO CRISPIN PEREZ,1518,3,21,1170,575,1149,1,8,1,0,564,1170
EDO. CARABOBO,MP. LIBERTADOR,PQ. U TOCUYITO,CARCEL DE TOCUYITO,703,2,5,190,138,185,0,1,2,0,44,190
EDO. CARABOBO,MP. LIBERTADOR,PQ. U TOCUYITO,UNIDAD EDUCATIVA CRISPIN PEREZ (ANEXO),3015,6,59,2143,1379,2084,0,8,0,1,696,2143
EDO. CARABOBO,MP. LIBERTADOR,PQ. U TOCUYITO,UNIDAD EDUCATIVA EL LIBERTADOR,2551,5,40,2076,1401,2036,1,16,0,0,618,2076
EDO. CARABOBO,MP. LIBERTADOR,PQ. U TOCUYITO,ESCUELA BASICA ESTADAL CLEOPATRA CASANOVA,5867,11,99,4616,3125,4517,0,19,2,2,1369,4616
EDO. CARABOBO,MP. LIBERTADOR,PQ. U TOCUYITO,UNIDAD EDUCATIVA PRIVADO LA TRINIDAD,1724,3,21,1435,640,1414,0,2,1,0,771,1435
EDO. CARABOBO,MP. LIBERTADOR,PQ. U TOCUYITO,UNIDAD EDUCATIVA ESTADAL FUNDACION 5 DE JULIO,1686,3,31,1298,932,1267,1,1,1,0,332,1298
EDO. CARABOBO,MP. LIBERTADOR,PQ. U TOCUYITO,CENTRO DE EDUCACION INICIAL JIPIJAPA,1149,2,15,781,596,766,1,2,0,1,166,781
EDO. CARABOBO,MP. LIBERTADOR,PQ. U TOCUYITO,CENTRO DE EDUCACION INICIAL EL JUNCAL,1139,2,14,887,695,873,2,6,1,1,168,887
EDO. CARABOBO,MP. LIBERTADOR,PQ. U TOCUYITO,UNIDAD EDUCATIVA LOS CARDONES,1531,3,21,1263,760,1242,2,5,0,0,475,1263
EDO. CARABOBO,MP. LIBERTADOR,PQ. U TOCUYITO,UNIDAD EDUCATIVA ESTADAL ISABEL TERESA DE BELLERA,3008,6,53,2454,1125,2401,0,11,2,4,1259,2454
EDO. CARABOBO,MP. LIBERTADOR,PQ. U TOCUYITO,UNIDAD EDUCATIVA NACIONAL LA INDIA,1052,2,6,862,661,856,1,6,0,1,187,862
EDO. CARABOBO,MP. LIBERTADOR,PQ. U TOCUYITO,ESCUELA EFRAIN PEREZ PEREZ,1126,2,13,874,682,861,0,2,2,0,175,874
EDO. CARABOBO,MP. LIBERTADOR,PQ. U TOCUYITO,UNIDAD EDUCATIVA LA YAGUARA,2689,5,54,2128,1525,2074,0,11,1,0,537,2128
EDO. CARABOBO,MP. LIBERTADOR,PQ. U TOCUYITO,ESCUELA EULALIO TOLEDO TOVAR,1791,3,35,1431,1176,1396,2,5,0,0,213,1431
EDO. CARABOBO,MP. LIBERTADOR,PQ. U TOCUYITO,UNIDAD EDUCATIVA COLEGIO PIO TAMAYO,2178,4,30,1740,1000,1710,0,8,0,1,701,1740
EDO. CARABOBO,MP. LIBERTADOR,PQ. U TOCUYITO,ESCUELA NACIONAL SAN JOSE LOS CHORRITOS,7358,13,108,5682,3248,5574,5,32,4,5,2280,5682
EDO. CARABOBO,MP. LIBERTADOR,PQ. U TOCUYITO,CENTRO DE EDUCACION INICIAL NACIONAL CRISPIN PEREZ,4764,9,67,3687,1870,3620,1,15,2,1,1731,3687
EDO. CARABOBO,MP. MIRANDA,PQ. MIRANDA,UNIDAD EDUCATIVA ESTADAL BOLIVARIANA ANTONIA PEREZ DE FEATHERTON,747,2,7,616,325,609,0,0,0,0,284,616
EDO. CARABOBO,MP. MIRANDA,PQ. MIRANDA,ESCUELA UNITARIA NACIONAL S N,162,1,2,49,42,47,0,1,0,0,4,49
EDO. CARABOBO,MP. MIRANDA,PQ. MIRANDA,CENTRO DE EDUCACION INICIAL SIMONCITO,921,2,14,786,586,772,0,1,1,1,183,786
EDO. CARABOBO,MP. MIRANDA,PQ. MIRANDA,ESCUELA BASICA ESTADAL SABANETA SUR,444,1,7,353,221,346,0,0,0,0,125,353
EDO. CARABOBO,MP. MIRANDA,PQ. MIRANDA,CENTRO EDUCATIVO INICIAL LAS NARANJITAS,2223,4,44,1773,1082,1729,0,8,1,1,637,1773
EDO. CARABOBO,MP. MIRANDA,PQ. MIRANDA,UNIDAD EDUCATIVA BOLIVARIANA EL CEMENTERIO,2150,4,17,1702,1276,1685,1,7,2,1,398,1702
EDO. CARABOBO,MP. MIRANDA,PQ. MIRANDA,CENTRO DE EDUCACION INICIAL BOLIVARIANO CONCENTRADA 77,688,2,4,576,403,572,0,1,0,0,168,576
EDO. CARABOBO,MP. MIRANDA,PQ. MIRANDA,ESCUELA DANIEL MENDOZA,3381,6,47,2676,1534,2629,0,7,1,1,1086,2676
EDO. CARABOBO,MP. MIRANDA,PQ. MIRANDA,CENTRO EDUCATIVO INICIAL FRANCISCO DE MIRANDA,1143,2,15,917,662,902,0,5,0,0,235,917
EDO. CARABOBO,MP. MIRANDA,PQ. MIRANDA,CENTRO EDUCACION INICIAL BOLIVARIANO SIMONCITO MIRANDITA,345,1,1,236,181,235,0,2,0,0,52,236
EDO. CARABOBO,MP. MIRANDA,PQ. MIRANDA,ESCUELA SANTO TOMAS,1666,3,24,1249,896,1225,1,7,0,0,321,1249
EDO. CARABOBO,MP. MIRANDA,PQ. MIRANDA,ESCUELA BASICA BOLIVARIANA DOCTOR SIMON AROCHA PINTO,5008,9,90,4083,2472,3993,0,25,0,1,1495,4083
EDO. CARABOBO,MP. MIRANDA,PQ. MIRANDA,ESCUELA BOLIVARIANA GRACIELA DE MEJIAS,238,1,0,172,149,172,0,0,0,0,23,172
EDO. CARABOBO,MP. SAN JOAQUIN,PQ. SAN JOAQUIN,ESCUELA 5 DE JULIO,1292,3,22,959,699,937,0,9,1,0,228,959
EDO. CARABOBO,MP. SAN JOAQUIN,PQ. SAN JOAQUIN,ESCUELA PRIMARIA BOLIVARIANA LA PRADERA,4919,9,48,4400,1439,4352,0,18,3,8,2884,4400
EDO. CARABOBO,MP. SAN JOAQUIN,PQ. SAN JOAQUIN,ESCUELA CECILIO ACOSTA,4242,8,63,3480,2401,3417,1,14,3,3,995,3480
EDO. CARABOBO,MP. SAN JOAQUIN,PQ. SAN JOAQUIN,CASA COMUNAL,1012,2,24,858,650,834,0,5,0,0,179,858
EDO. CARABOBO,MP. SAN JOAQUIN,PQ. SAN JOAQUIN,UNIDAD EDUCATIVA MONSEÑOR MONTES DE OCA,1416,3,31,1115,811,1084,1,7,2,0,263,1115
EDO. CARABOBO,MP. SAN JOAQUIN,PQ. SAN JOAQUIN,ESCUELA GRADUADA PEDRO GUAL,3274,6,40,2615,1445,2575,2,11,2,2,1113,2615
EDO. CARABOBO,MP. SAN JOAQUIN,PQ. SAN JOAQUIN,ESCUELA RECEPTORIA,1783,4,30,1464,823,1434,2,6,1,2,600,1464
EDO. CARABOBO,MP. SAN JOAQUIN,PQ. SAN JOAQUIN,ESCUELA BASICA FE Y ALEGRIA SIMON RODRIGUEZ,1178,2,25,971,644,946,0,4,0,0,298,971
EDO. CARABOBO,MP. SAN JOAQUIN,PQ. SAN JOAQUIN,ESCUELA ESTADAL ALEJO ZULOAGA,1035,2,13,807,672,794,0,4,0,0,118,807
EDO. CARABOBO,MP. SAN JOAQUIN,PQ. SAN JOAQUIN,ESCUELA ESTADAL NO 16 HACIENDA CURA,418,1,8,343,217,335,0,1,0,1,116,343
EDO. CARABOBO,MP. SAN JOAQUIN,PQ. SAN JOAQUIN,ESCUELA BASICA NACIONAL CONCENTRADA BOLIVARIANA LA ESTACION,1644,3,26,1384,732,1358,0,5,0,1,620,1384
EDO. CARABOBO,MP. SAN JOAQUIN,PQ. SAN JOAQUIN,GRUPO ESCOLAR DR RAFAEL PEREZ,3356,6,50,2787,1192,2737,0,15,1,1,1528,2787
EDO. CARABOBO,MP. SAN JOAQUIN,PQ. SAN JOAQUIN,ESCUELA BOLIVARIANA ROMERO GARCIA,2399,5,36,1964,888,1928,0,7,1,0,1032,1964
EDO. CARABOBO,MP. SAN JOAQUIN,PQ. SAN JOAQUIN,ESCUELA GRADUADA ANTONIO JOSE DE SUCRE,4417,8,69,3565,2558,3496,1,21,2,2,912,3565
EDO. CARABOBO,MP. SAN JOAQUIN,PQ. SAN JOAQUIN,LICEO ALFREDO PIETRI,2061,4,30,1572,910,1542,2,7,1,2,620,1572
EDO. CARABOBO,MP. SAN JOAQUIN,PQ. SAN JOAQUIN,UNIDAD EDUCATIVA MONSEÑOR JACINTO SOTO LAYA,1278,3,21,1067,903,1046,0,6,1,0,136,1067
EDO. CARABOBO,MP. SAN JOAQUIN,PQ. SAN JOAQUIN,LICEO JOSE FELIX RIVAS,2572,5,37,2280,1029,2243,0,11,0,1,1202,2280
EDO. CARABOBO,MP. DIEGO IBARRA,PQ. AGUAS CALIENTES,UNIDAD EDUCATIVA AMADA MARTINEZ PARRA,1632,3,37,1372,1083,1335,1,7,0,1,243,1372
EDO. CARABOBO,MP. DIEGO IBARRA,PQ. AGUAS CALIENTES,ESCUELA JORGELINA GARAY SANCHEZ,5361,10,80,4296,3152,4216,2,30,6,1,1025,4296
EDO. CARABOBO,MP. DIEGO IBARRA,PQ. AGUAS CALIENTES,181 ANIVERSARIO BATALLA DE CARABOBO,2073,4,45,1758,1349,1713,1,8,1,0,354,1758
EDO. CARABOBO,MP. DIEGO IBARRA,PQ. AGUAS CALIENTES,ESCUELA BASICA LA GUARICHA,1990,4,49,1644,1334,1595,0,11,0,1,249,1644
EDO. CARABOBO,MP. DIEGO IBARRA,PQ. AGUAS CALIENTES,CENTRO DE EDUCACION INTEGRAL VISTA ALEGRE,1777,3,32,1358,1064,1326,0,6,0,1,255,1358
EDO. CARABOBO,MP. DIEGO IBARRA,PQ. AGUAS CALIENTES,CENTRO DE EDUCACION INICIAL NACIONA ABDON CALDARON,519,1,5,411,325,406,0,6,0,1,74,411
EDO. CARABOBO,MP. DIEGO IBARRA,PQ. AGUAS CALIENTES,NUCLEO ESCOLAR RURAL 262 TEQUENDAMA,512,1,19,454,325,435,0,2,1,0,107,454
EDO. CARABOBO,MP. DIEGO IBARRA,PQ. AGUAS CALIENTES,ESCUELA BASICA NUCLEO ESCOLAR RURAL 262, PUNTA PALMITA,490,1,8,405,308,397,0,1,0,0,88,405
EDO. CARABOBO,MP. DIEGO IBARRA,PQ. AGUAS CALIENTES,ESCUELA BASICA ESTADAL MONSEÑOR GREGORIO ADAM,3703,7,68,2950,2083,2882,1,9,5,2,782,2950
EDO. CARABOBO,MP. DIEGO IBARRA,PQ. AGUAS CALIENTES,ESCUELA BASICA BOLIVARIANA. PADRE DEHON,981,2,16,814,625,798,0,3,0,0,170,814
EDO. CARABOBO,MP. DIEGO IBARRA,PQ. AGUAS CALIENTES,CENTRO DE EDUCACION INICIAL BOLIVARIANO EL BOSQUE,761,2,14,622,537,608,0,4,0,0,67,622
EDO. CARABOBO,MP. DIEGO IBARRA,PQ. AGUAS CALIENTES,ESCUELA RAMON DIAZ SANCHEZ,4507,8,65,3705,2709,3640,1,19,2,1,908,3705
EDO. CARABOBO,MP. DIEGO IBARRA,PQ. AGUAS CALIENTES,ESCUELA BASICA ESTADAL ANTONIO GUTIERREZ PEREZ,2903,5,67,2168,1636,2101,0,16,0,2,447,2168
EDO. CARABOBO,MP. DIEGO IBARRA,PQ. AGUAS CALIENTES,CENTRO DE EDUCACION INICIAL LA CABRERA,864,2,24,693,547,669,0,4,0,0,118,693
EDO. CARABOBO,MP. DIEGO IBARRA,PQ. AGUAS CALIENTES,CENTRO DE EDUCACION INICIAL SIMONCITO EL DELEITE,807,2,10,692,565,682,0,3,0,0,114,692
EDO. CARABOBO,MP. DIEGO IBARRA,PQ. AGUAS CALIENTES,ESCUELA BASICA MARISCAL SUCRE,2141,4,33,1838,1386,1805,0,7,1,0,411,1838
EDO. CARABOBO,MP. DIEGO IBARRA,PQ. AGUAS CALIENTES,UNIDAD EDUCATIVA NACIONAL 28 DE OCTUBRE,598,1,14,457,372,443,0,2,0,0,69,457
EDO. CARABOBO,MP. DIEGO IBARRA,PQ. AGUAS CALIENTES,UNIDAD EDUCATIVA EL DELEITE,1590,3,24,1359,1116,1335,1,9,1,1,207,1359
EDO. CARABOBO,MP. DIEGO IBARRA,PQ. AGUAS CALIENTES,CENNTRO DE EDUCACION INICIAL DOCTOR JOSE MARIA VARGAR,687,2,14,579,486,565,1,1,1,0,76,579
EDO. CARABOBO,MP. DIEGO IBARRA,PQ. MARIARA,LICEO ANIBAL PARADISI,3509,6,50,2850,1772,2800,0,18,4,1,1005,2850
EDO. CARABOBO,MP. DIEGO IBARRA,PQ. MARIARA,ALDEA UNIVERSITARIA MARIARHA,874,2,22,730,539,708,0,3,1,1,164,730
EDO. CARABOBO,MP. DIEGO IBARRA,PQ. MARIARA,ESCUELA NACIONAL EL DIVIDIVE,5219,10,96,4095,2633,3999,2,22,5,3,1334,4095
EDO. CARABOBO,MP. DIEGO IBARRA,PQ. MARIARA,ESCUELA BASICA DOCTOR RAUL LEONI,2133,4,33,1866,1386,1833,0,3,3,0,441,1866
EDO. CARABOBO,MP. DIEGO IBARRA,PQ. MARIARA,CENTRO DE CAPACITACION MARIARA,2926,5,50,2341,1369,2291,0,8,0,2,912,2341
EDO. CARABOBO,MP. DIEGO IBARRA,PQ. MARIARA,UNIDAD EDUCATIVA NUESTRA SEÑORA DEL CAMINO,4524,8,68,3564,1775,3496,1,25,3,2,1690,3564
EDO. CARABOBO,MP. DIEGO IBARRA,PQ. MARIARA,CENTRO EDUCACION INICIAL LAS BRISAS,1071,2,14,879,772,865,0,3,2,1,87,879
EDO. CARABOBO,MP. DIEGO IBARRA,PQ. MARIARA,ESCUELA BOLIVARIANA GUAMACHO,2061,4,39,1697,1313,1658,0,7,1,0,337,1697
EDO. CARABOBO,MP. DIEGO IBARRA,PQ. MARIARA,ESCUELA DE MEDICINA,1407,3,32,1185,739,1153,0,4,1,1,408,1185
EDO. CARABOBO,MP. DIEGO IBARRA,PQ. MARIARA,ESCUELA BASICA MARIA CLEMENCIA CAMARAN,2220,4,39,1898,1440,1859,1,4,1,0,413,1898
EDO. CARABOBO,MP. DIEGO IBARRA,PQ. MARIARA,ESCUELA NACIONAL MARIARA,4783,9,78,3909,2439,3831,0,19,0,2,1371,3909
EDO. CARABOBO,MP. DIEGO IBARRA,PQ. MARIARA,INSTITUTO MUNICIPAL DE LA CULTURA DIEGO IBARRA, MARIARA,1524,3,32,1258,784,1226,0,7,2,0,433,1258
EDO. CARABOBO,MP. DIEGO IBARRA,PQ. MARIARA,ESCUELA BASICA ESTADAL ALEJANDRO DE HUMBOLDT,521,1,7,435,327,428,0,2,1,0,98,435
EDO. CARABOBO,CE. VALENCIA,PQ. SANTA ROSA,ESCUELA GONZALEZ GUINAND,2505,5,26,2026,733,2000,1,8,1,2,1255,2026
EDO. CARABOBO,CE. VALENCIA,PQ. SANTA ROSA,ESCUELA BASICA ESTADAL MONSEÑOR BELLERA AROCHA,3173,6,44,2558,1353,2514,2,18,1,2,1138,2558
EDO. CARABOBO,CE. VALENCIA,PQ. SANTA ROSA,ESCUELA CARMEN NORTE,1648,3,29,1333,628,1304,0,3,1,2,670,1333
EDO. CARABOBO,CE. VALENCIA,PQ. SANTA ROSA,ESCUELA ESTADAL ANTONIO RANGEL,2159,4,35,1786,1028,1751,2,16,0,4,701,1786
EDO. CARABOBO,CE. VALENCIA,PQ. SANTA ROSA,ESCUELA ANTONIO JOSE DE SUCRE,3527,6,91,2830,1867,2739,0,10,2,2,858,2830
EDO. CARABOBO,CE. VALENCIA,PQ. SANTA ROSA,CENTRO INTEGRAL SIMONCITO,1301,3,20,1072,719,1052,1,3,2,0,327,1072
EDO. CARABOBO,CE. VALENCIA,PQ. SANTA ROSA,CICLO BASICO RAFAEL GUERRA MENDEZ,3278,6,74,2408,1030,2334,1,13,0,1,1289,2408
EDO. CARABOBO,CE. VALENCIA,PQ. SANTA ROSA,ESCUELA FELIX MANUEL LUCES,3647,7,82,2789,1799,2707,0,28,0,1,879,2789
EDO. CARABOBO,CE. VALENCIA,PQ. SANTA ROSA,ESCUELA RAFAEL SATURNO GUERRA,4611,9,85,3748,2360,3663,2,22,3,4,1272,3748
EDO. CARABOBO,CE. VALENCIA,PQ. SANTA ROSA,ESCUELA FE Y ALEGRIA,4637,9,84,3662,2077,3578,0,24,0,2,1475,3662
EDO. CARABOBO,CE. VALENCIA,PQ. SANTA ROSA,UNIDAD EDUCATIVA PRIVADO ARTESANAL LA SALLE,1529,3,30,1305,484,1275,2,8,0,1,780,1305
EDO. CARABOBO,CE. VALENCIA,PQ. SANTA ROSA,ESCUELA ANTONIO JOSE DE SUCRE SUR,3627,7,70,2815,1770,2745,1,23,3,1,947,2815
EDO. CARABOBO,CE. VALENCIA,PQ. SANTA ROSA,ESCUELA TECNICA COMERCIAL FERMIN TORO,1814,4,29,1274,565,1245,0,13,0,2,665,1274
EDO. CARABOBO,CE. VALENCIA,PQ. SANTA ROSA,UNIDAD EDUCATIVA ESPECIAL AUDIOFONOLOGIA CARABOBO,1330,3,16,987,605,971,0,4,1,1,360,987
EDO. CARABOBO,CE. VALENCIA,PQ. SANTA ROSA,ESCUELA BASICA FRANCISCO JOSE CISNEROS,288,1,6,245,143,239,0,1,0,0,95,245
EDO. CARABOBO,CE. VALENCIA,PQ. SANTA ROSA,UNIDAD EDUCATIVA NACIONAL MANUEL RODRIGUEZ VASQUEZ,3725,7,43,2773,1623,2730,2,12,3,2,1088,2773
EDO. CARABOBO,CE. VALENCIA,PQ. SANTA ROSA,UNIDAD EDUCATIVA LUIS BELTRAN DIAZ,745,2,25,601,394,576,0,4,0,0,178,601
EDO. CARABOBO,CE. VALENCIA,PQ. SANTA ROSA,COLEGIO NACIONAL DEL PERIODISTA,3745,7,67,2909,1721,2842,2,16,0,3,1100,2909
EDO. CARABOBO,CE. VALENCIA,PQ. SANTA ROSA,GRUPO ESCOLAR BEJUMA,4312,8,59,3428,2074,3369,1,24,1,3,1266,3428
EDO. CARABOBO,CE. VALENCIA,PQ. SANTA ROSA,UNIDAD EDUCATIVA LA UNIDAD,950,2,11,693,460,682,0,6,0,0,216,693
EDO. CARABOBO,CE. VALENCIA,PQ. CATEDRAL,GRUPO ESCOLAR RAFAEL ARVELO,4206,8,45,3119,1275,3074,1,17,4,1,1776,3119
EDO. CARABOBO,CE. VALENCIA,PQ. NEGRO PRIMERO,ESCUELA BASICA ESTADAL SANTA MARIA,141,1,0,126,126,126,0,0,0,0,0,126
EDO. CARABOBO,CE. VALENCIA,PQ. NEGRO PRIMERO,ESCUELA BASICA LUIS MARIANO CASTRO,120,1,0,99,98,99,0,0,0,0,1,99
EDO. CARABOBO,CE. VALENCIA,PQ. NEGRO PRIMERO,ESCUELA BASICA ESTADAL MANIROTE.,215,1,2,182,177,180,0,0,0,0,3,182
EDO. CARABOBO,CE. VALENCIA,PQ. NEGRO PRIMERO,ESCUELA BASICA ESTADAL LAS TUNAS,330,1,4,201,162,197,2,1,0,0,32,201
EDO. CARABOBO,CE. VALENCIA,PQ. NEGRO PRIMERO,ESCUELA BASICA ESTADAL LAS PALMAS.,158,1,0,99,95,99,0,2,0,0,2,99
EDO. CARABOBO,CE. VALENCIA,PQ. NEGRO PRIMERO,ESCUELA BASICA ESTADAL LAGUNITA.,341,1,6,288,253,282,0,1,0,0,28,288
EDO. CARABOBO,CE. VALENCIA,PQ. NEGRO PRIMERO,ESCUELA BASICA ESTADAL EL ALGARROBO.,145,1,3,115,99,112,0,1,0,0,12,115
EDO. CARABOBO,CE. VALENCIA,PQ. NEGRO PRIMERO,ESCUELA BASICA ESTADAL ALFARO.,160,1,2,119,90,117,0,2,0,0,25,119
EDO. CARABOBO,CE. VALENCIA,PQ. NEGRO PRIMERO,ESCUELA BASICA ESTADAL EL JENGIBRE.,187,1,1,162,150,161,0,1,1,0,9,162
EDO. CARABOBO,CE. VALENCIA,PQ. NEGRO PRIMERO,ESCUELA BASICA EL BARRIAL,415,1,6,283,255,277,1,3,0,0,18,283
EDO. CARABOBO,CE. VALENCIA,PQ. NEGRO PRIMERO,ESCUELA BASICA COGOLLAL,217,1,0,157,152,157,0,1,0,0,4,157
EDO. CARABOBO,CE. VALENCIA,PQ. NEGRO PRIMERO,ESCUELA BASICA ESTADAL LOS CARACAROS.,159,1,6,127,98,121,0,1,1,0,21,127
EDO. CARABOBO,CE. VALENCIA,PQ. NEGRO PRIMERO,ESCUELA BASICA ESTADAL  AGUA HONDA,345,1,7,247,174,240,0,3,0,0,63,247
EDO. CARABOBO,CE. VALENCIA,PQ. NEGRO PRIMERO,ESCUELA BASICA ESTADAL LUIS MARIA SUCRE,1369,3,18,965,739,947,0,6,4,1,197,965
EDO. CARABOBO,CE. VALENCIA,PQ. NEGRO PRIMERO,ESCUELA BASICA EL CUMBOTO,417,1,3,252,233,249,0,1,0,0,15,252
EDO. CARABOBO,CE. VALENCIA,PQ. NEGRO PRIMERO,ESCUELA BASICA NACIONAL BOLIVARIANA LOS MANGOS,512,1,7,356,305,349,0,3,1,0,40,356
EDO. CARABOBO,CE. VALENCIA,PQ. NEGRO PRIMERO,ESCUELA UNITARIA LAS DOS BOCAS,864,2,21,579,472,558,2,2,3,1,78,579
EDO. CARABOBO,CE. VALENCIA,PQ. SAN BLAS,GRUPO ESCOLAR JESUS GRANADOS CASARES,2675,5,24,2186,474,2162,0,3,0,0,1685,2186
EDO. CARABOBO,CE. VALENCIA,PQ. SAN BLAS,GRUPO ESCOLAR FERMIN TORO,5380,10,65,4198,1755,4133,0,16,1,1,2360,4198
EDO. CARABOBO,CE. VALENCIA,PQ. SAN BLAS,UNIDAD EDUCATIVA MUNICIPAL SANTA ANA,1026,2,8,791,353,783,1,5,1,0,423,791
EDO. CARABOBO,CE. VALENCIA,PQ. SAN BLAS,GRUPO ESCOLAR PADRE ALEXANDER,2010,4,25,1584,581,1559,0,4,0,1,973,1584
EDO. CARABOBO,CE. VALENCIA,PQ. SAN BLAS,LICEO BOLIVARIANO NACIONAL MARTIN JOSE SANABRIA,2780,5,22,2052,670,2030,2,6,0,1,1351,2052
EDO. CARABOBO,CE. VALENCIA,PQ. SAN BLAS,UNIDAD EDUCATIVA PEDRO GUZMAN GAGO,655,2,9,604,292,595,0,4,1,0,298,604
EDO. CARABOBO,CE. VALENCIA,PQ. SAN BLAS,GRUPO ESCOLAR EDUARDO VISO,4309,8,47,3369,983,3322,2,17,0,0,2320,3369
EDO. CARABOBO,CE. VALENCIA,PQ. SAN BLAS,ESCUELA BASICA ESTADAL MARIA GORETTI,1373,3,29,1153,430,1124,0,7,1,0,686,1153
EDO. CARABOBO,CE. VALENCIA,PQ. SAN BLAS,ESCUELA CONCENTRADA 94 118,1066,2,17,800,378,783,0,2,0,2,401,800
EDO. CARABOBO,CE. VALENCIA,PQ. EL SOCORRO,COLEGIO DON BOSCO,5197,10,64,3968,1240,3904,1,20,2,2,2639,3968
EDO. CARABOBO,CE. VALENCIA,PQ. SAN JOSE,COLEGIO JUAN XXIII,7844,14,32,6231,410,6199,0,9,1,6,5773,6231
EDO. CARABOBO,CE. VALENCIA,PQ. SAN JOSE,ESCUELA BASICA NACIONAL ANTONIO HERRERA TORO,2012,4,16,1554,259,1538,0,1,0,0,1278,1554
EDO. CARABOBO,CE. VALENCIA,PQ. SAN JOSE,UNIDAD EDUCATIVA NACIONAL CIRILO ALBERTO,4112,8,15,3305,280,3290,0,7,0,2,3001,3305
EDO. CARABOBO,CE. VALENCIA,PQ. SAN JOSE,INSTITUTO MARIA MONTESSORI,3618,7,24,2885,496,2861,3,2,0,2,2358,2885
EDO. CARABOBO,CE. VALENCIA,PQ. SAN JOSE,GRUPO ESCOLAR PEDRO CASTILLO,6828,12,39,5276,587,5237,0,11,1,5,4633,5276
EDO. CARABOBO,CE. VALENCIA,PQ. SAN JOSE,INSTITUTO NACIONAL DE CAPACITACION Y EDUCACION SOCIALISTA (INCES),4788,9,37,3804,920,3767,0,13,2,5,2827,3804
EDO. CARABOBO,CE. VALENCIA,PQ. SAN JOSE,UNIDAD EDUCATIVA INSTITUTO SAN VALENTIN,826,2,4,745,69,741,0,1,0,0,671,745
EDO. CARABOBO,CE. VALENCIA,PQ. SAN JOSE,UNIDAD EDUCATIVA CARABOBO,4919,9,29,4463,505,4434,1,7,0,1,3920,4463
EDO. CARABOBO,CE. VALENCIA,PQ. SAN JOSE,PRE ESCOLAR JULIO CASTRO.,3111,6,18,2603,342,2585,1,11,0,1,2230,2603
EDO. CARABOBO,CE. VALENCIA,PQ. SAN JOSE,COLEGIO LA SALLE,3749,7,18,3148,169,3130,0,5,1,3,2952,3148
EDO. CARABOBO,CE. VALENCIA,PQ. SAN JOSE,UNIVERSIDAD ALEJANDRO HUMBOLDT,4520,8,13,3396,214,3383,0,5,0,1,3163,3396
EDO. CARABOBO,CE. VALENCIA,PQ. SAN JOSE,UNIDAD EDUCATIVA INSTITUTO EXPERIMENTAL SIMON BOLIVAR (APUCITO),2307,4,11,2153,227,2142,0,3,1,0,1911,2153
EDO. CARABOBO,CE. VALENCIA,PQ. SAN JOSE,LICEO MANUEL FELIPE TOVAR,6737,12,24,5362,440,5338,1,3,2,3,4889,5362
EDO. CARABOBO,CE. VALENCIA,PQ. SAN JOSE,UNIDAD ESCOLAR ALFREDO COLOMINE,3856,7,22,3420,412,3398,1,8,1,3,2973,3420
EDO. CARABOBO,CE. VALENCIA,PQ. SAN JOSE,COLEGIO NUESTRA SEÑORA DEL LOURDES,4583,8,26,3521,481,3495,0,10,1,1,3002,3521
EDO. CARABOBO,CE. VALENCIA,PQ. SAN JOSE,ESCUELA MINERVA,3108,6,29,2538,314,2509,2,6,0,0,2187,2538
EDO. CARABOBO,CE. VALENCIA,PQ. SAN JOSE,UNIDAD EDUCATIVA COLEGIO INTERNACIONAL DE CARABOBO,1600,3,10,1447,108,1437,0,1,2,2,1324,1447
EDO. CARABOBO,CE. VALENCIA,PQ. SAN JOSE,UNIDAD EDUCATIVA COLEGIO LA ESPERANZA,3212,6,7,2671,284,2664,1,4,0,1,2374,2671
EDO. CARABOBO,CE. VALENCIA,PQ. SAN JOSE,UNIDAD EDUCATIVA PRIVADO SAGRADO CORAZON,8301,15,64,6682,909,6618,0,16,2,1,5690,6682
EDO. CARABOBO,CE. VALENCIA,PQ. SAN JOSE,COLEGIO CALASANZ,4608,8,27,3691,464,3664,0,7,0,1,3192,3691
EDO. CARABOBO,CE. VALENCIA,PQ. SAN JOSE,COLEGIO SAN GABRIEL ARCANGEL,5710,11,26,4687,301,4661,0,5,0,2,4353,4687
EDO. CARABOBO,CE. VALENCIA,PQ. SAN JOSE,ESCUELA LISANDRO RAMIREZ,9198,17,64,7523,721,7459,0,14,2,5,6717,7523
EDO. CARABOBO,CE. VALENCIA,PQ. SAN JOSE,LICEO CICLO DIVERSIFICADO PEDRO GUAL,6816,13,77,5486,1338,5409,0,20,3,3,4045,5486
EDO. CARABOBO,CE. VALENCIA,PQ. CANDELARIA,GRUPO ESCOLAR EUTIMIO RIVAS,4803,9,57,3894,1697,3837,0,19,1,7,2113,3894
EDO. CARABOBO,CE. VALENCIA,PQ. CANDELARIA,ESCUELA BASICA BRIGIDA HURTADO DE MENDIRI,641,2,6,512,326,506,0,2,0,0,178,512
EDO. CARABOBO,CE. VALENCIA,PQ. CANDELARIA,UNIDAD EDUCATIVA MONSEÑOR VICTOR  BELLERA,2344,4,13,1703,594,1690,0,9,0,5,1082,1703
EDO. CARABOBO,CE. VALENCIA,PQ. CANDELARIA,GRUPO ESCOLAR JUAN ANTONIO MICHELENA,6488,12,100,5149,2677,5049,4,22,0,3,2343,5149
EDO. CARABOBO,CE. VALENCIA,PQ. CANDELARIA,GRUPO ESCOLAR REPUBLICA DEL PERU,6262,12,95,4975,1860,4880,1,27,7,2,2983,4975
EDO. CARABOBO,CE. VALENCIA,PQ. CANDELARIA,ESCUELA BASICA NACIONAL FERNANDO PEÑALVER,2042,4,22,1491,653,1469,1,13,0,1,801,1491
EDO. CARABOBO,CE. VALENCIA,PQ. CANDELARIA,GRUPO ESCOLAR JOSE GREGORIO PONCE BELLO,3065,6,35,2406,1682,2371,2,11,0,0,676,2406
EDO. CARABOBO,CE. VALENCIA,PQ. MIGUEL PE#A,UNIDAD EDUCATIVA ARTURO MICHELENA,196,1,2,150,101,148,0,0,0,0,47,150
EDO. CARABOBO,CE. VALENCIA,PQ. MIGUEL PE#A,CEIM EZEQUIEL ZAMORA,1512,3,21,1207,844,1186,0,7,1,0,334,1207
EDO. CARABOBO,CE. VALENCIA,PQ. MIGUEL PE#A,PRE ESCOLAR FEDERACION,852,2,12,745,542,733,0,4,0,1,186,745
EDO. CARABOBO,CE. VALENCIA,PQ. MIGUEL PE#A,ESCUELA FE Y ALEGRIA DOCTOR LEOPOLDO YA EZ,6494,12,115,5339,1997,5224,3,39,1,3,3181,5339
EDO. CARABOBO,CE. VALENCIA,PQ. MIGUEL PE#A,ESCUELA BASICA MONSEÑOR AROCHA,240,1,4,191,94,187,1,0,0,0,92,191
EDO. CARABOBO,CE. VALENCIA,PQ. MIGUEL PE#A,UNIDAD EDUCATIVA SIERVO DE DIOS,751,2,16,613,418,597,0,3,0,0,176,613
EDO. CARABOBO,CE. VALENCIA,PQ. MIGUEL PE#A,LICEO ALEJO ZULOAGA,6716,12,74,5301,2595,5227,2,34,1,2,2593,5301
EDO. CARABOBO,CE. VALENCIA,PQ. MIGUEL PE#A,REPUBLICA ARABE SAHARAMI DEMOCRATICA,2814,5,59,2166,1105,2107,0,12,3,0,987,2166
EDO. CARABOBO,CE. VALENCIA,PQ. MIGUEL PE#A,ESCUELA BASICA ESTADAL MONSEÑOR LUIS EDUARDO HENRIQUEZ,2751,5,45,2259,1297,2214,0,19,2,0,896,2259
EDO. CARABOBO,CE. VALENCIA,PQ. MIGUEL PE#A,COLEGIO RAMON IGNACIO MENDEZ (UNIDAD EDUCATIVA ANEXO BELLA VISTA),1705,3,18,1261,927,1243,1,4,0,0,311,1261
EDO. CARABOBO,CE. VALENCIA,PQ. MIGUEL PE#A,LICEO PONCE BELLO,5530,10,77,4268,2607,4191,3,26,1,7,1547,4268
EDO. CARABOBO,CE. VALENCIA,PQ. MIGUEL PE#A,ESCUELA BASICA JOSE FELIX RIBAS,1006,2,3,770,554,767,0,5,0,0,208,770
EDO. CARABOBO,CE. VALENCIA,PQ. MIGUEL PE#A,FUNDACION VALENCIA 1,638,2,6,518,317,512,0,4,0,0,191,518
EDO. CARABOBO,CE. VALENCIA,PQ. MIGUEL PE#A,CENTRO DE INTREGACION MATERNAL LOMAS DE FUNVAL  PRE  ESCOLAR,1562,3,26,1290,752,1264,0,7,0,0,505,1290
EDO. CARABOBO,CE. VALENCIA,PQ. MIGUEL PE#A,GRUPO ESCOLAR NACIONAL SIMON RODRIGUEZ,5466,10,88,4310,1907,4222,1,19,0,1,2294,4310
EDO. CARABOBO,CE. VALENCIA,PQ. MIGUEL PE#A,ESCUELA RUIZ PINEDA,4950,9,53,3870,2428,3817,5,27,2,1,1354,3870
EDO. CARABOBO,CE. VALENCIA,PQ. MIGUEL PE#A,CENTRO DE EDUCACION INICIAL DON ROMULO GALLEGOS,1327,3,14,1089,737,1075,1,4,0,0,333,1089
EDO. CARABOBO,CE. VALENCIA,PQ. MIGUEL PE#A,GRUPO ESCOLAR PADRE BERGERETTI,4552,8,66,3446,2026,3380,1,20,1,2,1330,3446
EDO. CARABOBO,CE. VALENCIA,PQ. MIGUEL PE#A,ESCUELA BASICA IRMA VIVAS DE MARIN,1349,3,17,1025,789,1008,0,2,0,0,217,1025
EDO. CARABOBO,CE. VALENCIA,PQ. MIGUEL PE#A,CENTRO DE DESARROLLO COMUNAL EL CONCEJO,570,1,10,501,357,491,0,1,1,0,132,501
EDO. CARABOBO,CE. VALENCIA,PQ. MIGUEL PE#A,UNIDAD ESCOLAR DOCTOR ENRIQUE TEJERA,4558,8,54,3570,2546,3516,2,26,1,5,936,3570
EDO. CARABOBO,CE. VALENCIA,PQ. MIGUEL PE#A,ESCUELA BASICA EL SOCORRO,3863,7,79,2983,2001,2904,1,16,1,2,883,2983
EDO. CARABOBO,CE. VALENCIA,PQ. MIGUEL PE#A,ESCUELA BASICA ESTADAL DR. FRANCISCO ESPEJO,7579,14,128,5753,3545,5625,2,36,5,4,2033,5753
EDO. CARABOBO,CE. VALENCIA,PQ. MIGUEL PE#A,ESCUELA NACIONAL MANUEL ALCAZAR,5458,10,59,4279,2501,4220,1,20,0,2,1696,4279
EDO. CARABOBO,CE. VALENCIA,PQ. MIGUEL PE#A,ESCUELA BASICA BICENTENARIO III,930,2,15,730,519,715,0,6,0,0,190,730
EDO. CARABOBO,CE. VALENCIA,PQ. MIGUEL PE#A,JARDIN DE INFANCIA VENEZUELA,1389,3,27,1141,761,1114,0,10,4,0,339,1141
EDO. CARABOBO,CE. VALENCIA,PQ. MIGUEL PE#A,UNIDAD EDUCATIVA DOMINGO SAVIO,4606,8,63,3601,2193,3538,4,19,3,2,1317,3601
EDO. CARABOBO,CE. VALENCIA,PQ. MIGUEL PE#A,UNIDAD EDUCATIVA FUNDACIÓN VALENCIA II,3403,6,48,2622,1896,2574,1,29,1,0,647,2622
EDO. CARABOBO,CE. VALENCIA,PQ. MIGUEL PE#A,ESCUELA NACIONAL CONCENTRADA ANTONIO RICAURTE,5952,11,98,4521,3147,4423,0,35,2,0,1239,4521
EDO. CARABOBO,CE. VALENCIA,PQ. MIGUEL PE#A,JARDIN DE INFANCIA GUSTAVO H MACHADO,119,1,1,109,47,108,0,1,0,0,60,109
EDO. CARABOBO,CE. VALENCIA,PQ. MIGUEL PE#A,ESCUELA BASICA ESTADAL TRAPICHITO I,315,1,5,193,145,188,0,0,0,0,43,193
EDO. CARABOBO,CE. VALENCIA,PQ. MIGUEL PE#A,UNIDAD ESCOLAR NEGRO PRIMERO,5073,9,97,3895,2720,3798,2,28,2,0,1046,3895
EDO. CARABOBO,CE. VALENCIA,PQ. MIGUEL PE#A,CENTRO PRE ESCOLAR SIMON BOLIVAR,1940,4,38,1654,874,1616,0,9,3,2,728,1654
EDO. CARABOBO,CE. VALENCIA,PQ. MIGUEL PE#A,ESCUELA ESTADAL JOSE ANTONIO PAEZ,6148,11,104,4661,2687,4557,0,32,5,2,1831,4661
EDO. CARABOBO,CE. VALENCIA,PQ. MIGUEL PE#A,ESCUELA BOLIVARIANA ISABEL FERNANDEZ DE ICHAZU,3181,6,48,2510,1209,2462,1,13,1,2,1236,2510
EDO. CARABOBO,CE. VALENCIA,PQ. MIGUEL PE#A,ESCUELA NACIONAL EL PRADO,3190,6,52,2497,1335,2445,2,19,2,4,1083,2497
EDO. CARABOBO,CE. VALENCIA,PQ. MIGUEL PE#A,UNIDAD ESCOLAR LUIS BELTRAN PIETRO FIGUEROA,403,1,18,360,265,342,0,1,1,2,73,360
EDO. CARABOBO,CE. VALENCIA,PQ. MIGUEL PE#A,UNIDAD EDUCATIVA ROSALIA CAMPINS DE HERRERA,560,1,9,481,343,472,0,2,1,0,126,481
EDO. CARABOBO,CE. VALENCIA,PQ. MIGUEL PE#A,ESCUELA TRIBU DE JUDAS      (ANEXO ESCUELA BASICA LOMAS DE FUNVAL),1026,2,24,822,553,798,0,2,1,1,241,822
EDO. CARABOBO,CE. VALENCIA,PQ. MIGUEL PE#A,UNIDAD EDUCACION INTEGRAL LOMAS DE FUNVAL,4143,8,56,3391,2049,3335,3,34,1,1,1247,3391
EDO. CARABOBO,CE. VALENCIA,PQ. MIGUEL PE#A,EULALIA BUROS,672,2,11,529,329,518,0,1,0,0,188,529
EDO. CARABOBO,CE. VALENCIA,PQ. MIGUEL PE#A,PAULA BERBECIA,504,1,8,362,279,354,1,6,0,1,67,362
EDO. CARABOBO,CE. VALENCIA,PQ. MIGUEL PE#A,ESCUELA BASICA ESTADAL GENERAL DIEGO IBARRA TRAPICHITO,506,1,7,383,275,376,0,5,0,1,95,383
EDO. CARABOBO,CE. VALENCIA,PQ. MIGUEL PE#A,ESCUELA BASICA BOLIVARIANA JOSE RAFAEL POCATERRA,3649,7,41,2967,1105,2926,0,11,1,1,1808,2967
EDO. CARABOBO,CE. VALENCIA,PQ. MIGUEL PE#A,ESCUELA 19 DE ABRIL,3548,7,61,2837,1418,2776,1,15,3,3,1336,2837
EDO. CARABOBO,CE. VALENCIA,PQ. MIGUEL PE#A,ANEXO DOCTOR RAFAEL GUERRA MENDEZ,3010,6,41,2219,1425,2178,1,13,1,0,738,2219
EDO. CARABOBO,CE. VALENCIA,PQ. MIGUEL PE#A,UNIDAD EDUCATIVA ITIEL,1251,3,14,1094,643,1080,0,8,0,0,429,1094
EDO. CARABOBO,CE. VALENCIA,PQ. MIGUEL PE#A,ESCUELA BASICA ESTADAL BELLA VISTA II,3841,7,46,2878,1881,2832,1,18,2,4,926,2878
EDO. CARABOBO,CE. VALENCIA,PQ. MIGUEL PE#A,ESCUELA BASICA ESTADAL JOSE REGINO PEÑA,10665,19,216,7957,5116,7741,3,52,4,3,2563,7957
EDO. CARABOBO,CE. VALENCIA,PQ. MIGUEL PE#A,UNIDAD ESCOLAR SANTA MARIA DE CALATRAVA,2424,5,24,2085,778,2061,1,13,0,4,1265,2085
EDO. CARABOBO,CE. VALENCIA,PQ. MIGUEL PE#A,ANEXO DE RUIZ PINEDA 1,5069,9,66,3937,2458,3871,1,18,3,2,1389,3937
EDO. CARABOBO,CE. VALENCIA,PQ. MIGUEL PE#A,COLEGIO LUISA CACERES DE ARISMENDI,4117,8,40,3353,1022,3313,0,16,3,3,2269,3353
EDO. CARABOBO,CE. VALENCIA,PQ. MIGUEL PE#A,ESCUELA BASICA BOLIVARIANA LA PAZ,2247,4,26,1863,1438,1837,0,11,2,1,385,1863
EDO. CARABOBO,CE. VALENCIA,PQ. MIGUEL PE#A,UNIDAD EDUCATIVA CORINA ROMER DE SALAS,1405,3,21,1089,789,1068,2,10,0,0,267,1089
EDO. CARABOBO,CE. VALENCIA,PQ. MIGUEL PE#A,ESCUELA BASICA EL MILAGRO DE DIOS,2563,5,66,1996,1567,1930,0,4,1,2,356,1996
EDO. CARABOBO,CE. VALENCIA,PQ. MIGUEL PE#A,CENTRO PRE ESCOLAR CONSTRUCCION FORD,741,2,12,586,414,574,0,2,0,0,158,586
EDO. CARABOBO,CE. VALENCIA,PQ. MIGUEL PE#A,UNIDAD EDUCATIVA COLEGIO LUZ DE CARABOBO,204,1,2,176,69,174,0,0,0,1,104,176
EDO. CARABOBO,CE. VALENCIA,PQ. MIGUEL PE#A,PREESCOLAR CARABOBO,235,1,3,179,135,176,1,1,1,0,38,179
EDO. CARABOBO,CE. VALENCIA,PQ. MIGUEL PE#A,UNIDAD EDUCATIVA FELIPE NERY PULIDO,1896,4,11,1486,489,1475,1,5,0,1,979,1486
EDO. CARABOBO,CE. VALENCIA,PQ. MIGUEL PE#A,UNIDAD EDUCATIVA EL MILAGROS DE DIOS 1,1389,3,21,1061,795,1040,0,7,0,1,237,1061
EDO. CARABOBO,CE. VALENCIA,PQ. MIGUEL PE#A,UNIDAD EDUCATIVA CREACION LIBERTADOR I,580,1,14,474,330,460,0,2,1,0,127,474
EDO. CARABOBO,CE. VALENCIA,PQ. MIGUEL PE#A,ESCUELA BASICA LOMAS DE FUNVAL,3190,6,42,2606,1624,2564,2,19,2,3,914,2606
EDO. CARABOBO,CE. VALENCIA,PQ. MIGUEL PE#A,JARDIN DE INFANCIA BOLIVARIANO SAN AGUSTIN,560,1,4,469,347,465,0,3,0,0,115,469
EDO. CARABOBO,CE. VALENCIA,PQ. MIGUEL PE#A,PREESCOLAR RICARDO URRIERA,4648,9,76,3781,2310,3705,3,27,1,3,1361,3781
EDO. CARABOBO,CE. VALENCIA,PQ. MIGUEL PE#A,SANTA TERESITA DE ASIS  ( FE Y ALEGRIA),1653,3,21,1276,742,1255,0,3,2,0,508,1276
EDO. CARABOBO,CE. VALENCIA,PQ. MIGUEL PE#A,ESCUELA NACIONAL ISIDRO RAMIREZ,4640,9,62,3552,2349,3490,3,25,2,1,1110,3552
EDO. CARABOBO,CE. VALENCIA,PQ. MIGUEL PE#A,UNIDAD EDUCATIVA RAFAEL RANGEL,1502,3,37,1158,764,1121,0,5,0,0,352,1158
EDO. CARABOBO,CE. VALENCIA,PQ. MIGUEL PE#A,ESCUELA BASICA ESTADAL RAUL VILLARROEL,7095,13,147,5452,3522,5305,4,28,4,1,1746,5452
EDO. CARABOBO,CE. VALENCIA,PQ. MIGUEL PE#A,ESCUELA BASICA SOROCAIMA,1091,2,16,849,616,833,0,7,1,0,209,849
EDO. CARABOBO,CE. VALENCIA,PQ. MIGUEL PE#A,CENTRO DE EDUCACION INICIAL NACIONAL MONUMENTAL PRE ESCOLAR ALICIA FERRER,3874,7,51,3051,1833,3000,2,28,1,0,1136,3051
EDO. CARABOBO,CE. VALENCIA,PQ. MIGUEL PE#A,ESCUELA RICARDO URRIERA,2145,4,26,1783,1082,1757,0,6,0,1,668,1783
EDO. CARABOBO,CE. VALENCIA,PQ. MIGUEL PE#A,PRE ESCOLAR BOLIVARIANO EL CONCEJO,1425,3,24,1118,606,1094,0,7,0,2,479,1118
EDO. CARABOBO,CE. VALENCIA,PQ. MIGUEL PE#A,UNIDAD EDUCATIVA OBRA SOCIAL SAN JOSE DE CALAZANS,1160,2,27,952,652,925,0,5,0,0,268,952
EDO. CARABOBO,CE. VALENCIA,PQ. MIGUEL PE#A,UNIDAD EDUCATIVA OLIARI,988,2,11,752,457,741,0,3,1,0,280,752
EDO. CARABOBO,CE. VALENCIA,PQ. MIGUEL PE#A,ESCUELA BASICA RUIZ PINEDA II,4204,8,78,3345,2050,3267,0,15,2,2,1198,3345
EDO. CARABOBO,CE. VALENCIA,PQ. MIGUEL PE#A,ESCUELA BASICA ALFREDO PIETRI,2272,4,31,1738,1020,1707,1,11,0,2,673,1738
EDO. CARABOBO,CE. VALENCIA,PQ. MIGUEL PE#A,UNIDAD EDUCATIVA ROLANDO CARRILLO,1739,3,42,1420,981,1378,2,7,1,2,385,1420
EDO. CARABOBO,CE. VALENCIA,PQ. MIGUEL PE#A,UNIDAD EDUCATIVA MANUEL VICENTE ROMERO GARCIA,431,1,4,342,208,338,0,1,0,1,128,342
EDO. CARABOBO,CE. VALENCIA,PQ. MIGUEL PE#A,PRE ESCOLAR LOMAS DE FUNVAL,1063,2,22,827,518,805,0,6,0,0,281,827
EDO. CARABOBO,CE. VALENCIA,PQ. MIGUEL PE#A,LICEO BOLIVARIANO ERNESTO CHE GUEVARA,6021,11,85,4624,3218,4539,2,30,4,3,1282,4624
EDO. CARABOBO,CE. VALENCIA,PQ. MIGUEL PE#A,UNIDAD ESCOLAR CARIBAY,1216,3,21,1012,634,991,0,7,0,3,347,1012
EDO. CARABOBO,CE. VALENCIA,PQ. MIGUEL PE#A,UNIDAD EDUCATIVA DOCTOR GERMAN SUAREZ FLAMERICH,1131,2,17,869,624,852,0,6,1,1,220,869
EDO. CARABOBO,CE. VALENCIA,PQ. MIGUEL PE#A,ESCUELA BOLIVARIANA RAMON DIAZ SANCHEZ,2303,4,39,1868,932,1829,0,12,0,3,882,1868
EDO. CARABOBO,CE. VALENCIA,PQ. MIGUEL PE#A,UNIDAD DOCTOR ARISTIDES CALVANIS,479,1,1,376,323,375,0,2,0,0,50,376
EDO. CARABOBO,CE. VALENCIA,PQ. MIGUEL PE#A,ESCUELA BASICA MIGUEL ARTURO GONZALEZ  GRANADILLO,4197,8,49,3269,2122,3220,0,12,3,3,1080,3269
EDO. CARABOBO,CE. VALENCIA,PQ. RAFAEL URDANETA,UNIDAD EDUCATIVA GENERAL JOSE ANTONIO PAEZ,1407,3,28,1095,610,1067,1,5,3,1,447,1095
EDO. CARABOBO,CE. VALENCIA,PQ. RAFAEL URDANETA,ESCUELA BASICA BARRIO LA TRINIDAD,5037,9,57,4207,1417,4150,2,17,2,1,2711,4207
EDO. CARABOBO,CE. VALENCIA,PQ. RAFAEL URDANETA,ESCUELA ESTADAL HUMBERTO CELLI,2477,5,43,2085,1417,2042,0,7,0,0,618,2085
EDO. CARABOBO,CE. VALENCIA,PQ. RAFAEL URDANETA,GRUPO ESCOLAR GUACARA,4877,9,54,3894,2503,3840,1,21,3,2,1310,3894
EDO. CARABOBO,CE. VALENCIA,PQ. RAFAEL URDANETA,ESCUELA BASICA SANTA INES,5629,10,69,4646,2694,4577,1,38,3,2,1839,4646
EDO. CARABOBO,CE. VALENCIA,PQ. RAFAEL URDANETA,ESCUELA BASICA OLIMPIA BARRIOS,1547,3,26,1303,900,1277,1,11,0,0,365,1303
EDO. CARABOBO,CE. VALENCIA,PQ. RAFAEL URDANETA,ESCUELA BASICA LAS PALMITAS,6538,12,94,5211,3924,5117,2,29,2,1,1159,5211
EDO. CARABOBO,CE. VALENCIA,PQ. RAFAEL URDANETA,UNIDAD EDUCATIVA NACIONAL BOLIVARIANA  MERCEDES SANTANA,3122,6,22,2594,921,2572,0,12,2,1,1636,2594
EDO. CARABOBO,CE. VALENCIA,PQ. RAFAEL URDANETA,UNIDAD EDUCATIVA GRAN PODER DE DIOS,5016,9,61,4113,1645,4052,0,13,1,3,2390,4113
EDO. CARABOBO,CE. VALENCIA,PQ. RAFAEL URDANETA,UNIDAD EDUCATIVA TEOTISTE DE GALLEGOS,5505,10,60,4379,2899,4319,0,26,1,0,1393,4379
EDO. CARABOBO,CE. VALENCIA,PQ. RAFAEL URDANETA,JARDIN DE INFANCIA MANUELITA SAENZ,1954,4,32,1614,1091,1582,0,7,1,0,483,1614
EDO. CARABOBO,CE. VALENCIA,PQ. RAFAEL URDANETA,ESCUELA BASICA NACIONAL GENERAL RAFAEL URDANETA,4834,9,52,4010,1276,3958,0,26,3,2,2651,4010
EDO. CARABOBO,CE. VALENCIA,PQ. RAFAEL URDANETA,INCE LA ISABELICA,3899,7,44,3033,1178,2989,4,10,0,1,1796,3033
EDO. CARABOBO,CE. VALENCIA,PQ. RAFAEL URDANETA,INSTITUTO  DE EDUCACION ESPECIAL FLOR AMARILLO,1141,2,20,937,601,917,0,7,3,0,306,937
EDO. CARABOBO,CE. VALENCIA,PQ. RAFAEL URDANETA,ESCUELA JUAN JOSE RONDON,3501,7,89,2866,1315,2777,0,18,1,2,1441,2866
EDO. CARABOBO,CE. VALENCIA,PQ. RAFAEL URDANETA,UNIDAD EDUCATIVA CARABOBO,2215,4,34,1768,831,1734,0,4,1,2,896,1768
EDO. CARABOBO,CE. VALENCIA,PQ. RAFAEL URDANETA,UNIDAD EDUCATIVA COLEGIO TAMANACO,504,1,8,208,132,200,0,2,0,0,66,208
EDO. CARABOBO,CE. VALENCIA,PQ. RAFAEL URDANETA,UNIDAD EDUCATIVA CABRIALES,1003,2,15,764,543,749,0,7,1,0,198,764
EDO. CARABOBO,CE. VALENCIA,PQ. RAFAEL URDANETA,UNIDAD EDUCATIVA TERESA DE LA PARRA,2316,4,31,1917,1578,1886,2,3,0,1,302,1917
EDO. CARABOBO,CE. VALENCIA,PQ. RAFAEL URDANETA,ESCUELA BASICA ESTADAL JUANITA HERNANDEZ LEON,8628,16,113,7123,3037,7010,0,46,2,3,3922,7123
EDO. CARABOBO,CE. VALENCIA,PQ. RAFAEL URDANETA,ESCUELA JUAN USLAR,3400,6,35,2773,1577,2738,3,18,1,0,1139,2773
EDO. CARABOBO,CE. VALENCIA,PQ. RAFAEL URDANETA,ESCUELA BASICA LUIS SANOJO,5350,10,61,4509,1618,4448,1,17,1,0,2811,4509
EDO. CARABOBO,CE. VALENCIA,PQ. RAFAEL URDANETA,ESCUELA GUIGUE,2024,4,23,1590,1062,1567,0,11,1,0,493,1590
EDO. CARABOBO,CE. VALENCIA,PQ. RAFAEL URDANETA,ESCUELA ITACA,8250,15,85,6719,3418,6634,3,36,3,6,3168,6719
EDO. CARABOBO,CE. VALENCIA,PQ. RAFAEL URDANETA,ESCUELA NACIONAL MINAS DE AROA,1260,3,13,971,818,958,0,3,0,0,137,971
EDO. CARABOBO,CE. VALENCIA,PQ. RAFAEL URDANETA,UNIDAD EDUCATIVA BELLO MONTE,1437,3,10,1201,664,1191,1,8,0,0,518,1201
EDO. CARABOBO,CE. VALENCIA,PQ. RAFAEL URDANETA,PRE ESCOLAR MUNICIPAL BUCARAL SUR,2138,4,24,1776,851,1752,0,13,1,1,886,1776
EDO. CARABOBO,CE. VALENCIA,PQ. RAFAEL URDANETA,UNIDAD EDUCATIVA BOLIVARIANA BERACIERTA,4047,7,40,3361,1199,3321,0,22,3,3,2094,3361
EDO. CARABOBO,CE. VALENCIA,PQ. RAFAEL URDANETA,LICEO NACIONAL ENRIQUE BERNARDO NUÑEZ,4351,8,48,3624,1595,3576,0,23,0,0,1958,3624
EDO. CARABOBO,CE. VALENCIA,PQ. RAFAEL URDANETA,UNIDAD EDUCATIVA NACIONAL MERCEDES I DE CORRO,5795,11,71,4836,2469,4765,1,25,3,2,2265,4836
EDO. CARABOBO,CE. VALENCIA,PQ. RAFAEL URDANETA,COLEGIO NACIONAL BOLIVARIANO SIMONCITO LA TRINIDAD,871,2,8,734,540,726,0,1,1,0,184,734
EDO. CARABOBO,CE. VALENCIA,PQ. RAFAEL URDANETA,ESCUELA BASICA ASENTAMIENTO CAMPESINO,552,1,3,451,402,448,0,3,0,0,43,451
EDO. CARABOBO,CE. VALENCIA,PQ. RAFAEL URDANETA,PRE   ESCOLAR MUNICIPAL LAS PALMITAS,3863,7,67,3056,2341,2989,1,8,0,1,638,3056
EDO. CARABOBO,CE. VALENCIA,PQ. RAFAEL URDANETA,UNIDAD EDUCATIVA ESTADAL ANTONIO ALBERTO PEREZ ROMERO,2316,4,36,1841,1188,1805,2,9,2,1,603,1841
EDO. CARABOBO,CE. VALENCIA,PQ. RAFAEL URDANETA,LICEO JOSE AUSTRIA,5766,11,67,4905,1622,4838,1,15,2,1,3197,4905
EDO. CARABOBO,CE. VALENCIA,PQ. RAFAEL URDANETA,COLEGIO ISRRAEL,1588,3,22,1197,776,1175,0,9,1,0,389,1197
EDO. CARABOBO,MP. JUAN JOSE MORA,PQ. URAMA,ESCUELA BASICA DON ANDRES BELLO,444,1,4,373,330,369,0,0,0,0,39,373
EDO. CARABOBO,MP. JUAN JOSE MORA,PQ. URAMA,MEDICATURA RURAL DE URAMA,387,1,9,321,244,312,0,2,0,0,66,321
EDO. CARABOBO,MP. JUAN JOSE MORA,PQ. URAMA,ESCUELA UNITARIA NUMERO 2,579,1,5,395,294,390,0,0,0,0,96,395
EDO. CARABOBO,MP. JUAN JOSE MORA,PQ. URAMA,NUCLEO ESCOLAR RURAL 86,128,1,0,109,94,109,1,2,0,0,12,109
EDO. CARABOBO,MP. JUAN JOSE MORA,PQ. URAMA,ESCUELA BOLIVARIANA LA JOBERA,378,1,8,339,286,331,1,1,0,0,43,339
EDO. CARABOBO,MP. JUAN JOSE MORA,PQ. URAMA,ESCUELA BOLIVARIANA JOSEFINA GARCIA,1023,2,17,801,626,784,1,2,1,0,154,801
EDO. CARABOBO,MP. JUAN JOSE MORA,PQ. URAMA,ESCUELA BOLIVARIANA MANUEL MANRIQUE,1216,3,21,932,608,911,0,1,2,0,300,932
EDO. CARABOBO,MP. JUAN JOSE MORA,PQ. URAMA,CENTRO DE EDUCACION INICIAL CANOABITO DE LA COSTA,222,1,4,199,168,195,0,1,0,0,26,199
EDO. CARABOBO,MP. JUAN JOSE MORA,PQ. URAMA,ESCUELA BASICA GUAREMAL DE LA COSTA,216,1,2,182,163,180,0,1,0,0,16,182
EDO. CARABOBO,MP. JUAN JOSE MORA,PQ. URAMA,ESCUELA NACIONAL URAMA,1643,3,11,1232,932,1221,0,4,0,1,284,1232
EDO. CARABOBO,MP. JUAN JOSE MORA,PQ. MORON,ESCUELA BASICA NACIONAL LAS PARCELAS,2704,5,40,2234,1512,2194,1,8,4,0,669,2234
EDO. CARABOBO,MP. JUAN JOSE MORA,PQ. MORON,ESCUELA BASICA ESTADAL JULIO PEÑA,1727,3,27,1390,1102,1363,0,5,1,1,254,1390
EDO. CARABOBO,MP. JUAN JOSE MORA,PQ. MORON,ESCUELA TECNICA ROBINSONIANA PETROQUIMICA Y AGROAMBIENTAL ALI PRIMERA,596,1,16,480,401,464,2,0,0,0,61,480
EDO. CARABOBO,MP. JUAN JOSE MORA,PQ. MORON,ESCUELA NACIONAL BOCA DE YARACUY,448,1,2,381,308,379,0,1,0,0,70,381
EDO. CARABOBO,MP. JUAN JOSE MORA,PQ. MORON,ALDEA BOLIVARIANA MORON,1056,2,15,858,745,843,1,1,0,0,96,858
EDO. CARABOBO,MP. JUAN JOSE MORA,PQ. MORON,CASA COMUNAL JOSE FELIX MORA,490,1,6,419,367,413,0,0,0,0,46,419
EDO. CARABOBO,MP. JUAN JOSE MORA,PQ. MORON,ESCUELA NACIONAL CONCENTRADA SANTA ANA,3028,6,56,2534,1703,2478,3,22,1,3,746,2534
EDO. CARABOBO,MP. JUAN JOSE MORA,PQ. MORON,UNIDAD EDUCATIVA ESTADAL ROMULO GALLEGOS,3057,6,81,2607,1686,2526,3,10,0,2,825,2607
EDO. CARABOBO,MP. JUAN JOSE MORA,PQ. MORON,UNIDAD EDUCATIVA EDUARDO BLANCO,776,2,15,638,468,623,1,5,1,1,147,638
EDO. CARABOBO,MP. JUAN JOSE MORA,PQ. MORON,LICEO BOLIVARIANO JOSE FELIZ MORA,1796,3,19,1536,951,1517,2,9,1,2,552,1536
EDO. CARABOBO,MP. JUAN JOSE MORA,PQ. MORON,ESCUELA MUNICIPAL SAN DIEGO,1783,4,27,1467,1107,1440,2,5,0,0,326,1467
EDO. CARABOBO,MP. JUAN JOSE MORA,PQ. MORON,COMPLEJO EDUCATIVO BOLIVARIANO SIMON BOLIVAR,492,1,7,440,306,433,0,3,0,1,123,440
EDO. CARABOBO,MP. JUAN JOSE MORA,PQ. MORON,CENTRO DE EDUCACION INICIAL GLADISMAR SANTELIZ,401,1,6,363,302,357,0,0,0,0,55,363
EDO. CARABOBO,MP. JUAN JOSE MORA,PQ. MORON,ESCUELA GRADUADA UDON PEREZ,1999,4,27,1592,1271,1565,0,9,1,1,283,1592
EDO. CARABOBO,MP. JUAN JOSE MORA,PQ. MORON,UNIDAD EDUCATIVA FRANCISCO ROSA,320,1,5,277,166,272,1,1,0,0,104,277
EDO. CARABOBO,MP. JUAN JOSE MORA,PQ. MORON,LICEO AMBROSIO PLAZA,2444,5,31,1880,1213,1849,0,11,2,2,621,1880
EDO. CARABOBO,MP. JUAN JOSE MORA,PQ. MORON,ESCUELA BASICA ESTADAL MORON,1363,3,14,1161,950,1147,0,3,1,1,192,1161
EDO. CARABOBO,MP. JUAN JOSE MORA,PQ. MORON,CENTRO EDUCACION INICIAL  BOLIVARIANO. SANTA ANA    (SIMONCITO),1203,3,18,1025,695,1007,0,0,1,0,311,1025
EDO. CARABOBO,MP. JUAN JOSE MORA,PQ. MORON,CENTRO EDUCACION INICIAL  ESTADAL  TEODOSA BENITA FLORES,1512,3,33,1177,745,1144,0,6,2,1,390,1177
EDO. CARABOBO,MP. JUAN JOSE MORA,PQ. MORON,ESCUELA TECNICA NACIONAL ALPARGATON,184,1,6,169,145,163,0,1,0,0,17,169
EDO. CARABOBO,MP. JUAN JOSE MORA,PQ. MORON,UNIDAD EDUACTIVA   BOLIVARIANO  MAHATMA GANDHI,922,2,14,817,491,803,0,3,1,0,308,817
EDO. CARABOBO,MP. JUAN JOSE MORA,PQ. MORON,UNIDAD EDUCATIVA COLEGIO EVANGELICO SADIE DE WASMLEY,1327,3,13,1093,760,1080,0,6,0,1,313,1093
EDO. CARABOBO,MP. JUAN JOSE MORA,PQ. MORON,LICEO BOLIVARIANO JESUS MANUEL SUBERO,1049,2,13,939,606,926,2,7,0,0,311,939
EDO. CARABOBO,MP. JUAN JOSE MORA,PQ. MORON,ESCUELA BASICA FELIPE CECILIO TOVAR,653,2,10,540,464,530,0,2,0,0,64,540
EDO. CARABOBO,MP. JUAN JOSE MORA,PQ. MORON,ESCUELA TRICOLOR LA PARGUITA,235,1,0,190,182,190,2,1,1,0,4,190
EDO. CARABOBO,MP. JUAN JOSE MORA,PQ. MORON,UNIDAD EDUCATIVA CREACION PALMA SOLA,1617,3,24,1288,1125,1264,0,2,0,0,137,1288
EDO. CARABOBO,MP. JUAN JOSE MORA,PQ. MORON,UNIDAD EDUCATIVA CARMEN MARIA RODRIGUEZ,990,2,19,817,697,798,0,2,2,1,96,817
EDO. CARABOBO,MP. JUAN JOSE MORA,PQ. MORON,ESCUELA BOLIVARIANA  ESTADAL MORON,2471,5,63,2077,1260,2014,4,8,0,0,742,2077
EDO. CARABOBO,MP. JUAN JOSE MORA,PQ. MORON,UNIDAD EDUCATIVA  ISABEL LA CATOLICA,678,2,10,601,438,591,0,1,0,1,151,601
EDO. CARABOBO,MP. JUAN JOSE MORA,PQ. MORON,ESCUELA BASICA SAN VICENTE FERRER,397,1,4,368,315,364,0,1,0,0,48,368
EDO. CARABOBO,MP. JUAN JOSE MORA,PQ. MORON,UNIDAD EDUCATIVA  PRIVADA MARIA AUXILIADORA,805,2,15,693,451,678,1,3,1,1,221,693
EDO. CARABOBO,MP. JUAN JOSE MORA,PQ. MORON,JARDIN DE INFANCIA VALLE VERDE,383,1,3,355,322,352,0,2,0,0,28,355
EDO. CARABOBO,MP. JUAN JOSE MORA,PQ. MORON,CENTRO INTERNACIONAL EDUCACION Y DESARROLLO  MORON,1944,4,30,1606,1155,1576,0,4,0,0,417,1606
EDO. CARABOBO,MP. JUAN JOSE MORA,PQ. MORON,UNIDAD EDUCATIVA EL JABILLO,1275,3,19,1108,893,1089,0,1,0,1,194,1108
EDO. CARABOBO,MP. GUACARA,PQ. GUACARA,UNIDAD EDUCATIVA ESTADAL CARLOS FEDERICO GROSS,3687,7,58,3043,2134,2985,0,10,1,0,840,3043
EDO. CARABOBO,MP. GUACARA,PQ. GUACARA,ESCUELA BASICA NUEVA GUACARA,5221,10,64,4315,2775,4251,1,26,2,3,1444,4315
EDO. CARABOBO,MP. GUACARA,PQ. GUACARA,ESCUELA 19 DE JULIO,1145,2,14,1006,744,992,0,10,0,1,237,1006
EDO. CARABOBO,MP. GUACARA,PQ. GUACARA,ESCUELA NAC GRADUADA VIGIRIMA,2189,4,25,1667,1110,1642,0,6,0,0,526,1667
EDO. CARABOBO,MP. GUACARA,PQ. GUACARA,ESCUELA JOSE CECILIO AVILA,6029,11,90,5029,3134,4939,2,26,1,3,1773,5029
EDO. CARABOBO,MP. GUACARA,PQ. GUACARA,UNIDAD EDUCATIVA RICARDO ALTERIO,2883,5,32,2485,1467,2453,0,10,2,0,974,2485
EDO. CARABOBO,MP. GUACARA,PQ. GUACARA,ESCUELA VICENTE WALLIS,5230,10,88,4316,1906,4228,2,33,4,5,2278,4316
EDO. CARABOBO,MP. GUACARA,PQ. GUACARA,UNIDAD EDUCATIVA EZEQUIEL ZAMORA,2632,5,55,2229,1770,2174,0,18,2,0,384,2229
EDO. CARABOBO,MP. GUACARA,PQ. GUACARA,PREESCOLAR JOSE MARIA VARGAS,2064,4,30,1814,957,1784,0,4,0,2,821,1814
EDO. CARABOBO,MP. GUACARA,PQ. GUACARA,MERCAL DE PETROCASA,649,2,14,573,485,559,0,4,1,0,69,573
EDO. CARABOBO,MP. GUACARA,PQ. GUACARA,ESCUELA NACIONAL GRADUADA LOS NARANJILLOS,2989,6,53,2517,1285,2464,0,14,4,3,1158,2517
EDO. CARABOBO,MP. GUACARA,PQ. GUACARA,PRE ESCOLAR EL SAMAN,3862,7,50,3358,1932,3308,1,26,4,3,1342,3358
EDO. CARABOBO,MP. GUACARA,PQ. GUACARA,ESCUELA ESTADAL DOMITILA FERNANDEZ,1021,2,6,886,687,880,0,5,1,0,187,886
EDO. CARABOBO,MP. GUACARA,PQ. GUACARA,UNIDAD EDUCATIVA  BOLIVARIANA   DOCTOR ANDRÉS ELOY BLANCO,1319,3,33,1091,807,1058,0,6,0,0,245,1091
EDO. CARABOBO,MP. GUACARA,PQ. GUACARA,CENTRO DE EDUCACION INICIAL NACIONAL NUEVA GUACARA,2943,6,38,2465,1609,2427,0,6,2,2,808,2465
EDO. CARABOBO,MP. GUACARA,PQ. GUACARA,ESCUELA BASICA NACIONAL ADOLFO BLONVAL LOPEZ,3961,7,29,3429,1140,3400,0,12,0,2,2246,3429
EDO. CARABOBO,MP. GUACARA,PQ. GUACARA,ESCUELA BOLIVARIANA GUAICAIPURO,902,2,26,770,621,744,0,2,0,0,121,770
EDO. CARABOBO,MP. GUACARA,PQ. GUACARA,UNIDAD EDUCATIVA NACIONAL EL TOQUITO,4967,9,54,3988,2198,3934,1,19,0,3,1713,3988
EDO. CARABOBO,MP. GUACARA,PQ. GUACARA,ESCUELA BOLIVARIANA SIMON BOLIVAR,1231,3,26,1041,772,1015,0,10,0,0,233,1041
EDO. CARABOBO,MP. GUACARA,PQ. GUACARA,UNIDAD EDUCATIVA FRANCISCO DE BERROTERAN,1144,2,18,939,360,921,0,4,1,1,555,939
EDO. CARABOBO,MP. GUACARA,PQ. GUACARA,UNIDAD EDUCATIVA   NACIONAL   LUIS AUGUSTO MACHADO CISNEROS,6911,13,110,5528,2703,5418,4,34,3,4,2670,5528
EDO. CARABOBO,MP. GUACARA,PQ. GUACARA,UNIDAD EDUCATIVA ESTADAL GRADUADA RAUL CALCAMO,2510,5,29,2052,1326,2023,2,14,1,1,679,2052
EDO. CARABOBO,MP. GUACARA,PQ. GUACARA,UNIDAD EDUACTIVA   NACIONAL JOSE GREGORIO GUITIAN E,2909,5,49,2439,1087,2390,0,10,2,0,1291,2439
EDO. CARABOBO,MP. GUACARA,PQ. GUACARA,ESCUELAS PROFESOR MANUEL AROCHA OJEDA,4898,9,92,3963,2796,3871,2,30,6,1,1036,3963
EDO. CARABOBO,MP. GUACARA,PQ. GUACARA,ESCUELA MUNICIPAL FRANCISCO ESTABA ROJAS,784,2,8,710,588,702,1,4,0,0,109,710
EDO. CARABOBO,MP. GUACARA,PQ. GUACARA,UNIDAD EDUCATIVA PRIVADA OSCAR FERNANDO BENEDETTI (FE Y ALEGRIA),4770,9,79,4097,2723,4018,1,35,2,0,1257,4097
EDO. CARABOBO,MP. GUACARA,PQ. GUACARA,GRUPO ESCOLAR DIEGO IBARRA,6067,11,82,4849,2107,4767,0,23,3,5,2629,4849
EDO. CARABOBO,MP. GUACARA,PQ. GUACARA,ESCUELA BASICA BARTOLOME DE LAS CASA,690,2,9,597,406,588,0,3,0,0,179,597
EDO. CARABOBO,MP. GUACARA,PQ. GUACARA,ESCUELA BASICA OJO DE AGUA,952,2,11,812,645,801,1,5,0,0,150,812
EDO. CARABOBO,MP. GUACARA,PQ. CIUDAD ALIANZA,UNIDAD EDUCATIVA FELIX ROMAN DUQUE,3295,6,11,2692,555,2681,0,4,0,0,2122,2692
EDO. CARABOBO,MP. GUACARA,PQ. CIUDAD ALIANZA,GRUPO ESCOLAR ALONSO DIAZ MORENO,4415,8,39,3524,682,3485,1,5,1,2,2794,3524
EDO. CARABOBO,MP. GUACARA,PQ. CIUDAD ALIANZA,UNIDAD EDUCATIVA VIRGEN DE LAS NIEVES,2897,5,21,2472,568,2451,0,4,1,1,1877,2472
EDO. CARABOBO,MP. GUACARA,PQ. CIUDAD ALIANZA,CICLO BASICO COMUN SANTIAGO FRANCISCO MACHADO,4169,8,28,3512,835,3484,0,11,0,1,2637,3512
EDO. CARABOBO,MP. GUACARA,PQ. YAGUA,HOGAR DE ATENCION INTEGRAL AL NIÑO,1099,2,12,902,483,890,0,1,0,0,406,902
EDO. CARABOBO,MP. GUACARA,PQ. YAGUA,UNIDAD EDUCATIVA JUAN ANTONIO PEREZ BONALDE,937,2,8,828,392,820,0,3,1,0,424,828
EDO. CARABOBO,MP. GUACARA,PQ. YAGUA,ESCUELA BASICA QUEBRADA HONDA,640,2,10,531,401,521,0,7,0,0,113,531
EDO. CARABOBO,MP. GUACARA,PQ. YAGUA,ESCUELA BASICA  NACIONAL   DR. CARLOS ARVELO,969,2,8,728,425,720,0,4,0,0,291,728
EDO. CARABOBO,MP. GUACARA,PQ. YAGUA,GRUPO ESCOLAR CARLOS ARVELO,5101,9,77,4113,2194,4036,3,16,5,1,1817,4113
EDO. CARABOBO,MP. GUACARA,PQ. YAGUA,ESCUELA BASICA HENRIQUE TEJERA,4012,7,40,3228,2004,3188,1,10,1,0,1172,3228
EDO. CARABOBO,MP. MONTALBAN,PQ. MONTALBAN,UNIDAD EDUCATIVA ESTADAL LAS MATAS,611,2,7,497,276,490,0,4,0,0,210,497
EDO. CARABOBO,MP. MONTALBAN,PQ. MONTALBAN,MANUEL LATOUCHE ACOSTA,767,2,14,569,387,555,0,1,0,0,167,569
EDO. CARABOBO,MP. MONTALBAN,PQ. MONTALBAN,ESCUELA BOLIVARIANA ROMULO GALLEGOS,1642,3,22,1401,887,1379,0,5,1,0,486,1401
EDO. CARABOBO,MP. MONTALBAN,PQ. MONTALBAN,ESCUELA BASICA BOLIVARIANA  ANTONIO HERRERA TORO,3395,6,51,2693,1343,2642,1,9,0,1,1288,2693
EDO. CARABOBO,MP. MONTALBAN,PQ. MONTALBAN,ANEXO LICEO JOSE ANDRES CASTILLO,807,2,5,583,451,578,0,1,0,0,126,583
EDO. CARABOBO,MP. MONTALBAN,PQ. MONTALBAN,CENTRO EDUCATIVO Y RECREACIONAL FUNDACION DEL NIÑO PEDRO CAMEJO,2299,4,38,1951,1096,1913,0,8,1,1,807,1951
EDO. CARABOBO,MP. MONTALBAN,PQ. MONTALBAN,ESCUELA BASICA  MONSEÑOR FRANCISCO ANTONIO GRANADILLO,1678,3,23,1411,679,1388,1,4,0,0,704,1411
EDO. CARABOBO,MP. MONTALBAN,PQ. MONTALBAN,AMBULATORIO DE SALUD SABANA DE AGUIRRE,424,1,10,332,260,322,0,1,0,0,61,332
EDO. CARABOBO,MP. MONTALBAN,PQ. MONTALBAN,UNIDAD EDUCATIVA ESTADAL BERNARDINO,797,2,18,671,250,653,0,1,1,0,401,671
EDO. CARABOBO,MP. MONTALBAN,PQ. MONTALBAN,UNIDAD EDUCATIVA BOLIVARIANA SABANETA NORTE,671,2,12,482,216,470,0,1,1,0,252,482
EDO. CARABOBO,MP. MONTALBAN,PQ. MONTALBAN,UNIDAD EDUCATIVA TAMARE,1674,3,17,1348,607,1331,0,6,1,1,716,1348
EDO. CARABOBO,MP. MONTALBAN,PQ. MONTALBAN,PREESCOLAR ISABEL MARIA ORTEGA,761,2,18,609,305,591,0,0,0,0,286,609
EDO. CARABOBO,MP. MONTALBAN,PQ. MONTALBAN,JARDIN DE INFANCIA MONTALBAN,1243,3,15,1113,637,1098,0,5,0,0,456,1113
EDO. CARABOBO,MP. PUERTO CABELLO,PQ. FRATERNIDAD,ESCUELA TECNICA ROBINSONIANA MIGUEL PEÑA,700,2,12,529,293,517,0,2,0,0,222,529
EDO. CARABOBO,MP. PUERTO CABELLO,PQ. FRATERNIDAD,CICLO BASICO COMUN SIMON RODRIGUEZ,1828,4,14,1408,649,1394,2,8,0,1,734,1408
EDO. CARABOBO,MP. PUERTO CABELLO,PQ. FRATERNIDAD,UNIDAD EDUCATIVA NACIONAL COMPLEJO BOLIVARIANO SIMON RODRIGUEZ,957,2,11,725,357,714,0,1,0,0,356,725
EDO. CARABOBO,MP. PUERTO CABELLO,PQ. FRATERNIDAD,ESCUELA PRIMARIA BOLIVARIANA JUAN JOSE FLORES,3467,6,40,2746,1377,2706,1,15,2,1,1310,2746
EDO. CARABOBO,MP. PUERTO CABELLO,PQ. FRATERNIDAD,UNIDAD EDUCATIVA ESTADAL DOROTEO CENTENO,1969,4,24,1552,702,1528,1,3,0,1,821,1552
EDO. CARABOBO,MP. PUERTO CABELLO,PQ. PATANEMO,UNIDAD EDUCATIVA BOLIVARIANA  JOSE LAURENCIO SILVA,1616,3,33,1214,719,1181,0,8,1,0,453,1214
EDO. CARABOBO,MP. PUERTO CABELLO,PQ. PATANEMO,ESCUELA BOLIVARIANA PRIMAVERA,346,1,8,293,242,285,0,2,0,0,41,293
EDO. CARABOBO,MP. PUERTO CABELLO,PQ. PATANEMO,UNIDAD EDUCATIVA LOS CANEYES,912,2,13,695,379,682,0,7,0,0,296,695
EDO. CARABOBO,MP. PUERTO CABELLO,PQ. JUAN JOSE FLORES,ESCUELA EMELINA GUERRA,1543,3,18,1231,718,1213,3,3,1,0,488,1231
EDO. CARABOBO,MP. PUERTO CABELLO,PQ. JUAN JOSE FLORES,ESCUELA TECNICA ROBINSONIANA SAMUEL ROBINSON LA SALINA SUR,311,1,8,253,213,245,0,0,0,0,32,253
EDO. CARABOBO,MP. PUERTO CABELLO,PQ. JUAN JOSE FLORES,ESCUELA NACIONAL RAFAEL ANDRADE MENDOZA,2460,5,39,2009,1348,1970,2,4,1,1,614,2009
EDO. CARABOBO,MP. PUERTO CABELLO,PQ. JUAN JOSE FLORES,ESCUELA CONCENTRADA SAN JOSE,3110,6,44,2477,1869,2433,1,7,1,1,554,2477
EDO. CARABOBO,MP. PUERTO CABELLO,PQ. JUAN JOSE FLORES,ESCUELA JOSE RAFAEL POCATERRA,2408,5,32,1892,1380,1860,0,6,1,0,473,1892
EDO. CARABOBO,MP. PUERTO CABELLO,PQ. JUAN JOSE FLORES,UNIDAD EDUCATIVA ROSA OLIVEROS DE MAZA,630,2,9,459,290,450,0,0,0,0,160,459
EDO. CARABOBO,MP. PUERTO CABELLO,PQ. JUAN JOSE FLORES,UNIDAD EDUCATIVA INSTITUTO SAN JOSE OBRERO,1059,2,20,913,475,893,0,1,1,0,416,913
EDO. CARABOBO,MP. PUERTO CABELLO,PQ. JUAN JOSE FLORES,UNIDAD ESCOLAR ISABEL TERESA PONCE,2644,5,36,2226,1750,2190,0,9,0,0,431,2226
EDO. CARABOBO,MP. PUERTO CABELLO,PQ. JUAN JOSE FLORES,COLEGIO SAN JOSE LA SALLE,2595,5,37,2224,375,2187,0,8,1,0,1803,2224
EDO. CARABOBO,MP. PUERTO CABELLO,PQ. JUAN JOSE FLORES,ESCUELA PRIMARIA BOLIVARIANA  JUANA GARCIA DE LADERA,4216,8,73,3459,2391,3386,0,26,2,2,965,3459
EDO. CARABOBO,MP. PUERTO CABELLO,PQ. JUAN JOSE FLORES,ESCUELA ESTADAL CESAR AGREDA,2630,5,28,2125,1560,2097,0,9,0,0,528,2125
EDO. CARABOBO,MP. PUERTO CABELLO,PQ. JUAN JOSE FLORES,UNIDAD EDUCATIVA VISTAMAR,1478,3,27,1382,602,1355,2,1,1,2,747,1382
EDO. CARABOBO,MP. PUERTO CABELLO,PQ. JUAN JOSE FLORES,UNIDAD EDUCATIVA BOLIVARIANA NACIONAL JOSE ANTONIO MAITIN,2386,5,61,2036,1246,1975,3,7,0,3,716,2036
EDO. CARABOBO,MP. PUERTO CABELLO,PQ. JUAN JOSE FLORES,COLEGIO HERMANA DOLORES FE Y ALEGRIA,1996,4,32,1607,1004,1575,0,6,0,0,565,1607
EDO. CARABOBO,MP. PUERTO CABELLO,PQ. JUAN JOSE FLORES,ESCUELA BASICA BOLIVARIANA PROSPERO REVERON,2259,4,32,1948,1069,1916,1,7,0,2,837,1948
EDO. CARABOBO,MP. PUERTO CABELLO,PQ. JUAN JOSE FLORES,INSTITUTO UNIVERSITARIO DE TECNOLOGIA DE PUERTO CABELLO,1072,2,13,885,704,872,0,5,0,0,163,885
EDO. CARABOBO,MP. PUERTO CABELLO,PQ. JUAN JOSE FLORES,UNIDAD EDUCATIVA ESTADAL MARIA LUISA NIEVES,1176,2,18,927,683,909,0,5,0,0,221,927
EDO. CARABOBO,MP. PUERTO CABELLO,PQ. JUAN JOSE FLORES,ESCUELA BOLIVARIANA TERESITA ROSALES,3499,6,34,2994,1160,2960,1,6,1,3,1789,2994
EDO. CARABOBO,MP. PUERTO CABELLO,PQ. JUAN JOSE FLORES,ESCUELA NACIONAL BORBURATA,577,1,7,483,246,476,0,2,0,0,228,483
EDO. CARABOBO,MP. PUERTO CABELLO,PQ. JUAN JOSE FLORES,UNIDAD EDUCATIVA MUNICIPAL JOSE JUAQUIN PEREZ REINA,485,1,5,335,217,330,0,2,1,0,110,335
EDO. CARABOBO,MP. PUERTO CABELLO,PQ. JUAN JOSE FLORES,ESCUELA ESTADAL LA CRUZ,507,1,13,420,317,407,0,1,1,0,88,420
EDO. CARABOBO,MP. PUERTO CABELLO,PQ. JUAN JOSE FLORES,ESCUELA MARIA CONCEPCION DE BOLIVAR,4530,8,45,3519,1837,3474,2,16,3,3,1613,3519
EDO. CARABOBO,MP. PUERTO CABELLO,PQ. JUAN JOSE FLORES,UNIDAD EDUCATIVA MUNICIPAL ROMULO GALLEGOS,973,2,13,814,552,801,0,4,0,0,245,814
EDO. CARABOBO,MP. PUERTO CABELLO,PQ. JUAN JOSE FLORES,UNIDAD EDUCATIVA PUENTE LOS ESPAÑOLES,555,1,3,451,360,448,0,1,0,0,87,451
EDO. CARABOBO,MP. PUERTO CABELLO,PQ. GOAIGOAZA,UNIDAD EDUCATIVA MIQUIJA,993,2,12,753,551,741,0,1,0,0,189,753
EDO. CARABOBO,MP. PUERTO CABELLO,PQ. GOAIGOAZA,ESCUELA BASICA ESTADAL FRANCISCO FARFAN,2409,5,39,1881,1146,1842,1,6,3,2,684,1881
EDO. CARABOBO,MP. PUERTO CABELLO,PQ. GOAIGOAZA,UNIDAD EDUCATIVA NACIONAL CREACION LA CORINA,571,1,12,469,357,457,0,3,0,0,97,469
EDO. CARABOBO,MP. PUERTO CABELLO,PQ. GOAIGOAZA,UNIDAD EDUCATIVA INICIAL AÑO INTERNACIONAL DEL NIÑO,1882,4,36,1575,1171,1539,0,10,0,0,358,1575
EDO. CARABOBO,MP. PUERTO CABELLO,PQ. GOAIGOAZA,ESCUELA PRIMARIA BOLIVARIANA LICENCIADO CARLOS REQUENA,798,2,9,725,463,716,0,3,0,1,249,725
EDO. CARABOBO,MP. PUERTO CABELLO,PQ. GOAIGOAZA,UNIDAD EDUCATIVA ESCUELA NIÑOS ESPECIALES,1104,2,21,977,623,956,0,0,0,2,331,977
EDO. CARABOBO,MP. PUERTO CABELLO,PQ. GOAIGOAZA,ESCUELA PEDRO CAMEJO,842,2,10,739,498,729,0,6,1,0,224,739
EDO. CARABOBO,MP. PUERTO CABELLO,PQ. GOAIGOAZA,UNIDAD EDUCATIVA PRIVADA MONSEÑOR ALI LEBRUN FE Y ALEGRIA,3074,6,46,2620,1297,2574,1,7,4,2,1263,2620
EDO. CARABOBO,MP. PUERTO CABELLO,PQ. GOAIGOAZA,CICLO BASICO AGUSTIN ARMARIO,6793,12,93,5449,3467,5356,0,22,4,3,1860,5449
EDO. CARABOBO,MP. PUERTO CABELLO,PQ. GOAIGOAZA,UNIDAD EDUCATIVA MUNICIPAL RAFAEL GUTIERREZ,1741,3,25,1473,1121,1448,0,4,0,0,323,1473
EDO. CARABOBO,MP. PUERTO CABELLO,PQ. GOAIGOAZA,ESCUELA BASICA LA SALLE BALOCHE,4166,8,52,3403,1822,3351,0,9,3,1,1516,3403
EDO. CARABOBO,MP. PUERTO CABELLO,PQ. GOAIGOAZA,CENTRO EDUCACION INICIAL FELICITA BALCHE,813,2,18,670,420,652,0,3,0,1,228,670
EDO. CARABOBO,MP. PUERTO CABELLO,PQ. GOAIGOAZA,UNIDAD EDUCATIVA JESUS GUITIAN,1045,2,11,826,597,815,0,2,0,0,216,826
EDO. CARABOBO,MP. PUERTO CABELLO,PQ. GOAIGOAZA,UNIDAD EDUCATIVA MUNICIPAL CARIAPRIMA,293,1,7,233,167,226,0,0,0,0,59,233
EDO. CARABOBO,MP. PUERTO CABELLO,PQ. GOAIGOAZA,UNIDAD EDUCATIVA NACIONAL SANTA CRUZ,4713,9,59,3778,2201,3719,0,9,0,3,1506,3778
EDO. CARABOBO,MP. PUERTO CABELLO,PQ. DEMOCRACIA,UNIDAD EDUCATIVA PRIVADA JUAN MANUEL VALDEZ,343,1,2,243,216,241,0,0,0,0,25,243
EDO. CARABOBO,MP. PUERTO CABELLO,PQ. DEMOCRACIA,ESCUELA BASICA BARTOLOME SALOM,2879,5,60,2217,1489,2157,1,11,1,4,651,2217
EDO. CARABOBO,MP. PUERTO CABELLO,PQ. DEMOCRACIA,ESCUELA BASICA LAS TABLAS,670,2,6,577,458,571,1,0,0,1,111,577
EDO. CARABOBO,MP. PUERTO CABELLO,PQ. DEMOCRACIA,GRUPO ESCOLAR CARLOS FELIPE ALVIZU,2617,5,53,2013,1424,1960,0,7,3,0,526,2013
EDO. CARABOBO,MP. PUERTO CABELLO,PQ. DEMOCRACIA,GRUPO ESCOLAR TABORDA,3425,6,48,2732,2009,2684,3,12,0,0,660,2732
EDO. CARABOBO,MP. PUERTO CABELLO,PQ. DEMOCRACIA,CENTRO DE EDUCACION INICIAL TABORDA,1066,2,11,853,648,842,0,5,0,0,189,853
EDO. CARABOBO,MP. PUERTO CABELLO,PQ. DEMOCRACIA,ESCUELA NACIONAL CONCENTRADA LA PROVIDENCIA,285,1,4,210,185,206,1,0,1,0,19,210
EDO. CARABOBO,MP. PUERTO CABELLO,PQ. DEMOCRACIA,ESCUELA CONCENTRADA 29 DE NOVIEMBRE,902,2,17,686,485,669,2,1,0,0,181,686
EDO. CARABOBO,MP. PUERTO CABELLO,PQ. BORBURATA,GRUPO ESCOLAR CACHIRI,3170,6,18,2324,1160,2306,1,11,2,3,1129,2324
EDO. CARABOBO,MP. PUERTO CABELLO,PQ. BORBURATA,UNIDAD EDUCATIVA MUNICIPAL  RURAL GAÑANGO,1601,3,17,1098,821,1081,0,6,0,0,254,1098
EDO. CARABOBO,MP. PUERTO CABELLO,PQ. BORBURATA,ESCUELA BOLIVARIANA AGUSTIN ARMARIO,2062,4,30,1396,1234,1366,0,9,0,0,123,1396
EDO. CARABOBO,MP. PUERTO CABELLO,PQ. UNION,GRUPO ESCOLAR REPUBLICA DE HONDURAS,3924,7,56,2895,1507,2839,3,16,1,2,1310,2895
EDO. CARABOBO,MP. PUERTO CABELLO,PQ. UNION,UNIDAD EDUCATIVA COLEGIO EVANGELICO DE PUERTO CABELLO,547,1,6,398,264,392,0,0,1,0,127,398
EDO. CARABOBO,MP. PUERTO CABELLO,PQ. BARTOLOME SALOM,UNIDAD EDUCATIVA LIGIA DE RIOS,836,2,15,714,494,699,1,3,0,0,201,714
EDO. CARABOBO,MP. PUERTO CABELLO,PQ. BARTOLOME SALOM,JARDIN DE INFANCIA SAN ESTEBAN,2550,5,54,2109,1322,2055,1,9,1,1,721,2109
EDO. CARABOBO,MP. PUERTO CABELLO,PQ. BARTOLOME SALOM,ESCUELA BARRIO SAN ESTEBAN,5907,11,74,4910,3179,4836,4,19,0,4,1630,4910
EDO. CARABOBO,MP. PUERTO CABELLO,PQ. BARTOLOME SALOM,CICLO BASICO COMUN CARABOBO,3480,6,56,2835,1558,2779,1,9,2,4,1205,2835
EDO. CARABOBO,MP. PUERTO CABELLO,PQ. BARTOLOME SALOM,UNIDAD EDUCATIVA MANUELA SAENZ,671,2,6,512,283,506,0,3,0,0,220,512
EDO. CARABOBO,MP. PUERTO CABELLO,PQ. BARTOLOME SALOM,UNIDAD EDUCATIVA OVIDIO DE CROLY,616,2,6,523,352,517,0,4,0,0,161,523
EDO. CARABOBO,MP. PUERTO CABELLO,PQ. BARTOLOME SALOM,ESCUELA FEDERAL JOSE RAMON PELAYO,4278,8,47,3559,1309,3512,1,4,0,1,2197,3559
EDO. CARABOBO,MP. PUERTO CABELLO,PQ. BARTOLOME SALOM,UNIDAD EDUCATIVA MUNICIPAL CARLOS AUGUSTO CUBILLAN,2065,4,19,1658,645,1639,0,4,0,0,990,1658
EDO. CARABOBO,MP. PUERTO CABELLO,PQ. BARTOLOME SALOM,UNIDAD EDUCATIVA MUNICIPAL VALLE SECO,544,1,12,399,269,387,1,0,0,0,117,399
EDO. CARABOBO,MP. PUERTO CABELLO,PQ. BARTOLOME SALOM,UNIDAD EDUCATIVA MUNICIPAL DR ADOLFO PRINCE LARA,1420,3,23,1092,423,1069,0,3,0,1,642,1092
EDO. CARABOBO,MP. PUERTO CABELLO,PQ. BARTOLOME SALOM,ESCUELA GRADUADA GUILLERMO SMITH,2507,5,37,2084,1363,2047,0,7,0,2,675,2084
EDO. CARABOBO,MP. PUERTO CABELLO,PQ. BARTOLOME SALOM,UNIDAD EDUCATIVA MIS VECINOS,1348,3,18,1122,799,1104,0,8,0,0,297,1122
EDO. CARABOBO,MP. PUERTO CABELLO,PQ. BARTOLOME SALOM,ESCUELA ADOLFO PRINCE LARA,895,2,31,683,446,652,0,3,1,0,202,683
EDO. CARABOBO,MP. PUERTO CABELLO,PQ. BARTOLOME SALOM,UNIDAD EDUCATIVA VALLE VERDE,1796,4,28,1504,1249,1476,0,5,0,0,222,1504
