Estado,Municipio,Parroquia,Centro,Número de Electores escrutados.,Número de Actas Procesadas.,Número total de Votos Nulos.,Número Total de Votantes que votaron realmente.,HUGO CHAVEZ,Número total de Votos Válidos.,ORLANDO CHIRINO,REINA SEQUERA,LUIS REYES,MARIA BOLIVAR,HENRIQUE CAPRILES RADONSKI,Número de Votos Escrutados.
EDO. GUARICO,MP. ZARAZA,PQ. SAN JOSE DE UNARE,ESCUELA BOLIVARIANA DOCTOR BENITO GUTIERREZ LOPEZ,1652,3,40,1242,810,1202,0,6,0,0,386,1242
EDO. GUARICO,MP. ZARAZA,PQ. SAN JOSE DE UNARE,ESCUELA BASICA F 78 GUARIBITO,352,1,8,241,190,233,1,1,0,0,41,241
EDO. GUARICO,MP. ZARAZA,PQ. SAN JOSE DE UNARE,ESCUELA NACIONAL UNITARIA F 83 PALO SANO,262,1,4,191,137,187,0,3,1,0,46,191
EDO. GUARICO,MP. ZARAZA,PQ. ZARAZA,ESCUELA BASICA NACIONAL BONIFACIO GOMEZ,765,2,13,633,393,620,1,4,1,0,221,633
EDO. GUARICO,MP. ZARAZA,PQ. ZARAZA,ESCUELA BASICA NOHEMY HIGUERA DE GUZMAN,3136,6,46,2366,1384,2320,3,14,3,2,914,2366
EDO. GUARICO,MP. ZARAZA,PQ. ZARAZA,ALDEA UNIVERSITARIA BOLIVARIANA NUCLEO ZARAZA,431,1,8,322,258,314,0,6,0,0,50,322
EDO. GUARICO,MP. ZARAZA,PQ. ZARAZA,ESCUELA BASICA NACIONAL RÓMULO GALLEGOS,4993,9,67,3668,2317,3601,3,20,4,3,1254,3668
EDO. GUARICO,MP. ZARAZA,PQ. ZARAZA,ESCUELA BOLIVARIANA MAZAGUARO,380,1,7,243,199,236,0,2,1,0,34,243
EDO. GUARICO,MP. ZARAZA,PQ. ZARAZA,LICEO BOLIVARIANO PADRE FRANCISCO HURTADO,814,2,10,631,429,621,0,5,2,0,185,631
EDO. GUARICO,MP. ZARAZA,PQ. ZARAZA,ESCUELA PRIMARIA FC 17 LOS TAPARITOS,852,2,7,558,462,551,0,3,1,0,85,558
EDO. GUARICO,MP. ZARAZA,PQ. ZARAZA,UNIVERSIDAD NACIONAL EXPERIMENTAL SIMON RODRIGUEZ,259,1,5,212,170,207,0,1,0,0,36,212
EDO. GUARICO,MP. ZARAZA,PQ. ZARAZA,ESCUELA BOLIVARIANA AGUA NEGRA,907,2,9,606,486,597,1,5,2,0,103,606
EDO. GUARICO,MP. ZARAZA,PQ. ZARAZA,ESCUELA NACIONAL LA PEREÑA,74,1,0,59,53,59,0,1,0,0,5,59
EDO. GUARICO,MP. ZARAZA,PQ. ZARAZA,ESCUELA ESTADAL DELFINA FEMAYOR DE MOLINA,3472,6,37,2662,1930,2625,0,22,1,1,671,2662
EDO. GUARICO,MP. ZARAZA,PQ. ZARAZA,ESCUELA ESTADAL COLUMBA MENDOZA RODRIGUEZ,790,2,12,588,444,576,0,3,0,0,129,588
EDO. GUARICO,MP. ZARAZA,PQ. ZARAZA,ESCUELA NACIONAL UNITARIA F 80 EL DIVIDIVI
EDO. GUARICO,MP. ZARAZA,PQ. ZARAZA,ESCUELA ESTADAL LA PIEDRA,407,1,3,263,200,260,1,1,1,0,57,263
EDO. GUARICO,MP. ZARAZA,PQ. ZARAZA,ESCUELA CONCENTRADA FC 13 SANTA CRUZ DE UNARE,398,1,2,274,242,272,0,0,0,0,30,274
EDO. GUARICO,MP. ZARAZA,PQ. ZARAZA,ESCUELA BASICA ANTONIO JOSE SOTILLO,2178,4,37,1673,1000,1636,0,15,0,1,620,1673
EDO. GUARICO,MP. ZARAZA,PQ. ZARAZA,LICEO EDUARDO DELFIN MENDEZ II,285,1,2,244,119,242,0,3,1,0,119,244
EDO. GUARICO,MP. ZARAZA,PQ. ZARAZA,LICEO BOLIVARIANO GRAN MARISCAL DE AYACUCHO,128,1,1,83,72,82,0,0,0,0,10,83
EDO. GUARICO,MP. ZARAZA,PQ. ZARAZA,ESCUELA BOLIVARIANA ARTURO ALVAREZ ALAYÓN,1248,3,19,1032,663,1013,0,8,1,0,341,1032
EDO. GUARICO,MP. ZARAZA,PQ. ZARAZA,ESCUELA BOLIVARIANA TACALITO,1611,3,14,1178,941,1164,1,9,2,1,210,1178
EDO. GUARICO,MP. ZARAZA,PQ. ZARAZA,ESCUELA ESTADAL OLGA ROJAS DE CABEZA,2571,5,44,1985,1405,1941,1,11,2,1,521,1985
EDO. GUARICO,MP. ZARAZA,PQ. ZARAZA,CASA DE LA CULTURA ERNESTO LUIS RODRIGUEZ,465,1,4,378,185,374,0,4,0,0,185,378
EDO. GUARICO,MP. ZARAZA,PQ. ZARAZA,LICEO EDUARDO DELFIN MENDEZ,3819,7,47,3103,1472,3056,2,25,2,0,1555,3103
EDO. GUARICO,MP. ZARAZA,PQ. ZARAZA,ESCUELA BASICA NACIONAL FRANCISCO SALIAS,4369,8,50,3477,1714,3427,1,24,2,1,1685,3477
EDO. GUARICO,MP. ZARAZA,PQ. ZARAZA,ESCUELA BOLIVARIANA LA ESPERANZA,1250,3,8,867,812,859,1,2,0,0,44,867
EDO. GUARICO,MP. ZARAZA,PQ. ZARAZA,CENTRO DE EDUCACION INICIAL FC 59 LAS LAGUNITAS,145,1,0,113,111,113,0,0,0,0,2,113
EDO. GUARICO,MP. ZARAZA,PQ. ZARAZA,ESCUELA ESPECIALIDADES MERCEDES SOTILLO,128,1,0,115,85,115,0,0,0,0,30,115
EDO. GUARICO,MP. ZARAZA,PQ. ZARAZA,INSTITUTO DE EDUCACION BOLIVARIANA ESPECIAL ZARAZA,296,1,4,249,191,245,1,1,0,0,52,249
EDO. GUARICO,MP. CHAGUARAMAS,PQ. CHAGUARAMAS,SALA DE COMPUTACION CARLOS CORONADO,244,1,6,199,111,193,0,1,0,0,81,199
EDO. GUARICO,MP. CHAGUARAMAS,PQ. CHAGUARAMAS,BIBLIOTECA PUBLICA FLOR MARIA MANUITT,537,1,6,420,283,414,1,0,0,0,130,420
EDO. GUARICO,MP. CHAGUARAMAS,PQ. CHAGUARAMAS,ESCUELA BASICA DC 58 LAS CAMAZAS,165,1,3,90,54,87,0,0,1,0,32,90
EDO. GUARICO,MP. CHAGUARAMAS,PQ. CHAGUARAMAS,ESCUELA BASICA SAN LORENZO MARTIR,1213,3,39,953,603,914,0,7,2,0,302,953
EDO. GUARICO,MP. CHAGUARAMAS,PQ. CHAGUARAMAS,ESCUELA GC 37 MAMONAL,432,1,3,329,242,326,0,0,0,0,84,329
EDO. GUARICO,MP. CHAGUARAMAS,PQ. CHAGUARAMAS,ESCUELA BASICA BOLIVARIANA CHAGUARAMAS,3067,6,66,2362,1261,2296,0,16,1,1,1017,2362
EDO. GUARICO,MP. CHAGUARAMAS,PQ. CHAGUARAMAS,ESCUELA DC 22 EL ARBOLITO,341,1,10,247,138,237,0,1,0,0,98,247
EDO. GUARICO,MP. CHAGUARAMAS,PQ. CHAGUARAMAS,ESCUELA BASICA DC 57 SANTA EDELMIRA,428,1,10,322,266,312,0,2,0,1,43,322
EDO. GUARICO,MP. CHAGUARAMAS,PQ. CHAGUARAMAS,ESCUELA BASICA DC 6 SAN NICOLAS,260,1,8,241,197,233,0,1,0,0,35,241
EDO. GUARICO,MP. CHAGUARAMAS,PQ. CHAGUARAMAS,UNIDAD EDUCATIVA PRUDENCIO ESAA,288,1,17,237,155,220,1,0,0,0,64,237
EDO. GUARICO,MP. CHAGUARAMAS,PQ. CHAGUARAMAS,CONCENTRACIÓN ESCOLAR DC 5 LAS PIEDRAS,416,1,4,297,200,293,0,1,0,0,92,297
EDO. GUARICO,MP. CHAGUARAMAS,PQ. CHAGUARAMAS,CONCENTRACIÓN ESCOLAR DC 25 ROBLECITO,512,1,4,358,277,354,0,0,0,0,77,358
EDO. GUARICO,MP. CHAGUARAMAS,PQ. CHAGUARAMAS,JARDIN DE INFANCIA LAS MALVINAS,244,1,3,184,128,181,0,1,0,0,52,184
EDO. GUARICO,MP. CHAGUARAMAS,PQ. CHAGUARAMAS,ESCUELA ESTADAL DC 54 CASIANERO,438,1,1,341,244,340,0,0,0,0,96,341
EDO. GUARICO,MP. CHAGUARAMAS,PQ. CHAGUARAMAS,ESCUELA DC 19 PAJA BRAVA,1152,2,40,923,587,883,0,4,1,0,291,923
EDO. GUARICO,CE. ROSCIO,PQ. CANTAGALLO,UNIDAD EDUCATIVA BOLIVARIANA ROGELIA MAYO TORREALBA,1405,3,10,1182,799,1172,0,6,0,0,367,1182
EDO. GUARICO,CE. ROSCIO,PQ. CANTAGALLO,ESCUELA BOLIVARIANA AC 9 PASO PELAO,276,1,2,262,212,260,0,1,0,0,47,262
EDO. GUARICO,CE. ROSCIO,PQ. PARAPARA,GRUPO ESCOLAR BOLIVARIANO LUCIA ALVAREZ RIVERO,1424,3,10,1119,757,1109,0,2,1,0,349,1119
EDO. GUARICO,CE. ROSCIO,PQ. PARAPARA,PREESCOLAR BOLIVARIANO PARAPARA,197,1,0,167,133,167,0,1,0,0,33,167
EDO. GUARICO,CE. ROSCIO,PQ. PARAPARA,LICEO BOLIVARIANO JOAQUIN CRESPO,355,1,5,303,238,298,1,1,0,0,58,303
EDO. GUARICO,CE. ROSCIO,PQ. PARAPARA,ESCUELA ESTADAL CONCENTRADA AC 15,606,2,6,486,377,480,0,2,1,0,100,486
EDO. GUARICO,CE. ROSCIO,PQ.SAN JUAN DE LOS MORROS,CENTRO DE EDUCACION INICIAL LOS LLANERITOS,79,1,0,76,42,76,0,0,0,0,34,76
EDO. GUARICO,CE. ROSCIO,PQ.SAN JUAN DE LOS MORROS,CENTRO PREESCOLAR EDUCATIVO AÑO INTERNACIONAL DEL NIÑO NUCLEO OLGA DE BRUGUERA,615,2,7,543,406,536,0,4,0,0,126,543
EDO. GUARICO,CE. ROSCIO,PQ.SAN JUAN DE LOS MORROS,UNIDAD EDUCATIVA NACIONAL RAFAEL CABRERA MALO,2652,5,20,2234,974,2214,0,7,0,1,1232,2234
EDO. GUARICO,CE. ROSCIO,PQ.SAN JUAN DE LOS MORROS,ESCUELA BASICA RURAL  MONSEÑOR ENRIQUE RODRIGUEZ ALVAREZ,1718,3,29,1454,914,1425,0,7,2,2,500,1454
EDO. GUARICO,CE. ROSCIO,PQ.SAN JUAN DE LOS MORROS,ESCUELA RURAL BOLIVARIANA AC 48 LAS MINAS,413,1,14,379,322,365,0,3,1,0,39,379
EDO. GUARICO,CE. ROSCIO,PQ.SAN JUAN DE LOS MORROS,ESCUELA BASICA JOSE TOMAS LEAL,1456,3,30,1271,843,1241,1,6,0,2,389,1271
EDO. GUARICO,CE. ROSCIO,PQ.SAN JUAN DE LOS MORROS,TALLER EDUCACION LABORAL GUARICO,808,2,7,693,391,686,2,6,0,1,286,693
EDO. GUARICO,CE. ROSCIO,PQ.SAN JUAN DE LOS MORROS,LICEO BOLIVARIANO VICENTE EMILIO SOJO,3859,7,54,3290,1672,3236,0,13,0,0,1551,3290
EDO. GUARICO,CE. ROSCIO,PQ.SAN JUAN DE LOS MORROS,ESCUELA BASICA GENERAL RAFAEL URDANETA,560,1,10,459,382,449,0,1,0,0,66,459
EDO. GUARICO,CE. ROSCIO,PQ.SAN JUAN DE LOS MORROS,CENTRO DEL NIÑO Y LA FAMILIA LAS VEGAS,358,1,3,313,226,310,0,2,0,0,82,313
EDO. GUARICO,CE. ROSCIO,PQ.SAN JUAN DE LOS MORROS,ESCUELA BASICA LERMITH HERNANDEZ,2927,5,73,2333,1348,2260,1,14,1,0,896,2333
EDO. GUARICO,CE. ROSCIO,PQ.SAN JUAN DE LOS MORROS,ESCUELA BASICA ZULME AZUEJE SANTAELLA,1157,2,28,988,552,960,1,7,0,0,400,988
EDO. GUARICO,CE. ROSCIO,PQ.SAN JUAN DE LOS MORROS,ESCUELA AC 24 CAMBURITO,339,1,2,258,192,256,1,1,0,0,62,258
EDO. GUARICO,CE. ROSCIO,PQ.SAN JUAN DE LOS MORROS,CENTRO DE EDUCACIÓN INICIAL BOLIVARIANO LUISA CACERES DE ARISMENDI,459,1,12,398,254,386,0,3,0,0,129,398
EDO. GUARICO,CE. ROSCIO,PQ.SAN JUAN DE LOS MORROS,ESCUELA BASICA BOLIVARIANA EDUARDO MENDEZ,3300,6,48,2789,1732,2741,0,16,1,2,990,2789
EDO. GUARICO,CE. ROSCIO,PQ.SAN JUAN DE LOS MORROS,UNIDAD EDUCATIVA NACIONAL BOLIVARIANA LICENCIADO FERDERICO BRITO FIGUEROA,481,1,4,427,311,423,0,2,0,0,110,427
EDO. GUARICO,CE. ROSCIO,PQ.SAN JUAN DE LOS MORROS,ESCUELA BASICA JOSE ANTONIO PAEZ,1478,3,29,1214,875,1185,0,10,1,0,299,1214
EDO. GUARICO,CE. ROSCIO,PQ.SAN JUAN DE LOS MORROS,PENITENCIARIA GENERAL DE VENEZUELA,247,1,3,118,86,115,0,1,0,0,28,118
EDO. GUARICO,CE. ROSCIO,PQ.SAN JUAN DE LOS MORROS,CENTRO DE EDUCACION INICIAL JOSE DE LOS SANTOS PEREIRA,246,1,6,212,117,206,0,2,0,0,87,212
EDO. GUARICO,CE. ROSCIO,PQ.SAN JUAN DE LOS MORROS,ESCUELA BASICA AMALIA DE LARA,3379,6,66,2829,1864,2763,1,10,1,2,885,2829
EDO. GUARICO,CE. ROSCIO,PQ.SAN JUAN DE LOS MORROS,UNIDAD EDUCATIVA NACIONAL BOLIVARIANA FEDERACION VENEZOLANA DE MAESTROS,4135,8,45,3442,1968,3397,1,27,3,5,1393,3442
EDO. GUARICO,CE. ROSCIO,PQ.SAN JUAN DE LOS MORROS,NUCLEO INTEGRAL DE BIENESTAR ESTUDIANTIL,1161,2,12,954,386,942,0,5,1,2,548,954
EDO. GUARICO,CE. ROSCIO,PQ.SAN JUAN DE LOS MORROS,ESCUELA BASICA NACIONAL REPUBLICA DEL BRASIL,4115,8,58,3407,1683,3349,0,20,1,1,1644,3407
EDO. GUARICO,CE. ROSCIO,PQ.SAN JUAN DE LOS MORROS,CENTRO EDUCATIVO BOLIVARIANO INICIAL LOS LAURELES,1200,3,14,1020,610,1006,0,5,1,0,390,1020
EDO. GUARICO,CE. ROSCIO,PQ.SAN JUAN DE LOS MORROS,ESCUELA BASICA BOLIVARIANA GENERAL JOAQUIN CRESPO,337,1,4,303,188,299,0,0,0,0,111,303
EDO. GUARICO,CE. ROSCIO,PQ.SAN JUAN DE LOS MORROS,PRE ESCOLAR BOLIVARIANO EZEQUIEL ZAMORA,830,2,19,736,478,717,0,7,1,0,231,736
EDO. GUARICO,CE. ROSCIO,PQ.SAN JUAN DE LOS MORROS,ESCUELA BASICA NACIONAL DOCTOR VICENTE PEÑA,1892,4,13,1568,610,1555,0,13,0,1,931,1568
EDO. GUARICO,CE. ROSCIO,PQ.SAN JUAN DE LOS MORROS,ESCUELA BASICA ANDRES BELLO,2479,5,39,2039,1228,2000,1,12,1,1,757,2039
EDO. GUARICO,CE. ROSCIO,PQ.SAN JUAN DE LOS MORROS,ESCUELA BASICA RURAL BOLIVARIANA AC 10 LUCIANERO,228,1,6,213,154,207,0,2,0,0,51,213
EDO. GUARICO,CE. ROSCIO,PQ.SAN JUAN DE LOS MORROS,LICEO JUAN GERMAN ROSCIO,3654,7,38,3043,1195,3005,0,26,1,1,1782,3043
EDO. GUARICO,CE. ROSCIO,PQ.SAN JUAN DE LOS MORROS,ESCUELA BASICA ANTONIO JOSE DE SUCRE,1896,4,48,1638,1057,1590,1,9,0,0,523,1638
EDO. GUARICO,CE. ROSCIO,PQ.SAN JUAN DE LOS MORROS,ESCUELA BASICA JOSEFA MOLINA DE DUQUE,1944,4,32,1624,902,1592,0,6,2,0,682,1624
EDO. GUARICO,CE. ROSCIO,PQ.SAN JUAN DE LOS MORROS,ESCUELA BASICA BOLIVARIANA FRANCISCO DE MIRANDA,1377,3,21,1158,787,1137,0,9,0,1,340,1158
EDO. GUARICO,CE. ROSCIO,PQ.SAN JUAN DE LOS MORROS,UNIDAD EDUCATIVA NACIONAL JOSE FELIX RIBAS,2100,4,22,1805,766,1783,0,16,0,2,999,1805
EDO. GUARICO,CE. ROSCIO,PQ.SAN JUAN DE LOS MORROS,UNIDAD EDUCATIVA NACIONAL PUENTE GUARICO,51,1,2,43,31,41,0,1,0,0,9,43
EDO. GUARICO,CE. ROSCIO,PQ.SAN JUAN DE LOS MORROS,GRUPO ESCOLAR JOSE FELIX RIBAS,2994,6,55,2586,1125,2531,0,12,0,1,1393,2586
EDO. GUARICO,CE. ROSCIO,PQ.SAN JUAN DE LOS MORROS,CENTRO PREESCOLAR AÑO INTERNACIONAL DEL NIÑO,924,2,9,755,405,746,0,8,1,0,332,755
EDO. GUARICO,CE. ROSCIO,PQ.SAN JUAN DE LOS MORROS,JARDINES INTEGRADOS AL NER 015,280,1,1,222,158,221,0,2,0,1,60,222
EDO. GUARICO,CE. ROSCIO,PQ.SAN JUAN DE LOS MORROS,ESCUELA BOLIVARIANA FELIPE ANTONIO ACOSTA CARLES,575,1,13,497,381,484,0,1,1,0,101,497
EDO. GUARICO,CE. ROSCIO,PQ.SAN JUAN DE LOS MORROS,RESIDENCIA DE ANCIANOS FRANCISCO LAZO MARTI,1955,4,28,1633,1221,1605,0,10,0,1,373,1633
EDO. GUARICO,CE. ROSCIO,PQ.SAN JUAN DE LOS MORROS,ESCUELA BASICA JUAN ANTONIO PADILLA,2236,4,25,2007,582,1982,1,4,0,2,1393,2007
EDO. GUARICO,CE. ROSCIO,PQ.SAN JUAN DE LOS MORROS,INTERNADO JUDICIAL LOS PINOS,518,1,1,189,167,188,1,1,0,0,19,189
EDO. GUARICO,CE. ROSCIO,PQ.SAN JUAN DE LOS MORROS,GRUPO ESCOLAR JOSE DE LOS SANTOS PEREIRA,3323,6,54,2830,1525,2776,1,10,0,0,1240,2830
EDO. GUARICO,CE. ROSCIO,PQ.SAN JUAN DE LOS MORROS,ESCUELA BASICA RURAL BOLIVARIA AC 19 LOS BAGRES,229,1,3,225,184,222,0,2,1,0,35,225
EDO. GUARICO,CE. ROSCIO,PQ.SAN JUAN DE LOS MORROS,CICLO BASICO LUIS BARRIOS CRUZ,4015,7,64,3513,1830,3449,2,15,1,2,1599,3513
EDO. GUARICO,CE. ROSCIO,PQ.SAN JUAN DE LOS MORROS,GRUPO ESCOLAR LIC. FRANCISCO ARANDA,3433,6,73,2919,1389,2846,1,15,0,1,1440,2919
EDO. GUARICO,CE. ROSCIO,PQ.SAN JUAN DE LOS MORROS,ESCUELA BASICA RURAL BOLIVARIANA AC 41 EL CASTRERO,747,2,9,629,397,620,0,2,0,0,221,629
EDO. GUARICO,CE. ROSCIO,PQ.SAN JUAN DE LOS MORROS,CENTRO DE EDUCACION INICIAL PREESCOLAR REPUBLICA DEL BRASIL,1095,2,16,972,532,956,1,5,0,0,418,972
EDO. GUARICO,CE. ROSCIO,PQ.SAN JUAN DE LOS MORROS,ESCUELA ESTADAL PEDRO ZARAZA,2032,4,29,1663,1227,1634,0,6,1,1,399,1663
EDO. GUARICO,CE. ROSCIO,PQ.SAN JUAN DE LOS MORROS,ESCUELA CENTRO DE EDUCACION INICIAL BOLIVARIANO VALLECITO GUAFAL,1202,3,13,1099,679,1086,0,6,1,0,400,1099
EDO. GUARICO,MP. MELLADO,PQ. EL SOMBRERO,ESCUELA DE EDUCACION INICIAL NACIONAL BOLIVARIANA MONSEÑOR ARTURO CELESTINO ALVAREZ,323,1,8,274,192,266,0,2,0,0,72,274
EDO. GUARICO,MP. MELLADO,PQ. EL SOMBRERO,ESCUELA BOLIVARIANA BC 11 LA GUÁSIMA,335,1,5,292,235,287,0,1,0,0,51,292
EDO. GUARICO,MP. MELLADO,PQ. EL SOMBRERO,CENTRO MOVIL,265,1,7,214,174,207,0,1,1,0,31,214
EDO. GUARICO,MP. MELLADO,PQ. EL SOMBRERO,UNIDAD EDUCATIVA NACIONAL JULIAN MELLADO,2772,5,53,2233,1451,2180,1,12,2,0,714,2233
EDO. GUARICO,MP. MELLADO,PQ. EL SOMBRERO,GRUPO ESCOLAR JUAN JOSE TOVAR,3396,6,52,2571,1430,2519,0,17,0,1,1071,2571
EDO. GUARICO,MP. MELLADO,PQ. EL SOMBRERO,ESCUELA ESTADAL CONCENTRADA BC 3 LAGUNA SECA,322,1,9,246,191,237,0,1,0,0,45,246
EDO. GUARICO,MP. MELLADO,PQ. EL SOMBRERO,LICEO ALBERTO ISAAC PADRA,1437,3,15,1242,860,1227,0,9,2,1,355,1242
EDO. GUARICO,MP. MELLADO,PQ. EL SOMBRERO,ESCUELA DE EDUCACIÓN INICIAL ALICIA SANCHEZ ESAAC,461,1,10,400,330,390,0,2,0,0,58,400
EDO. GUARICO,MP. MELLADO,PQ. EL SOMBRERO,INSTITUTO DE EDUCACION ESPECIAL SAN JUDAS TADEO,601,2,12,489,319,477,1,3,0,0,154,489
EDO. GUARICO,MP. MELLADO,PQ. EL SOMBRERO,ESCUELA BOLIVARIANA LA CACHAMA,207,1,3,189,147,186,0,0,0,0,39,189
EDO. GUARICO,MP. MELLADO,PQ. EL SOMBRERO,ESCUELA ESTADAL CONCENTRADA BC 7 LA FUNDACIÓN,195,1,2,145,134,143,0,0,0,1,8,145
EDO. GUARICO,MP. MELLADO,PQ. EL SOMBRERO,ESCUELA BOLIVARIANA PUEBLO NUEVO,882,2,12,731,568,719,0,6,0,0,145,731
EDO. GUARICO,MP. MELLADO,PQ. EL SOMBRERO,ESCUELA BOLIVARIANA NER 053 LAS LAJITAS,324,1,2,279,244,277,0,0,0,0,33,279
EDO. GUARICO,MP. MELLADO,PQ. EL SOMBRERO,CENTRO DE EDUCACIÓN INICIAL EL TURPIAL,625,2,6,554,359,548,1,2,1,0,185,554
EDO. GUARICO,MP. MELLADO,PQ. EL SOMBRERO,ESCUELA PRE VOCACIONAL DOCTOR JOSE CECILIO MONTILLA,2798,5,33,2220,1346,2187,0,6,2,1,832,2220
EDO. GUARICO,MP. MELLADO,PQ. EL SOMBRERO,ESCUELA BASICA CAMPO ALEGRE,2107,4,38,1719,1329,1681,0,10,1,1,340,1719
EDO. GUARICO,MP. MELLADO,PQ. SOSA,ESCUELA TECNICA AGROPECUARIA SOSA,961,2,9,779,442,770,0,3,0,0,325,779
EDO. GUARICO,MP. MELLADO,PQ. SOSA,ESCUELA BOLIVARIANA BC 9 LA JUANERA,196,1,4,183,156,179,0,0,0,0,23,183
EDO. GUARICO,MP.SAN GERONIMO DE G,PQ. CAZORLA,ESCUELA BASICA CONCENTRADA SAN JOSE,344,1,4,282,185,278,0,1,0,0,92,282
EDO. GUARICO,MP.SAN GERONIMO DE G,PQ. CAZORLA,ESCUELA CONCENTRADA   20 PASO DE HATO,989,2,9,673,448,664,0,2,0,0,214,673
EDO. GUARICO,MP.SAN GERONIMO DE G,PQ. CAZORLA,ESCUELA BASICA LA CHIPOLA,111,1,0,82,56,82,0,0,0,0,26,82
EDO. GUARICO,MP.SAN GERONIMO DE G,PQ. CAZORLA,UNIDAD EDUCATIVA LEONARDO INFANTE,1959,4,13,1296,776,1283,0,7,1,0,499,1296
EDO. GUARICO,MP.SAN GERONIMO DE G,PQ. CAZORLA,ESCUELA ESTADAL CC 46 MANGAS COBERAS,412,1,0,228,162,228,0,0,0,0,66,228
EDO. GUARICO,MP.SAN GERONIMO DE G,PQ. CAZORLA,ESCUELA ESTADAL CC 19 EL PERICO,466,1,9,341,248,332,0,0,0,0,84,341
EDO. GUARICO,MP.SAN GERONIMO DE G,PQ. GUAYABAL,ESCUELA ESTADAL C 56 MEDIA LUNA,275,1,4,187,121,183,0,1,0,0,61,187
EDO. GUARICO,MP.SAN GERONIMO DE G,PQ. GUAYABAL,ESCUELA BASICA ANDRES BELLO,290,1,4,257,199,253,0,2,1,0,51,257
EDO. GUARICO,MP.SAN GERONIMO DE G,PQ. GUAYABAL,ESCUELA ESTADAL C 07 SAMANCITO,224,1,7,158,123,151,0,1,0,0,27,158
EDO. GUARICO,MP.SAN GERONIMO DE G,PQ. GUAYABAL,GRUPO ESCOLAR CARLOS DEL POZO,5485,10,77,4178,2809,4101,0,28,5,0,1259,4178
EDO. GUARICO,MP.SAN GERONIMO DE G,PQ. GUAYABAL,ESCUELA ESTADAL CC 11 ORORAL,895,2,17,660,414,643,0,4,0,0,225,660
EDO. GUARICO,MP.SAN GERONIMO DE G,PQ. GUAYABAL,ESCUELA ESTADAL C 9 AGUA VERDE,832,2,3,589,444,586,0,3,0,0,139,589
EDO. GUARICO,MP.SAN GERONIMO DE G,PQ. GUAYABAL,UNIDAD EDUCATIVA DOCTOR JULIO DE ARMAS,1027,2,17,858,605,841,0,2,0,0,234,858
EDO. GUARICO,MP.SAN GERONIMO DE G,PQ. GUAYABAL,UNIDAD EDUCATIVA CC 49 CAMORUCO ESPAÑOLERO,200,1,1,155,99,154,0,0,0,0,55,155
EDO. GUARICO,MP. INFANTE,PQ. VALLE DE LA PASCUA,ESCUELA BASICA DC  21 EL BOSTERO
EDO. GUARICO,MP. INFANTE,PQ. VALLE DE LA PASCUA,UNIDAD EDUCATIVA GENERAL JOSE ANTONIO PAEZ,388,1,3,297,197,294,0,1,0,1,95,297
EDO. GUARICO,MP. INFANTE,PQ. VALLE DE LA PASCUA,INCES,435,1,5,378,229,373,0,1,0,1,142,378
EDO. GUARICO,MP. INFANTE,PQ. VALLE DE LA PASCUA,INSTITUTO UNIVERSITARIO TECNOLOGICO DE LOS LLANOS,3291,6,47,2847,1377,2800,0,9,0,1,1413,2847
EDO. GUARICO,MP. INFANTE,PQ. VALLE DE LA PASCUA,LICEO JOSE GREGORIO GONZALEZ,334,1,8,296,183,288,0,1,0,0,104,296
EDO. GUARICO,MP. INFANTE,PQ. VALLE DE LA PASCUA,PRESCOLAR ARAGUANEY,1323,3,9,1103,516,1094,0,3,1,0,574,1103
EDO. GUARICO,MP. INFANTE,PQ. VALLE DE LA PASCUA,FUNDACION NACIONAL EL NIÑO SIMON,580,1,1,506,276,505,0,2,0,0,227,506
EDO. GUARICO,MP. INFANTE,PQ. VALLE DE LA PASCUA,ESCUELA BASICA CLARA MATOS ARZOLA,3789,7,53,3141,1859,3088,1,25,3,5,1195,3141
EDO. GUARICO,MP. INFANTE,PQ. VALLE DE LA PASCUA,ESCUELA NACIONAL 3712, JACOME ABAJO.,731,2,8,601,380,593,0,5,0,1,207,601
EDO. GUARICO,MP. INFANTE,PQ. VALLE DE LA PASCUA,ESCUELA BASICA FRANCISCO LAZO MARTÍ,5239,10,64,4373,1946,4309,1,26,2,3,2331,4373
EDO. GUARICO,MP. INFANTE,PQ. VALLE DE LA PASCUA,ESCUELA BASICA JOSE MANUEL FUENTES ACEVEDO,3973,7,64,3248,2172,3184,0,28,2,0,982,3248
EDO. GUARICO,MP. INFANTE,PQ. VALLE DE LA PASCUA,CASA DE LA CULTURA LORENZO RUBIN ZAMORA,383,1,6,317,202,311,0,2,0,0,107,317
EDO. GUARICO,MP. INFANTE,PQ. VALLE DE LA PASCUA,UNIVERSIDAD ROMULO GALLEGOS,316,1,5,271,116,266,0,0,0,0,150,271
EDO. GUARICO,MP. INFANTE,PQ. VALLE DE LA PASCUA,ESCUELA BASICA BOLIVARIANA CARLOS JOSE BELLO,3180,6,50,2665,1243,2615,0,19,1,0,1352,2665
EDO. GUARICO,MP. INFANTE,PQ. VALLE DE LA PASCUA,ESCUELA BASICA DC 20 EL PÁRAMO,770,2,15,637,469,622,0,4,0,0,149,637
EDO. GUARICO,MP. INFANTE,PQ. VALLE DE LA PASCUA,ASOCIACION MONSEÑOR SALAS,1500,3,8,1292,871,1284,0,2,0,1,410,1292
EDO. GUARICO,MP. INFANTE,PQ. VALLE DE LA PASCUA,UNIDAD EDUCATIVA CELESTINO PERAZA,449,1,9,372,250,363,0,1,0,0,112,372
EDO. GUARICO,MP. INFANTE,PQ. VALLE DE LA PASCUA,ESCUELA BOLIVARIANA CE 41 MERCEDES DE MELO MAMONAL,1035,2,18,845,642,827,1,4,1,0,179,845
EDO. GUARICO,MP. INFANTE,PQ. VALLE DE LA PASCUA,UNIDAD EDUCATIVA PREBISPERO JUAN SANTIAGO GUASCO,3911,7,59,3182,2156,3123,0,20,0,3,944,3182
EDO. GUARICO,MP. INFANTE,PQ. VALLE DE LA PASCUA,ESCUELA ESTADAL CONCENTRADA DC 42 LOMA DE PIEDRA,299,1,3,242,203,239,0,0,1,0,35,242
EDO. GUARICO,MP. INFANTE,PQ. VALLE DE LA PASCUA,COMPLEJO CULTURAL OTO RODRIGUEZ,243,1,2,219,150,217,0,1,0,0,66,219
EDO. GUARICO,MP. INFANTE,PQ. VALLE DE LA PASCUA,UNIVERSIDAD NACIONAL EXPERIMENTAL SIMON RODRIGUEZ,448,1,13,389,226,376,0,0,0,0,150,389
EDO. GUARICO,MP. INFANTE,PQ. VALLE DE LA PASCUA,UNIDAD EDUCATIVA BOLIVARIANA JUAN GERMAN ROSCIO,1356,3,17,1109,415,1092,0,6,0,0,671,1109
EDO. GUARICO,MP. INFANTE,PQ. VALLE DE LA PASCUA,UNIDAD EDUCATIVA JUAN JOSE RONDON,3947,7,58,3265,2016,3207,1,12,2,2,1174,3265
EDO. GUARICO,MP. INFANTE,PQ. VALLE DE LA PASCUA,GRUPO ESCOLAR JUANA JOSEFA VARGAS,4351,8,50,3615,1675,3565,1,22,2,1,1864,3615
EDO. GUARICO,MP. INFANTE,PQ. VALLE DE LA PASCUA,ESCUELA BASICA DC 08 LOS ALGODONES,850,2,15,651,475,636,1,2,0,0,158,651
EDO. GUARICO,MP. INFANTE,PQ. VALLE DE LA PASCUA,ESCUELA BASICA DC 9 LA PEREÑA,313,1,1,268,183,267,0,1,1,0,82,268
EDO. GUARICO,MP. INFANTE,PQ. VALLE DE LA PASCUA,UNIDAD EDUCATIVA BOLIVARIANA LIBERTADOR EC 040,688,2,11,548,245,537,2,1,0,0,289,548
EDO. GUARICO,MP. INFANTE,PQ. VALLE DE LA PASCUA,CENTRO PRE ESCOLAR ABIERTO ANDRES BELLO,1575,3,25,1347,876,1322,0,4,0,4,438,1347
EDO. GUARICO,MP. INFANTE,PQ. VALLE DE LA PASCUA,UNIDAD EDUCATIVA LICEO BOLIVARIANO MONSEÑOR RAFAEL CHACIN,3836,7,50,3215,2177,3165,2,31,4,1,950,3215
EDO. GUARICO,MP. INFANTE,PQ. VALLE DE LA PASCUA,UNIVERSIDAD ROMULO GALLEGOS EDIFICIO NUMERO 2,467,1,6,404,219,398,0,1,0,1,177,404
EDO. GUARICO,MP. INFANTE,PQ. VALLE DE LA PASCUA,ESCUELA DE ESPECIALIDADES SAN JOSE,1006,2,15,844,312,829,0,4,0,1,512,844
EDO. GUARICO,MP. INFANTE,PQ. VALLE DE LA PASCUA,ESCUELA BOLIVARIANA 12 DE OCTUBRE,1101,2,10,971,584,961,0,6,1,0,370,971
EDO. GUARICO,MP. INFANTE,PQ. VALLE DE LA PASCUA,ESCUELA ESTADAL UNITARIA DC 58 LAS GARZAS,270,1,5,170,112,165,0,1,0,0,52,170
EDO. GUARICO,MP. INFANTE,PQ. VALLE DE LA PASCUA,ESCUELA BASICA MARIANO MONTILLA,3850,7,39,3155,1818,3116,2,16,0,1,1279,3155
EDO. GUARICO,MP. INFANTE,PQ. VALLE DE LA PASCUA,GRUPO ESCOLAR RAFAEL GONZALEZ UDIS,5322,10,64,4304,2382,4240,1,23,5,1,1828,4304
EDO. GUARICO,MP. INFANTE,PQ. VALLE DE LA PASCUA,AMBULATORIO ALFALLANOS,1490,3,24,1205,768,1181,0,1,0,0,412,1205
EDO. GUARICO,MP. INFANTE,PQ. VALLE DE LA PASCUA,CENTRO DE VOTACION MOVIL,228,1,4,200,80,196,0,3,0,0,113,200
EDO. GUARICO,MP. INFANTE,PQ. VALLE DE LA PASCUA,UNIDAD EDUCATIVA LOURDES CAMERO RAMIREZ,3576,7,35,2920,2047,2885,2,16,1,2,817,2920
EDO. GUARICO,MP. INFANTE,PQ. VALLE DE LA PASCUA,ESCUELA BASICA BANDERA BLANCA,146,1,2,131,110,129,0,0,0,0,19,131
EDO. GUARICO,MP. INFANTE,PQ. VALLE DE LA PASCUA,UNIDAD EDUCATIVA APAMATE,232,1,4,211,182,207,0,0,0,0,25,211
EDO. GUARICO,MP. INFANTE,PQ. VALLE DE LA PASCUA,LICEO BOLIVARIANO JOSE GIL FORTOUL,3182,6,50,2707,1138,2657,0,15,1,2,1501,2707
EDO. GUARICO,MP. INFANTE,PQ. VALLE DE LA PASCUA,UNIDAD EDUCATIVA ANDRES BELLO,826,2,15,730,407,715,1,5,0,0,302,730
EDO. GUARICO,MP. INFANTE,PQ. VALLE DE LA PASCUA,ESCUELA BASICA ESTADAL UNITARIA D 52 COROZALITO,207,1,4,133,112,129,0,2,0,0,15,133
EDO. GUARICO,MP. INFANTE,PQ. VALLE DE LA PASCUA,UNIDAD EDUCATIVA JESUS LOPEZ ESCOBAR,533,1,9,393,269,384,1,2,2,0,110,393
EDO. GUARICO,MP. INFANTE,PQ. VALLE DE LA PASCUA,UNIVERSIDAD NACIONAL ABIERTA,441,1,2,379,259,377,0,3,0,0,115,379
EDO. GUARICO,MP. INFANTE,PQ. VALLE DE LA PASCUA,COLEGIO NUESTRA SEÑORA DEL VALLE,2605,5,20,2243,701,2223,0,12,0,3,1507,2243
EDO. GUARICO,MP. INFANTE,PQ. ESPINO,ESCUELA ESTADAL CONCENTRADA NUMERO DC 36 PARMANA,494,1,4,336,256,332,0,4,3,0,69,336
EDO. GUARICO,MP. INFANTE,PQ. ESPINO,ESCUELA BASICA ENRIQUE BENITO NUÑEZ,2659,5,30,2058,1633,2028,0,8,1,0,386,2058
EDO. GUARICO,MP. INFANTE,PQ. ESPINO,ESCUELA ESTADAL NUMERO DC 62  RABANAL,237,1,3,186,142,183,0,2,0,0,39,186
EDO. GUARICO,MP. INFANTE,PQ. ESPINO,ESCUELA NACIONAL UNITARIA NUMERO D 84 LA IGUANA,174,1,1,120,107,119,1,1,0,0,10,120
EDO. GUARICO,MP. INFANTE,PQ. ESPINO,ESCUELA BASICA NUMERO D 70 PABLO MARIA MATOS,170,1,0,115,81,115,0,0,0,0,34,115
EDO. GUARICO,MP. EL SOCORRO,PQ. EL SOCORRO,ESCUELA NACIONAL CONCENTRADA NÚMERO  2924 3500  LA PUENTE,436,1,6,350,243,344,0,0,0,0,101,350
EDO. GUARICO,MP. EL SOCORRO,PQ. EL SOCORRO,UNIDAD EDUCATIVA NACIONAL JOSE MELECIO CAMACHO,1156,2,26,923,623,897,0,6,1,0,267,923
EDO. GUARICO,MP. EL SOCORRO,PQ. EL SOCORRO,ESCUELA DE ESPECIALIDADES CORAZON DE JESUS,796,2,5,689,475,684,0,1,0,0,208,689
EDO. GUARICO,MP. EL SOCORRO,PQ. EL SOCORRO,ESCUELA BASICA BOLIVARIANA FC 50 CORRAL VIEJO,828,2,15,630,373,615,0,3,1,0,238,630
EDO. GUARICO,MP. EL SOCORRO,PQ. EL SOCORRO,NUCLEO ESCOLAR RURAL 497 BOQUERON,90,1,3,81,66,78,0,0,0,0,12,81
EDO. GUARICO,MP. EL SOCORRO,PQ. EL SOCORRO,ESCUELA BASICA BOLIVARIANA JOBO GACHO,462,1,10,395,306,385,0,2,0,0,77,395
EDO. GUARICO,MP. EL SOCORRO,PQ. EL SOCORRO,ESCUELA BASICA ESTADAL FC 37 MAHOMAL,121,1,1,114,94,113,0,0,0,0,19,114
EDO. GUARICO,MP. EL SOCORRO,PQ. EL SOCORRO,ESCUELA ESTADAL FC 43 LOMAS PERDOMERAS,405,1,6,288,199,282,1,1,0,0,81,288
EDO. GUARICO,MP. EL SOCORRO,PQ. EL SOCORRO,ESCUELA BASICA NACIONAL CREACION SALSIPUEDES,385,1,6,331,275,325,0,1,0,0,49,331
EDO. GUARICO,MP. EL SOCORRO,PQ. EL SOCORRO,ESCUELA COROCITO PEÑERO,489,1,8,377,315,369,0,3,1,0,50,377
EDO. GUARICO,MP. EL SOCORRO,PQ. EL SOCORRO,ESCUELA TECNICA AGROPECUARIA HENRY PITIER,1057,2,22,912,645,890,0,2,0,1,242,912
EDO. GUARICO,MP. EL SOCORRO,PQ. EL SOCORRO,ESCUELA BASICA CARLOS IRAZABAL PEREZ,4832,9,73,3616,2234,3543,0,17,2,2,1288,3616
EDO. GUARICO,MP. EL SOCORRO,PQ. EL SOCORRO,ESCUELA BASICA MARGOT RISSO DE MALAVE,1101,2,25,894,661,869,0,6,1,1,200,894
EDO. GUARICO,MP. EL SOCORRO,PQ. EL SOCORRO,ESCUELA BASICA NACIONAL NUMERO 0080 DIVIDIVE,184,1,1,172,144,171,0,0,0,0,27,172
EDO. GUARICO,MP. EL SOCORRO,PQ. EL SOCORRO,ESCUELA BASICA ESTATAL UNITARIA FC 86 MANIRAL,387,1,3,268,179,265,0,3,0,0,83,268
EDO. GUARICO,MP. MIRANDA,PQ. EL CALVARIO,ESCUELA NACIONAL CONCENTRADA NUMERO 178 1778 EL CALVARIO,1127,2,30,844,577,814,0,3,1,0,233,844
EDO. GUARICO,MP. MIRANDA,PQ. GUARDATINAJAS,ESCUELA ESTADAL CC 17 MONTE OSCURO
EDO. GUARICO,MP. MIRANDA,PQ. GUARDATINAJAS,GRUPO ESCOLAR FRANCISCO CONDE,2169,4,30,1673,1164,1643,1,6,0,0,472,1673
EDO. GUARICO,MP. MIRANDA,PQ. GUARDATINAJAS,UNIDAD EDUCATIVA DOCTOR LUIS JOSE ACOSTA RODRIGUEZ,454,1,8,368,269,360,1,0,0,0,90,368
EDO. GUARICO,MP. MIRANDA,PQ. CALABOZO,UNIDAD EDUCATIVA PARMENIA DIAZ DE CARVAJAL,529,1,12,459,331,447,0,3,0,1,112,459
EDO. GUARICO,MP. MIRANDA,PQ. CALABOZO,ESCUELA BOLIVARIANA LECHERITO 5,485,1,7,389,347,382,0,1,0,0,34,389
EDO. GUARICO,MP. MIRANDA,PQ. CALABOZO,COLEGIO NUESTRA SEÑORA DE LA COROMOTO,1958,4,26,1676,660,1650,1,7,1,2,979,1676
EDO. GUARICO,MP. MIRANDA,PQ. CALABOZO,ESCUELA BASICA ANTONIO ESTEVEZ,642,2,20,560,403,540,0,1,0,0,136,560
EDO. GUARICO,MP. MIRANDA,PQ. CALABOZO,ESCUELA BASICA DOCTOR FRANCISCO LAZO MARTI,3766,7,27,3168,1594,3141,0,30,0,1,1516,3168
EDO. GUARICO,MP. MIRANDA,PQ. CALABOZO,JARDIN DE INFANCIA MARIA TERESA DEL TORO,1651,3,33,1371,978,1338,0,7,0,0,353,1371
EDO. GUARICO,MP. MIRANDA,PQ. CALABOZO,GRUPO ESCOLAR JOSE RAFAEL VISO RODRIGUEZ,3792,7,61,3066,2114,3005,2,21,4,0,864,3066
EDO. GUARICO,MP. MIRANDA,PQ. CALABOZO,GRUPO ESCOLAR CAMAGUAN,1717,3,26,1389,911,1363,0,6,0,1,445,1389
EDO. GUARICO,MP. MIRANDA,PQ. CALABOZO,GRUPO ESCOLAR PEDRO ITRIAGO CHACIN,3342,6,51,2701,1784,2650,1,11,0,3,851,2701
EDO. GUARICO,MP. MIRANDA,PQ. CALABOZO,ESCUELA BASICA ANDRES BELLO
EDO. GUARICO,MP. MIRANDA,PQ. CALABOZO,ESCUELA TECNICA COMERCIAL DOCTOR RAFAEL LORETO LORETO,1092,2,26,939,554,913,0,6,0,0,353,939
EDO. GUARICO,MP. MIRANDA,PQ. CALABOZO,CASA DE LA CULTURA FRANCISCO LAZO MARTÍ,2321,4,20,1906,916,1886,0,10,2,0,958,1906
EDO. GUARICO,MP. MIRANDA,PQ. CALABOZO,ESCUELA BOLIVARIANA RURAL CC 81 NER 016 UVERITO PEREÑO
EDO. GUARICO,MP. MIRANDA,PQ. CALABOZO,UNIDAD EDUCATIVA JUAN EDUVIGES LEDEZMA ALVAREZ,934,2,18,782,670,764,1,4,0,0,89,782
EDO. GUARICO,MP. MIRANDA,PQ. CALABOZO,ESCUELA NUESTRA SEÑORA DE LOS DOLORES,1255,3,23,1067,863,1044,3,8,0,0,170,1067
EDO. GUARICO,MP. MIRANDA,PQ. CALABOZO,ESCUELA ESTADAL C 20 LOS ANDRESEROS,231,1,2,171,143,169,0,1,1,0,24,171
EDO. GUARICO,MP. MIRANDA,PQ. CALABOZO,ESCUELA BOLIVARIANA CC 71 COROZOPANDO NER 485,596,1,29,427,332,398,0,2,0,0,64,427
EDO. GUARICO,MP. MIRANDA,PQ. CALABOZO,CENTRO MOVIL,485,1,2,406,298,404,0,3,0,0,103,406
EDO. GUARICO,MP. MIRANDA,PQ. CALABOZO,CICLO BASICO JOAQUIN CRESPO,1016,2,6,843,630,837,0,3,0,1,203,843
EDO. GUARICO,MP. MIRANDA,PQ. CALABOZO,ESCUELA BASICA CELINA ACOSTA DE VIANA,2835,5,47,2301,1424,2254,0,13,2,1,814,2301
EDO. GUARICO,MP. MIRANDA,PQ. CALABOZO,UNIDAD EDUCATIVA JOSE FELIX RIBAS,2266,4,19,1810,1449,1791,0,15,0,1,326,1810
EDO. GUARICO,MP. MIRANDA,PQ. CALABOZO,CENTRO EDUCATIVO INICIAL ANTONIO JOSE DE SUCRE,1094,2,13,935,656,922,0,7,1,0,258,935
EDO. GUARICO,MP. MIRANDA,PQ. CALABOZO,ESCUELA BASICA CC 25 SOCORRO DE PORTUGUESA
EDO. GUARICO,MP. MIRANDA,PQ. CALABOZO,GRUPO ESCOLAR ESTADOS UNIDOS DE AMERICA,2591,5,30,2082,1027,2052,0,11,3,2,1009,2082
EDO. GUARICO,MP. MIRANDA,PQ. CALABOZO,UNIDAD EDUCATIVA SIMON RODRIGUEZ,1937,4,18,1600,1206,1582,0,9,2,2,363,1600
EDO. GUARICO,MP. MIRANDA,PQ. CALABOZO,UNIDAD EDUCATIVA NACIONAL DOCTOR JOSE MARIA VARGAS,328,1,5,260,217,255,0,1,0,0,37,260
EDO. GUARICO,MP. MIRANDA,PQ. CALABOZO,NUCLEO EDUCACION UNIVERSIDAD ROMULO GALLEGOS,1496,3,23,1224,727,1201,1,6,0,2,465,1224
EDO. GUARICO,MP. MIRANDA,PQ. CALABOZO,GRUPO ESCOLAR OTONIEL GUGLIETA,3120,6,52,2481,1882,2429,3,18,3,2,521,2481
EDO. GUARICO,MP. MIRANDA,PQ. CALABOZO,UNIDAD EDUCATIVA JUAN GERMAN ROSCIO,3291,6,69,2617,1950,2548,2,15,1,1,579,2617
EDO. GUARICO,MP. MIRANDA,PQ. CALABOZO,ESCUELA ESTADAL RURAL CC 13 PASO DE MUJICA
EDO. GUARICO,MP. MIRANDA,PQ. CALABOZO,ESCUELA BOLIVARIANA LUISA CACERES DE ARISMENDI,746,2,18,638,490,620,0,7,0,0,123,638
EDO. GUARICO,MP. MIRANDA,PQ. CALABOZO,LICEO FRANCISCO DE MIRANDA,3975,7,40,3321,2123,3281,2,17,0,4,1135,3321
EDO. GUARICO,MP. MIRANDA,PQ. CALABOZO,ESCUELA BOLIVARIANA NUMERO 1988,379,1,7,309,253,302,0,3,0,0,46,309
EDO. GUARICO,MP. MIRANDA,PQ. CALABOZO,CONCENTRACION ESCOLAR CC 03 PALO SECO
EDO. GUARICO,MP. MIRANDA,PQ. CALABOZO,CENTRO MÓVIL BOQUERONES
EDO. GUARICO,MP. MIRANDA,PQ. CALABOZO,INSTITUTO NACIONAL DE COOPERACION EDUCATIVA SOCIALISTA CALABOZO,943,2,7,777,456,770,2,5,0,0,307,777
EDO. GUARICO,MP. MIRANDA,PQ. CALABOZO,ESCUELA BOLIVARIANA PIRITU
EDO. GUARICO,MP. MIRANDA,PQ. CALABOZO,ESCUELA BASICA ESTADAL LA MATICA,416,1,11,377,329,366,0,1,0,0,36,377
EDO. GUARICO,MP. MIRANDA,PQ. CALABOZO,UNIDAD EDUCATIVA BICENTENARIO DE LAS AMERICAS,2624,5,35,2335,2055,2300,0,11,1,0,233,2335
EDO. GUARICO,MP. MIRANDA,PQ. CALABOZO,UNIDAD EDUCATIVA BOLIVARIANA LECHERITO 2,186,1,2,176,149,174,1,1,1,0,22,176
EDO. GUARICO,MP. MIRANDA,PQ. CALABOZO,LICEO HUMBOLDT,3589,7,59,2982,1612,2923,3,15,1,1,1291,2982
EDO. GUARICO,MP. MIRANDA,PQ. CALABOZO,CENTRO DE EDUCACION INICIAL DOCTOR GUSTAVO HURDANETA DELGADO,670,2,9,590,386,581,1,3,0,0,191,590
EDO. GUARICO,MP. MIRANDA,PQ. CALABOZO,ESCUELA BASICA VERITA,1575,3,14,1270,1030,1256,0,4,2,1,219,1270
EDO. GUARICO,MP. MIRANDA,PQ. CALABOZO,ESCUELA TECNICA INDUSTRIAL DOCTOR HUMBERTO FERNANDEZ MORAN
EDO. GUARICO,MP. MIRANDA,PQ. CALABOZO,UNIDAD EDUCATIVA VIRGEN MILAGROSA,1289,3,15,1064,867,1049,1,8,1,0,172,1064
EDO. GUARICO,MP. MIRANDA,PQ. CALABOZO,GRUPO ESCOLAR RAMON FRANCISCO FEO,2937,6,29,2387,1184,2358,2,16,1,1,1154,2387
EDO. GUARICO,MP. MIRANDA,PQ. CALABOZO,UNIDAD EDUCATIVA SIMON BOLIVAR,1644,3,18,1332,1094,1314,1,7,0,1,211,1332
EDO. GUARICO,MP. MIRANDA,PQ. CALABOZO,ESCUELA DE NIÑOS ESPECIALES,783,2,16,661,378,645,0,4,1,0,262,661
EDO. GUARICO,MP. MIRANDA,PQ. CALABOZO,UNIDAD EDUCATIVA GRAN MARISCAL DE AYACUCHO,659,2,15,551,451,536,0,1,1,0,83,551
EDO. GUARICO,MP. MIRANDA,PQ. CALABOZO,ESCUELA ESTADAL C 41 LAS BARBAS,234,1,3,178,122,175,0,3,0,0,50,178
EDO. GUARICO,MP. MIRANDA,PQ. CALABOZO,ESCUELA ESTADAL CC 14 NER 016
EDO. GUARICO,MP. MIRANDA,PQ. EL RASTRO,ESCUELA BASICA CREACION EL RASTRO,308,1,3,244,193,241,0,0,0,0,48,244
EDO. GUARICO,MP. MIRANDA,PQ. EL RASTRO,ESCUELA BOLIVARIANA FELIPE DAGER,1872,4,49,1444,948,1395,1,11,0,0,435,1444
EDO. GUARICO,MP. CAMAGUAN,PQ. CAMAGUAN,ESCUELA BOLIVARIANA LA NEGRA,943,2,18,796,572,778,1,4,1,0,200,796
EDO. GUARICO,MP. CAMAGUAN,PQ. CAMAGUAN,ESCUELA BOLIVARIANA LA ROMPIA,245,1,4,166,99,162,0,1,1,0,61,166
EDO. GUARICO,MP. CAMAGUAN,PQ. CAMAGUAN,CASA DE LAS MISIONES,312,1,6,274,196,268,0,0,0,0,72,274
EDO. GUARICO,MP. CAMAGUAN,PQ. CAMAGUAN,ESCUELA BOLIVARIANA JOSEFINA MORENO DE OLIVARES,1681,3,28,1302,885,1274,0,7,0,0,382,1302
EDO. GUARICO,MP. CAMAGUAN,PQ. CAMAGUAN,CENTRO DE EDUCACION INICIAL MARIA ENRIQUETA HURTADO,323,1,3,269,179,266,0,3,0,0,84,269
EDO. GUARICO,MP. CAMAGUAN,PQ. CAMAGUAN,ESCUELA BOLIVARIANA INMACULADA NIÑA,1132,2,33,948,515,915,0,5,0,0,395,948
EDO. GUARICO,MP. CAMAGUAN,PQ. CAMAGUAN,ESCUELA BOLIVARIANA JOAQUIN CRESPO,3524,6,77,2677,1388,2600,1,20,4,0,1187,2677
EDO. GUARICO,MP. CAMAGUAN,PQ. CAMAGUAN,ESCUELA BASICA BRISAS DE CAMAGUAN,769,2,13,669,455,656,1,6,0,0,194,669
EDO. GUARICO,MP. CAMAGUAN,PQ. CAMAGUAN,ESCUELA BOLIVARIANA SOMBRERITO,613,2,9,453,390,444,0,2,1,0,51,453
EDO. GUARICO,MP. CAMAGUAN,PQ. CAMAGUAN,CENTRO DE EDUCACION TOQUITO,221,1,4,194,123,190,0,2,0,0,65,194
EDO. GUARICO,MP. CAMAGUAN,PQ. PUERTO MIRANDA,CASA COMUNAL SAN FERNANDO 2000 PRIMERA ETAPA,48,1,0,44,20,44,0,1,0,0,23,44
EDO. GUARICO,MP. CAMAGUAN,PQ. PUERTO MIRANDA,ESCUELA BOLIVARIANA PUERTO MIRANDA,2448,5,57,1936,1295,1879,1,8,1,0,574,1936
EDO. GUARICO,MP. CAMAGUAN,PQ. UVERITO,UNIDAD EDUCATIVA BOLIVARIANA SIMON BOLIVAR,128,1,5,113,77,108,0,3,0,0,28,113
EDO. GUARICO,MP. CAMAGUAN,PQ. UVERITO,ESCUELA BOLIVARIANA UVERITO,1332,3,23,1006,703,983,0,8,3,1,268,1006
EDO. GUARICO,MP. ORTIZ,PQ. ORTIZ,ESCUELA BASICA JUAN GERMAN ROSCIO,1896,4,25,1551,1001,1526,0,11,0,0,514,1551
EDO. GUARICO,MP. ORTIZ,PQ. ORTIZ,ESCUELA ESTADAL AC 16 TIGUIGUE,747,2,14,583,432,569,0,5,4,0,128,583
EDO. GUARICO,MP. ORTIZ,PQ. ORTIZ,ESCUELA PRIMARIA AC 25 BUCARAL,196,1,4,166,130,162,0,1,0,0,31,166
EDO. GUARICO,MP. ORTIZ,PQ. ORTIZ,ESCUELA BASICA  CREACION LA ROMANA NER 392,554,1,3,476,320,473,0,4,0,0,149,476
EDO. GUARICO,MP. ORTIZ,PQ. ORTIZ,JARDIN DE INFANCIA JUAN GERMAN ROSCIO,368,1,6,292,196,286,0,2,0,0,88,292
EDO. GUARICO,MP. ORTIZ,PQ. ORTIZ,ESCUELA ESTADAL BOLIVARIANA BATALLA DE LA VICTORIA,198,1,5,162,127,157,0,1,0,0,29,162
EDO. GUARICO,MP. ORTIZ,PQ. ORTIZ,CICLO COMBINADO BEATRIZ DE RODRIGUEZ,3052,6,40,2441,1382,2401,0,23,3,1,992,2441
EDO. GUARICO,MP. ORTIZ,PQ. SAN FCO. DE TIZNADOS,UNIDAD EDUCATIVA EL CARITO,91,1,1,67,62,66,0,0,0,0,4,67
EDO. GUARICO,MP. ORTIZ,PQ. SAN FCO. DE TIZNADOS,ESCUELA BOLIVARIANA LUISA CACERES DE ARISMENDI,1520,3,36,1166,877,1130,1,4,0,0,248,1166
EDO. GUARICO,MP. ORTIZ,PQ. SAN FCO. DE TIZNADOS,ESCUELA ESTADAL UNITARIA AC 23 EL CARITO,276,1,1,219,201,218,0,2,0,0,15,219
EDO. GUARICO,MP. ORTIZ,PQ. SAN FCO. DE TIZNADOS,ESCUELA AC 34 LAS LAJITAS,168,1,2,149,145,147,0,0,0,0,2,149
EDO. GUARICO,MP. ORTIZ,PQ. SAN FCO. DE TIZNADOS,ESCUELA BASICA AC 36 GUAITOCO,259,1,2,186,145,184,0,2,1,0,36,186
EDO. GUARICO,MP. ORTIZ,PQ. SAN JOSE DE TIZNADOS,ESCUELA BOLIVARIANA JOSE ANGEL RODRIGUEZ TRUJILLO,1417,3,25,1112,859,1087,0,3,1,0,224,1112
EDO. GUARICO,MP. ORTIZ,PQ. SAN JOSE DE TIZNADOS,PREESCOLAR BOLIVARIANO MARIA DE TABARE,169,1,6,143,99,137,0,1,0,0,37,143
EDO. GUARICO,MP. ORTIZ,PQ. SAN JOSE DE TIZNADOS,ESCUELA BOLIVARIANA ASENTAMIENTO CAMPESINO LOS CHIGUIRES,284,1,9,246,194,237,0,3,0,1,39,246
EDO. GUARICO,MP. ORTIZ,PQ. SAN JOSE DE TIZNADOS,ESCUELA BASICA BOLIVARIANA SAN JOSE,989,2,6,773,488,767,0,1,0,0,278,773
EDO. GUARICO,MP. ORTIZ,PQ. S LORENZO DE TIZNADOS,ESCUELA PRIMARIA AC 17 BERSUGA,350,1,6,237,198,231,0,1,0,0,32,237
EDO. GUARICO,MP. ORTIZ,PQ. S LORENZO DE TIZNADOS,ESCUELA ESTADAL BOLIVARIANA AC 14 CHIRGUA,418,1,2,327,224,325,0,1,0,0,100,327
EDO. GUARICO,MP. ORTIZ,PQ. S LORENZO DE TIZNADOS,ESCUELA BASICA AC 47 PARADERO,178,1,1,158,144,157,0,0,0,0,13,158
EDO. GUARICO,MP. ORTIZ,PQ. S LORENZO DE TIZNADOS,ESCUELA ESTADAL LA FLORIDA 1,268,1,1,167,99,166,0,0,0,0,67,167
EDO. GUARICO,MP. ORTIZ,PQ. S LORENZO DE TIZNADOS,ESCUELA ESTADAL AC 18 CANUTO,740,2,7,562,487,555,0,1,0,0,67,562
EDO. GUARICO,MP. S MARIA DE IPIRE,PQ. ALTAMIRA,ESCUELA ESTADAL F 64 PUERTO REQUENA,332,1,4,260,240,256,0,0,0,0,16,260
EDO. GUARICO,MP. S MARIA DE IPIRE,PQ. ALTAMIRA,ESCUELA ESTADAL FC 45 ALTAMIRA,515,1,11,370,315,359,0,1,3,0,40,370
EDO. GUARICO,MP. S MARIA DE IPIRE,PQ. SANTA MARIA DE IPIRE,ESCUELA ESTADAL FC 44 LAS PARAULATAS,225,1,7,168,108,161,1,2,0,0,50,168
EDO. GUARICO,MP. S MARIA DE IPIRE,PQ. SANTA MARIA DE IPIRE,ESCUELA BOLIVARIANA ANTONIO DE ARMAS MATUTE,2554,5,47,1853,1057,1806,0,8,5,1,735,1853
EDO. GUARICO,MP. S MARIA DE IPIRE,PQ. SANTA MARIA DE IPIRE,ESCUELA NACIONAL UNITARIA NÚMERO 1566 AGUA AMARILLA,300,1,0,209,183,209,1,0,0,0,25,209
EDO. GUARICO,MP. S MARIA DE IPIRE,PQ. SANTA MARIA DE IPIRE,ESCUELA DE ARTES Y OFICIOS NUESTRA SEÑORA DE LA CANDELARIA,1684,3,19,1309,902,1290,0,4,0,0,384,1309
EDO. GUARICO,MP. S MARIA DE IPIRE,PQ. SANTA MARIA DE IPIRE,PRE ESCOLAR DOCTOR CECILIO REQUENA OSORIO,436,1,9,331,218,322,1,5,0,0,98,331
EDO. GUARICO,MP. S MARIA DE IPIRE,PQ. SANTA MARIA DE IPIRE,ESCUELA ESTADAL CONCENTRADA FC 16 CHAGUARAMAL DE MAYORGA,215,1,1,136,122,135,0,2,0,0,11,136
EDO. GUARICO,MP. S MARIA DE IPIRE,PQ. SANTA MARIA DE IPIRE,ASOCIACION DE PRODUCTORES AGRICOLAS SANTA MARIA DE IPIRE,343,1,3,273,179,270,0,2,2,0,87,273
EDO. GUARICO,MP. S MARIA DE IPIRE,PQ. SANTA MARIA DE IPIRE,ESCUELA CONCENTRADA FC 40 EL VENADO,360,1,3,237,191,234,0,2,1,0,40,237
EDO. GUARICO,MP. S MARIA DE IPIRE,PQ. SANTA MARIA DE IPIRE,ESCUELA ESTADAL CONCENTRADA FC 75 LOS GUATACAROS,411,1,8,277,228,269,1,1,0,0,39,277
EDO. GUARICO,MP. S MARIA DE IPIRE,PQ. SANTA MARIA DE IPIRE,ESCUELA ESTADAL CONCENTRADA FC 38 EL MANGUITO,560,1,4,404,314,400,0,6,0,1,79,404
EDO. GUARICO,MP. S MARIA DE IPIRE,PQ. SANTA MARIA DE IPIRE,UNIDAD EDUCATIVA BALTAZAR PADRON,224,1,0,182,128,182,0,2,0,0,52,182
EDO. GUARICO,MP. S MARIA DE IPIRE,PQ. SANTA MARIA DE IPIRE,ESCUELA ESTADAL CONCENTRADA FC 47 LAGUNA GRANDE,81,1,3,73,58,70,0,2,0,0,10,73
EDO. GUARICO,MP. S MARIA DE IPIRE,PQ. SANTA MARIA DE IPIRE,INSTITUTO DE EDUCACIÓN ESPECIAL SANTA MARIA,680,2,9,549,356,540,0,6,0,0,178,549
EDO. GUARICO,MP. S MARIA DE IPIRE,PQ. SANTA MARIA DE IPIRE,UNIDAD EDUCATIVA ANA MELENDEZ DE RAMIREZ,1080,2,13,850,601,837,1,9,2,0,224,850
EDO. GUARICO,MP. S MARIA DE IPIRE,PQ. SANTA MARIA DE IPIRE,ESCUELA NACIONAL CONCENTRADA NÚMERO 3614 3498 MATA DE LOS INDIOS,251,1,5,180,129,175,0,0,1,0,45,180
EDO. GUARICO,MP. S MARIA DE IPIRE,PQ. SANTA MARIA DE IPIRE,UNIDAD EDUCATIVA NACIONAL FRANCISCO DE MIRANDA,234,1,11,183,123,172,0,1,1,0,47,183
EDO. GUARICO,MP. LAS MERCEDES,PQ. LAS MERCEDES,CENTRO DE EDUCACION INICIAL LAS PALMAS,499,1,16,375,282,359,0,1,0,0,76,375
EDO. GUARICO,MP. LAS MERCEDES,PQ. LAS MERCEDES,CENTRO DE EDUCACION INICIAL LAS PERLAS
EDO. GUARICO,MP. LAS MERCEDES,PQ. LAS MERCEDES,UNIDAD EDUCATIVA NACIONAL RAFAEL PAREDES,3507,7,74,2615,1623,2541,0,17,3,0,898,2615
EDO. GUARICO,MP. LAS MERCEDES,PQ. LAS MERCEDES,UNIDAD EDUCATIVA MONSEÑOR RODRIGUEZ ALVAREZ,4035,7,101,3085,1687,2984,0,19,3,0,1275,3085
EDO. GUARICO,MP. LAS MERCEDES,PQ. LAS MERCEDES,CENTRO EDUCACION INICIAL EL AZULEJO,445,1,8,329,255,321,0,1,0,0,65,329
EDO. GUARICO,MP. LAS MERCEDES,PQ. LAS MERCEDES,UNIDAD EDUCATIVA NACIONAL PEDRO ITRIAGO CHACIN,410,1,20,318,235,298,0,1,0,0,62,318
EDO. GUARICO,MP. LAS MERCEDES,PQ. LAS MERCEDES,ESCUELA NACIONAL EL GAVILAN,146,1,6,122,96,116,0,0,0,0,20,122
EDO. GUARICO,MP. LAS MERCEDES,PQ. LAS MERCEDES,UNIDAD EDUCATIVA MIGUEL GONZALEZ CONTRERAS,2052,4,54,1548,939,1494,0,6,1,0,548,1548
EDO. GUARICO,MP. LAS MERCEDES,PQ. LAS MERCEDES,ESCUELA BOLIVARIANA MODESTO JUVENCIO MANUITT
EDO. GUARICO,MP. LAS MERCEDES,PQ. LAS MERCEDES,MUNICIPIO ESCOLAR NÚMERO 8,923,2,24,690,425,666,0,6,1,0,234,690
EDO. GUARICO,MP. LAS MERCEDES,PQ. CABRUTA,ESCUELA BASICA ANGEL MORENO,4085,8,70,3116,2404,3046,1,18,1,0,622,3116
EDO. GUARICO,MP. LAS MERCEDES,PQ. CABRUTA,UNIDAD EDUCATIVA VICENTE YANEZ PINZON,1396,3,14,1133,974,1119,2,6,1,0,136,1133
EDO. GUARICO,MP. LAS MERCEDES,PQ. CABRUTA,ESCUELA BASICA ESTADAL D 72 MEDANOS DE GOMEZ,194,1,0,79,74,79,0,0,1,0,4,79
EDO. GUARICO,MP. LAS MERCEDES,PQ. CABRUTA,ESC ESTADAL D 68 GOLFO TRISTE,170,1,3,108,89,105,0,0,1,0,15,108
EDO. GUARICO,MP. LAS MERCEDES,PQ. CABRUTA,ESCUELA BOLIVARIANA ESTADAL DC 43 TERECAY,486,1,11,381,324,370,0,1,0,0,45,381
EDO. GUARICO,MP. LAS MERCEDES,PQ. STA RITA DE MANAPIRE,UNIDAD EDUCATIVA ESTADAL BOLIVARIANA DC 7 SANTA RITA,1435,3,20,1121,910,1101,1,2,0,0,188,1121
EDO. GUARICO,MP.S JOSE DE GUARIBE,PQ. SAN JOSE DE GUARIBE,ESCUELA BASICA BOLIVARIANA GC 27 EL CINCO,375,1,7,273,189,266,0,3,0,0,74,273
EDO. GUARICO,MP.S JOSE DE GUARIBE,PQ. SAN JOSE DE GUARIBE,ESCUELA BASICA GC 19 RIO NEGRO,152,1,1,103,71,102,0,0,0,0,31,103
EDO. GUARICO,MP.S JOSE DE GUARIBE,PQ. SAN JOSE DE GUARIBE,ESCUELA BASICA MONSEÑOR CRESPO,3165,6,38,2474,1584,2436,1,21,0,0,830,2474
EDO. GUARICO,MP.S JOSE DE GUARIBE,PQ. SAN JOSE DE GUARIBE,CENTRO MOVIL,250,1,9,206,143,197,0,1,0,0,53,206
EDO. GUARICO,MP.S JOSE DE GUARIBE,PQ. SAN JOSE DE GUARIBE,UNIDAD EDUCATIVA COLEGIO SANTIAGO MARIÑO,341,1,8,297,207,289,0,0,0,0,82,297
EDO. GUARICO,MP.S JOSE DE GUARIBE,PQ. SAN JOSE DE GUARIBE,CENTRO DE EDUCACION INICIAL INAVI,1391,3,35,1155,677,1120,0,7,1,1,434,1155
EDO. GUARICO,MP.S JOSE DE GUARIBE,PQ. SAN JOSE DE GUARIBE,ESCUELA BASICA BOLIVARIANA GC 57 GUARIBITO,210,1,0,173,153,173,0,0,0,0,20,173
EDO. GUARICO,MP.S JOSE DE GUARIBE,PQ. SAN JOSE DE GUARIBE,ESCUELA TECNICA ROBINSONIANA DIEGO BAUTISTA URBANEJA,1031,2,29,846,594,817,0,2,0,0,221,846
EDO. GUARICO,MP.S JOSE DE GUARIBE,PQ. SAN JOSE DE GUARIBE,ESCUELA BÁSICA EC 25 EL CEDRO,112,1,1,98,87,97,0,0,0,0,10,98
EDO. GUARICO,MP.S JOSE DE GUARIBE,PQ. SAN JOSE DE GUARIBE,ESCUELA BASICA BOLIVARIANA GC 36 CONGOROCHO,277,1,5,227,97,222,0,2,1,0,122,227
EDO. GUARICO,MP.S JOSE DE GUARIBE,PQ. SAN JOSE DE GUARIBE,ESCUELA BOLIVARIANA GC 13 LAS LAJAS,282,1,5,217,169,212,0,1,0,0,42,217
EDO. GUARICO,MP.S JOSE DE GUARIBE,PQ. SAN JOSE DE GUARIBE,ESCUELA BASICA BOLIVARIANA GC 23 UVERAL,466,1,8,342,269,334,0,3,0,0,62,342
EDO. GUARICO,MP. MONAGAS,PQ. LEZAMA,ESCUELA BASICA GC PUNTERAL,147,1,2,122,97,120,0,1,0,0,22,122
EDO. GUARICO,MP. MONAGAS,PQ. LEZAMA,ESCUELA BASICA GC 17 LOS NEGROS,411,1,7,308,159,301,0,5,0,0,137,308
EDO. GUARICO,MP. MONAGAS,PQ. LEZAMA,ESCUELA NACIONAL GC 35 LA ESPERANZA,271,1,3,214,97,211,0,0,1,0,113,214
EDO. GUARICO,MP. MONAGAS,PQ. LEZAMA,ESCUELA BASICA CONCENTRADA GC BELLAS BRISAS,258,1,8,218,168,210,0,1,0,0,41,218
EDO. GUARICO,MP. MONAGAS,PQ. LEZAMA,UNIDAD EDUCATIVA JESUS BANDRES,2269,4,39,1694,1126,1655,1,9,1,1,517,1694
EDO. GUARICO,MP. MONAGAS,PQ. SOUBLETTE,ESCUELA UNITARIA NÚMERO 5 TUCUPIDO ARAGORT,190,1,3,144,95,141,0,0,0,0,46,144
EDO. GUARICO,MP. MONAGAS,PQ. SOUBLETTE,ESCUELA BASICA GC 45 ORUZ DE PALMARITO,416,1,3,342,253,339,0,1,0,0,85,342
EDO. GUARICO,MP. MONAGAS,PQ. SOUBLETTE,ESCUELA BASICA BOLIVARIANA GC 21 ARENITAS,438,1,10,326,234,316,0,2,0,0,80,326
EDO. GUARICO,MP. MONAGAS,PQ. SOUBLETTE,UNIDAD EDUCATIVA NACIONAL BOLIVARIANA DOCTOR PEDRO MARÍA ARÉVALO,1130,2,5,834,550,829,1,4,0,0,274,834
EDO. GUARICO,MP. MONAGAS,PQ. SAN FCO DE MACAIRA,GRUPO ESCOLAR MACAIRA,1513,3,15,1128,865,1113,0,3,2,0,243,1128
EDO. GUARICO,MP. MONAGAS,PQ. SAN FCO DE MACAIRA,ESCUELA MIXTA 196 JABILLAL DE MACAIRA,561,1,6,398,324,392,0,0,0,0,68,398
EDO. GUARICO,MP. MONAGAS,PQ. ALTAGRACIA DE ORITUCO,ESCUELA BASICA RUBEN HURTADO RODRIGUEZ,2029,4,51,1581,1170,1530,1,10,2,0,347,1581
EDO. GUARICO,MP. MONAGAS,PQ. ALTAGRACIA DE ORITUCO,ESCUELA BASICA ANDRES BELLO,678,2,15,587,487,572,0,7,0,0,78,587
EDO. GUARICO,MP. MONAGAS,PQ. ALTAGRACIA DE ORITUCO,UNIDAD EDUCATIVA LICEO DOCTOR RAMON BUENAHORA,1369,3,31,1155,616,1124,0,2,0,1,505,1155
EDO. GUARICO,MP. MONAGAS,PQ. ALTAGRACIA DE ORITUCO,ESCUELA BASICA JOSE RAMON CAMEJO,3086,6,46,2401,1259,2355,1,23,3,0,1069,2401
EDO. GUARICO,MP. MONAGAS,PQ. ALTAGRACIA DE ORITUCO,ESCUELA BASICA BOLIVARIANA GC 54 BOTALON,559,1,5,451,382,446,0,0,0,0,64,451
EDO. GUARICO,MP. MONAGAS,PQ. ALTAGRACIA DE ORITUCO,UNIDA EDUCATIVA SAN PABLO APOSTOL,125,1,2,115,60,113,0,0,0,0,53,115
EDO. GUARICO,MP. MONAGAS,PQ. ALTAGRACIA DE ORITUCO,UNIDAD EDUCATIVA COLEGIO MADRE CANDELARIA,201,1,4,182,106,178,0,2,0,0,70,182
EDO. GUARICO,MP. MONAGAS,PQ. ALTAGRACIA DE ORITUCO,UNIDAD EDUCATIVA COLEGIO BATALLA DE LA VICTORIA,57,1,2,45,22,43,0,0,0,0,21,45
EDO. GUARICO,MP. MONAGAS,PQ. ALTAGRACIA DE ORITUCO,ESCUELA BASICA ALTAGRACIA,1035,2,9,864,560,855,0,6,1,0,288,864
EDO. GUARICO,MP. MONAGAS,PQ. ALTAGRACIA DE ORITUCO,UNIDAD EDUCATIVA COLEGIO LIBERTADOR,126,1,5,106,46,101,0,0,0,0,55,106
EDO. GUARICO,MP. MONAGAS,PQ. ALTAGRACIA DE ORITUCO,CENTRO MOVIL,418,1,7,365,218,358,0,3,0,0,137,365
EDO. GUARICO,MP. MONAGAS,PQ. ALTAGRACIA DE ORITUCO,ESCUELA BASICA ROMULO GALLEGOS,1528,3,38,1132,899,1094,2,6,1,0,186,1132
EDO. GUARICO,MP. MONAGAS,PQ. ALTAGRACIA DE ORITUCO,CENTRO DE SERVICIO SOCIAL MADRE CANDELARIA,1370,3,29,1131,835,1102,0,8,1,1,257,1131
EDO. GUARICO,MP. MONAGAS,PQ. ALTAGRACIA DE ORITUCO,ESCUELA PRE VOCACIONAL CAP MONSEÑOR SIXTO SOSA,324,1,4,247,153,243,0,1,0,0,89,247
EDO. GUARICO,MP. MONAGAS,PQ. ALTAGRACIA DE ORITUCO,ESCUELA BASICA LA CUMANA,381,1,8,353,216,345,0,1,0,0,128,353
EDO. GUARICO,MP. MONAGAS,PQ. ALTAGRACIA DE ORITUCO,ESCUELA ESTADAL GC 3 TAGUAPIRE,474,1,13,360,268,347,0,4,0,0,75,360
EDO. GUARICO,MP. MONAGAS,PQ. ALTAGRACIA DE ORITUCO,INSTITUTO NACIONAL DE CAPACITACION Y EDUCACION SOCIALISTA,308,1,5,263,215,258,0,1,1,0,41,263
EDO. GUARICO,MP. MONAGAS,PQ. ALTAGRACIA DE ORITUCO,ESCUELA BASICA BOLIVARIANA GC 01 OROCOLLAL,952,2,17,678,593,661,2,1,2,0,63,678
EDO. GUARICO,MP. MONAGAS,PQ. ALTAGRACIA DE ORITUCO,ESCUELA BASICA SIMON RODRIGUEZ,378,1,5,332,302,327,0,1,0,0,24,332
EDO. GUARICO,MP. MONAGAS,PQ. ALTAGRACIA DE ORITUCO,UNIDAD EDUCATIVA COLEGIO GENERALISIMO FRANCISCO DE MIRANDA,52,1,2,43,27,41,0,0,0,0,14,43
EDO. GUARICO,MP. MONAGAS,PQ. ALTAGRACIA DE ORITUCO,ESCUELA BASICA DR. JOSE FRANCISCO TORREALBA,2318,4,27,1838,1066,1811,0,7,1,0,737,1838
EDO. GUARICO,MP. MONAGAS,PQ. ALTAGRACIA DE ORITUCO,ESCUELA DE ARTES Y OFICIOS HIGINIO MORALES,1392,3,24,1203,697,1179,1,4,0,3,474,1203
EDO. GUARICO,MP. MONAGAS,PQ. ALTAGRACIA DE ORITUCO,ESCUELA BASICA ABELARDO MENDEZ,3442,6,52,2832,1513,2780,0,16,2,1,1248,2832
EDO. GUARICO,MP. MONAGAS,PQ. ALTAGRACIA DE ORITUCO,ESCUELA BASICA LOS GUAIQUERIES,2850,5,42,2264,1729,2222,0,14,2,0,477,2264
EDO. GUARICO,MP. MONAGAS,PQ. ALTAGRACIA DE ORITUCO,ESCUELA BASICA BOLIVARIANA ORITUCO,2331,4,48,1937,1267,1889,1,11,0,0,610,1937
EDO. GUARICO,MP. MONAGAS,PQ. ALTAGRACIA DE ORITUCO,JARDIN DE INFANCIA SIMON BOLIVAR,255,1,1,239,131,238,0,6,0,0,101,239
EDO. GUARICO,MP. MONAGAS,PQ. ALTAGRACIA DE ORITUCO,ESCUELA BASICA PROSPERO INFANTE,2770,5,48,2237,1679,2189,0,17,2,3,488,2237
EDO. GUARICO,MP. MONAGAS,PQ. ALTAGRACIA DE ORITUCO,ESCUELA BASICA JOSE TADEO MONAGAS,2687,5,48,2223,1695,2175,0,10,3,1,466,2223
EDO. GUARICO,MP. MONAGAS,PQ. ALTAGRACIA DE ORITUCO,UNIDAD EDUCATIVA COLEGIO NUESTRA SEÑORA DE ALTAGRACIA,438,1,2,387,133,385,0,2,0,0,250,387
EDO. GUARICO,MP. MONAGAS,PQ. ALTAGRACIA DE ORITUCO,UNIDAD EDUCATIVA JUAN BARNUEVO,1705,3,31,1427,560,1396,0,10,0,1,825,1427
EDO. GUARICO,MP. MONAGAS,PQ. ALTAGRACIA DE ORITUCO,ESCUELA BASICA BOLIVARIANA GC 1525 JULIO ORTIZ,248,1,2,232,188,230,0,1,0,0,41,232
EDO. GUARICO,MP. MONAGAS,PQ. LIBERTAD DE ORITUCO,CONCENTRACION ESCOLAR G 42 SAMANITO,185,1,6,134,90,128,0,1,0,0,37,134
EDO. GUARICO,MP. MONAGAS,PQ. LIBERTAD DE ORITUCO,ESCUELA ESTADAL GC 34 LIBERTAD,485,1,5,357,285,352,0,0,0,0,67,357
EDO. GUARICO,MP. MONAGAS,PQ. SAN RAFAEL DE ORITUCO,CONCENTRACION ESCOLAR GC 8 TUIRA PILONCITO,320,1,11,255,229,244,0,0,0,0,15,255
EDO. GUARICO,MP. MONAGAS,PQ. SAN RAFAEL DE ORITUCO,GRUPO ESCOLAR LUISA ROJAS DE GONZALEZ,2340,4,50,1858,1213,1808,0,10,0,1,584,1858
EDO. GUARICO,MP. MONAGAS,PQ. SAN RAFAEL DE ORITUCO,UNIDAD EDUCATIVA BOLIVARIANA EZEQUIEL ZAMORA,633,2,15,563,444,548,0,1,0,0,103,563
EDO. GUARICO,MP. MONAGAS,PQ. PASO REAL DE MACAIRA,ESCUELA DOCTOR BENITO GUTIERREZ LOPEZ,2074,4,24,1583,981,1559,0,9,3,0,566,1583
EDO. GUARICO,MP. MONAGAS,PQ. PASO REAL DE MACAIRA,ESCUELA ESTADAL CONCENTRADA GC 22 SAN ANTONIO DE TAMANACO,670,2,12,494,420,482,1,3,0,0,58,494
EDO. GUARICO,MP. MONAGAS,PQ. PASO REAL DE MACAIRA,UNIDAD EDUCATIVA NACIONAL PATRIA NUEVA,550,1,12,440,342,428,0,3,0,0,83,440
EDO. GUARICO,MP. RIBAS,PQ. TUCUPIDO,ESCUELA ESTADAL UNITARIA EL DOS,130,1,1,119,88,118,0,1,0,0,29,119
EDO. GUARICO,MP. RIBAS,PQ. TUCUPIDO,ESCUELA BOLIVARIANA EC 21 CUJI NEGRO,570,1,4,511,409,507,0,3,0,1,94,511
EDO. GUARICO,MP. RIBAS,PQ. TUCUPIDO,ESCUELA BASICA EC 45 LEONES DE FAJARDO,333,1,4,250,150,246,0,2,0,1,93,250
EDO. GUARICO,MP. RIBAS,PQ. TUCUPIDO,ESCUELA BASICA ARTURO ALVAREZ ALAYON,1406,3,23,1159,713,1136,0,11,1,2,409,1159
EDO. GUARICO,MP. RIBAS,PQ. TUCUPIDO,CENTRO DE EDUCACION INICIAL LOMAS DEL PARAISO,132,1,1,108,88,107,0,0,0,0,19,108
EDO. GUARICO,MP. RIBAS,PQ. TUCUPIDO,PRE ESCOLAR BOLIVARIANO NARCISO LOPEZ CAMACHO,394,1,6,333,188,327,0,0,1,0,138,333
EDO. GUARICO,MP. RIBAS,PQ. TUCUPIDO,ESCUELA DE ESPECIALIDADES VICTORIO CABEZA,546,1,5,461,207,456,0,1,0,0,248,461
EDO. GUARICO,MP. RIBAS,PQ. TUCUPIDO,ESCUELA PRIMARIA BOLIVARIANA EC 24 LA CABRERA,282,1,4,252,190,248,0,0,0,0,58,252
EDO. GUARICO,MP. RIBAS,PQ. TUCUPIDO,ESCUELA BOLIVARIANA SAN VICENTE,407,1,1,299,241,298,0,0,0,0,57,299
EDO. GUARICO,MP. RIBAS,PQ. TUCUPIDO,ESCUELA BASICA NACIONAL BOLIVARIANA ARENITA,305,1,1,221,149,220,0,0,2,0,69,221
EDO. GUARICO,MP. RIBAS,PQ. TUCUPIDO,UNIVERSIDAD NACIONAL EXPERIMENTAL DE LA FUERZA ARMADA   UNEFA,188,1,3,163,82,160,0,0,0,0,78,163
EDO. GUARICO,MP. RIBAS,PQ. TUCUPIDO,ESCUELA BASICA NARCISO LOPEZ CAMACHO,2850,5,46,2190,1055,2144,1,17,1,0,1070,2190
EDO. GUARICO,MP. RIBAS,PQ. TUCUPIDO,UNIDAD EDUCATIVA ESTADAL CONCENTRADA BOLIVARIANA DC 40 SOLEDAD Y BONANZA,162,1,1,156,120,155,0,5,0,0,30,156
EDO. GUARICO,MP. RIBAS,PQ. TUCUPIDO,ESCUELA BOLIVARIANA EC 7 EL JOBO,433,1,1,307,219,306,0,0,0,0,87,307
EDO. GUARICO,MP. RIBAS,PQ. TUCUPIDO,UNIDAD EDUCATIVA DC 23 SAN JOSE DE PUÑO DE ORO,349,1,2,275,208,273,1,1,1,0,62,275
EDO. GUARICO,MP. RIBAS,PQ. TUCUPIDO,CASA DEL PODER POPULAR,160,1,4,140,82,136,0,0,0,0,54,140
EDO. GUARICO,MP. RIBAS,PQ. TUCUPIDO,CENTRO DE EDUCACION INICIAL ROSA ELVIRA AQUINO,189,1,0,170,134,170,0,1,0,0,35,170
EDO. GUARICO,MP. RIBAS,PQ. TUCUPIDO,ESCUELA BASICA CAMPO ALEGRE,171,1,0,163,133,163,0,1,0,0,29,163
EDO. GUARICO,MP. RIBAS,PQ. TUCUPIDO,ESCUELA ESTADAL UNITARIA E 25 CERRO GRANDE,586,1,11,424,271,413,0,1,1,0,140,424
EDO. GUARICO,MP. RIBAS,PQ. TUCUPIDO,CASA DE LA CULTURA RAFAEL RENGIFO,472,1,9,412,236,403,0,3,0,0,164,412
EDO. GUARICO,MP. RIBAS,PQ. TUCUPIDO,ESCUELA NUCLEO ESCOLAR RURAL 498 LAS PALMAS,224,1,6,144,101,138,0,0,0,0,37,144
EDO. GUARICO,MP. RIBAS,PQ. TUCUPIDO,ESCUELA BOLIVARIANA EC 17 CAMACHO,550,1,6,372,205,366,0,1,0,0,160,372
EDO. GUARICO,MP. RIBAS,PQ. TUCUPIDO,UNIDAD EDUCATIVA BOLIVARIANA PEDRO DEL CORRAL,1087,2,13,907,520,894,0,6,0,0,368,907
EDO. GUARICO,MP. RIBAS,PQ. TUCUPIDO,CENTRO DE EDUCACION INICIAL ONDINA BALZA BENITEZ,211,1,4,189,146,185,0,4,0,0,35,189
EDO. GUARICO,MP. RIBAS,PQ. TUCUPIDO,ESCUELA NACIONAL BOLIVARIANA BELLA VISTA,977,2,19,770,557,751,0,2,0,0,192,770
EDO. GUARICO,MP. RIBAS,PQ. TUCUPIDO,GRUPO ESCOLAR FELIX ANTONIO SAA,2914,5,41,2198,1134,2157,2,17,4,0,1000,2198
EDO. GUARICO,MP. RIBAS,PQ. TUCUPIDO,CENTRO DE EDUCACION INICIAL EL ARRENDAJO,350,1,0,314,246,314,0,2,1,0,65,314
EDO. GUARICO,MP. RIBAS,PQ. TUCUPIDO,LICEO BOLIVARIANO VICTOR MANUEL OVALLES,2307,4,55,1830,789,1775,0,8,1,2,975,1830
EDO. GUARICO,MP. RIBAS,PQ. TUCUPIDO,UNIDAD EDUCATIVA NACIONAL JOSE CALIXTO MORIN,790,2,7,652,406,645,0,2,0,0,237,652
EDO. GUARICO,MP. RIBAS,PQ. TUCUPIDO,ESCUELA BOLIVARIANA MUERTO ZORRO,207,1,3,156,118,153,0,1,0,0,34,156
EDO. GUARICO,MP. RIBAS,PQ. TUCUPIDO,SIMONCITO JOSE FELIX RIBAS,829,2,13,698,474,685,0,6,0,1,204,698
EDO. GUARICO,MP. RIBAS,PQ. TUCUPIDO,ESCUELA BASICA SAN GERONIMO,140,1,0,128,80,128,0,0,0,0,48,128
EDO. GUARICO,MP. RIBAS,PQ. TUCUPIDO,ESCUELA E 12 CHAPARRAL,303,1,5,215,168,210,0,1,0,0,41,215
EDO. GUARICO,MP. RIBAS,PQ. TUCUPIDO,ESCUELA BASICA UNITARIA E 20 PARATE BUENO,223,1,4,165,136,161,0,2,0,0,23,165
EDO. GUARICO,MP. RIBAS,PQ. TUCUPIDO,ESCUELA ESTADAL ROBLECITO,275,1,4,209,151,205,0,0,1,0,53,209
EDO. GUARICO,MP. RIBAS,PQ. TUCUPIDO,UNIDAD EDUCATIVA BOLIVARIANA NACIONAL CARO DE LA NEGRA,1700,3,10,1250,883,1240,1,1,1,0,354,1250
EDO. GUARICO,MP. RIBAS,PQ. TUCUPIDO,EC 2 PAN DE AZUCAR,175,1,5,155,125,150,0,1,0,0,24,155
EDO. GUARICO,MP. RIBAS,PQ. TUCUPIDO,ESCUELA BOLIVARIANA LUIS GUGLIETA RAMOS,1569,3,30,1287,739,1257,0,7,0,1,510,1287
EDO. GUARICO,MP. RIBAS,PQ. SAN RAFAEL DE LAYA,JUNTA PARROQUIAL SAN RAFAEL DE LAYA,384,1,2,277,219,275,0,0,0,0,56,277
EDO. GUARICO,MP. RIBAS,PQ. SAN RAFAEL DE LAYA,ESCUELA TECNICA JOSE ANTONIO HURTADO ASCANIO,1901,4,23,1438,1034,1415,1,3,0,0,377,1438
EDO. GUARICO,MP. RIBAS,PQ. SAN RAFAEL DE LAYA,ESCUELA ESTADAL EC 22 LA ESTRELLA,268,1,5,191,99,186,0,1,0,0,86,191
