Estado,Municipio,Parroquia,Centro,Número de Electores escrutados.,Número de Actas Procesadas.,Número total de Votos Nulos.,Número Total de Votantes que votaron realmente.,HUGO CHAVEZ,Número total de Votos Válidos.,ORLANDO CHIRINO,REINA SEQUERA,LUIS REYES,MARIA BOLIVAR,HENRIQUE CAPRILES RADONSKI,Número de Votos Escrutados.
EDO. PORTUGUESA,MP. GUANARITO,PQ. DIVINA PASTORA,ESCUELA CONCENTRADA MIXTA NUMERO 133,559,1,26,440,290,414,0,2,0,0,122,440
EDO. PORTUGUESA,MP. GUANARITO,PQ. DIVINA PASTORA,ESCUELA CONCENTRADA NUMERO 5,185,1,1,149,116,148,0,0,0,0,32,149
EDO. PORTUGUESA,MP. GUANARITO,PQ. DIVINA PASTORA,ESCUELA ESTADAL CONCENTRADA NUMERO 108,514,1,24,407,243,383,0,5,0,0,135,407
EDO. PORTUGUESA,MP. GUANARITO,PQ. DIVINA PASTORA,ESCUELA CONCENTRADA NACIONAL MIXTA Y ANEXA ESTADAL NUMERO 132,852,2,23,699,498,676,0,4,0,0,174,699
EDO. PORTUGUESA,MP. GUANARITO,PQ. DIVINA PASTORA,ESCUELA CONCENTRADA NUMERO 109,376,1,2,307,237,305,0,1,0,0,67,307
EDO. PORTUGUESA,MP. GUANARITO,PQ. DIVINA PASTORA,UNIDAD ESTADAL CONCENTRADA NUMERO 537,175,1,7,158,107,151,0,0,1,0,43,158
EDO. PORTUGUESA,MP. GUANARITO,PQ. DIVINA PASTORA,ESCUELA BASICA ESTADAL UNITARIA SIN NUMERO NER 166,100,1,3,87,60,84,0,3,0,0,21,87
EDO. PORTUGUESA,MP. GUANARITO,PQ. DIVINA PASTORA,ESCUELA ESTADAL CONCENTRADA NUMERO 121,319,1,11,264,200,253,0,5,0,0,48,264
EDO. PORTUGUESA,MP. GUANARITO,PQ. DIVINA PASTORA,ESCUELA NACIONAL CONCENTRADA LA CEBEREÑA,520,1,10,430,278,420,2,5,0,0,135,430
EDO. PORTUGUESA,MP. GUANARITO,PQ. DIVINA PASTORA,ESCUELA ESTADAL UNITARIA NUMERO 51
EDO. PORTUGUESA,MP. GUANARITO,CM. GUANARITO,ESCUELA ESTADAL UNITARIA NUMERO 129,775,2,8,654,304,646,0,0,0,0,342,654
EDO. PORTUGUESA,MP. GUANARITO,CM. GUANARITO,ESCUELA ESTADAL CONCENTRADA LA HOYADA NUMERO 107,764,2,10,586,493,576,0,1,3,0,79,586
EDO. PORTUGUESA,MP. GUANARITO,CM. GUANARITO,ESCUELA BASICA UNITARIA 536 COROZAL,585,1,6,484,246,478,0,1,0,0,231,484
EDO. PORTUGUESA,MP. GUANARITO,CM. GUANARITO,ESCUELA BASICA PORTUGUESA,2674,5,38,2207,1612,2169,2,11,4,1,539,2207
EDO. PORTUGUESA,MP. GUANARITO,CM. GUANARITO,ESCUELA ESTADAL UNITARIA NUMERO 131,268,1,0,148,136,148,1,0,0,0,11,148
EDO. PORTUGUESA,MP. GUANARITO,CM. GUANARITO,ESCUELA ESTADAL UNITARIA NUMERO 12,362,1,5,277,234,272,0,0,1,0,37,277
EDO. PORTUGUESA,MP. GUANARITO,CM. GUANARITO,ESCUELA ESTADAL CONCENTRADA NUMERO 134,110,1,2,92,71,90,0,0,0,0,19,92
EDO. PORTUGUESA,MP. GUANARITO,CM. GUANARITO,ESCUELA ESTADAL UNITARIA NUMERO 126,232,1,5,177,103,172,0,1,0,0,68,177
EDO. PORTUGUESA,MP. GUANARITO,CM. GUANARITO,ESCUELA ESTADAL UNITARIA NUMERO 125,343,1,4,284,223,280,0,5,0,0,52,284
EDO. PORTUGUESA,MP. GUANARITO,CM. GUANARITO,ESCUELA BASICA UNITARIA NUMERO 117,491,1,11,433,301,422,1,1,2,0,117,433
EDO. PORTUGUESA,MP. GUANARITO,CM. GUANARITO,ESCUELA MUNICIPAL GUANARITO,3105,6,68,2592,1705,2524,0,6,2,0,811,2592
EDO. PORTUGUESA,MP. GUANARITO,CM. GUANARITO,ESCUELA BASICA FRAY ANDRES GRAZALEMA,1462,3,58,1254,784,1196,1,5,3,0,403,1254
EDO. PORTUGUESA,MP. GUANARITO,CM. GUANARITO,ESCUELA BASICA MONSEÑOR UNDA,2895,6,50,2285,1333,2235,0,10,5,0,887,2285
EDO. PORTUGUESA,MP. GUANARITO,CM. GUANARITO,ESCC.BOLIVARIANA SIMON RODRIGUEZ,450,1,13,388,320,375,0,4,0,0,51,388
EDO. PORTUGUESA,MP. GUANARITO,CM. GUANARITO,ESCUELA BASICA UNITARIA NUMERO 512,392,1,3,329,292,326,0,3,1,0,30,329
EDO. PORTUGUESA,MP. GUANARITO,CM. GUANARITO,ESCUELA ESTADAL CONCENTRADA 124,447,1,8,346,209,338,0,0,0,0,129,346
EDO. PORTUGUESA,MP. GUANARITO,CM. GUANARITO,CICLO COMBINADO ARTURO CELESTINO ALVAREZ,2432,5,55,1951,1259,1896,1,4,5,0,627,1951
EDO. PORTUGUESA,MP. GUANARITO,CM. GUANARITO,PARQUE DE RECREACION DIRIGIDA CONSEJO VENEZOLANO DEL NIÑO,1347,3,26,1051,649,1025,0,4,3,0,369,1051
EDO. PORTUGUESA,MP. GUANARITO,PQ.TRINIDAD DE LA CAPILLA,ESCUELA ESTADAL BASICA NUMERO 110,736,2,10,554,432,544,1,1,3,1,106,554
EDO. PORTUGUESA,MP. GUANARITO,PQ.TRINIDAD DE LA CAPILLA,ESCUELA ESTADAL BASICA UNITARIA NUMERO 122,296,1,2,208,186,206,0,0,0,0,20,208
EDO. PORTUGUESA,MP. GUANARITO,PQ.TRINIDAD DE LA CAPILLA,ESCUELA ESTADAL CONCENTRADA NUMERO 112,504,1,5,368,315,363,0,1,1,1,45,368
EDO. PORTUGUESA,MP. GUANARITO,PQ.TRINIDAD DE LA CAPILLA,ESCUELA ESTADAL CONCENTRADA NUMERO 113
EDO. PORTUGUESA,MP. GUANARITO,PQ.TRINIDAD DE LA CAPILLA,E.B.E. CONCENTRADA N° 111 LA ARENOSA NER 7,181,1,5,157,142,152,0,1,0,0,9,157
EDO. PORTUGUESA,MP. GUANARITO,PQ.TRINIDAD DE LA CAPILLA,ESCUELA ESTADAL CONCENTRADA NUMERO 204
EDO. PORTUGUESA,MP. GUANARITO,PQ.TRINIDAD DE LA CAPILLA,ESCUELA ESTADAL CONCENTRADA NUMERO 36,196,1,1,164,154,163,0,1,0,0,8,164
EDO. PORTUGUESA,MP. OSPINO,PQ. APARICION,ESCUELA ESTADAL EL TIGRE NUMERO 156,109,1,2,106,104,104,0,0,0,0,0,106
EDO. PORTUGUESA,MP. OSPINO,PQ. APARICION,ESCUELA CONCENTRADA NACIONAL SIN NUMERO,518,1,2,332,287,330,1,4,2,1,35,332
EDO. PORTUGUESA,MP. OSPINO,PQ. APARICION,ESCUELA ESTADAL UNITARIA NUMERO 328,607,2,9,488,331,479,0,2,0,0,146,488
EDO. PORTUGUESA,MP. OSPINO,PQ. APARICION,ESCUELA ESTADAL SIN NUMERO BELLA TOVAR,129,1,3,119,77,116,0,1,0,0,38,119
EDO. PORTUGUESA,MP. OSPINO,PQ. APARICION,ESCUELA MAMARIA,324,1,11,283,247,272,0,0,0,0,25,283
EDO. PORTUGUESA,MP. OSPINO,PQ. APARICION,ESCUELA GRADUADA LA CORTEZA,1897,4,37,1509,1087,1472,1,15,4,0,365,1509
EDO. PORTUGUESA,MP. OSPINO,PQ. APARICION,ESCUELA BOLIVARIANA FRAY FELIPE DE PALMA,378,1,5,332,266,327,0,0,0,0,61,332
EDO. PORTUGUESA,MP. OSPINO,PQ. APARICION,ESCUELA BOLIVARIANA PARAPARITO,264,1,3,210,198,207,0,1,0,0,8,210
EDO. PORTUGUESA,MP. OSPINO,PQ. APARICION,UNIDAD EDUCATIVA NACIONAL LA CORTEZA,1042,2,15,875,645,860,0,4,0,0,211,875
EDO. PORTUGUESA,MP. OSPINO,PQ. APARICION,ESCUELA ESTADAL NUMERO 482 NUCLEO 09.,327,1,1,241,232,240,0,0,0,0,8,241
EDO. PORTUGUESA,MP. OSPINO,PQ. APARICION,ESCUELA CONCENTRADA TIPO NUMERO 327,614,2,18,517,407,499,0,2,0,0,90,517
EDO. PORTUGUESA,MP. OSPINO,PQ. APARICION,ESCUELA BASICA CONCENTRADA SIN NUMERO,215,1,6,167,126,161,0,0,0,0,35,167
EDO. PORTUGUESA,MP. OSPINO,CM. OSPINO,UNIDAD EDUCATIVA GABRIEL PEREZ DE PAGOLA,1168,2,15,996,474,981,0,7,0,0,500,996
EDO. PORTUGUESA,MP. OSPINO,CM. OSPINO,ESCUELA TECNICA AGROPECUARIA OSPINO,1214,3,19,934,444,915,2,7,0,0,462,934
EDO. PORTUGUESA,MP. OSPINO,CM. OSPINO,ESCUELA CONCENTRADA EL JOBAL NUMERO 333,199,1,2,159,139,157,0,1,0,0,17,159
EDO. PORTUGUESA,MP. OSPINO,CM. OSPINO,ESCUELA UNITARIA NUMERO 339,103,1,0,96,96,96,0,0,0,0,0,96
EDO. PORTUGUESA,MP. OSPINO,CM. OSPINO,ESCUELA CONCENTRADA NUMERO 485,622,2,7,528,374,521,0,1,0,0,146,528
EDO. PORTUGUESA,MP. OSPINO,CM. OSPINO,ESCUELA CONCENTRADA NUMERO 483,338,1,1,257,211,256,0,3,0,1,41,257
EDO. PORTUGUESA,MP. OSPINO,CM. OSPINO,CENTRO DE EDUCACION INICIAL NEGRA HIPOLITA,209,1,5,191,167,186,0,0,0,0,19,191
EDO. PORTUGUESA,MP. OSPINO,CM. OSPINO,ESCUELA UNITARIA LAS QUESERAS NUMERO 341,140,1,2,128,69,126,0,0,0,0,57,128
EDO. PORTUGUESA,MP. OSPINO,CM. OSPINO,ESCUELA ESTADAL CONCENTRADA MIXTA NUMERO 330,512,1,2,425,361,423,2,2,0,0,58,425
EDO. PORTUGUESA,MP. OSPINO,CM. OSPINO,ESCUELA BASICA BATALLA DE OSPINO,976,2,21,827,599,806,0,6,0,0,201,827
EDO. PORTUGUESA,MP. OSPINO,CM. OSPINO,ESCUELA ESTADAL UNITARIA NUMERO 148,77,1,1,69,60,68,0,1,0,0,7,69
EDO. PORTUGUESA,MP. OSPINO,CM. OSPINO,ESCUELA ESTADAL CONCENTRADA NUMERO 152,859,2,13,668,494,655,0,3,0,0,158,668
EDO. PORTUGUESA,MP. OSPINO,CM. OSPINO,ESCUELA ESPECIAL CONCENTRADA NUMERO 153,304,1,7,209,144,202,0,1,2,0,55,209
EDO. PORTUGUESA,MP. OSPINO,CM. OSPINO,ESCUELA NACIONAL GRADUADA OSPINO,1393,3,38,1107,827,1069,0,12,3,0,227,1107
EDO. PORTUGUESA,MP. OSPINO,CM. OSPINO,ESCUELA GRADUADA BARRIO ARRIBA,1795,3,16,1485,995,1469,1,7,1,1,464,1485
EDO. PORTUGUESA,MP. OSPINO,CM. OSPINO,ESCUELA ESTADAL UNITARIA SIN NUMERO,272,1,4,220,167,216,0,3,1,0,45,220
EDO. PORTUGUESA,MP. OSPINO,CM. OSPINO,ESCUELA CONCENTRADA MIXTA NUMERO 334,357,1,8,274,238,266,0,2,0,0,26,274
EDO. PORTUGUESA,MP. OSPINO,CM. OSPINO,ESCUELA BASICA NACIONAL CIUDAD TRUJILLO,1522,3,26,1233,540,1207,0,10,0,1,656,1233
EDO. PORTUGUESA,MP. OSPINO,CM. OSPINO,ESCUELA ESTADAL CONCENTRADA NUMERO 331,493,1,6,412,339,406,0,6,0,0,61,412
EDO. PORTUGUESA,MP. OSPINO,CM. OSPINO,ESCUELA ESTADAL CONCENTRADA NUMERO 332,413,1,5,330,285,325,0,1,0,0,39,330
EDO. PORTUGUESA,MP. OSPINO,CM. OSPINO,ESCUELA NERIA DE QUINTERO,2235,4,48,1791,1247,1743,1,12,1,0,482,1791
EDO. PORTUGUESA,MP. OSPINO,CM. OSPINO,ESCUELA UNITARIA 488,138,1,0,130,127,130,0,0,0,0,3,130
EDO. PORTUGUESA,MP. OSPINO,CM. OSPINO,ESCUELA ESTADAL NUMERO 369,408,1,5,316,227,311,0,8,0,1,75,316
EDO. PORTUGUESA,MP. OSPINO,CM. OSPINO,ESCUELA ESTADAL CONCENTRADA NUMERO 157 LIBERTADOR,1127,2,37,892,733,855,0,6,2,1,113,892
EDO. PORTUGUESA,MP. OSPINO,CM. OSPINO,ESCUELA PRIMARIA OSPINO REAL,230,1,5,209,142,204,0,1,0,0,61,209
EDO. PORTUGUESA,MP. OSPINO,CM. OSPINO,ESCUELA ESTADAL UNITARIA NUMERO 340 MATAPELADA,210,1,4,157,111,153,0,1,1,0,40,157
EDO. PORTUGUESA,MP. OSPINO,CM. OSPINO,ESCUELA BASICA DANIEL CAMEJO ACOSTA,931,2,23,806,490,783,0,3,2,0,288,806
EDO. PORTUGUESA,MP. OSPINO,PQ. LA ESTACION,ESCUELA CONCENTRADA MIXTA 351,358,1,6,216,166,210,0,0,2,0,42,216
EDO. PORTUGUESA,MP. OSPINO,PQ. LA ESTACION,ESCUELA ESTADAL UNITARIA NUMERO 329,165,1,6,122,95,116,0,0,0,0,21,122
EDO. PORTUGUESA,MP. OSPINO,PQ. LA ESTACION,ESCUELA BOLIVARIANA JOBILLAL,57,1,1,41,39,40,1,0,0,0,0,41
EDO. PORTUGUESA,MP. OSPINO,PQ. LA ESTACION,ESCUELA ESTADAL CONCENTRADA NUMERO 361,528,1,8,376,307,368,0,5,1,0,55,376
EDO. PORTUGUESA,MP. OSPINO,PQ. LA ESTACION,ESCUELA ESTADAL UNITARIA NUMERO 344,392,1,3,242,179,239,0,2,1,0,57,242
EDO. PORTUGUESA,MP. OSPINO,PQ. LA ESTACION,ESCUELA ESTADAL CONCENTRADA NUMERO 323,814,2,21,513,433,492,0,2,0,0,57,513
EDO. PORTUGUESA,MP. OSPINO,PQ. LA ESTACION,ESCUELA ESTADAL UNITARIA NUMERO 349,109,1,1,94,80,93,0,1,1,0,11,94
EDO. PORTUGUESA,MP. OSPINO,PQ. LA ESTACION,ESCUELA ESTADAL CONCENTRADA NUMERO 324,256,1,4,202,183,198,0,1,0,0,14,202
EDO. PORTUGUESA,MP. OSPINO,PQ. LA ESTACION,ESCUELA ESTADAL CONCENTRADA NUMERO 359,493,1,6,352,309,346,1,4,0,0,32,352
EDO. PORTUGUESA,MP. OSPINO,PQ. LA ESTACION,ESCUELA ESTADAL CONCENTRADA NUMERO 93,74,1,0,57,54,57,0,0,0,0,3,57
EDO. PORTUGUESA,MP. OSPINO,PQ. LA ESTACION,ESCUELA ESTADAL NUMERO 355,186,1,3,158,141,155,0,1,0,0,13,158
EDO. PORTUGUESA,MP. OSPINO,PQ. LA ESTACION,ESCUELA ESTADAL CONCENTRADA NUMERO 353,108,1,3,71,57,68,0,3,0,0,8,71
EDO. PORTUGUESA,MP. OSPINO,PQ. LA ESTACION,ESCUELA CONCENTRADA NUMERO 345,174,1,4,134,96,130,0,1,0,0,33,134
EDO. PORTUGUESA,MP. OSPINO,PQ. LA ESTACION,ESCUELA CONCENTRADA NUMERO 346,52,1,0,41,41,41,0,0,0,0,0,41
EDO. PORTUGUESA,MP. OSPINO,PQ. LA ESTACION,ESCUELA BOLIVARIANA EL RODEO,148,1,6,124,76,118,0,1,0,0,41,124
EDO. PORTUGUESA,MP. OSPINO,PQ. LA ESTACION,ESCUELA ESTADAL UNITARIA NUMERO 146,117,1,3,62,46,59,0,0,0,0,13,62
EDO. PORTUGUESA,MP. OSPINO,PQ. LA ESTACION,ESCUELA ESTADAL UNITARIA SIN NUMERO,63,1,1,50,44,49,0,0,1,0,4,50
EDO. PORTUGUESA,MP. OSPINO,PQ. LA ESTACION,ESCUELA ESTADAL UNITARIA NUMERO 354,81,1,0,68,57,68,0,3,0,0,8,68
EDO. PORTUGUESA,MP. OSPINO,PQ. LA ESTACION,ESCUELA ESTADAL UNITARIA NUMERO 358,169,1,1,121,118,120,0,0,0,0,2,121
EDO. PORTUGUESA,MP. OSPINO,PQ. LA ESTACION,ESCUELA CONCENTRADA MIXTA SIN NUMERO,338,1,4,261,245,257,0,2,0,0,10,261
EDO. PORTUGUESA,MP. OSPINO,PQ. LA ESTACION,ESCUELA ESTADAL CONCENTRADA NUMERO 348,132,1,3,113,101,110,0,1,0,0,8,113
EDO. PORTUGUESA,MP. OSPINO,PQ. LA ESTACION,ESCUELA ESTADAL CONCENTRADA NUMERO 84,130,1,2,98,89,96,0,1,0,0,6,98
EDO. PORTUGUESA,MP. OSPINO,PQ. LA ESTACION,ESCUELA ESTADAL NUMERO 343,424,1,7,313,234,306,0,4,0,0,68,313
EDO. PORTUGUESA,MP. OSPINO,PQ. LA ESTACION,ESCUELA BASICA COSPES,1245,3,24,1011,752,987,0,5,1,0,229,1011
EDO. PORTUGUESA,MP. OSPINO,PQ. LA ESTACION,ESCUELA NACIONAL UNITARIA GUACHE DE GARABOTE,437,1,1,295,276,294,0,2,0,0,16,295
EDO. PORTUGUESA,MP.GENARO BOCONOITO,PQ. ANTOLIN TOVAR AQUINO,ESCUELA ESTADAL CONCENTRADA NUMERO 01,540,1,6,453,371,447,1,2,0,0,73,453
EDO. PORTUGUESA,MP.GENARO BOCONOITO,PQ. ANTOLIN TOVAR AQUINO,ESCUELA ESTADAL CONCENTRADA NUMERO 10,296,1,3,233,180,230,1,3,0,0,46,233
EDO. PORTUGUESA,MP.GENARO BOCONOITO,PQ. ANTOLIN TOVAR AQUINO,ESCUELA NACIONAL CONCENTRADA NUMERO 3872 BARRIALITO,355,1,3,282,253,279,0,3,2,0,21,282
EDO. PORTUGUESA,MP.GENARO BOCONOITO,PQ. ANTOLIN TOVAR AQUINO,ESCUELA ESTADAL CONCENTRADA NUMERO 04,287,1,7,264,242,257,0,0,0,0,15,264
EDO. PORTUGUESA,MP.GENARO BOCONOITO,PQ. ANTOLIN TOVAR AQUINO,ESCUELA NACIONAL CONCENTRADA NUMERO 229 Y 105 ANEXA,781,2,14,650,536,636,0,3,1,0,96,650
EDO. PORTUGUESA,MP.GENARO BOCONOITO,PQ. ANTOLIN TOVAR AQUINO,ESCUELA ESTADAL UNITARIA NUMERO 504,135,1,0,121,119,121,0,0,1,0,1,121
EDO. PORTUGUESA,MP.GENARO BOCONOITO,PQ. ANTOLIN TOVAR AQUINO,ESCUELA  ESTADAL CONCENTRADA NUMERO 02,611,2,16,521,455,505,0,1,0,0,49,521
EDO. PORTUGUESA,MP.GENARO BOCONOITO,PQ. ANTOLIN TOVAR AQUINO,ESCUELA ESTADAL CONCENTRADA NUMERO 69,632,2,8,558,501,550,0,3,0,0,46,558
EDO. PORTUGUESA,MP.GENARO BOCONOITO,PQ. ANTOLIN TOVAR AQUINO,ESCUELA BASICA SAN NICOLAS,1728,3,39,1407,1047,1368,1,6,0,0,314,1407
EDO. PORTUGUESA,MP.GENARO BOCONOITO,PQ. ANTOLIN TOVAR AQUINO,ESCUELA ESTADAL CONCENTRADA NUMERO 40,344,1,14,289,242,275,0,0,1,0,32,289
EDO. PORTUGUESA,MP.GENARO BOCONOITO,PQ. ANTOLIN TOVAR AQUINO,ESCUELA NACIONAL UNITARIA NUMERO 3573,255,1,5,215,188,210,0,1,0,0,21,215
EDO. PORTUGUESA,MP.GENARO BOCONOITO,CM. BOCONOITO,ESCUELA BASICA CARLOS QUINTERO ALEGRIA,2918,5,39,2306,1786,2267,0,17,2,0,462,2306
EDO. PORTUGUESA,MP.GENARO BOCONOITO,CM. BOCONOITO,ESCUELA ESTADAL CONCENTRADA NUMERO 465,207,1,5,180,132,175,0,6,0,0,37,180
EDO. PORTUGUESA,MP.GENARO BOCONOITO,CM. BOCONOITO,ESCUELA CONCENTRADA NACIONAL SIPORORO NUMERO 1629S N ANEXA 83,1093,2,20,903,807,883,0,4,1,0,71,903
EDO. PORTUGUESA,MP.GENARO BOCONOITO,CM. BOCONOITO,ESCUELA ESTADAL CONCENTRADA NUMERO 21,419,1,6,355,285,349,0,2,1,0,61,355
EDO. PORTUGUESA,MP.GENARO BOCONOITO,CM. BOCONOITO,ESCUELA ESTADAL NUMERO 464,1030,2,18,879,662,861,1,6,0,0,192,879
EDO. PORTUGUESA,MP.GENARO BOCONOITO,CM. BOCONOITO,ESCUELA ESTADAL CONCENTRADA NUMERO 3,501,1,5,415,382,410,0,2,0,0,26,415
EDO. PORTUGUESA,MP.GENARO BOCONOITO,CM. BOCONOITO,ESCUELA NACIONAL CONCENTRADA NUMERO 2882 Y ANEXA 85,1708,3,40,1411,1055,1371,0,8,0,0,308,1411
EDO. PORTUGUESA,MP.GENARO BOCONOITO,CM. BOCONOITO,ESCUELA ESTADAL CONCENTRADA NUMERO 24 PUENTE PAEZ,550,1,8,425,379,417,0,3,0,0,35,425
EDO. PORTUGUESA,MP.GENARO BOCONOITO,CM. BOCONOITO,UNIDAD EDUCATIVA NACIONAL BOCONOITO,1940,4,31,1630,1317,1599,0,5,0,1,276,1630
EDO. PORTUGUESA,MP.S RAFAEL DE ONOTO,CM. SAN RAFAEL DE ONOTO,ESCUELA BASICA TRINA DE MORENO,1003,2,14,840,644,826,0,3,0,1,178,840
EDO. PORTUGUESA,MP.S RAFAEL DE ONOTO,CM. SAN RAFAEL DE ONOTO,INSTITUTO DE EDUCACION ESPECIAL  MARIA BELEN DE SIVIRA,678,2,12,591,391,579,0,2,0,0,186,591
EDO. PORTUGUESA,MP.S RAFAEL DE ONOTO,CM. SAN RAFAEL DE ONOTO,ESCUELA ESTADAL EL HIJITO NUMERO 182,462,1,7,388,345,381,0,3,1,0,32,388
EDO. PORTUGUESA,MP.S RAFAEL DE ONOTO,CM. SAN RAFAEL DE ONOTO,ESCUELA NACIONAL CONCENTRADA MANGO MOCHO,1172,2,22,1008,722,986,0,10,0,0,254,1008
EDO. PORTUGUESA,MP.S RAFAEL DE ONOTO,CM. SAN RAFAEL DE ONOTO,ESCUELA ESTADAL CONCENTRADA NUMERO 185 MARINA DE CONTRERAS,546,1,7,485,408,478,0,3,1,0,66,485
EDO. PORTUGUESA,MP.S RAFAEL DE ONOTO,CM. SAN RAFAEL DE ONOTO,UNIDAD EDUCATIVA MENCA DE LEONI,3155,6,80,2518,1596,2438,1,21,0,0,820,2518
EDO. PORTUGUESA,MP.S RAFAEL DE ONOTO,CM. SAN RAFAEL DE ONOTO,ESCUELA BASICA ESTADAL CONCENTRADA PASO COJEDES,178,1,4,149,130,145,0,1,0,0,14,149
EDO. PORTUGUESA,MP.S RAFAEL DE ONOTO,CM. SAN RAFAEL DE ONOTO,CICLO COMBINADO JOSE DE LA CRUZ PAREDES,1218,3,13,1037,618,1024,0,9,1,0,396,1037
EDO. PORTUGUESA,MP.S RAFAEL DE ONOTO,CM. SAN RAFAEL DE ONOTO,ESCUELA ESTADAL CONCENTRADA NUMERO 166 TEJERIAS,1267,3,26,1051,773,1025,0,4,0,1,247,1051
EDO. PORTUGUESA,MP.S RAFAEL DE ONOTO,PQ. SANTA FE,ESCUELA CONCENTRADA SANTA FE,966,2,12,849,652,837,1,1,2,0,181,849
EDO. PORTUGUESA,MP.S RAFAEL DE ONOTO,PQ. THERMO MORLES,ESCUELA NACIONAL CONCENTRADA EL MORRO,357,1,4,296,261,292,0,1,0,0,30,296
EDO. PORTUGUESA,MP.S RAFAEL DE ONOTO,PQ. THERMO MORLES,ESCUELA BASICA ALGARROBITO NUMERO 6,1267,3,22,1000,714,978,0,11,0,0,253,1000
EDO. PORTUGUESA,CE. GUANARE,CM. GUANARE,ESCUELA BASICA ESTADAL GUILLERMO GAMARRA MARRERO,2005,4,47,1687,1094,1640,0,11,1,1,533,1687
EDO. PORTUGUESA,CE. GUANARE,CM. GUANARE,ESCUELA CONCENTRADA NUMERO 44,100,1,2,84,73,82,0,0,0,0,9,84
EDO. PORTUGUESA,CE. GUANARE,CM. GUANARE,CENTRO EDUCATIVO RECREACIONAL  GRISELDA DE LA RIVA,223,1,5,191,143,186,0,0,0,0,43,191
EDO. PORTUGUESA,CE. GUANARE,CM. GUANARE,ESCUELA MULTIGRADO NACIONAL SIN NUMERO,309,1,2,115,88,113,0,0,0,0,25,115
EDO. PORTUGUESA,CE. GUANARE,CM. GUANARE,ESCUELA ESTADAL MULTIGRADO NUMERO 222,218,1,1,151,112,150,0,0,0,0,38,151
EDO. PORTUGUESA,CE. GUANARE,CM. GUANARE,CICLO DIVERCIFICADO CARLOS EMILIO MUÑOZ ORAA,2379,4,31,1982,1131,1951,0,14,0,2,804,1982
EDO. PORTUGUESA,CE. GUANARE,CM. GUANARE,ESCUELA CONCENTRADA MIXTA NUMERO 1810 82
EDO. PORTUGUESA,CE. GUANARE,CM. GUANARE,ESCUELA BASICA ORLANDO GIL CASA DIEGO,3562,7,65,3109,1629,3044,1,15,3,0,1396,3109
EDO. PORTUGUESA,CE. GUANARE,CM. GUANARE,JARDIN DE INFANCIA GUANARE INAN,821,2,17,684,275,667,0,1,0,0,391,684
EDO. PORTUGUESA,CE. GUANARE,CM. GUANARE,ESC. BOLIVARIANA  SOL DE JUSTICIA,592,1,13,517,467,504,3,1,2,0,31,517
EDO. PORTUGUESA,CE. GUANARE,CM. GUANARE,ESCUELA BASICA LIBERTADOR,1435,3,31,1200,987,1169,0,5,1,0,176,1200
EDO. PORTUGUESA,CE. GUANARE,CM. GUANARE,ESCUELA CONCENTRADA MIXTA NUMERO 1808 Y 90,734,2,13,575,455,562,1,2,1,0,103,575
EDO. PORTUGUESA,CE. GUANARE,CM. GUANARE,ESCUELA ESTADAL CONCENTRADA SIN NUMERO OJO DE AGUA LA CAMPIÑA NER NUMERO 34,101,1,3,94,76,91,0,0,0,0,15,94
EDO. PORTUGUESA,CE. GUANARE,CM. GUANARE,BIBLIOTECA PUBLICA DOCTOR ALIRIO UGARTE PELAYO,1489,3,26,1221,534,1195,0,7,1,1,652,1221
EDO. PORTUGUESA,CE. GUANARE,CM. GUANARE,ESCUELA BASICA NACIONAL DOCTOR MELITON VARGAS,2890,5,52,2226,1280,2174,3,17,3,0,871,2226
EDO. PORTUGUESA,CE. GUANARE,CM. GUANARE,ESCUELA BASICA DOCTOR CARLOS RODRIGUEZ ORTIZ,1314,3,30,1149,769,1119,0,8,0,0,342,1149
EDO. PORTUGUESA,CE. GUANARE,CM. GUANARE,ESCUELA BASICA MARIA CONCEPCION PALACIOS,2948,6,42,2469,1608,2427,2,17,2,0,798,2469
EDO. PORTUGUESA,CE. GUANARE,CM. GUANARE,ESCUELA TECNICA INDUSTRIAL GUANARE,1567,3,37,1292,861,1255,1,9,2,1,381,1292
EDO. PORTUGUESA,CE. GUANARE,CM. GUANARE,ESCUELA BASICA MIGUEL ANTONIO VASQUEZ,2984,6,99,2440,2072,2341,1,11,3,1,253,2440
EDO. PORTUGUESA,CE. GUANARE,CM. GUANARE,ESCUELA BASICA LUIS FAJARDO GALENO,1265,3,46,1083,730,1037,0,7,3,0,297,1083
EDO. PORTUGUESA,CE. GUANARE,CM. GUANARE,ESCUELA ESTADAL UNITARIA NUMERO 81,322,1,1,233,215,232,0,2,1,0,14,233
EDO. PORTUGUESA,CE. GUANARE,CM. GUANARE,ESCUELA ESTADAL CONCENTRADA NUMERO 48,544,1,7,439,367,432,0,3,0,0,62,439
EDO. PORTUGUESA,CE. GUANARE,CM. GUANARE,COLEGIO ADVENTISTA ANDRES BELLO,778,2,10,689,281,679,0,8,1,1,388,689
EDO. PORTUGUESA,CE. GUANARE,CM. GUANARE,ESCUELA BASICA NACIONAL CONCENTRADA SIN NUMERO,439,1,8,366,329,358,0,0,0,0,29,366
EDO. PORTUGUESA,CE. GUANARE,CM. GUANARE,COLEGIO PRIVADO NUESTRA SEÑORA DE LOURDES,173,1,1,163,47,162,0,0,0,0,115,163
EDO. PORTUGUESA,CE. GUANARE,CM. GUANARE,ESCUELA BASICA ESTADAL CONCENTRADA NUMERO 543,112,1,0,110,108,110,0,0,1,0,1,110
EDO. PORTUGUESA,CE. GUANARE,CM. GUANARE,ESCUELA BASICA AMADIO MARQUEZ,3834,7,74,3093,2448,3019,0,21,2,0,548,3093
EDO. PORTUGUESA,CE. GUANARE,CM. GUANARE,ESCUELA GENERAL CARLOS SOUBLETTE,555,1,10,500,414,490,0,3,0,0,73,500
EDO. PORTUGUESA,CE. GUANARE,CM. GUANARE,ESCUELA POPULAR CATOLICA FE Y ALEGRIA,1844,4,40,1636,754,1596,0,8,0,0,834,1636
EDO. PORTUGUESA,CE. GUANARE,CM. GUANARE,ESCUELA BASICA VIRGINIA DE RAMOS,2784,5,43,2326,1451,2283,1,11,0,0,820,2326
EDO. PORTUGUESA,CE. GUANARE,CM. GUANARE,ESCUELA CONCENTRADA 19 DE ABRIL,2258,4,39,1797,1422,1758,1,9,1,0,325,1797
EDO. PORTUGUESA,CE. GUANARE,CM. GUANARE,CASA DE SALUD,371,1,14,258,170,244,0,2,0,1,71,258
EDO. PORTUGUESA,CE. GUANARE,CM. GUANARE,CICLO COMBINADO JOSE VICENTE DE UNDA,2380,5,44,1912,826,1868,1,11,1,3,1026,1912
EDO. PORTUGUESA,CE. GUANARE,CM. GUANARE,ESCUELA BASICA SAN RAFAEL NUMERO 467,663,2,10,558,501,548,0,7,0,0,40,558
EDO. PORTUGUESA,CE. GUANARE,CM. GUANARE,CENTRO DE ATENCION AL NIÑO  DOÑA BOLIVIA RIERA DE MARTINEZ,379,1,6,332,266,326,0,2,0,0,58,332
EDO. PORTUGUESA,CE. GUANARE,CM. GUANARE,CENTRO DE BELLAS ARTES AMANDA MUÑOZ,108,1,0,104,45,104,0,0,0,0,59,104
EDO. PORTUGUESA,CE. GUANARE,CM. GUANARE,ESCUELA BASICA JUAN FERNANDEZ DE LEON,3649,7,89,3075,1227,2986,1,30,1,2,1725,3075
EDO. PORTUGUESA,CE. GUANARE,CM. GUANARE,ESCUELA ESTADAL MULTIGRADO NUMERO 55 EL PUENTE,367,1,4,291,262,287,0,0,2,0,23,291
EDO. PORTUGUESA,CE. GUANARE,CM. GUANARE,ESCUELA BASICA GIRALUNA,2498,5,52,2127,691,2075,0,11,0,0,1373,2127
EDO. PORTUGUESA,CE. GUANARE,CM. GUANARE,ESCUELA BASICA ESTADAL HORTENCIA PERAZA,2241,4,45,1712,1105,1667,0,13,0,1,548,1712
EDO. PORTUGUESA,CE. GUANARE,CM. GUANARE,ESCUELA BOLIVARIANA SAN RAFAEL DE LAS GUASDUAS NUMERO 51,375,1,10,312,257,302,0,2,1,0,42,312
EDO. PORTUGUESA,CE. GUANARE,CM. GUANARE,UNIDAD EDUCATIVA PRIVADA COLEGIO CATOLICO SAN JOSE,335,1,9,305,187,296,0,1,1,0,107,305
EDO. PORTUGUESA,CE. GUANARE,CM. GUANARE,FACULTAD DE MEDICINA EXTENCION GUANARE,571,1,22,525,240,503,0,2,1,1,259,525
EDO. PORTUGUESA,CE. GUANARE,CM. GUANARE,ESCUELA BASICA DON SIMON RODRIGUEZ,890,2,25,728,507,703,0,8,1,0,187,728
EDO. PORTUGUESA,CE. GUANARE,CM. GUANARE,CENTRO DE ATENCION INTEGRAL,1706,3,35,1571,836,1536,0,9,1,0,690,1571
EDO. PORTUGUESA,CE. GUANARE,CM. GUANARE,ESCUELA BASICA ARNOLDO JOSE PERAZA,2378,4,59,2016,1550,1957,1,11,3,0,392,2016
EDO. PORTUGUESA,CE. GUANARE,CM. GUANARE,ESCUELA BASICA ESTADAL 530,1237,3,30,1039,809,1009,1,11,1,0,187,1039
EDO. PORTUGUESA,CE. GUANARE,CM. GUANARE,UNIDAD EDUCATIVA CESAR LIZARDO,191,1,5,171,75,166,0,1,0,0,90,171
EDO. PORTUGUESA,CE. GUANARE,CM. GUANARE,ESCUELA BASICA DON ANTONIO TORREALBA,1762,3,28,1468,1082,1440,1,4,0,0,353,1468
EDO. PORTUGUESA,CE. GUANARE,CM. GUANARE,ESCUELA BASICA GILBERTO OROPEZA,1487,3,22,1225,1021,1203,1,8,0,0,173,1225
EDO. PORTUGUESA,CE. GUANARE,CM. GUANARE,ESCUELA BASICA JOSE MARIA VARGAS,2944,6,64,2410,1036,2346,0,20,1,0,1289,2410
EDO. PORTUGUESA,CE. GUANARE,CM. GUANARE,ESCUELA BASICA ESTADAL RAFAEL ROBERTO GAVIDIA,893,2,43,773,538,730,0,5,1,0,186,773
EDO. PORTUGUESA,CE. GUANARE,CM. GUANARE,ESCUELA BASICA NACIONAL DOCTOR MIGUEL ORAA,2292,4,35,1851,1046,1816,2,17,2,0,749,1851
EDO. PORTUGUESA,CE. GUANARE,CM. GUANARE,ESCUELA BASICA CIUDAD DE GUANARE,3318,6,79,2636,1327,2557,3,21,4,2,1200,2636
EDO. PORTUGUESA,CE. GUANARE,CM. GUANARE,JARDIN DE INFANCIA JOSE VICENTE DE UNDA,762,2,20,673,558,653,0,4,1,1,89,673
EDO. PORTUGUESA,CE. GUANARE,CM. GUANARE,PRE ESCOLAR JUAN PABLO SEGUNDO,2398,5,43,2041,1680,1998,0,13,0,0,305,2041
EDO. PORTUGUESA,CE. GUANARE,CM. GUANARE,GRUPO ESCOLAR NACIONAL DIEGO ANTONIO BRICEÑO,3076,6,62,2528,1722,2466,3,18,2,1,720,2528
EDO. PORTUGUESA,CE. GUANARE,CM. GUANARE,CICLO BASICO COMBINADO DOCTOR FELIX SATURNINO ARISA,1535,3,32,1247,759,1215,1,12,1,0,442,1247
EDO. PORTUGUESA,CE. GUANARE,CM. GUANARE,NUCLEO RURAL NUMERO 289 ESCUELA ESTADAL NUMERO 49.,186,1,5,162,143,157,0,2,0,0,12,162
EDO. PORTUGUESA,CE. GUANARE,CM. GUANARE,COLEGIO UNIVERSITARIO FERMIN TORO,2831,5,38,2465,1315,2427,0,19,0,2,1091,2465
EDO. PORTUGUESA,CE. GUANARE,CM. GUANARE,ESCUELA CONCENTRADA MIXTA NUMERO 14,158,1,7,121,83,114,0,0,0,0,31,121
EDO. PORTUGUESA,CE. GUANARE,CM. GUANARE,ESCUELA ANDRES ELOY BLANCO,1397,3,29,1168,739,1139,1,9,1,0,389,1168
EDO. PORTUGUESA,CE. GUANARE,CM. GUANARE,ESCUELA BASICA ANA DE ZAMBRANO ROA,1402,3,20,1245,579,1225,1,8,0,1,636,1245
EDO. PORTUGUESA,CE. GUANARE,CM. GUANARE,ESCUELA BASICA UNITARIA NUMERO 56,77,1,0,62,59,62,0,0,1,0,2,62
EDO. PORTUGUESA,CE. GUANARE,CM. GUANARE,PRE ESCOLAR LOS LLANERITOS,442,1,11,397,242,386,0,0,1,0,143,397
EDO. PORTUGUESA,CE. GUANARE,CM. GUANARE,ESCUELA ESTADAL CONCENTRADA NUMERO 76 BUENA VISTA EL COCO
EDO. PORTUGUESA,CE. GUANARE,CM. GUANARE,JARDIN DE INFANCIA,934,2,18,865,463,847,0,10,1,0,373,865
EDO. PORTUGUESA,CE. GUANARE,CM. GUANARE,ESCUELA BASICA CONCENTRADA SIN NUMERO 5 DE JULIO,193,1,6,181,158,175,0,3,1,0,13,181
EDO. PORTUGUESA,CE. GUANARE,CM. GUANARE,ESCUELA ESTADAL BASICA NICOMEDES CASTILLO,1703,3,33,1393,859,1360,2,8,2,0,489,1393
EDO. PORTUGUESA,CE. GUANARE,CM. GUANARE,ESCUELA ESTADAL CONCENTRADA BASICA NUMERO 33,1146,2,15,908,706,893,0,4,0,0,183,908
EDO. PORTUGUESA,CE. GUANARE,CM. GUANARE,ESCUELA ESTADAL CONCENTRADA NUMERO 9,295,1,6,201,162,195,2,2,0,0,29,201
EDO. PORTUGUESA,CE. GUANARE,CM. GUANARE,ESCUELA GRADUADA BASICA TIERRA BUENA,996,2,16,851,747,835,2,2,0,0,84,851
EDO. PORTUGUESA,CE. GUANARE,CM. GUANARE,JARDIN DE INFANCIA LOS CACHORRITOS,1383,3,20,1199,865,1179,2,13,0,1,298,1199
EDO. PORTUGUESA,CE. GUANARE,CM. GUANARE,LICEO LA COMUNIDAD NUEVA,2354,4,44,2046,992,2002,0,11,0,0,999,2046
EDO. PORTUGUESA,CE. GUANARE,CM. GUANARE,INTERNADO JUDICIAL,373,1,1,131,118,130,0,0,0,0,12,131
EDO. PORTUGUESA,CE. GUANARE,CM. GUANARE,PRE ESCOLAR MATILDE DE PIERLUISSI,954,2,16,857,331,841,0,3,0,1,506,857
EDO. PORTUGUESA,CE. GUANARE,CM. GUANARE,CENTRO MATERNAL BLANCA R. PEREZ,880,2,12,816,225,804,0,2,0,2,575,816
EDO. PORTUGUESA,CE. GUANARE,CM. GUANARE,ESCUELA CONCENTRADA MIXTA NUMERO 53
EDO. PORTUGUESA,CE. GUANARE,CM. GUANARE,ESCUELA BASICA PROFESORA CELINDA ADAMS,1221,3,25,1016,772,991,1,3,1,0,214,1016
EDO. PORTUGUESA,CE. GUANARE,CM. GUANARE,ESCUELA ESTADAL CONCENTRADA NUMERO 15 NUCLEO ESCOLAR RURAL NUMERO 289,154,1,6,123,104,117,0,0,0,0,13,123
EDO. PORTUGUESA,CE. GUANARE,CM. GUANARE,ESCUELA BASICA CONCENTRADA JOSE FELIX RIVAS,310,1,3,268,231,265,0,0,0,0,34,268
EDO. PORTUGUESA,CE. GUANARE,CM. GUANARE,UNIDAD EDUCATIVA JOSE DE LOS SANTOS URRIOLA,409,1,6,334,263,328,0,3,0,0,62,334
EDO. PORTUGUESA,CE. GUANARE,CM. GUANARE,ESCUELA ESTADAL GRADUADA NUMERO 16 LA CURVA TERESA DE LA PARRA,762,2,15,602,539,587,0,3,0,0,45,602
EDO. PORTUGUESA,CE. GUANARE,CM. GUANARE,ESCUELA BASICA TRADICIONAL NUMERO 469 ANTONIO JOSE DE SUCRE,814,2,31,676,510,645,0,7,0,0,128,676
EDO. PORTUGUESA,CE. GUANARE,PQ. CORDOBA,ESCUELA BASICA CORDOBA
EDO. PORTUGUESA,CE. GUANARE,PQ. CORDOBA,ESCUELA NACIONAL UNITARIA NUMERO 118 ANEXA CON MIXTA NUMERO 73,300,1,3,236,211,233,0,1,0,0,21,236
EDO. PORTUGUESA,CE. GUANARE,PQ. CORDOBA,ESCUELA ESTADAL CONCENTRADA NUMERO 78
EDO. PORTUGUESA,CE. GUANARE,PQ. CORDOBA,ESCUELA ESTADAL CONCENTRADA NUMERO 79
EDO. PORTUGUESA,CE. GUANARE,PQ. CORDOBA,ESCUELA NACIONAL UNITARIA NUMERO 211
EDO. PORTUGUESA,CE. GUANARE,PQ. CORDOBA,ESCUELA ESTADAL UNITARIA NUMERO 260,87,1,1,56,51,55,0,1,0,0,3,56
EDO. PORTUGUESA,CE. GUANARE,PQ. VIRGEN DE LA COROMOTO,UNIDAD EDUCATIVA NACIONAL TUCUPIDO,1508,3,45,1263,940,1218,0,6,0,1,271,1263
EDO. PORTUGUESA,CE. GUANARE,PQ. VIRGEN DE LA COROMOTO,ESCUELA ESTADAL CONCENTRADA NUMERO 23,296,1,9,238,185,229,0,1,0,0,43,238
EDO. PORTUGUESA,CE. GUANARE,PQ. VIRGEN DE LA COROMOTO,ESCUELA ESTADAL UNITARIA NUMERO 529 NER 30
EDO. PORTUGUESA,CE. GUANARE,PQ. VIRGEN DE LA COROMOTO,ESCUELA ESTATAL CONCENTRADA  546 LOS HIERROS,157,1,4,144,109,140,0,1,0,0,30,144
EDO. PORTUGUESA,CE. GUANARE,PQ. VIRGEN DE LA COROMOTO,E.T.C QUEBRADA DE LA VIRGEN,2236,4,60,1748,1307,1688,1,16,2,0,362,1748
EDO. PORTUGUESA,CE. GUANARE,PQ. VIRGEN DE LA COROMOTO,ESCUELA ESTADAL NUMERO 07 Y ANEXA NACIONAL,470,1,4,403,296,399,0,2,0,0,101,403
EDO. PORTUGUESA,CE. GUANARE,PQ. VIRGEN DE LA COROMOTO,ESCUELA ESTADAL CONCENTRADA NUMERO 11 NUCLEO 30,326,1,8,277,177,269,0,6,0,0,86,277
EDO. PORTUGUESA,CE. GUANARE,PQ. VIRGEN DE LA COROMOTO,ESCUELA ESTADAL CONCENTRADA NUMERO 12 Y ANEXA NACIONAL,806,2,32,685,561,653,0,4,3,0,85,685
EDO. PORTUGUESA,CE. GUANARE,PQ. VIRGEN DE LA COROMOTO,ESCUELA ESTADAL UNITARIA NUMERO 64,324,1,4,292,270,288,0,0,0,0,18,292
EDO. PORTUGUESA,CE. GUANARE,PQ. VIRGEN DE LA COROMOTO,ESCUELA BOLIVARIANA NEGRO PRIMERO NER 030,206,1,2,190,160,188,0,3,0,0,25,190
EDO. PORTUGUESA,CE. GUANARE,PQ.SAN JOSE DE LA MONTA#A,ESCUELA ESTADAL CONCENTRADA NUMERO 208,371,1,4,237,182,233,0,1,0,0,50,237
EDO. PORTUGUESA,CE. GUANARE,PQ.SAN JOSE DE LA MONTA#A,ESCUELA BASICA NUMERO 216 NUCLEO RURAL NUMERO 223
EDO. PORTUGUESA,CE. GUANARE,PQ.SAN JOSE DE LA MONTA#A,ESCUELA ESTADAL CONCENTRADA NUMERO 205
EDO. PORTUGUESA,CE. GUANARE,PQ.SAN JUAN GUANAGUANARE,ESCUELA BASICA ESTADAL CONCENTRADA LAS PLAYITAS NUMERO 5NER 11,213,1,3,189,185,186,0,0,0,0,1,189
EDO. PORTUGUESA,CE. GUANARE,PQ.SAN JUAN GUANAGUANARE,ESCUELA BASICA 3 DE NOVIEMBRE,2540,5,46,2096,1354,2050,2,15,4,2,673,2096
EDO. PORTUGUESA,CE. GUANARE,PQ.SAN JUAN GUANAGUANARE,ESCUELA ESTADAL NUMERO 10 Y ANEXA NACIONAL,644,2,9,512,408,503,1,1,3,0,90,512
EDO. PORTUGUESA,CE. GUANARE,PQ.SAN JUAN GUANAGUANARE,ESCUELA ESTADAL CONCENTRADA LOLA DE PACHECO,238,1,6,213,153,207,0,2,0,0,52,213
EDO. PORTUGUESA,CE. GUANARE,PQ.SAN JUAN GUANAGUANARE,CENTRO CULTURAL DON ANTONIO TORREALBA MESA DE CAVACA,264,1,3,236,171,233,0,0,0,0,62,236
EDO. PORTUGUESA,CE. GUANARE,PQ.SAN JUAN GUANAGUANARE,UNIDAD EDUCATIVA NACIONAL SAN JUAN DE GUANAGUANARE,1491,3,15,1290,832,1275,0,10,2,1,430,1290
EDO. PORTUGUESA,CE. GUANARE,PQ.SAN JUAN GUANAGUANARE,ESCUELA BASICA CONCENTRADA NUMERO 490,337,1,9,298,237,289,0,3,0,0,49,298
EDO. PORTUGUESA,CE. GUANARE,PQ.SAN JUAN GUANAGUANARE,UNIDAD CONCENTRADA NUMERO 277,267,1,2,207,188,205,0,2,2,0,13,207
EDO. PORTUGUESA,CE. GUANARE,PQ.SAN JUAN GUANAGUANARE,ESCUELA BASICA ESTADAL SIMON BOLIVAR,1231,3,26,969,672,943,0,11,0,0,260,969
EDO. PORTUGUESA,CE. GUANARE,PQ.SAN JUAN GUANAGUANARE,ESCUELA BASICA CONCENTRADA NUMERO 42,177,1,6,152,129,146,0,1,0,0,16,152
EDO. PORTUGUESA,CE. GUANARE,PQ.SAN JUAN GUANAGUANARE,ESCUELA UNITARIA SIN NUMERO EL BUEY,258,1,13,207,169,194,0,0,0,0,25,207
EDO. PORTUGUESA,CE. GUANARE,PQ.SAN JUAN GUANAGUANARE,ESCUELA ESTADAL CONCENTRADA NUMERO 47,510,1,11,445,279,434,0,2,0,0,153,445
EDO. PORTUGUESA,CE. GUANARE,PQ.SAN JUAN GUANAGUANARE,ESCUELA GRANJA OSCAR VILLANUEVA ANEXA NUMERO 390,1160,2,13,958,497,945,0,4,0,0,444,958
EDO. PORTUGUESA,MP. ESTELLER,PQ. UVERAL,ESCUELA UNITARIA 405
EDO. PORTUGUESA,MP. ESTELLER,PQ. UVERAL,ESCUELA CONCENTRADA 382,378,1,3,303,246,300,3,5,0,0,46,303
EDO. PORTUGUESA,MP. ESTELLER,PQ. UVERAL,ESCUELA UNITARIA NUMERO 398,166,1,3,135,122,132,0,0,0,0,10,135
EDO. PORTUGUESA,MP. ESTELLER,PQ. UVERAL,CICLO BASICO UVERAL,1021,2,21,768,616,747,1,9,4,0,117,768
EDO. PORTUGUESA,MP. ESTELLER,PQ. UVERAL,ESCUELA ESTADAL CONCENTRADA NUMERO 370,190,1,3,161,115,158,0,3,0,0,40,161
EDO. PORTUGUESA,MP. ESTELLER,PQ. UVERAL,ESCUELA ESTADAL 1912 402,606,2,13,490,406,477,0,1,1,0,69,490
EDO. PORTUGUESA,MP. ESTELLER,PQ. UVERAL,ESCUELA ESTADAL CONCENTRADA NUMERO 381 MANTECAL,434,1,9,355,325,346,0,2,0,0,19,355
EDO. PORTUGUESA,MP. ESTELLER,PQ. UVERAL,ESCUELA ESTADAL CONCENTRADA NUMERO 383 SAN JORGE,185,1,1,170,169,169,0,0,0,0,0,170
EDO. PORTUGUESA,MP. ESTELLER,PQ. UVERAL,ESCUELA BASICA ESTADAL CONCENTRADA NUMERO 401,183,1,3,169,145,166,0,1,0,0,20,169
EDO. PORTUGUESA,MP. ESTELLER,PQ. UVERAL,ESCUELA CONCENTRADA NUMERO 1890,246,1,3,210,181,207,0,0,0,1,25,210
EDO. PORTUGUESA,MP. ESTELLER,PQ. UVERAL,ESCUELA ESTADAL UNITARIA 404,100,1,2,92,78,90,0,0,0,0,12,92
EDO. PORTUGUESA,MP. ESTELLER,PQ. UVERAL,ESCUELA BASICA PAUJICITO,465,1,5,371,283,366,0,5,1,0,77,371
EDO. PORTUGUESA,MP. ESTELLER,PQ. UVERAL,ESCUELA ESTADAL UNITARIA NUMERO 389,255,1,3,171,142,168,0,2,0,0,24,171
EDO. PORTUGUESA,MP. ESTELLER,PQ. UVERAL,ESCUELA ESTADAL CONCENTRADA EL PAJON NUMERO 388,265,1,4,217,177,213,0,1,0,0,35,217
EDO. PORTUGUESA,MP. ESTELLER,CM. PIRITU,ESCUELA ESTADAL UNITARIA NUMERO 489,336,1,5,294,272,289,0,1,0,0,16,294
EDO. PORTUGUESA,MP. ESTELLER,CM. PIRITU,ESCUELA ESTADAL CONCENTRADA NUMERO 395 LA PAVA,233,1,0,209,197,209,0,1,0,0,11,209
EDO. PORTUGUESA,MP. ESTELLER,CM. PIRITU,ESCUELA  ESTADAL CONCENTRADA  NUMERO 394,244,1,2,202,183,200,0,1,1,0,15,202
EDO. PORTUGUESA,MP. ESTELLER,CM. PIRITU,ESCUELA BASICA NACIONAL CONCENTRADA NUMERO 1892,218,1,0,192,183,192,0,0,0,0,9,192
EDO. PORTUGUESA,MP. ESTELLER,CM. PIRITU,ESCUELA ESTADAL UNITARIA NUMERO 393 EL DANTO,224,1,2,173,148,171,0,1,0,1,21,173
EDO. PORTUGUESA,MP. ESTELLER,CM. PIRITU,ESCUELA BASICA JESUS ALVARADO NUÑEZ,2396,5,33,1885,1232,1852,1,5,1,0,613,1885
EDO. PORTUGUESA,MP. ESTELLER,CM. PIRITU,CENTRO DE EDUCACION INICIAL LAS GUAFITAS,257,1,3,232,208,229,0,0,0,0,21,232
EDO. PORTUGUESA,MP. ESTELLER,CM. PIRITU,ESCUELA NACIONAL CONCENTRADA MIXTA NUMERO 2360,352,1,2,277,254,275,0,1,0,0,20,277
EDO. PORTUGUESA,MP. ESTELLER,CM. PIRITU,ESCUELA ESTADAL NUMERO 374,236,1,2,198,166,196,0,1,2,0,27,198
EDO. PORTUGUESA,MP. ESTELLER,CM. PIRITU,ESCUELA BASICA  ANTONIO RODRIGUEZ PICON,2637,5,55,2038,1434,1983,2,21,1,0,525,2038
EDO. PORTUGUESA,MP. ESTELLER,CM. PIRITU,ESCUELA ESTADAL CONCENTRADA NUMERO 371,338,1,7,295,240,288,0,1,0,0,47,295
EDO. PORTUGUESA,MP. ESTELLER,CM. PIRITU,ESCUELA ESTADAL CONCENTRADA NUMERO 375,333,1,10,273,229,263,2,2,1,0,29,273
EDO. PORTUGUESA,MP. ESTELLER,CM. PIRITU,ESCUELA ESTADAL CONCENTRADA NUMERO 377,346,1,1,303,295,302,1,0,0,0,6,303
EDO. PORTUGUESA,MP. ESTELLER,CM. PIRITU,ESCUELA BASICA LA GUTIERREÑA,449,1,10,378,305,368,0,7,2,0,54,378
EDO. PORTUGUESA,MP. ESTELLER,CM. PIRITU,ESCUELA ESTADAL UNITARIA NUMERO175,113,1,1,111,101,110,0,0,0,0,9,111
EDO. PORTUGUESA,MP. ESTELLER,CM. PIRITU,ESCUELA  ESTADAL CONCENTRADA  NUMERO 386,558,1,15,451,361,436,1,5,0,0,69,451
EDO. PORTUGUESA,MP. ESTELLER,CM. PIRITU,PARQUE DE RECREACION DIRIGIDA,1533,3,34,1338,765,1304,0,9,2,0,528,1338
EDO. PORTUGUESA,MP. ESTELLER,CM. PIRITU,ESCUELA ESTADAL CONCENTRADA NUMERO 2938,203,1,1,183,172,182,0,1,1,0,8,183
EDO. PORTUGUESA,MP. ESTELLER,CM. PIRITU,ESCUELA CONCENTRADA MIXTA NUMERO 384,462,1,4,388,340,384,0,0,0,1,43,388
EDO. PORTUGUESA,MP. ESTELLER,CM. PIRITU,UNIDAD CONCENTRADA JUAN ZABARCE,1586,3,22,1346,1062,1324,0,8,1,1,252,1346
EDO. PORTUGUESA,MP. ESTELLER,CM. PIRITU,ESCUELA BASICA PIRITU,2769,5,45,2317,1821,2272,1,13,0,2,435,2317
EDO. PORTUGUESA,MP. ESTELLER,CM. PIRITU,ESCUELA BASICA LOS CORRALES,807,2,3,641,576,638,0,3,2,0,57,641
EDO. PORTUGUESA,MP. ESTELLER,CM. PIRITU,ESCUELA BASICA MATIAS SALAZAR,1539,3,30,1313,1117,1283,1,6,0,0,159,1313
EDO. PORTUGUESA,MP. ESTELLER,CM. PIRITU,ESCUELA NACIONAL CONCENTRADA NUMERO 2935,429,1,7,325,286,318,0,2,1,0,29,325
EDO. PORTUGUESA,MP. ESTELLER,CM. PIRITU,ESCUELA ESTADAL UNITARIA LAS TRINCHERAS,410,1,7,332,273,325,0,2,0,0,50,332
EDO. PORTUGUESA,MP. ESTELLER,CM. PIRITU,INSTITUTO COMERCIAL PADRE ESTELLER,1356,3,41,1142,697,1101,0,14,1,0,389,1142
EDO. PORTUGUESA,MP. ESTELLER,CM. PIRITU,ESCUELA BASICA NACIONAL BANCO DEL PUEBLO,501,1,15,428,348,413,0,4,0,0,61,428
EDO. PORTUGUESA,MP. ESTELLER,CM. PIRITU,ESCUELA ESTADAL CONCENTRADA NUMERO 380,301,1,5,254,215,249,0,3,0,0,31,254
EDO. PORTUGUESA,MP. ESTELLER,CM. PIRITU,CICLO COMBINADO PABLO HERRERA CAMPINS,2917,5,70,2400,1481,2330,1,23,0,1,824,2400
EDO. PORTUGUESA,MP. ESTELLER,CM. PIRITU,ESCUELA ESTADAL CONCENTRADA NUMERO 385,271,1,3,239,209,236,0,3,0,0,24,239
EDO. PORTUGUESA,MP. SANTA ROSALIA,PQ. FLORIDA,ESCUELA BASICA NUEVA FLORIDA NUMERO 419
EDO. PORTUGUESA,MP. SANTA ROSALIA,PQ. FLORIDA,ESCUELA BASICA TUREN,1413,3,19,1088,888,1069,1,9,0,0,171,1088
EDO. PORTUGUESA,MP. SANTA ROSALIA,PQ. FLORIDA,ESCUELA BASICA ESTADAL CONCENTRADA NUMERO 162 LA REDOMA
EDO. PORTUGUESA,MP. SANTA ROSALIA,PQ. FLORIDA,ESCUELA UNITARIA EL TORO
EDO. PORTUGUESA,MP. SANTA ROSALIA,PQ. FLORIDA,ESCUELA BASICA ESTADAL UNITARIA LA 23
EDO. PORTUGUESA,MP. SANTA ROSALIA,CM. EL PLAYON,UNIDAD EDUCATIVA NACIONAL EL PLAYON,1007,2,13,858,621,845,1,6,0,0,217,858
EDO. PORTUGUESA,MP. SANTA ROSALIA,CM. EL PLAYON,ESCUELA BOLIVARIANA PUNTO FIJO
EDO. PORTUGUESA,MP. SANTA ROSALIA,CM. EL PLAYON,ESCUELA BASICA EL PLAYON,2249,4,36,1705,1196,1669,3,11,0,0,459,1705
EDO. PORTUGUESA,MP. SANTA ROSALIA,CM. EL PLAYON,ESCUELA BOLIVARIANA BARRIO UNIDO NUMERO 418,191,1,2,152,128,150,0,0,0,0,22,152
EDO. PORTUGUESA,MP. SANTA ROSALIA,CM. EL PLAYON,ESCUELA  BOLIVARIANA SAN PABLO,717,2,1,623,554,622,0,1,0,0,67,623
EDO. PORTUGUESA,MP. SANTA ROSALIA,CM. EL PLAYON,ESCUELA CONCENTRADA BOLIVARIANA POBLADO I
EDO. PORTUGUESA,MP. SANTA ROSALIA,CM. EL PLAYON,ESCUELA BASICA RAYITO DE LUZ,529,1,10,459,338,449,0,1,0,0,110,459
EDO. PORTUGUESA,MP. SANTA ROSALIA,CM. EL PLAYON,ESCUELA BOLIVARIANA LA FELICIDAD,283,1,4,260,248,256,0,1,0,0,7,260
EDO. PORTUGUESA,MP. SANTA ROSALIA,CM. EL PLAYON,ESCUELA BOLIVARIANA POBLADO II
EDO. PORTUGUESA,MP. SANTA ROSALIA,CM. EL PLAYON,ESCUELA BOLIVARIANA  MICRO SUR III,193,1,1,158,144,157,0,0,0,0,13,158
EDO. PORTUGUESA,MP. SANTA ROSALIA,CM. EL PLAYON,ESCUELA ESTADAL CONCENTRADA NUMERO 416 COGOTE
EDO. PORTUGUESA,MP. SANTA ROSALIA,CM. EL PLAYON,ESCUELA BASICA ESTADAL  NUMERO 417 EL GATEADO,965,2,11,777,664,766,0,2,1,0,99,777
EDO. PORTUGUESA,MP. SANTA ROSALIA,CM. EL PLAYON,ESCUELA CONCENTRADA NACIONAL MICRO SUR II,475,1,5,412,381,407,0,1,1,0,24,412
EDO. PORTUGUESA,MP. SANTA ROSALIA,CM. EL PLAYON,ESCUELA BOLIVARIANA NER 31,128,1,1,114,79,113,0,0,0,0,34,114
EDO. PORTUGUESA,MP. SANTA ROSALIA,CM. EL PLAYON,ESCUELA ESTADAL BOLIVARIANA NUMERO 429 COROZAL,182,1,9,154,106,145,0,3,0,0,36,154
EDO. PORTUGUESA,MP. TUREN,PQ. SAN ISIDRO LABRADOR,ESCUELA BASICA CHINGALI NUCLEO ESCOLAR RURAL 23,140,1,2,122,104,120,0,3,0,0,13,122
EDO. PORTUGUESA,MP. TUREN,PQ. SAN ISIDRO LABRADOR,ESCUELA BOLIVARIANA EL PALMAR,827,2,7,605,552,598,0,2,0,1,43,605
EDO. PORTUGUESA,MP. TUREN,PQ. SAN ISIDRO LABRADOR,ESCUELA ESTADAL CONCENTRADA LA ROGEÑA,231,1,0,201,189,201,0,1,2,0,9,201
EDO. PORTUGUESA,MP. TUREN,PQ. SAN ISIDRO LABRADOR,ESCUELA BOLIVARIANA MARIA ISABEL COLMENAREZ,1174,2,11,878,643,867,0,5,0,0,219,878
EDO. PORTUGUESA,MP. TUREN,PQ. SAN ISIDRO LABRADOR,ESCUELA TECNICA AGROPECUARIA LA COLONIA,1160,2,11,962,492,951,0,6,0,1,452,962
EDO. PORTUGUESA,MP. TUREN,PQ. SAN ISIDRO LABRADOR,ESCUELA BOLIVARIANA MICRO ESTE,203,1,4,180,163,176,0,1,0,0,12,180
EDO. PORTUGUESA,MP. TUREN,CM. VILLA BRUZUAL,ESCUELA BOLIVARIANA CIUDAD DE MERIDA,3354,6,53,2586,1652,2533,1,20,5,1,854,2586
EDO. PORTUGUESA,MP. TUREN,CM. VILLA BRUZUAL,ESCUELA BOLIVARIANA CANOITA NUMERO 1781,445,1,6,365,331,359,0,3,1,0,24,365
EDO. PORTUGUESA,MP. TUREN,CM. VILLA BRUZUAL,UNIDAD EDUCATIVA COLEGIO JOSE ANTONIO PAEZ,1084,2,15,923,539,908,0,6,0,0,363,923
EDO. PORTUGUESA,MP. TUREN,CM. VILLA BRUZUAL,CENTRO DE CAPACITACION EN ARTES Y OFICIO AMALIA MORANDI,1244,3,26,1095,626,1069,1,12,0,0,430,1095
EDO. PORTUGUESA,MP. TUREN,CM. VILLA BRUZUAL,ESCUELA BOLIVARIANA TUREN,1101,2,11,943,569,932,0,6,0,1,356,943
EDO. PORTUGUESA,MP. TUREN,CM. VILLA BRUZUAL,ESCUELA BOLIVARIANA PARICUA,562,1,8,457,399,449,0,2,2,0,46,457
EDO. PORTUGUESA,MP. TUREN,CM. VILLA BRUZUAL,ESCUELA BOLIVARIANA JOSE BENIGNO DORANTE,952,2,16,793,653,777,0,8,0,0,116,793
EDO. PORTUGUESA,MP. TUREN,CM. VILLA BRUZUAL,JARDIN DE INFANCIA ARCOIRIS,311,1,9,244,159,235,0,4,0,0,72,244
EDO. PORTUGUESA,MP. TUREN,CM. VILLA BRUZUAL,ESCUELA BOLIVARIANA LAS CARAMAS NUMERO 422,534,1,6,410,368,404,0,1,0,0,35,410
EDO. PORTUGUESA,MP. TUREN,CM. VILLA BRUZUAL,UNIDAD EDUCATIVA NACIONAL 27 DE JUNIO,2078,4,26,1792,1092,1766,0,8,1,1,664,1792
EDO. PORTUGUESA,MP. TUREN,CM. VILLA BRUZUAL,ESCUELA BASICA BOLIVARIANA ROMULO GALLEGOS,1605,3,32,1334,1134,1302,0,6,0,0,162,1334
EDO. PORTUGUESA,MP. TUREN,CM. VILLA BRUZUAL,ESCUELA BASICA TIBERIO GRATEROL,2318,4,29,1870,1540,1841,0,8,2,0,291,1870
EDO. PORTUGUESA,MP. TUREN,CM. VILLA BRUZUAL,ESCUELA NACIONAL BOLIVARIANA LA VEGA QUINTEREÑA,83,1,3,76,59,73,0,2,0,1,11,76
EDO. PORTUGUESA,MP. TUREN,CM. VILLA BRUZUAL,ESCUELA BASICA PATIO GRANDE,1495,3,18,1272,873,1254,0,7,0,0,374,1272
EDO. PORTUGUESA,MP. TUREN,CM. VILLA BRUZUAL,ESCUELA BASICA ESTADAL  NUMERO 409 TUREN VIEJO
EDO. PORTUGUESA,MP. TUREN,CM. VILLA BRUZUAL,INSTITUTO DE EDUCACION ESPECIAL BOLIVARIANO TUREN,1577,3,24,1167,766,1143,0,15,1,0,361,1167
EDO. PORTUGUESA,MP. TUREN,CM. VILLA BRUZUAL,JARDIN DE INFANCIA VILLA BRUZUAL,570,1,5,444,344,439,0,2,0,0,93,444
EDO. PORTUGUESA,MP. TUREN,CM. VILLA BRUZUAL,ESCUELA ESTADAL CONCENTRADA BASICA ASEQUIONCITO 415,132,1,1,121,115,120,0,0,0,0,5,121
EDO. PORTUGUESA,MP. TUREN,CM. VILLA BRUZUAL,ESCUELA BASICA CONCENTRADA NUMERO 410,567,1,5,463,416,458,0,3,0,0,39,463
EDO. PORTUGUESA,MP. TUREN,CM. VILLA BRUZUAL,CICLO BASICO TUREN,2368,5,40,1948,1316,1908,2,13,1,0,576,1948
EDO. PORTUGUESA,MP. TUREN,CM. VILLA BRUZUAL,ESCUELA BASICA ESTADAL NUMERO 435 LA ADUANA,464,1,9,404,317,395,0,5,0,0,73,404
EDO. PORTUGUESA,MP. TUREN,CM. VILLA BRUZUAL,ESCUELA BOLIVARIANA DOCTOR ANGEL RIVAS BALDWIN,2408,5,27,1813,1230,1786,1,13,0,1,541,1813
EDO. PORTUGUESA,MP. TUREN,CM. VILLA BRUZUAL,ESCUELA BASICA CARLOS GAUNA,627,2,12,553,390,541,0,3,0,0,148,553
EDO. PORTUGUESA,MP. TUREN,CM. VILLA BRUZUAL,ESCUELA BOLIVARIANA EL JOBAL,373,1,4,280,186,276,0,0,0,1,89,280
EDO. PORTUGUESA,MP. TUREN,CM. VILLA BRUZUAL,CENTRO EDUCACION INICIAL SIMONCITO CIUDAD DE MERIDA,832,2,13,712,501,699,0,2,0,0,196,712
EDO. PORTUGUESA,MP. TUREN,CM. VILLA BRUZUAL,UNIDAD EDUCATIVA EL ASEQUION,436,1,4,341,311,337,0,1,0,2,23,341
EDO. PORTUGUESA,MP. TUREN,CM. VILLA BRUZUAL,UNIDAD EDUCATIVA INSTITUTO ANDRES BELLO,1563,3,20,1338,621,1318,0,7,0,0,690,1338
EDO. PORTUGUESA,MP. TUREN,PQ. CANELONES,ESCUELA BOLIVARIANA LA CEIBA,704,2,13,603,461,590,0,2,0,0,127,603
EDO. PORTUGUESA,MP. TUREN,PQ. CANELONES,ESCUELA BASICA LA MISION,2927,5,41,2400,2040,2359,1,13,1,0,304,2400
EDO. PORTUGUESA,MP. TUREN,PQ. CANELONES,UNIDAD EDUCATIVA ESTADAL ANTONIO JOSE DE SUCRE,868,2,23,729,550,706,0,4,4,0,148,729
EDO. PORTUGUESA,MP. TUREN,PQ. CANELONES,ESCUELA BASICA ESTADAL NUMERO 514,120,1,1,114,107,113,0,2,0,0,4,114
EDO. PORTUGUESA,MP. TUREN,PQ. CANELONES,ESCUELA ESTADAL CONCENTRADA NUMERO 146,392,1,2,334,296,332,0,1,0,0,35,334
EDO. PORTUGUESA,MP. TUREN,PQ. CANELONES,ESCUELA ESTADAL NUMERO 145,176,1,4,163,151,159,0,0,0,0,8,163
EDO. PORTUGUESA,MP. TUREN,PQ. CANELONES,ESCUELA BASICA ESTADAL NUMERO 411,481,1,13,430,337,417,0,4,0,0,76,430
EDO. PORTUGUESA,MP. TUREN,PQ. SANTA CRUZ,ESCUELA BASICA ESTADAL CONCENTRADA NUMERO 496 LOS CABALLOS,130,1,0,107,86,107,0,1,1,0,19,107
EDO. PORTUGUESA,MP. TUREN,PQ. SANTA CRUZ,ESCUELA ESTADAL CONCENTRADA SANTA ROSA NUMERO 420,505,1,7,391,353,384,0,1,1,0,29,391
EDO. PORTUGUESA,MP. TUREN,PQ. SANTA CRUZ,ESCUELA BOLIVARIANA LA REFORMA,297,1,2,228,186,226,0,4,1,0,35,228
EDO. PORTUGUESA,MP. TUREN,PQ. SANTA CRUZ,ESCUELA BASICA CONCENTRADA MERECURE,192,1,4,142,120,138,0,1,0,0,17,142
EDO. PORTUGUESA,MP. TUREN,PQ. SANTA CRUZ,ESCUELA BASICA ESTADAL ALIDA AGUILERA DE NOGUERA,2001,4,45,1510,1194,1465,2,12,5,1,251,1510
EDO. PORTUGUESA,MP. TUREN,PQ. SANTA CRUZ,ESCUELA ESTADAL CONCENTRADA NUMERO 141,226,1,11,184,161,173,0,0,2,0,10,184
EDO. PORTUGUESA,MP. PAPELON,CM. PAPELON,ESCUELA ESTADAL BASICA CONCENTRADA NUMERO 26,874,2,9,712,425,703,0,5,0,0,273,712
EDO. PORTUGUESA,MP. PAPELON,CM. PAPELON,ESCUELA BASICA CIUDAD DE SAN FELIPE,1713,3,35,1375,643,1340,1,9,1,0,686,1375
EDO. PORTUGUESA,MP. PAPELON,CM. PAPELON,ESCUELA CONCENTRADA NUMERO 497,428,1,11,328,244,317,0,2,1,0,70,328
EDO. PORTUGUESA,MP. PAPELON,CM. PAPELON,UNIDAD EDUCATIVA LUIS ANTONIO CASTILLO,1527,3,28,1272,646,1244,1,5,1,0,591,1272
EDO. PORTUGUESA,MP. PAPELON,CM. PAPELON,ESCUELA ESTADAL UNITARIA NUMERO 70
EDO. PORTUGUESA,MP. PAPELON,PQ. CA#O DELGADITO,ESCUELA BASICA CONCENTRADA NUMERO 20,644,2,5,522,420,517,2,3,0,0,92,522
EDO. PORTUGUESA,MP. PAPELON,PQ. CA#O DELGADITO,ESCUELA MIXTA COROZAL NUMERO 30 40,249,1,1,210,189,209,0,0,3,1,16,210
EDO. PORTUGUESA,MP. PAPELON,PQ. CA#O DELGADITO,ESCUELA ESTADAL CONCENTRADA NUMERO 17
EDO. PORTUGUESA,MP. PAPELON,PQ. CA#O DELGADITO,ESCUELA ESTADAL CONCENTRADA NUMERO 30,361,1,4,277,180,273,0,0,1,0,92,277
EDO. PORTUGUESA,MP. PAPELON,PQ. CA#O DELGADITO,ESCUELA BASICA CONCENTRADA NUMERO 119
EDO. PORTUGUESA,MP. PAPELON,PQ. CA#O DELGADITO,ESCUELA BASICA JOSE ANTONIO PAEZ,850,2,15,660,592,645,0,2,2,0,49,660
EDO. PORTUGUESA,MP. PAPELON,PQ. CA#O DELGADITO,ESCUELA ESTADAL UNITARIA NUMERO 57 SABANA DULCE
EDO. PORTUGUESA,MP. PAPELON,PQ. CA#O DELGADITO,ESCUELA ESTADAL BASICA NUMERO 28 CAÑO DELGADITO,409,1,5,311,270,306,1,4,0,0,31,311
EDO. PORTUGUESA,MP. PAPELON,PQ. CA#O DELGADITO,ESCUELA ESTADAL BASICA NUMERO 29,787,2,20,657,504,637,0,7,1,0,125,657
EDO. PORTUGUESA,MP. PAPELON,PQ. CA#O DELGADITO,ESCUELA BASICA UNITARIA NUMERO 60,161,1,3,121,99,118,1,0,0,0,18,121
EDO. PORTUGUESA,MP. PAPELON,PQ. CA#O DELGADITO,ESCUELA BASICA CONCENTRADA NUMERO 19 SAN ANDRES,220,1,4,195,159,191,0,1,0,0,31,195
EDO. PORTUGUESA,MP. PAPELON,PQ. CA#O DELGADITO,ESCUELA ESTADAL UNITARIA NUMERO 61,198,1,2,160,145,158,0,1,0,0,12,160
EDO. PORTUGUESA,MP. PAPELON,PQ. CA#O DELGADITO,ESCUELA BASICA DOCTOR RAFAEL QUINTERO SERRA,1256,3,32,972,768,940,0,4,0,0,168,972
EDO. PORTUGUESA,MP. PAPELON,PQ. CA#O DELGADITO,ESCUELA FE Y ESPERANZA,131,1,6,125,109,119,0,1,0,0,9,125
EDO. PORTUGUESA,MP. AGUA BLANCA,CM. AGUA BLANCA,ESCUELA BOLIVARIANA MAZATO,123,1,2,112,108,110,0,0,0,0,2,112
EDO. PORTUGUESA,MP. AGUA BLANCA,CM. AGUA BLANCA,ESCUELA CONCENTRADA NUMERO 180,231,1,5,219,198,214,0,1,0,0,15,219
EDO. PORTUGUESA,MP. AGUA BLANCA,CM. AGUA BLANCA,ESCUELA ESTADAL CONCENTRADA NUMERO 2474,1369,3,34,1212,990,1178,0,8,1,2,177,1212
EDO. PORTUGUESA,MP. AGUA BLANCA,CM. AGUA BLANCA,CENTRO EDUCACION INICIAL PARAISO INFANTIL,236,1,7,211,163,204,0,3,0,0,38,211
EDO. PORTUGUESA,MP. AGUA BLANCA,CM. AGUA BLANCA,CENTRO EDUCACION INICIAL BOLIVARIANO COLINAS DE SANTA CLARA,413,1,5,376,302,371,0,3,0,0,66,376
EDO. PORTUGUESA,MP. AGUA BLANCA,CM. AGUA BLANCA,ESCUELA NACIONAL CONCENTRADA QUEBRADA HONDA,508,1,7,457,409,450,0,1,0,0,40,457
EDO. PORTUGUESA,MP. AGUA BLANCA,CM. AGUA BLANCA,ESCUELA BASICA ATAPAIMA,3082,6,48,2467,1568,2419,3,19,2,2,825,2467
EDO. PORTUGUESA,MP. AGUA BLANCA,CM. AGUA BLANCA,ESCUELA ESTADAL UNITARIA NUMERO 178,304,1,6,269,192,263,0,1,1,0,69,269
EDO. PORTUGUESA,MP. AGUA BLANCA,CM. AGUA BLANCA,LICEO OSCAR PICON GIACOPPINI,1608,3,44,1401,980,1357,2,7,0,0,368,1401
EDO. PORTUGUESA,MP. AGUA BLANCA,CM. AGUA BLANCA,ESCUELA NACIONAL CONCENTRADA LA ESPERANZA,565,1,6,475,424,469,0,2,0,1,42,475
EDO. PORTUGUESA,MP. AGUA BLANCA,CM. AGUA BLANCA,CENTRO EDUCACION INICIAL LOS RETOÑITOS,349,1,8,327,257,319,0,0,1,0,61,327
EDO. PORTUGUESA,MP. AGUA BLANCA,CM. AGUA BLANCA,ESCUELA ESTADAL UNITARIA NUMERO 169,305,1,3,265,222,262,0,0,0,0,40,265
EDO. PORTUGUESA,MP. AGUA BLANCA,CM. AGUA BLANCA,ESCUELA ESTADAL 250 AÑOS DE AGUA BLANCA,1651,3,42,1430,1147,1388,0,3,3,0,235,1430
EDO. PORTUGUESA,MP. AGUA BLANCA,CM. AGUA BLANCA,ESCUELA BOLIVARIANA EL HATICO,131,1,6,120,108,114,0,0,0,0,6,120
EDO. PORTUGUESA,MP. AGUA BLANCA,CM. AGUA BLANCA,ESCUELA CONCENTRADA NUMERO 768,512,1,11,438,389,427,0,1,0,0,37,438
EDO. PORTUGUESA,MP. AGUA BLANCA,CM. AGUA BLANCA,ESCUELA NACIONAL EL TOCUYANO,879,2,9,768,735,759,0,2,1,0,21,768
EDO. PORTUGUESA,MP. AGUA BLANCA,CM. AGUA BLANCA,UNIDAD EDUCATIVA ESTADAL GUMERSINDO MARTINEZ,1115,2,38,945,705,907,1,1,2,0,198,945
EDO. PORTUGUESA,MP. AGUA BLANCA,CM. AGUA BLANCA,ESCUELA LA APISA,340,1,1,293,287,292,0,0,0,0,5,293
EDO. PORTUGUESA,MP. AGUA BLANCA,CM. AGUA BLANCA,ESCUELA NACIONAL CONCENTRADA PIRITAL,493,1,3,420,394,417,0,1,0,0,22,420
EDO. PORTUGUESA,MP. ARAURE,CM. ARAURE,ESCUELA NACIONAL NUMERO 3765,459,1,16,376,295,360,0,2,1,0,62,376
EDO. PORTUGUESA,MP. ARAURE,CM. ARAURE,UNIVERSIDAD NACIONAL YACAMBU,1451,3,16,1357,388,1341,0,6,0,0,947,1357
EDO. PORTUGUESA,MP. ARAURE,CM. ARAURE,UNIDAD EDUCATIVA BOLIVARIANA NACIONAL VILLAS DEL PILAR,2974,6,45,2652,1284,2607,2,12,1,2,1306,2652
EDO. PORTUGUESA,MP. ARAURE,CM. ARAURE,MODULO INTEGRAL DE BIENESTAR ESTUDIANTIL NIBE,1189,2,18,1018,792,1000,0,5,1,0,202,1018
EDO. PORTUGUESA,MP. ARAURE,CM. ARAURE,PRE ESCOLAR LAS PALMITAS,1097,2,23,863,649,840,0,5,0,0,186,863
EDO. PORTUGUESA,MP. ARAURE,CM. ARAURE,ESCUELA BASICA MONSEÑOR OMAR RAMOS CORDERO,3480,7,71,2834,2202,2763,1,17,2,3,538,2834
EDO. PORTUGUESA,MP. ARAURE,CM. ARAURE,ESCUELA BASICA 13 DE JUNIO,1037,2,14,837,612,823,1,2,2,0,206,837
EDO. PORTUGUESA,MP. ARAURE,CM. ARAURE,ESCUELA BASICA OMAR RAMOS CORDERO 3,2390,5,37,1954,1578,1917,0,12,0,0,327,1954
EDO. PORTUGUESA,MP. ARAURE,CM. ARAURE,ESCUELA BASICA GENERAL PAEZ,2498,5,21,2061,1208,2040,2,11,1,0,818,2061
EDO. PORTUGUESA,MP. ARAURE,CM. ARAURE,ESCUELA NACIONAL NUMERO 3332 Y 202,623,2,12,506,417,494,0,3,0,0,74,506
EDO. PORTUGUESA,MP. ARAURE,CM. ARAURE,ESCUELA BASICA YOLANDA RIVERA DE PIERUZZINI,3657,7,53,3189,2307,3136,0,21,1,2,805,3189
EDO. PORTUGUESA,MP. ARAURE,CM. ARAURE,UNIDAD EDUCATIVA NACIONAL SAMUEL ROBINSON,1686,3,39,1506,1083,1467,1,3,1,1,378,1506
EDO. PORTUGUESA,MP. ARAURE,CM. ARAURE,UNIVERSIDAD NACIONAL ABIERTA NUCLEO ARAURE,771,2,23,715,302,692,0,0,0,2,388,715
EDO. PORTUGUESA,MP. ARAURE,CM. ARAURE,ESC. BASC. ANTONIO JOSE DE SUCRE,121,1,4,109,102,105,0,0,0,0,3,109
EDO. PORTUGUESA,MP. ARAURE,CM. ARAURE,ESCUELA BASICA OSCAR MENDOZA,1529,3,48,1344,1161,1296,0,4,1,0,130,1344
EDO. PORTUGUESA,MP. ARAURE,CM. ARAURE,ESCUELA BASICA BOLIVARIANA DESARROLLO CAMBURITO,1678,3,22,1483,763,1461,0,6,1,2,689,1483
EDO. PORTUGUESA,MP. ARAURE,CM. ARAURE,ESCUELA BASICA BOLIVARIANA NUESTRA SEÑORA DEL PILAR,1274,3,11,1110,388,1099,0,4,0,0,707,1110
EDO. PORTUGUESA,MP. ARAURE,CM. ARAURE,ESCUELA ESTADAL CONCENTRADA NUMERO 179 QUEBRADA DE ARMO,1140,2,21,1020,834,999,0,4,1,0,160,1020
EDO. PORTUGUESA,MP. ARAURE,CM. ARAURE,ESCUELA BASICA CARLOS ALBERTO PELAYO,1729,3,33,1390,829,1357,1,4,0,1,522,1390
EDO. PORTUGUESA,MP. ARAURE,CM. ARAURE,UNIDAD EDUCATIVA ESTADAL LOS BOTALONES,399,1,3,281,208,278,1,0,0,1,68,281
EDO. PORTUGUESA,MP. ARAURE,CM. ARAURE,EDIFICIO BANCO DE DESARROLLO AGROPECUARIO (BANDAGRO),263,1,1,214,132,213,0,1,0,0,80,214
EDO. PORTUGUESA,MP. ARAURE,CM. ARAURE,PRE   ESCOLAR SIMONCITO,1405,3,40,1280,907,1240,1,5,1,0,326,1280
EDO. PORTUGUESA,MP. ARAURE,CM. ARAURE,GRUPO ESCOLAR BATALLA DE ARAURE,2436,5,61,2141,1145,2080,2,12,0,1,920,2141
EDO. PORTUGUESA,MP. ARAURE,CM. ARAURE,ESCUELA BASICA TRICENTENARIA DE ARAURE,2779,5,27,2299,2032,2272,0,9,0,0,231,2299
EDO. PORTUGUESA,MP. ARAURE,CM. ARAURE,ESCUELA BASICA NEREIDA MORENO DE DUGARTE,1507,3,19,1330,796,1311,0,12,2,1,500,1330
EDO. PORTUGUESA,MP. ARAURE,CM. ARAURE,ESCUELA BASICA GENERAL JUAN GUILLERMO IRIBARREN,2766,5,52,2392,1815,2340,1,15,2,3,504,2392
EDO. PORTUGUESA,MP. ARAURE,CM. ARAURE,ESCUELA ESTADAL NUMERO 175,812,2,7,666,553,659,1,5,2,0,98,666
EDO. PORTUGUESA,MP. ARAURE,CM. ARAURE,ESCUELA BASICA CIUDAD DE ARAURE,1836,4,10,1574,292,1564,0,7,0,0,1265,1574
EDO. PORTUGUESA,MP. ARAURE,CM. ARAURE,ESCUELA BASICA FRANCISCO DE MIRANDA,2548,5,53,2103,1246,2050,2,3,3,0,796,2103
EDO. PORTUGUESA,MP. ARAURE,CM. ARAURE,ESCUELA ESTADAL NUMERO 194,387,1,2,290,279,288,0,1,0,0,8,290
EDO. PORTUGUESA,MP. ARAURE,CM. ARAURE,CENTRO PRE ESCOLAR AÑO INTERNACIONAL DEL NIÑO,1825,4,58,1621,860,1563,0,12,0,5,686,1621
EDO. PORTUGUESA,MP. ARAURE,CM. ARAURE,CENTRO PRE ESCOLAR ANDRES BELLO,449,1,5,401,320,396,0,2,0,0,74,401
EDO. PORTUGUESA,MP. ARAURE,CM. ARAURE,CICLO COMBINADO JUAN PABLO PEREZ GRATEROL,764,2,17,666,476,649,0,5,1,0,167,666
EDO. PORTUGUESA,MP. ARAURE,CM. ARAURE,CICLO COMBINADO HILARION LOPEZ,1831,4,29,1423,530,1394,0,9,0,1,854,1423
EDO. PORTUGUESA,MP. ARAURE,CM. ARAURE,INSTITUTO MUNICIPAL DE RECREACIÓN DEPORTIVA ARAURE,1482,3,31,1248,626,1217,1,10,1,0,579,1248
EDO. PORTUGUESA,MP. ARAURE,CM. ARAURE,ESCUELA GRADUADA TAPA DE PIEDRA,2643,5,45,2313,1981,2268,1,12,3,0,271,2313
EDO. PORTUGUESA,MP. ARAURE,CM. ARAURE,JARDIN DE INFANCIA LA LAGUNITA,2203,4,21,1919,1579,1898,2,13,1,3,300,1919
EDO. PORTUGUESA,MP. ARAURE,CM. ARAURE,ESCUELA ESTADAL BETTY URDANETA DE HERRERA,845,2,12,748,670,736,0,1,0,1,64,748
EDO. PORTUGUESA,MP. ARAURE,CM. ARAURE,INSTITUTO EDUCATIVO INICIAL SIMÓN BOLÍVAR,570,1,3,463,243,460,0,1,0,0,216,463
EDO. PORTUGUESA,MP. ARAURE,CM. ARAURE,ESCUELA BASICA UNITARIA NUMERO 173,206,1,3,139,132,136,1,0,1,0,2,139
EDO. PORTUGUESA,MP. ARAURE,CM. ARAURE,COLEGIO UNIVERSITARIO FERMÍN TORO,1873,4,20,1560,737,1540,1,10,1,1,790,1560
EDO. PORTUGUESA,MP. ARAURE,CM. ARAURE,UNIDAD EDUCATIVA NACIONAL LA LUCIA,1133,2,25,914,717,889,0,5,0,0,167,914
EDO. PORTUGUESA,MP. ARAURE,CM. ARAURE,ESCUELA NACIONAL UNITARIA NUMERO 76,349,1,4,309,278,305,0,0,0,0,27,309
EDO. PORTUGUESA,MP. ARAURE,CM. ARAURE,ESCUELA CONCENTRADA MIXTA MIRAFLORES,1019,2,18,873,701,855,0,3,2,1,148,873
EDO. PORTUGUESA,MP. ARAURE,CM. ARAURE,ESCUELA ESTADAL CONCENTRADA NUMERO 164 EL JOBITO,623,2,15,546,393,531,1,4,1,0,132,546
EDO. PORTUGUESA,MP. ARAURE,CM. ARAURE,ASILO DE ANCIANOS,477,1,4,372,188,368,0,1,0,1,178,372
EDO. PORTUGUESA,MP. ARAURE,CM. ARAURE,ESCUELA BASICA ALI PRIMERA,3361,6,85,2753,2278,2668,0,7,2,1,380,2753
EDO. PORTUGUESA,MP. ARAURE,CM. ARAURE,ESCUELA ESTADAL NUMERO 1,473,1,1,361,349,360,0,3,0,0,8,361
EDO. PORTUGUESA,MP. ARAURE,CM. ARAURE,CENTRO PREESCOLAR EL PERIQUITO,168,1,0,153,130,153,0,0,0,0,23,153
EDO. PORTUGUESA,MP. ARAURE,CM. ARAURE,ESCUELA BOLIVARIANA GUACUY II,212,1,2,203,179,201,0,0,0,0,22,203
EDO. PORTUGUESA,MP. ARAURE,CM. ARAURE,CENTRO PRE ESCOLAR BARAURE III,1283,3,17,1045,826,1028,0,11,0,1,190,1045
EDO. PORTUGUESA,MP. ARAURE,CM. ARAURE,PREESCOLAR SIMON BOLIVAR,287,1,9,264,236,255,0,0,0,0,19,264
EDO. PORTUGUESA,MP. ARAURE,CM. ARAURE,JARDIN ESCOLAR ARAURE, (INAM),1376,3,25,1198,899,1173,0,3,1,1,269,1198
EDO. PORTUGUESA,MP. ARAURE,CM. ARAURE,ESCUELA NACIONAL CONCENTRADA NUMERO 3348 1880,984,2,19,797,644,778,0,8,1,0,125,797
EDO. PORTUGUESA,MP. ARAURE,CM. ARAURE,ESCUELA CONCENTRADA NACIONAL NUMERO 3751 POTRERO DE ARMO,528,1,11,475,419,464,0,0,0,0,45,475
EDO. PORTUGUESA,MP. ARAURE,CM. ARAURE,COLEGIO GRAN MARISCAL DE AYACUCHO,904,2,11,805,317,794,1,2,0,0,474,805
EDO. PORTUGUESA,MP. ARAURE,CM. ARAURE,ESCUELA ESTADAL CONCENTRADA NUMERO 161,1337,3,9,1069,685,1060,3,7,0,1,364,1069
EDO. PORTUGUESA,MP. ARAURE,CM. ARAURE,ESCUELA ESTADAL CONCENTRADA NUMERO 160,1028,2,6,918,172,912,0,2,0,1,737,918
EDO. PORTUGUESA,MP. ARAURE,CM. ARAURE,ESCUELA ESTADAL CONCENTRADA NUMERO 163,709,2,13,648,543,635,1,4,1,0,86,648
EDO. PORTUGUESA,MP. ARAURE,CM. ARAURE,ESCUELA ESTADAL NUMERO 176 GUAIMARAL,381,1,15,325,255,310,0,2,0,0,53,325
EDO. PORTUGUESA,MP. ARAURE,CM. ARAURE,ESCUELA BASICA NUMERO 440,87,1,0,73,72,73,0,0,1,0,0,73
EDO. PORTUGUESA,MP. ARAURE,CM. ARAURE,ESCUELA BASICA CONCENTRADA NUMERO 190,239,1,0,182,175,182,0,2,0,0,5,182
EDO. PORTUGUESA,MP. ARAURE,PQ. RIO ACARIGUA,ESCUELA BOLIVARIANA 22403,173,1,2,150,144,148,0,0,0,0,4,150
EDO. PORTUGUESA,MP. ARAURE,PQ. RIO ACARIGUA,ESCUELA ESTADAL UNITARIA NUMERO 321,797,2,6,593,555,587,0,2,2,0,28,593
EDO. PORTUGUESA,MP. ARAURE,PQ. RIO ACARIGUA,ESCUELA ESTADAL UNITARIA 184 LAS MESAS,164,1,3,155,147,152,0,1,1,0,3,155
EDO. PORTUGUESA,MP. ARAURE,PQ. RIO ACARIGUA,ESCUELA BASICA LISANDRO ALVARADO,2690,5,28,2196,1712,2168,1,10,3,0,442,2196
EDO. PORTUGUESA,MP. ARAURE,PQ. RIO ACARIGUA,ESCUELA NACIONAL CONCENTRADA NUMERO 170 LA ROGEÑA,424,1,7,352,320,345,1,0,0,0,24,352
EDO. PORTUGUESA,MP. ARAURE,PQ. RIO ACARIGUA,ESCUELA ESTADAL UNITARIA NUMERO 185,662,2,3,558,524,555,1,6,1,0,23,558
EDO. PORTUGUESA,MP. ARAURE,PQ. RIO ACARIGUA,ESCUELA ESTADAL UNITARIA NUMERO 184,578,1,6,409,374,403,0,1,1,1,26,409
EDO. PORTUGUESA,MP. ARAURE,PQ. RIO ACARIGUA,ESCUELA ESTADAL CONCENTRADA MIXTA NUMERO 171,463,1,6,369,338,363,1,3,0,0,21,369
EDO. PORTUGUESA,MP. ARAURE,PQ. RIO ACARIGUA,UNIDAD EDUCATIVA NACIONAL MANUEL BARRIOS FREITEZ,1728,3,43,1449,1156,1406,0,5,2,0,243,1449
EDO. PORTUGUESA,MP. SUCRE,PQ. SAN JOSE DE SAGUAZ,ESCUELA ESTADAL UNITARIA N° 254 EL ALTO DE SAGUAZ,104,1,0,92,67,92,0,1,0,0,24,92
EDO. PORTUGUESA,MP. SUCRE,PQ. SAN JOSE DE SAGUAZ,ESCUELA BASICA UNITARIA NUMERO 256,123,1,2,113,84,111,0,1,0,0,26,113
EDO. PORTUGUESA,MP. SUCRE,PQ. SAN JOSE DE SAGUAZ,ESCUELA CONCENTRADA MIXTA NUMERO 217 105 2174,817,2,18,626,440,608,0,5,2,0,161,626
EDO. PORTUGUESA,MP. SUCRE,PQ. SAN JOSE DE SAGUAZ,ESCUELA ESTADAL CONCENTRADA,397,1,9,344,274,335,0,0,0,0,61,344
EDO. PORTUGUESA,MP. SUCRE,PQ.SAN RAFAEL PALO ALZADO,ESCUELA BASICA UNITARIA SIN NUMERO,316,1,9,265,230,256,0,1,0,0,25,265
EDO. PORTUGUESA,MP. SUCRE,PQ.SAN RAFAEL PALO ALZADO,ESCUELA BASICA PALO ALSADO,923,2,9,703,437,694,0,3,0,0,254,703
EDO. PORTUGUESA,MP. SUCRE,PQ.SAN RAFAEL PALO ALZADO,ESCUELA ESTADAL CONCENTRADA NUMERO 213,256,1,5,204,111,199,0,0,2,0,86,204
EDO. PORTUGUESA,MP. SUCRE,PQ.SAN RAFAEL PALO ALZADO,ESCUELA NACIONAL CONCENTRADA NUMERO 203,300,1,5,246,189,241,0,1,0,0,51,246
EDO. PORTUGUESA,MP. SUCRE,PQ.SAN RAFAEL PALO ALZADO,ESCUELA NACIONAL CONCENTRADA NUMERO 1788,661,2,12,531,407,519,0,1,0,0,111,531
EDO. PORTUGUESA,MP. SUCRE,CM. BISCUCUY,ESCUELA ESTADAL CIUDAD DE BISCUCUY,663,2,13,595,331,582,1,3,0,0,247,595
EDO. PORTUGUESA,MP. SUCRE,CM. BISCUCUY,ESCUELA ESTADAL UNITARIA NUMERO 234 SANTO CRISTO,1099,2,39,911,712,872,1,1,1,1,156,911
EDO. PORTUGUESA,MP. SUCRE,CM. BISCUCUY,ESCUELA BASICA MESA DE LAS PIÑAS,621,2,35,546,372,511,0,2,0,0,137,546
EDO. PORTUGUESA,MP. SUCRE,CM. BISCUCUY,ESCUELA BASICA JAIME CAZORLA,3133,6,67,2423,1127,2356,1,10,1,2,1215,2423
EDO. PORTUGUESA,MP. SUCRE,CM. BISCUCUY,UNIDAD EDUCATIVA SALUDABLE ARGIMIRO GABALDON,845,2,27,739,368,712,0,2,0,0,342,739
EDO. PORTUGUESA,MP. SUCRE,CM. BISCUCUY,ESCUELA ESTADAL CONCENTRADA NUMERO 223,531,1,9,448,345,439,0,2,1,0,91,448
EDO. PORTUGUESA,MP. SUCRE,CM. BISCUCUY,ESCUELA BASICA GUILLERMO GAMARRA MARRERO,2242,4,59,1827,1039,1768,1,12,1,0,715,1827
EDO. PORTUGUESA,MP. SUCRE,CM. BISCUCUY,ESCUELA BASICA ESTADAL UNITARIA NUMERO 236 EL CACHO,131,1,5,118,88,113,0,1,0,0,24,118
EDO. PORTUGUESA,MP. SUCRE,CM. BISCUCUY,PRE ESCOLAR LAS MONTAÑITAS,904,2,22,815,431,793,0,7,0,0,355,815
EDO. PORTUGUESA,MP. SUCRE,CM. BISCUCUY,LICEO FERNANDO DELGADO LOZANO,1031,2,27,865,402,838,0,10,0,0,426,865
EDO. PORTUGUESA,MP. SUCRE,CM. BISCUCUY,ESCUELA CONCENTRADA MIXTA NUMERO 226 JOSE DE CRUZ MANZANILLA,476,1,10,348,214,338,0,1,1,0,122,348
EDO. PORTUGUESA,MP. SUCRE,CM. BISCUCUY,ESCUELA ESTADAL CONCENTRADA NUMERO 210,379,1,7,307,226,300,0,6,1,0,67,307
EDO. PORTUGUESA,MP. SUCRE,CM. BISCUCUY,ESCUELA ESTADAL UNITARIA NUMERO 237,289,1,1,222,182,221,0,2,0,0,37,222
EDO. PORTUGUESA,MP. SUCRE,CM. BISCUCUY,ESCUELA ROMULO GALLEGOS,1062,2,15,897,471,882,0,3,0,0,408,897
EDO. PORTUGUESA,MP. SUCRE,CM. BISCUCUY,CENTRO EDUCACION INICIAL ARGEMIRO GABALDON,321,1,4,293,229,289,0,0,0,0,60,293
EDO. PORTUGUESA,MP. SUCRE,CM. BISCUCUY,ESCUELA BASICA CONCENTRADA NUMERO 225,300,1,5,262,194,257,0,2,0,0,61,262
EDO. PORTUGUESA,MP. SUCRE,PQ. UVENCIO A VELASQUEZ,E.B.E. CONCENTRADA N° 238 EL NUEZAL II,96,1,0,82,70,82,0,1,0,0,11,82
EDO. PORTUGUESA,MP. SUCRE,PQ. UVENCIO A VELASQUEZ,ESCUELA BASICA CONCENTRADA NUMERO 043 PECHO DE SALVAJE,140,1,7,120,98,113,0,3,0,0,12,120
EDO. PORTUGUESA,MP. SUCRE,PQ. UVENCIO A VELASQUEZ,ESCUELA ESTADAL CONCENTRADA NUMERO 224,582,1,7,472,316,465,0,3,0,0,146,472
EDO. PORTUGUESA,MP. SUCRE,PQ. UVENCIO A VELASQUEZ,ESCUELA BASICA CONCENTRADA NUMERO 255,280,1,2,211,135,209,1,0,0,0,73,211
EDO. PORTUGUESA,MP. SUCRE,PQ. UVENCIO A VELASQUEZ,ESCUELA BASICA VICTOR RAMOS VALDERRAMA,2619,5,47,2015,1399,1968,0,8,3,0,558,2015
EDO. PORTUGUESA,MP. SUCRE,PQ. UVENCIO A VELASQUEZ,ESCUELA BASICA UNITARIA SIN NUMERO,453,1,2,360,159,358,0,1,1,0,197,360
EDO. PORTUGUESA,MP. SUCRE,PQ. UVENCIO A VELASQUEZ,ESCUELA ESTADAL UNITARIA NUMERO 240,380,1,2,275,226,273,0,0,0,0,47,275
EDO. PORTUGUESA,MP. SUCRE,PQ. CONCEPCION,ESCUELA ESTADAL CONCENTRADA MIXTA NUMERO 276,313,1,2,240,192,238,0,0,0,0,46,240
EDO. PORTUGUESA,MP. SUCRE,PQ. CONCEPCION,ESCUELA BASICA CONCENTRADA NUMERO 543,230,1,6,197,177,191,0,0,0,0,14,197
EDO. PORTUGUESA,MP. SUCRE,PQ. CONCEPCION,ESCUELA NACIONAL CONCENTRADA NUMERO 3832,528,1,2,415,381,413,0,1,0,0,31,415
EDO. PORTUGUESA,MP. SUCRE,PQ. CONCEPCION,E.B.N. CONCENTRADA N° 281 EL MORICHAL,129,1,8,119,109,111,0,0,0,0,2,119
EDO. PORTUGUESA,MP. SUCRE,PQ. CONCEPCION,ESCUELA ESTADAL UNITARIA NUMERO 268,361,1,9,258,135,249,1,0,0,0,113,258
EDO. PORTUGUESA,MP. SUCRE,PQ. CONCEPCION,ESCUELA ESTADAL CONCENTRADA NUMERO 219,462,1,2,346,252,344,0,2,0,0,90,346
EDO. PORTUGUESA,MP. SUCRE,PQ. CONCEPCION,ESCUELA ESTADAL CONCENTRADA NUMERO 218,878,2,24,639,442,615,0,5,1,0,167,639
EDO. PORTUGUESA,MP. SUCRE,PQ. VILLA ROSA,ESCUELA BASICA VILLA ROSA,1053,2,8,822,479,814,0,4,5,3,323,822
EDO. PORTUGUESA,MP. SUCRE,PQ. VILLA ROSA,ESCUELA BASICA CONCENTRADA NUMERO 233,236,1,5,219,166,214,0,1,0,0,47,219
EDO. PORTUGUESA,MP. SUCRE,PQ. VILLA ROSA,ESCUELA ESTADAL CONCENTRADA NUMERO 227,339,1,5,245,167,240,1,1,1,0,70,245
EDO. PORTUGUESA,MP. SUCRE,PQ. VILLA ROSA,ESCUELA BASICA CONCENTRADA MIXTA NUMERO 207,368,1,4,287,220,283,0,1,0,0,62,287
EDO. PORTUGUESA,MP. SUCRE,PQ. VILLA ROSA,ESCUELA ESTADAL CONCENTRADA NUMERO 231,758,2,10,625,426,615,0,6,0,0,183,625
EDO. PORTUGUESA,MP. SUCRE,PQ. VILLA ROSA,ESCUELA ESTADAL CONCENTRADA NUMERO 230,538,1,3,430,397,427,0,1,0,0,29,430
EDO. PORTUGUESA,MP. SUCRE,PQ. VILLA ROSA,ESCUELA ESTADAL CONCENTRADA NUMERO 206,294,1,6,262,169,256,0,1,0,0,86,262
EDO. PORTUGUESA,MP. SUCRE,PQ. VILLA ROSA,ESCUELA BASICA CONCENTRADA NUMERO 238,207,1,4,180,151,176,0,0,0,0,25,180
EDO. PORTUGUESA,MP. SUCRE,PQ. VILLA ROSA,ESCUELA ESTADAL CONCENTRADA NUMERO 244,314,1,5,259,223,254,0,2,0,0,29,259
EDO. PORTUGUESA,MP. SUCRE,PQ. VILLA ROSA,ESCUELA ESTADAL NUMERO 259,213,1,4,177,101,173,0,1,0,0,71,177
EDO. PORTUGUESA,MP. M.JOSE V DE UNDA,PQ. PE#A BLANCA,LICEO BOLIVARIANO PEÑA BLANCA,730,2,13,610,481,597,0,5,1,0,110,610
EDO. PORTUGUESA,MP. M.JOSE V DE UNDA,PQ. PE#A BLANCA,ESCUELA ESTADAL UNITARIA NUMERO 302 LOS BUCARES,100,1,4,83,51,79,0,1,0,0,27,83
EDO. PORTUGUESA,MP. M.JOSE V DE UNDA,PQ. PE#A BLANCA,ESCUELA BASICA ESTADAL CONCENTRADA NUMERO 316,413,1,6,326,308,320,0,1,0,0,11,326
EDO. PORTUGUESA,MP. M.JOSE V DE UNDA,PQ. PE#A BLANCA,ESCUELA NACIONAL CONCENTRADA NUMERO 189 1170 1184,861,2,9,597,431,588,1,7,0,0,149,597
EDO. PORTUGUESA,MP. M.JOSE V DE UNDA,CM. CHABASQUEN,E.B. CONCENTRADA ESTADAL N° 300 PUEBLO VIEJO,195,1,5,166,136,161,0,0,0,0,25,166
EDO. PORTUGUESA,MP. M.JOSE V DE UNDA,CM. CHABASQUEN,ESCUELA BASICA CONCENTRADA MIXTA NUMERO 285 1785,328,1,3,259,170,256,1,1,0,1,83,259
EDO. PORTUGUESA,MP. M.JOSE V DE UNDA,CM. CHABASQUEN,ESCUELA BASICA CONCENTRADA NUMERO 306 SAN RAFAEL
EDO. PORTUGUESA,MP. M.JOSE V DE UNDA,CM. CHABASQUEN,ESCUELA ESTADAL CONCENTRADA NUMERO 288 EL RINCON,427,1,5,317,261,312,0,4,0,0,47,317
EDO. PORTUGUESA,MP. M.JOSE V DE UNDA,CM. CHABASQUEN,ESCUELA ESTADAL CONCENTRADA NUMERO 506 EL COGOLLAL,104,1,2,88,65,86,0,0,0,0,21,88
EDO. PORTUGUESA,MP. M.JOSE V DE UNDA,CM. CHABASQUEN,MUSEO CHABASQUEN
EDO. PORTUGUESA,MP. M.JOSE V DE UNDA,CM. CHABASQUEN,ESCUELA ESTADAL SANTA ROSA NUMERO 318,458,1,12,379,301,367,0,5,0,0,61,379
EDO. PORTUGUESA,MP. M.JOSE V DE UNDA,CM. CHABASQUEN,CICLO COMBINADO RAMON PAREJO GOMEZ,2227,4,46,1645,973,1599,0,14,1,1,610,1645
EDO. PORTUGUESA,MP. M.JOSE V DE UNDA,CM. CHABASQUEN,LICEO BOLIVARIANO RURAL LA PICA,86,1,1,75,59,74,0,0,0,0,15,75
EDO. PORTUGUESA,MP. M.JOSE V DE UNDA,CM. CHABASQUEN,ESCUELA BASICA ESTADAL CONCENTRADA NUMERO 308 LA GRAN PARADA NER 4,169,1,4,139,126,135,0,0,0,0,9,139
EDO. PORTUGUESA,MP. M.JOSE V DE UNDA,CM. CHABASQUEN,ESCUELA ESTADAL CONCENTRADA NUMERO 240,485,1,5,382,309,377,0,1,0,0,67,382
EDO. PORTUGUESA,MP. M.JOSE V DE UNDA,CM. CHABASQUEN,ESCUELA BASICA ESTADAL CONCENTRADA NUMERO 481 LA GOAJIRITA
EDO. PORTUGUESA,MP. M.JOSE V DE UNDA,CM. CHABASQUEN,ESCUELA BASICA CONCENTRADA NUMERO 310,203,1,4,163,129,159,0,1,1,0,28,163
EDO. PORTUGUESA,MP. M.JOSE V DE UNDA,CM. CHABASQUEN,ESCUELA ESTADAL CONCENTRADA MIXTA NUMERO 291,1161,2,30,778,575,748,0,8,1,0,164,778
EDO. PORTUGUESA,MP. M.JOSE V DE UNDA,CM. CHABASQUEN,CENTRO PREESCOLAR DOCTORA GLADIS DE LUSINCHI,270,1,5,225,153,220,1,0,0,0,66,225
EDO. PORTUGUESA,MP. M.JOSE V DE UNDA,CM. CHABASQUEN,ESCUELA BASICA ESTADAL UNITARIA NUMERO 304,228,1,4,199,167,195,0,1,0,0,27,199
EDO. PORTUGUESA,MP. M.JOSE V DE UNDA,CM. CHABASQUEN,ESCUELA ESTADAL CONCENTRADA NUMERO 294,328,1,4,280,203,276,0,2,0,0,71,280
EDO. PORTUGUESA,MP. M.JOSE V DE UNDA,CM. CHABASQUEN,ESCUELA ESTADAL UNITARIA NUMERO 508,491,1,17,341,245,324,0,6,0,0,73,341
EDO. PORTUGUESA,MP. M.JOSE V DE UNDA,CM. CHABASQUEN,ESCUELA BASICA NUMERO 295,450,1,9,312,275,303,0,0,0,0,28,312
EDO. PORTUGUESA,MP. M.JOSE V DE UNDA,CM. CHABASQUEN,ESCUELA BASICA CONCENTRADA NUMERO 315,202,1,3,154,143,151,0,1,0,0,7,154
EDO. PORTUGUESA,MP. M.JOSE V DE UNDA,CM. CHABASQUEN,ESCUELA ESTADAL UNITARIA NUMERO 317,384,1,6,277,212,271,0,3,0,0,56,277
EDO. PORTUGUESA,MP. M.JOSE V DE UNDA,CM. CHABASQUEN,GRUPO ESCOLAR NACIONAL FRANCISCO DE LA HOZ BERRIOS,129,1,5,107,66,102,0,1,0,0,35,107
EDO. PORTUGUESA,MP. M.JOSE V DE UNDA,CM. CHABASQUEN,ESCUELA ESTADAL UNITARIA NUMERO 312,272,1,3,194,149,191,0,1,0,0,41,194
EDO. PORTUGUESA,MP. M.JOSE V DE UNDA,CM. CHABASQUEN,UNIDAD EDUCATIVA PETRA DE ORELLANA,830,2,15,672,516,657,0,5,2,0,134,672
EDO. PORTUGUESA,MP. M.JOSE V DE UNDA,CM. CHABASQUEN,ESCUELA CONCENTRADA NUMERO 292,476,1,11,336,255,325,1,3,1,0,65,336
EDO. PORTUGUESA,MP. M.JOSE V DE UNDA,CM. CHABASQUEN,ESCUELA BASICA UNITARIA NUMERO 1806,423,1,2,339,291,337,0,0,0,0,46,339
EDO. PORTUGUESA,MP. M.JOSE V DE UNDA,CM. CHABASQUEN,ESCUELA BASICA CONCENTRADA NUMERO 287 EL PUENTE,739,2,14,613,338,599,0,4,0,0,257,613
EDO. PORTUGUESA,MP. M.JOSE V DE UNDA,CM. CHABASQUEN,ESCUELA BASICA CONCENTRADA NUMERO 297,394,1,9,309,236,300,0,1,0,0,63,309
EDO. PORTUGUESA,MP. PAEZ,PQ. PIMPINELA,ESCUELA CONCENTRADA NACIONAL NUMERO 2886,610,2,14,509,470,495,1,1,1,0,22,509
EDO. PORTUGUESA,MP. PAEZ,PQ. PIMPINELA,ESCUELA BASICA PIMPINELA,1994,4,28,1571,1364,1543,2,7,0,0,170,1571
EDO. PORTUGUESA,MP. PAEZ,PQ. PIMPINELA,ESCUELA BASICA CENTRO L,707,2,11,633,556,622,0,3,2,1,60,633
EDO. PORTUGUESA,MP. PAEZ,PQ. PIMPINELA,ESCUELA SIMON RODRIGUEZ LA COCUIZA,359,1,8,296,255,288,0,2,2,0,29,296
EDO. PORTUGUESA,MP. PAEZ,CM. ACARIGUA,ESCUELA BASICA DON ANDRES BELLO,492,1,15,425,382,410,0,0,1,0,27,425
EDO. PORTUGUESA,MP. PAEZ,CM. ACARIGUA,JARDIN DE INFANCIA PROFESORA CARMEN DE FIGUEIRA,664,2,12,531,368,519,0,1,0,0,150,531
EDO. PORTUGUESA,MP. PAEZ,CM. ACARIGUA,ESCUELA GRADUADA BENJAMIN MONTILLA,1820,4,21,1433,1079,1412,3,5,0,3,322,1433
EDO. PORTUGUESA,MP. PAEZ,CM. ACARIGUA,CENTRO COMUNITARIO DE AJEDREZ,93,1,2,84,50,82,0,1,0,0,31,84
EDO. PORTUGUESA,MP. PAEZ,CM. ACARIGUA,CENTRO DE EDUCACION INICIAL BOLIVARIANO ROMULO GALLEGOS,611,2,6,532,418,526,0,5,0,0,103,532
EDO. PORTUGUESA,MP. PAEZ,CM. ACARIGUA,GRUPO ESCOLAR ESTADAL CURPA,2273,4,45,1806,1313,1761,3,14,1,0,430,1806
EDO. PORTUGUESA,MP. PAEZ,CM. ACARIGUA,LICEO BOLIVARIANO INDEPENDENCIA DE VENEZUELA,2368,4,44,2165,1992,2121,0,5,0,0,124,2165
EDO. PORTUGUESA,MP. PAEZ,CM. ACARIGUA,ESCUELA BASICA PALACIO FAJARDO,3167,6,46,2428,982,2382,0,13,0,1,1386,2428
EDO. PORTUGUESA,MP. PAEZ,CM. ACARIGUA,ESCUELA BASICA BOLIVARIANA MANUELITA SAENZ,1772,3,20,1530,1281,1510,0,8,0,0,221,1530
EDO. PORTUGUESA,MP. PAEZ,CM. ACARIGUA,ESCUELA BASICA ALBERTO LEVY MORA,3781,7,86,2922,2305,2836,0,28,0,0,503,2922
EDO. PORTUGUESA,MP. PAEZ,CM. ACARIGUA,CENTRO EDUCACION INICIAL SIMONCITO DURIGUA,302,1,15,263,199,248,0,2,0,0,47,263
EDO. PORTUGUESA,MP. PAEZ,CM. ACARIGUA,CICLO COMBINADO EDUARDO CHOLET,3623,7,42,3183,1582,3141,1,12,0,0,1546,3183
EDO. PORTUGUESA,MP. PAEZ,CM. ACARIGUA,ESCUELA BASICA GOAJIRA I,3258,6,68,2765,1274,2697,1,17,3,2,1400,2765
EDO. PORTUGUESA,MP. PAEZ,CM. ACARIGUA,ESCUELA BASICA LUISA GRATEROL DE PEREZ,1748,3,41,1491,1201,1450,0,3,0,0,246,1491
EDO. PORTUGUESA,MP. PAEZ,CM. ACARIGUA,ESCUELA BASICA TRINA DE MORENO,4022,7,80,3318,2505,3238,1,22,1,0,709,3318
EDO. PORTUGUESA,MP. PAEZ,CM. ACARIGUA,ESCUELA BASICA LUZ DE PEREIRA,3283,6,44,2689,2227,2645,2,13,2,1,400,2689
EDO. PORTUGUESA,MP. PAEZ,CM. ACARIGUA,ESCUELA BASICA ANA SUSANA DE OUSSET,3831,7,62,3109,1568,3047,2,13,2,2,1460,3109
EDO. PORTUGUESA,MP. PAEZ,CM. ACARIGUA,ESCUELA BASICA 5 DE DICIEMBRE,3612,7,42,2918,2617,2876,0,10,1,3,245,2918
EDO. PORTUGUESA,MP. PAEZ,CM. ACARIGUA,UNIVERSIDAD NACIONAL EXPERIMENTAL SIMON RODRIGUEZ,1345,3,11,1071,588,1060,0,10,1,0,461,1071
EDO. PORTUGUESA,MP. PAEZ,CM. ACARIGUA,UNIDAD EDUCATIVA FE Y ALEGRIA SANTA ELENA,1382,3,27,1181,1012,1154,0,5,0,1,136,1181
EDO. PORTUGUESA,MP. PAEZ,CM. ACARIGUA,GIMNASIO CUBIERTO WILBALDO ZABALETA,306,1,1,270,147,269,0,4,0,0,118,270
EDO. PORTUGUESA,MP. PAEZ,CM. ACARIGUA,ESCUELA BASICA CIUDAD DE ACARIGUA,3026,6,57,2339,1231,2282,1,20,1,3,1026,2339
EDO. PORTUGUESA,MP. PAEZ,CM. ACARIGUA,UNIDAD EDUCATIVA LOS CORTIJOS,1920,4,45,1731,1008,1686,0,19,0,2,657,1731
EDO. PORTUGUESA,MP. PAEZ,CM. ACARIGUA,ESCUELA NACIONAL BASICA SAN VICENTE,2312,4,62,1890,1314,1828,1,19,0,2,492,1890
EDO. PORTUGUESA,MP. PAEZ,CM. ACARIGUA,ESCUELA BASICA HERMANAS PERAZAS,3692,7,60,3024,1747,2964,1,19,2,6,1189,3024
EDO. PORTUGUESA,MP. PAEZ,CM. ACARIGUA,CICLO COMBINADO JOSE ANTONIO PAEZ,2996,6,41,2403,1215,2362,2,11,0,2,1132,2403
EDO. PORTUGUESA,MP. PAEZ,CM. ACARIGUA,ESCUELA BOLIVARIANA DURIGUA VIEJA,657,2,10,532,444,522,0,3,1,0,74,532
EDO. PORTUGUESA,MP. PAEZ,CM. ACARIGUA,CICLO COMBINADO 5 DE DICIEMBRE,2273,4,41,1826,1310,1785,0,10,0,1,464,1826
EDO. PORTUGUESA,MP. PAEZ,CM. ACARIGUA,ESCUELA BASICA MIGUEL OTERO SILVA,3193,6,55,2524,1336,2469,1,16,3,1,1112,2524
EDO. PORTUGUESA,MP. PAEZ,CM. ACARIGUA,UNIDAD EDUCATIVA PRIVADA EL AVILA,1457,3,29,1171,434,1142,0,3,1,3,701,1171
EDO. PORTUGUESA,MP. PAEZ,CM. ACARIGUA,UNIDAD EDUCATIVA NACIONAL DURIGUA,1877,4,29,1609,1257,1580,0,9,0,0,314,1609
EDO. PORTUGUESA,MP. PAEZ,CM. ACARIGUA,PRE ESCOLAR LEOWALDO JOSE SORONDO,2552,5,63,2236,1247,2173,2,17,2,3,902,2236
EDO. PORTUGUESA,MP. PAEZ,CM. ACARIGUA,C.E.I  EL ARAGUANEY,95,1,0,87,65,87,0,0,0,0,22,87
EDO. PORTUGUESA,MP. PAEZ,CM. ACARIGUA,ESCUELA BASICA ROMULO GALLEGOS,3768,7,90,3314,2231,3224,2,22,0,1,968,3314
EDO. PORTUGUESA,MP. PAEZ,CM. ACARIGUA,ESCUELA BASICA FE Y ALEGRIA,3521,6,36,2722,1912,2686,3,12,6,1,752,2722
EDO. PORTUGUESA,MP. PAEZ,CM. ACARIGUA,COLEGIO SANTO ANGEL DE LA GUARDA,1696,3,15,1485,632,1470,0,6,0,0,832,1485
EDO. PORTUGUESA,MP. PAEZ,CM. ACARIGUA,GRUPO ESCOLAR RAIMUNDO ANDUEZA PALACIO,2903,5,44,2369,1420,2325,0,20,1,3,881,2369
EDO. PORTUGUESA,MP. PAEZ,CM. ACARIGUA,UNIDAD EDUCATIVA ESTADAL 19 DE ABRIL,374,1,1,330,302,329,0,2,0,0,25,330
EDO. PORTUGUESA,MP. PAEZ,CM. ACARIGUA,ESCUELA TECNICA COMERCIAL PROFESOR ADEMAR VASQUEZ,1377,3,18,1209,689,1191,0,8,0,0,494,1209
EDO. PORTUGUESA,MP. PAEZ,CM. ACARIGUA,PRE ESCOLAR DURIGUA VIEJA,767,2,17,647,547,630,0,6,1,0,76,647
EDO. PORTUGUESA,MP. PAEZ,CM. ACARIGUA,UNIDAD EDUCATIVA PRIVADA GENERALISIMO FRANCISCO DE MIRANDA,1178,2,14,976,440,962,0,1,0,1,520,976
EDO. PORTUGUESA,MP. PAEZ,CM. ACARIGUA,JARDIN DE INFANCIA BOLIVARIANO ALTAMIRA,781,2,11,700,593,689,1,3,1,0,91,700
EDO. PORTUGUESA,MP. PAEZ,CM. ACARIGUA,JARDIN DE INFANCIA EL AMANECER,2881,5,43,2481,1816,2438,0,14,3,3,602,2481
EDO. PORTUGUESA,MP. PAEZ,CM. ACARIGUA,CENTRO DE RECREACION EDUCATIVA ROSALIA,949,2,15,864,640,849,0,6,0,0,203,864
EDO. PORTUGUESA,MP. PAEZ,CM. ACARIGUA,UNIDAD EDUCATIVA COLEGIO VICENTE EMILIO SOJO,1005,2,11,873,403,862,0,4,1,0,454,873
EDO. PORTUGUESA,MP. PAEZ,CM. ACARIGUA,ALDEA UNIVERSITARIA METROPOLITANA DE ACARIGUA ARAURE,131,1,1,113,69,112,0,2,0,1,40,113
EDO. PORTUGUESA,MP. PAEZ,CM. ACARIGUA,COMEDOR POPULAR  GENERAL JOSE ANTONIO PAEZ,85,1,3,76,28,73,0,0,0,0,45,76
EDO. PORTUGUESA,MP. PAEZ,CM. ACARIGUA,GRUPO ESCOLAR BOLIVARIANO DURIGUA,3183,6,62,2604,1792,2542,0,29,3,1,717,2604
EDO. PORTUGUESA,MP. PAEZ,CM. ACARIGUA,JARDIN DE INFANCIA EL CARMELO,1470,3,33,1275,944,1242,1,27,1,1,268,1275
EDO. PORTUGUESA,MP. PAEZ,CM. ACARIGUA,ESCUELA NACIONAL GRADUADA SAN ANTONIO,1903,4,50,1652,1073,1602,0,6,2,0,521,1652
EDO. PORTUGUESA,MP. PAEZ,CM. ACARIGUA,CENTRO DE EDUCACION INICIAL VENEZUELA,434,1,5,402,134,397,0,0,0,0,263,402
EDO. PORTUGUESA,MP. PAEZ,CM. ACARIGUA,ESCUELA BASICA LA VICTORIA,915,2,9,803,711,794,0,4,0,1,78,803
EDO. PORTUGUESA,MP. PAEZ,CM. ACARIGUA,INSTITUTO UNIVERSITARIO DE TECNOLOGIA DEL ESTADO PORTUGUESA,476,1,9,422,281,413,0,1,0,1,130,422
EDO. PORTUGUESA,MP. PAEZ,CM. ACARIGUA,JARDIN DE INFANCIA MIGUEL OCTAVIO,1690,3,60,1470,1020,1410,0,9,1,1,379,1470
EDO. PORTUGUESA,MP. PAEZ,CM. ACARIGUA,ESCUELA BASICA BATALLA DE CARABOBO,3502,6,60,2678,2239,2618,1,5,0,1,372,2678
EDO. PORTUGUESA,MP. PAEZ,CM. ACARIGUA,ESCUELA BASICA 24 DE JULIO,3233,6,55,2743,1676,2688,3,18,2,3,986,2743
EDO. PORTUGUESA,MP. PAEZ,PQ. PAYARA,ESCUELA ESTADAL CONCENTRADA NUMERO 143 CAJARITO,324,1,1,255,223,254,0,1,0,0,30,255
EDO. PORTUGUESA,MP. PAEZ,PQ. PAYARA,LICEO BOLIVARIANO ANDRES ELOY BLANCO,463,1,9,378,331,369,1,4,0,0,33,378
EDO. PORTUGUESA,MP. PAEZ,PQ. PAYARA,ESCUELA ESTADAL EL TAMARINDO,259,1,1,233,229,232,0,1,0,0,2,233
EDO. PORTUGUESA,MP. PAEZ,PQ. PAYARA,ESCUELA ESTADAL CONCENTRADA LOS CHINOS,175,1,2,147,141,145,0,1,0,0,3,147
EDO. PORTUGUESA,MP. PAEZ,PQ. PAYARA,ESCUELA BASICA PAYARA,3827,7,47,2950,2494,2903,2,14,0,2,391,2950
EDO. PORTUGUESA,MP. PAEZ,PQ. PAYARA,ESCUELA CONCENTRADA MIXTA NUMERO 1886 151,523,1,4,438,377,434,1,2,1,0,53,438
EDO. PORTUGUESA,MP. PAEZ,PQ. PAYARA,ESCUELA CONCENTRADA ESTADAL NUMERO 140,734,2,19,612,551,593,1,1,2,1,37,612
EDO. PORTUGUESA,MP. PAEZ,PQ. PAYARA,ESCUELA ESTADAL CONCENTRADA LOS MAMONES NUMERO 138,569,1,6,457,423,451,0,2,0,0,26,457
EDO. PORTUGUESA,MP. PAEZ,PQ. RAMON PERAZA,ESCUELA BASICA SABANETICA,863,2,6,748,650,742,0,5,2,0,85,748
EDO. PORTUGUESA,MP. PAEZ,PQ. RAMON PERAZA,MARATAN NUMERO 142,207,1,8,172,135,164,0,2,0,0,27,172
EDO. PORTUGUESA,MP. PAEZ,PQ. RAMON PERAZA,ESCUELA BASICA ESTADAL  CONCENTRADA NUMERO 144,579,1,16,474,308,458,0,6,0,0,144,474
EDO. PORTUGUESA,MP. PAEZ,PQ. RAMON PERAZA,ESCUELA RURAL BASICA LA EXTENSION MIJAGUITO,1349,3,53,1051,837,998,0,3,1,0,157,1051
EDO. PORTUGUESA,MP. PAEZ,PQ. RAMON PERAZA,UNIDAD EDUCATIVA ESPINITAL,758,2,17,654,505,637,0,4,0,0,128,654
