Estado,Municipio,Parroquia,Centro,Número de Electores escrutados.,Número de Actas Procesadas.,Número total de Votos Nulos.,Número Total de Votantes que votaron realmente.,HUGO CHAVEZ,Número total de Votos Válidos.,ORLANDO CHIRINO,REINA SEQUERA,LUIS REYES,MARIA BOLIVAR,HENRIQUE CAPRILES RADONSKI,Número de Votos Escrutados.
EDO. MIRANDA,MP. INDEPENDENCIA,PQ. STA TERESA DEL TUY,ESCUELA BASICA ESTADO PORTUGUESA,868,2,19,727,463,708,0,1,0,0,244,727
EDO. MIRANDA,MP. INDEPENDENCIA,PQ. STA TERESA DEL TUY,ESCUELA BASICA NACIONAL JUAN ANTONIO ROMAN VALECILLOS,3268,6,47,2654,1769,2607,1,16,2,3,816,2654
EDO. MIRANDA,MP. INDEPENDENCIA,PQ. STA TERESA DEL TUY,LICEO NACIONAL  DOS LAGUNAS,2584,5,51,2113,1650,2062,0,7,3,0,402,2113
EDO. MIRANDA,MP. INDEPENDENCIA,PQ. STA TERESA DEL TUY,UNIDAD EDUCATIVA ESTADAL SANTA BARBARA,1291,3,22,1064,903,1042,0,4,0,0,135,1064
EDO. MIRANDA,MP. INDEPENDENCIA,PQ. STA TERESA DEL TUY,CENTRO CULTURAL  JUAN ESPAÑA,1629,3,29,1336,935,1307,0,2,0,0,370,1336
EDO. MIRANDA,MP. INDEPENDENCIA,PQ. STA TERESA DEL TUY,UNIDAD EDUCATIVA PRIVADA CONGRESO DE ANGOSTURA,1556,3,23,1279,760,1256,0,4,0,0,492,1279
EDO. MIRANDA,MP. INDEPENDENCIA,PQ. STA TERESA DEL TUY,UNIDAD EDUCATIVA SEUCE,2028,4,35,1536,1393,1501,4,6,4,0,94,1536
EDO. MIRANDA,MP. INDEPENDENCIA,PQ. STA TERESA DEL TUY,UNIVERSIDAD NACIONAL EXPERIMENTAL SIMON RODRIGUEZ,1473,3,21,1229,670,1208,0,3,0,0,535,1229
EDO. MIRANDA,MP. INDEPENDENCIA,PQ. STA TERESA DEL TUY,UNIDAD EDUCATIVA PRIVADA FRANCISCO TAMAYO,1038,2,20,847,474,827,0,1,1,0,351,847
EDO. MIRANDA,MP. INDEPENDENCIA,PQ. STA TERESA DEL TUY,ESCUELA BASICA NACIONAL CIUDAD LOZADA,3576,7,40,2833,2210,2793,0,10,4,1,568,2833
EDO. MIRANDA,MP. INDEPENDENCIA,PQ. STA TERESA DEL TUY,CENTRO DE EDUCACION INICIAL CIUDAD LOZADA,492,1,5,378,315,373,0,1,0,1,56,378
EDO. MIRANDA,MP. INDEPENDENCIA,PQ. STA TERESA DEL TUY,ESCUELA BASICA NACIONAL 24 DE JUNIO,4129,8,68,3407,2650,3339,1,13,4,2,669,3407
EDO. MIRANDA,MP. INDEPENDENCIA,PQ. STA TERESA DEL TUY,UNIDAD EDUCATIVA NACIONAL SAN JOSE DE RIO CHICO,2913,5,85,2311,1473,2226,2,12,2,2,735,2311
EDO. MIRANDA,MP. INDEPENDENCIA,PQ. STA TERESA DEL TUY,UNIDAD EDUCATIVA ESTADAL SIMON BOLIVAR,338,1,6,280,248,274,1,0,0,0,25,280
EDO. MIRANDA,MP. INDEPENDENCIA,PQ. STA TERESA DEL TUY,CENTRO DE EDUCACION INICIAL NACIONAL  EZEQUIEL ZAMORA PREESCOLAR,408,1,10,345,244,335,0,3,0,0,88,345
EDO. MIRANDA,MP. INDEPENDENCIA,PQ. STA TERESA DEL TUY,UNIDAD EDUCATIVA NACIONAL  DOLORES GONZALEZ,1883,4,36,1520,808,1484,0,6,0,2,668,1520
EDO. MIRANDA,MP. INDEPENDENCIA,PQ. STA TERESA DEL TUY,UNIDAD EDUCATIVA ESTADAL MIGUEL HERNANDEZ,440,1,3,393,335,390,1,4,0,0,50,393
EDO. MIRANDA,MP. INDEPENDENCIA,PQ. STA TERESA DEL TUY,UNIDAD EDUCATIVA ESTADAL 15 DE OCTUBRE,1548,3,29,1273,1010,1244,0,1,1,0,232,1273
EDO. MIRANDA,MP. INDEPENDENCIA,PQ. STA TERESA DEL TUY,LICEO PRIVADO JOSE LEONARDO CHIRINOS,377,1,1,311,168,310,0,1,0,0,141,311
EDO. MIRANDA,MP. INDEPENDENCIA,PQ. STA TERESA DEL TUY,UNIDAD EDUCATIVA PRIVADA FRANCISCO LINARES ALCANTARA,1304,3,18,1068,638,1050,0,4,1,0,407,1068
EDO. MIRANDA,MP. INDEPENDENCIA,PQ. STA TERESA DEL TUY,CONCENTRACION RURAL MOROCOPITO,532,1,6,414,342,408,1,3,1,0,61,414
EDO. MIRANDA,MP. INDEPENDENCIA,PQ. STA TERESA DEL TUY,PREESCOLAR LAS CAMPANITAS,1704,3,25,1433,1112,1408,0,1,1,0,294,1433
EDO. MIRANDA,MP. INDEPENDENCIA,PQ. STA TERESA DEL TUY,UNIDAD EDUCATIVA PRIVADA AGUSTIN AVELEDO,3374,6,38,2857,1175,2819,1,15,1,2,1625,2857
EDO. MIRANDA,MP. INDEPENDENCIA,PQ. STA TERESA DEL TUY,UNIDAD EDUCATIVA ESTADAL PEDRO RODRIGUEZ VALDIVIEZO,3631,7,85,2917,2391,2832,2,12,3,1,423,2917
EDO. MIRANDA,MP. INDEPENDENCIA,PQ. STA TERESA DEL TUY,GRUPO ESCOLAR EZEQUIEL ZAMORA,3330,6,36,2617,1559,2581,0,9,1,1,1011,2617
EDO. MIRANDA,MP. INDEPENDENCIA,PQ. EL CARTANAL,CENTRO DE EDUCACION INICIAL ABILIO REYES PREESCOLAR,679,2,11,558,417,547,0,4,0,0,126,558
EDO. MIRANDA,MP. INDEPENDENCIA,PQ. EL CARTANAL,LICEO BOLIVARIANO CARTANAL II,4736,9,59,3846,2875,3787,1,21,2,3,885,3846
EDO. MIRANDA,MP. INDEPENDENCIA,PQ. EL CARTANAL,UNIDAD EDUCATIVA ESTADAL BOLIVARIANA AGUSTINA MARTINA BLANCO,837,2,6,724,676,718,0,2,0,0,40,724
EDO. MIRANDA,MP. INDEPENDENCIA,PQ. EL CARTANAL,UNIDAD EDUCATIVA ESTADAL CARTANAL I,3399,6,53,2748,2045,2695,0,13,2,2,633,2748
EDO. MIRANDA,MP. INDEPENDENCIA,PQ. EL CARTANAL,ESCUELA BASICA NACIONAL CARTANAL  VICENTE EMILIO  SOJO,6589,12,91,5510,4068,5419,1,33,5,3,1309,5510
EDO. MIRANDA,MP. INDEPENDENCIA,PQ. EL CARTANAL,ESCUELA BASICA NACIONAL PEDRO VICENTE NU EZ,2609,5,65,2251,1423,2186,0,12,1,0,750,2251
EDO. MIRANDA,MP. INDEPENDENCIA,PQ. EL CARTANAL,CONCENTRACION NACIONAL 3626,2463,5,54,2107,1545,2053,1,10,0,2,495,2107
EDO. MIRANDA,MP. INDEPENDENCIA,PQ. EL CARTANAL,ESCUELA BASICA NACIONAL CARTANAL II,4039,7,81,3332,2359,3251,2,11,4,3,872,3332
EDO. MIRANDA,MP. INDEPENDENCIA,PQ. EL CARTANAL,CENTRO DE EDUCACION INICIAL NACIONAL MARVELIA HERNANDEZ FERRER,171,1,2,151,133,149,0,0,0,0,16,151
EDO. MIRANDA,MP. INDEPENDENCIA,PQ. EL CARTANAL,CENTRO DE EDUCACION INICIAL NACIONAL  DOS LAGUNAS PREESCOLAR,245,1,6,200,141,194,0,0,0,0,53,200
EDO. MIRANDA,MP. INDEPENDENCIA,PQ. EL CARTANAL,UNIDAD EDUCATIVA NACIONAL 12 DE MARZO,1981,4,54,1653,1275,1599,1,11,0,1,311,1653
EDO. MIRANDA,MP. INDEPENDENCIA,PQ. EL CARTANAL,UNIDAD EDUCATIVA ESTADAL MANUEL DIAZ RODRIGUEZ,1472,3,21,1141,919,1120,0,8,1,1,191,1141
EDO. MIRANDA,MP. INDEPENDENCIA,PQ. EL CARTANAL,UNIDAD EDUCATIVA NACIONAL GUILLERMO COVA,5875,11,130,4931,3396,4801,0,23,3,10,1369,4931
EDO. MIRANDA,MP. INDEPENDENCIA,PQ. EL CARTANAL,ESCUELA BASICA ESTADAL CARTANAL II (LAS CASITAS),1162,2,21,985,721,964,0,4,0,2,237,985
EDO. MIRANDA,MP. INDEPENDENCIA,PQ. EL CARTANAL,CENTRO EDUCACION INICIAL BOLIVARIANO TITO SALAS,355,1,6,299,244,293,0,1,1,1,46,299
EDO. MIRANDA,MP. INDEPENDENCIA,PQ. EL CARTANAL,ESCUELA BASICA DOS LAGUNAS 2 LUIS BELTRAN PRIETO FIGUEROA,3125,6,57,2546,1754,2489,0,14,1,0,720,2546
EDO. MIRANDA,MP. INDEPENDENCIA,PQ. EL CARTANAL,ESCUELA BASICA DOS LAGUNAS RAUL LEONI,2966,5,59,2465,1819,2406,1,13,0,2,571,2465
EDO. MIRANDA,MP. BARUTA,PQ. BARUTA,ESCUELA  MUNICIPAL MONSEÑOR LUCAS GUILLERMO CASTILLO,1431,3,23,1127,407,1104,1,4,2,0,690,1127
EDO. MIRANDA,MP. BARUTA,PQ. BARUTA,UNIDAD EDUCATIVA INSTITUTO ARTURO MICHELENA,3093,6,11,2385,195,2374,0,2,0,2,2175,2385
EDO. MIRANDA,MP. BARUTA,PQ. BARUTA,LICEO NACIONAL JOSE ALBERTO VELANDIA,2403,5,9,1952,195,1943,0,1,0,0,1747,1952
EDO. MIRANDA,MP. BARUTA,PQ. BARUTA,LICEO LOS ARCOS,3827,7,20,3066,119,3046,0,1,0,1,2925,3066
EDO. MIRANDA,MP. BARUTA,PQ. BARUTA,UNIDAD EDUCATIVA COLEGIO LAS CUMBRES,5717,10,16,4257,314,4241,1,11,0,1,3914,4257
EDO. MIRANDA,MP. BARUTA,PQ. BARUTA,UNIDAD EDUCATIVA COLEGIO EMIL FRIEDMAN,3249,6,12,2492,117,2480,0,3,0,0,2360,2492
EDO. MIRANDA,MP. BARUTA,PQ. BARUTA,INSTITUTO LEOPARDI,3197,6,12,2231,266,2219,0,8,0,2,1943,2231
EDO. MIRANDA,MP. BARUTA,PQ. BARUTA,UNIDAD EDUCATIVA NACIONAL SOROCAIMA,2122,4,12,1585,215,1573,0,5,3,0,1350,1585
EDO. MIRANDA,MP. BARUTA,PQ. BARUTA,CASA DE TODOS Y JUSTICIA DE PAZ,1872,4,24,1539,578,1515,0,4,0,1,932,1539
EDO. MIRANDA,MP. BARUTA,PQ. BARUTA,UNIDAD EDUCATIVA COLEGIO LOS RISCOS,3430,6,13,2584,281,2571,0,3,1,1,2285,2584
EDO. MIRANDA,MP. BARUTA,PQ. BARUTA,INSTITUTO UNIVERSITARIO DE TECNOLOGIA INDUSTRIAL RODOLFO LOERO ARISMENDI,280,1,3,252,76,249,0,0,0,1,172,252
EDO. MIRANDA,MP. BARUTA,PQ. BARUTA,COMPLEJO EDUCATIVO PRIVADO INSTITUTO ESCUELA,10093,19,28,7826,377,7798,1,7,1,4,7408,7826
EDO. MIRANDA,MP. BARUTA,PQ. BARUTA,UNIDAD EDUCATIVA FE Y ALEGRIA COLEGIO MONTERREY,2746,5,43,2275,882,2232,0,4,1,2,1343,2275
EDO. MIRANDA,MP. BARUTA,PQ. BARUTA,UNIDAD EDUCATIVA NACIONAL REPUBLICA DE INDONESIA,3168,6,26,2472,544,2446,1,4,0,2,1895,2472
EDO. MIRANDA,MP. BARUTA,PQ. BARUTA,UNIDAD EDUCATIVA CENTRO DE EDUCACION ACTIVA MARIA MONTESSORI,2135,4,9,1734,93,1725,0,2,0,0,1630,1734
EDO. MIRANDA,MP. BARUTA,PQ. BARUTA,INSTITUTO UNIVERSITARIO DE NUEVAS PROFESIONES,117,1,4,91,17,87,0,0,0,0,70,91
EDO. MIRANDA,MP. BARUTA,PQ. BARUTA,CENTRO VENEZOLANO AMERICANO,4084,8,30,2930,494,2900,2,8,2,3,2391,2930
EDO. MIRANDA,MP. BARUTA,PQ. BARUTA,UNIDAD EDUCATIVA COLEGIO LA CONCEPCION,5541,10,42,4340,383,4298,0,8,1,3,3903,4340
EDO. MIRANDA,MP. BARUTA,PQ. BARUTA,PRE ESCOLAR NUESTRA SEÑORA DEL ROSARIO,4427,8,71,3505,1418,3434,1,10,2,4,1999,3505
EDO. MIRANDA,MP. BARUTA,PQ. BARUTA,COLEGIO DE MEDICOS DEL DISTRITO METROPOLITANO DE CARACAS,3924,7,14,3138,255,3124,0,2,0,2,2865,3138
EDO. MIRANDA,MP. BARUTA,PQ. BARUTA,COLEGIO SANTO TOMAS DE VILLANUEVA,4990,9,31,3476,209,3445,0,1,0,4,3231,3476
EDO. MIRANDA,MP. BARUTA,PQ. BARUTA,UNIDAD EDUCATIVA RURAL MANUELITA SAENZ,714,2,15,574,402,559,0,2,0,1,154,574
EDO. MIRANDA,MP. BARUTA,PQ. BARUTA,CENTRO EDUCATIVO ASOCIACION PROFESORES UNIVERSIDAD CENTRAL DE VENEZUELA  (CEAPUCV),1827,4,14,1362,206,1348,0,2,0,3,1137,1362
EDO. MIRANDA,MP. BARUTA,PQ. BARUTA,ASOCIACION DESARROLLO INTEGRAL COMUNITARIO,1565,3,11,1210,417,1199,0,1,0,1,780,1210
EDO. MIRANDA,MP. BARUTA,PQ. BARUTA,UNIDAD EDUCATIVA INICIAL SIMONCITO EZEQUIEL ZAMORA,1135,2,11,1051,1012,1040,0,2,0,0,26,1051
EDO. MIRANDA,MP. BARUTA,PQ. BARUTA,ESCUELA BASICA NACIONAL HERMANAS MARIA LORENZA,1185,2,8,919,156,911,0,4,0,0,751,919
EDO. MIRANDA,MP. BARUTA,PQ. BARUTA,UNIDAD EDUCATIVA PRIVADA COLEGIO ALTO PRADO,3582,7,8,2840,184,2832,0,1,0,1,2646,2840
EDO. MIRANDA,MP. BARUTA,PQ. BARUTA,UNIDAD EDUCATIVA JOSE TADEO MONAGAS,3329,6,70,2717,1940,2647,4,8,3,3,689,2717
EDO. MIRANDA,MP. BARUTA,PQ. BARUTA,UNIDAD EDUCATIVA COLEGIO NUESTRA SEÑORA DE LA CONSOLACION,1496,3,7,1212,124,1205,0,1,0,0,1080,1212
EDO. MIRANDA,MP. BARUTA,PQ. BARUTA,INSTITUTO DIDACTICO ANTONIO JOSE DE SUCRE,1669,3,6,1272,95,1266,0,2,0,1,1168,1272
EDO. MIRANDA,MP. BARUTA,PQ. BARUTA,COLEGIO LA CONCORDIA,3468,6,20,2632,362,2612,1,6,0,1,2242,2632
EDO. MIRANDA,MP. BARUTA,PQ. BARUTA,AMBULATORIO URBANO TIPO 1 DOCTOR ANGEL GUEDES,587,1,7,493,182,486,1,2,0,0,301,493
EDO. MIRANDA,MP. BARUTA,PQ. BARUTA,UNIDAD EDUCATIVA COLEGIO FRAY LUIS AMIGO,7090,13,40,5268,619,5228,1,7,2,5,4594,5268
EDO. MIRANDA,MP. BARUTA,PQ. BARUTA,LICEO NACIONAL ALEJO FORTIQUE,4742,9,53,3819,1328,3766,0,14,0,6,2418,3819
EDO. MIRANDA,MP. BARUTA,PQ. BARUTA,UNIDAD EDUCATIVA PRIVADA MINERVA I,807,2,8,641,60,633,0,1,0,0,572,641
EDO. MIRANDA,MP. BARUTA,PQ. BARUTA,COLEGIO MATER SALVATORI,2484,5,10,1892,126,1882,0,2,0,1,1753,1892
EDO. MIRANDA,MP. BARUTA,PQ. BARUTA,JARDIN DE INFANCIA PREESCOLAR MANUEL FELIPE RUGELES,304,1,0,274,189,274,0,2,0,0,83,274
EDO. MIRANDA,MP. BARUTA,PQ. BARUTA,UNIDAD EDUCATIVA ESTADAL LINO DE CLEMENTE,3223,6,23,2580,267,2557,1,3,1,0,2285,2580
EDO. MIRANDA,MP. BARUTA,PQ. BARUTA,UNIDAD EDUCATIVA COLEGIO MADRE MATILDE,2877,5,13,2132,95,2119,0,4,0,0,2020,2132
EDO. MIRANDA,MP. BARUTA,PQ. BARUTA,JARDIN DE INFANCIA DON ROMULO BENTANCOURT,528,1,5,462,247,457,0,0,0,1,209,462
EDO. MIRANDA,MP. BARUTA,PQ. BARUTA,PREESCOLAR GUSTAVO ARISMENDI ITURBE,1214,3,15,995,666,980,0,4,2,1,307,995
EDO. MIRANDA,MP. BARUTA,PQ. BARUTA,ESCUELA MUNICIPAL NUMERO 05 MIGUEL JOSE SANZ,3496,6,65,2866,1255,2801,0,9,4,3,1530,2866
EDO. MIRANDA,MP. BARUTA,PQ. BARUTA,ESCUELA BASICA NACIONAL SANTA CRUZ DEL ESTE,4166,8,55,3302,1785,3247,2,7,1,1,1451,3302
EDO. MIRANDA,MP. BARUTA,PQ. BARUTA,COLEGIO PROMESAS PATRIAS,2984,6,26,2360,387,2334,0,6,0,5,1936,2360
EDO. MIRANDA,MP. BARUTA,PQ. BARUTA,MODULO DE SERVICIO DE OJO DE AGUA,2807,5,52,2271,1298,2219,3,8,1,2,907,2271
EDO. MIRANDA,MP. BARUTA,PQ. BARUTA,PRE ESCOLAR LAS LOMITAS,3104,6,8,2535,141,2527,2,2,0,0,2382,2535
EDO. MIRANDA,MP. BARUTA,PQ. BARUTA,ESCUELA BASICA NACIONAL CENTRO COMUNAL,1358,3,16,1077,597,1061,0,3,1,1,459,1077
EDO. MIRANDA,MP. BARUTA,PQ. BARUTA,CENTRO DE EDUCACION INICIAL MUNICIPAL EL CARMEN,102,1,3,89,48,86,0,0,0,0,38,89
EDO. MIRANDA,MP. BARUTA,PQ. BARUTA,UNIVERSIDAD SIMON BOLIVAR,4556,8,59,3646,763,3587,2,6,1,1,2814,3646
EDO. MIRANDA,MP. BARUTA,PQ. BARUTA,ESCUELA BASICA MUNICIPAL GENERAL JOSE ANTONIO PAEZ,2013,4,24,1639,941,1615,0,3,3,1,667,1639
EDO. MIRANDA,MP. BARUTA,PQ. BARUTA,UNIDAD EDUCATIVA NUESTRA SEÑORA DEL ROSARIO,5533,10,33,4322,523,4289,0,9,0,2,3755,4322
EDO. MIRANDA,MP. BARUTA,PQ. BARUTA,UNIDAD EDUCATIVA COLEGIO LA COROMOTO,1778,3,12,1430,196,1418,0,1,0,2,1219,1430
EDO. MIRANDA,MP. BARUTA,PQ. EL CAFETAL,UNIDAD EDUCATIVA COLEGIO CAURIMARE UNO,1617,3,6,1206,81,1200,0,2,0,1,1116,1206
EDO. MIRANDA,MP. BARUTA,PQ. EL CAFETAL,CAMARA DE INDUSTRIALES DEL ESTADO BOLIVARIANO DE MIRANDA,2727,5,10,1967,154,1957,1,0,0,1,1801,1967
EDO. MIRANDA,MP. BARUTA,PQ. EL CAFETAL,CENTRO ESCOLAR AULA NUEVA,3772,7,11,2933,159,2922,2,2,0,1,2758,2933
EDO. MIRANDA,MP. BARUTA,PQ. EL CAFETAL,INSTITUTO MADISON,1647,3,9,1260,77,1251,0,2,0,2,1170,1260
EDO. MIRANDA,MP. BARUTA,PQ. EL CAFETAL,UNIDAD EDUCATIVA COLEGIO CHAMPAGNAT ASOCIACION CIVIL V.E.A.S.,4701,9,24,3680,197,3656,0,7,1,1,3450,3680
EDO. MIRANDA,MP. BARUTA,PQ. EL CAFETAL,ESCUELA NACIONAL JESUS MARIA ALFARO ZAMORA,4981,9,25,3797,422,3772,0,8,0,2,3340,3797
EDO. MIRANDA,MP. BARUTA,PQ. EL CAFETAL,UNIDAD EDUCATIVA COLEGIO  LOS ARAYANES,1134,2,5,911,122,906,0,0,0,2,782,911
EDO. MIRANDA,MP. BARUTA,PQ. EL CAFETAL,INSTITUTO CENTRO APRENDIZAJE MADISON,1587,3,3,1278,75,1275,0,1,0,0,1199,1278
EDO. MIRANDA,MP. BARUTA,PQ. EL CAFETAL,CENTRO INFANTIL AMERICA,1120,2,3,899,64,896,0,1,0,0,831,899
EDO. MIRANDA,MP. BARUTA,PQ. EL CAFETAL,UNIDAD EDUCATIVA COLEGIO SAN LUIS DE CARACAS,6623,12,30,5047,373,5017,1,3,1,2,4637,5047
EDO. MIRANDA,MP. BARUTA,PQ. EL CAFETAL,ESCUELA BASICA NACIONAL BOLIVARIANA EUTIMIO RIVAS,1309,3,6,981,115,975,0,1,0,1,858,981
EDO. MIRANDA,MP. BARUTA,PQ. EL CAFETAL,UNIDAD EDUCATIVA NACIONAL JOSEFA IRAUSQUIN LOPEZ.,1911,4,3,1419,96,1416,1,2,0,2,1315,1419
EDO. MIRANDA,MP. BARUTA,PQ. EL CAFETAL,UNIDAD EDUCATIVA CHUAO,575,1,3,402,43,399,0,0,0,1,355,402
EDO. MIRANDA,MP. BARUTA,PQ. EL CAFETAL,INSTITUTO CUMBRES DE CARACAS ASOCIACION CIVIL,2166,4,6,1729,62,1723,1,2,0,0,1658,1729
EDO. MIRANDA,MP. BARUTA,PQ. EL CAFETAL,UNIDAD EDUCATIVA COLEGIO EL ANGEL,2446,5,7,1792,105,1785,0,4,1,0,1675,1792
EDO. MIRANDA,MP. BARUTA,PQ. EL CAFETAL,GUARDERIA PRE ESCOLAR VIGERLI,493,1,1,378,46,377,0,0,0,0,331,378
EDO. MIRANDA,MP. BARUTA,PQ. EL CAFETAL,UNIDAD EDUCATIVA NACIONAL FRANCISCO ESPEJO,1375,3,7,1000,88,993,0,0,1,1,903,1000
EDO. MIRANDA,MP. BARUTA,PQ. EL CAFETAL,BIBLIOTECA PUBLICA DOCTOR RAUL LEONI,2984,6,12,2322,225,2310,0,2,0,0,2083,2322
EDO. MIRANDA,MP. BARUTA,PQ. LAS MINAS DE BARUTA,ESCUELA MUNICIPAL JERMAN UBALDO LIRA,1811,4,27,1519,761,1492,0,2,0,3,726,1519
EDO. MIRANDA,MP. BARUTA,PQ. LAS MINAS DE BARUTA,COLEGIO  SANTA ROSA DE LIMA,8621,16,45,6550,485,6505,1,12,2,2,6003,6550
EDO. MIRANDA,MP. BARUTA,PQ. LAS MINAS DE BARUTA,COMPLEJO EDUCATIVO COLEGIO AMERICANO,5672,10,71,4678,1499,4607,1,17,3,0,3087,4678
EDO. MIRANDA,MP. BARUTA,PQ. LAS MINAS DE BARUTA,REGISTRO CIVIL DE LA PARROQUIA LAS MINAS,1983,4,19,1614,728,1595,0,2,1,0,864,1614
EDO. MIRANDA,MP. BARUTA,PQ. LAS MINAS DE BARUTA,UNIDAD EDUCATIVA NACIONAL TITO SALAS,4823,9,56,3785,1978,3729,1,8,2,2,1738,3785
EDO. MIRANDA,MP. BARUTA,PQ. LAS MINAS DE BARUTA,COLEGIO INTERNACIONAL DE CARACAS,3724,7,49,3075,977,3026,1,9,4,2,2033,3075
EDO. MIRANDA,MP. BARUTA,PQ. LAS MINAS DE BARUTA,UNIDAD EDUCATIVA ESTADAL  ADOLFO NAVAS  CORONADO,5222,10,100,4288,2129,4188,0,13,1,2,2043,4288
EDO. MIRANDA,MP. BARUTA,PQ. LAS MINAS DE BARUTA,COLEGIO DE FARMACEUTICOS DISTRITO METROPOLITANO DE CARACAS  Y EL ESTADO MIRANDA,1276,3,3,923,54,920,0,1,0,1,864,923
EDO. MIRANDA,MP. BARUTA,PQ. LAS MINAS DE BARUTA,ESCUELA BASICA NACIONAL  LAS MINITAS,2844,5,28,2205,1182,2177,0,7,0,0,988,2205
EDO. MIRANDA,MP. SIMON BOLIVAR,PQ. S ANTONIO DE YARE,UNIDAD EDUCATIVA NACIONAL 28 DE MARZO,683,2,11,580,462,569,0,1,1,0,105,580
EDO. MIRANDA,MP. SIMON BOLIVAR,PQ. S ANTONIO DE YARE,CENTRO PENITENCIARIO REGION CAPITAL YARE II,104,1,2,24,20,22,0,0,0,0,2,24
EDO. MIRANDA,MP. SIMON BOLIVAR,PQ. S ANTONIO DE YARE,CONCENTRACION ESCOLAR SIN NUMERO PUENTE CARRERA,257,1,7,225,189,218,0,2,0,1,26,225
EDO. MIRANDA,MP. SIMON BOLIVAR,PQ. S ANTONIO DE YARE,CONCENTRACION ESCOLAR SIN NUMERO EL LECHOZAL,219,1,7,171,136,164,0,0,0,0,28,171
EDO. MIRANDA,MP. SIMON BOLIVAR,PQ. S ANTONIO DE YARE,UNIDAD EDUCATIVA ESTADAL SAN ANTONIO DE PADUA,2450,5,50,2003,1589,1953,0,4,1,3,356,2003
EDO. MIRANDA,MP. SIMON BOLIVAR,PQ. S ANTONIO DE YARE,UNIDAD EDUCATIVA ESTADAL ARTURO USLAR PIETRI,2462,5,40,2046,1672,2006,0,17,1,2,314,2046
EDO. MIRANDA,MP. SIMON BOLIVAR,PQ. S ANTONIO DE YARE,UNIDAD EDUCATIVA NACIONAL CACIQUE YARE,377,1,7,315,258,308,0,1,1,1,47,315
EDO. MIRANDA,MP. SIMON BOLIVAR,PQ. SAN FCO DE YARE,ESCUELA BASICA NACIONAL CHACAO,4538,8,81,3774,2477,3693,1,17,2,3,1193,3774
EDO. MIRANDA,MP. SIMON BOLIVAR,PQ. SAN FCO DE YARE,CASA DE LA CULTURA,678,2,7,570,456,563,0,2,0,0,105,570
EDO. MIRANDA,MP. SIMON BOLIVAR,PQ. SAN FCO DE YARE,UNIDAD  EDUCATIVA ESTILITA DE ALZURU,2267,4,33,1828,1415,1795,0,8,2,0,370,1828
EDO. MIRANDA,MP. SIMON BOLIVAR,PQ. SAN FCO DE YARE,UNIDAD EDUCATIVA ESTADAL BOLIVARIANA LA VIRGEN DE COROMOTO,977,2,26,791,668,765,0,2,0,0,95,791
EDO. MIRANDA,MP. SIMON BOLIVAR,PQ. SAN FCO DE YARE,CASA COMUNAL NUESTRA SENORA DE LOUDES,106,1,1,88,68,87,0,0,0,0,19,88
EDO. MIRANDA,MP. SIMON BOLIVAR,PQ. SAN FCO DE YARE,PARADOR TURISTICO SAN FRANCISCO DE YARE,1386,3,20,1128,701,1108,0,6,2,0,399,1128
EDO. MIRANDA,MP. SIMON BOLIVAR,PQ. SAN FCO DE YARE,CENTRO DE EDUCACION INICIAL BENITA RIVAS TORO,510,1,2,464,273,462,0,3,0,0,186,464
EDO. MIRANDA,MP. SIMON BOLIVAR,PQ. SAN FCO DE YARE,UNIDAD EDUCATIVA NACIONAL BOLIVARIANA JOSE TADEO MONAGAS,256,1,4,219,156,215,0,2,0,0,57,219
EDO. MIRANDA,MP. SIMON BOLIVAR,PQ. SAN FCO DE YARE,UNIDAD EDUCATIVA NACIONAL LIBERTADOR,2619,5,79,2193,1447,2114,3,2,1,0,661,2193
EDO. MIRANDA,MP. SIMON BOLIVAR,PQ. SAN FCO DE YARE,UNIDAD EDUCATIVA NACIONAL BOLIVARIANA ESTADO MIRANDA,177,1,3,135,115,132,0,0,0,0,17,135
EDO. MIRANDA,MP. SIMON BOLIVAR,PQ. SAN FCO DE YARE,UNIDAD EDUCATIVA ESTADAL LUISA DE JACOTTE,407,1,9,361,299,352,0,1,1,0,51,361
EDO. MIRANDA,MP. SIMON BOLIVAR,PQ. SAN FCO DE YARE,CONCENTRACION ESCOLAR SIN NUMERO CAMBAMBE,969,2,23,813,631,790,0,2,0,0,157,813
EDO. MIRANDA,MP. SIMON BOLIVAR,PQ. SAN FCO DE YARE,UNIDAD EDUCATIVA ESTADAL BENITA RIBAS TORO,2308,4,29,2048,850,2019,0,6,0,0,1163,2048
EDO. MIRANDA,MP. SIMON BOLIVAR,PQ. SAN FCO DE YARE,UNIDAD EDUCATIVA PRIVADA CORONEL ANTONIO NICOLAS BRICENO,217,1,6,189,142,183,0,0,0,0,41,189
EDO. MIRANDA,MP. SIMON BOLIVAR,PQ. SAN FCO DE YARE,UNIDAD EDUCATIVA ESTADAL QUEBRADA SECA,1112,2,29,928,672,899,0,4,0,3,220,928
EDO. MIRANDA,MP. SIMON BOLIVAR,PQ. SAN FCO DE YARE,UNIDAD EDUCATIVA LOS ANILES,677,2,8,584,460,576,0,2,0,3,111,584
EDO. MIRANDA,MP. PLAZA,PQ. GUARENAS,CENTRO DE EDUCACIÓN INICIAL DOÑA VIRGINIA BELLO DE BETANCOURT,391,1,8,341,217,333,0,1,0,1,114,341
EDO. MIRANDA,MP. PLAZA,PQ. GUARENAS,CASA COMUNAL PINAL II PARTE ALTA,276,1,1,260,234,259,0,0,1,0,24,260
EDO. MIRANDA,MP. PLAZA,PQ. GUARENAS,ESCUELA MARTIN VERA GUERRA,1524,3,18,1339,875,1321,0,6,0,1,439,1339
EDO. MIRANDA,MP. PLAZA,PQ. GUARENAS,UNIDAD EDUCATIVA NACIONAL BOLIVARIANA MIGUEL OTERO SILVA,6052,11,198,4809,3534,4611,1,15,3,6,1052,4809
EDO. MIRANDA,MP. PLAZA,PQ. GUARENAS,ESCUELA NACIONAL GRADUADA JUDITH DALO SANDON,2919,5,62,2429,1586,2367,1,6,2,1,771,2429
EDO. MIRANDA,MP. PLAZA,PQ. GUARENAS,ESCUELA TECNICA INDUSTRIAL ROBINSONIANA RUBEN GONZALEZ,3001,6,37,2542,1326,2505,0,11,0,1,1167,2542
EDO. MIRANDA,MP. PLAZA,PQ. GUARENAS,CENTRO DE EDUCACIÓN INICIAL  LOS AZULEJOS,336,1,7,311,212,304,0,1,0,1,90,311
EDO. MIRANDA,MP. PLAZA,PQ. GUARENAS,CIUDAD DE LOS MUCHACHOS FE Y ALEGRIA,1083,2,8,944,585,936,0,2,0,1,348,944
EDO. MIRANDA,MP. PLAZA,PQ. GUARENAS,ALDEA UNIVERSITARIA CORONELA MANUELITA SAENZ,373,1,4,333,218,329,0,0,0,0,111,333
EDO. MIRANDA,MP. PLAZA,PQ. GUARENAS,CENTRO DE EDUCACIÓN INICIAL NACIONAL   LUCERITO,546,1,10,487,375,477,0,2,1,0,99,487
EDO. MIRANDA,MP. PLAZA,PQ. GUARENAS,CENTRO DE EDUCACION INICIAL TERESA DE LA PARRA,460,1,11,432,288,421,0,0,0,1,132,432
EDO. MIRANDA,MP. PLAZA,PQ. GUARENAS,GRUPO ESCOLAR MENCA DE LEONI II,4916,9,68,4198,2475,4130,0,19,5,6,1625,4198
EDO. MIRANDA,MP. PLAZA,PQ. GUARENAS,CENTRO COMUNAL GUARENAS,2372,4,53,1872,1317,1819,2,7,0,2,491,1872
EDO. MIRANDA,MP. PLAZA,PQ. GUARENAS,GRUPO ESCOLAR RUIZ PINEDA,3870,7,65,3144,1911,3079,0,11,4,1,1152,3144
EDO. MIRANDA,MP. PLAZA,PQ. GUARENAS,ESCUELA  BOLIVARIANA HORACIO REQUENA QUINTERO,218,1,7,192,157,185,0,2,0,0,26,192
EDO. MIRANDA,MP. PLAZA,PQ. GUARENAS,LICEO BOLIVARIANO ANTONIO MARIA PIÑATE,592,1,7,511,324,504,0,0,0,0,180,511
EDO. MIRANDA,MP. PLAZA,PQ. GUARENAS,PRE ESCOLAR YOLANDA MARTINEZ,517,1,5,458,294,453,0,3,0,0,156,458
EDO. MIRANDA,MP. PLAZA,PQ. GUARENAS,CENTRO CULTURAL MAGO,1719,3,33,1426,1075,1393,0,6,0,1,311,1426
EDO. MIRANDA,MP. PLAZA,PQ. GUARENAS,GRUPO ESCOLAR AMBROSIO PLAZA,4518,8,70,3753,2150,3683,0,16,2,1,1514,3753
EDO. MIRANDA,MP. PLAZA,PQ. GUARENAS,COLEGIO PARROQUIAL  JESUS MARIA MARRERO,6636,12,118,5627,2183,5509,0,16,4,4,3302,5627
EDO. MIRANDA,MP. PLAZA,PQ. GUARENAS,ESCUELA RURAL BOLIVARIANA CAMPO ALEGRE 028,187,1,0,167,160,167,0,0,0,0,7,167
EDO. MIRANDA,MP. PLAZA,PQ. GUARENAS,ESCUELA BASICA BOLIVARIANA RICARDO MONTILLA,3754,7,50,3170,1745,3120,4,16,2,5,1348,3170
EDO. MIRANDA,MP. PLAZA,PQ. GUARENAS,CENTRO DE EDUCACIÓN INICIAL  AMBROSIO PLAZA,833,2,16,742,468,726,0,4,0,1,253,742
EDO. MIRANDA,MP. PLAZA,PQ. GUARENAS,UNIVERSIDAD NACIONAL EXPERIMENTAL POLITECNICA LUIS CABALLERO MEJIAS,531,1,9,482,274,473,0,1,0,0,198,482
EDO. MIRANDA,MP. PLAZA,PQ. GUARENAS,LICEO ALONSO ANDREA DE LEDEZMA,3846,7,66,3217,2064,3151,1,11,1,4,1070,3217
EDO. MIRANDA,MP. PLAZA,PQ. GUARENAS,CENTRO DE FORMACIÓN SOCIALISTA INSTITUTO NACIONAL DE CAPACITACIÓN Y EDUCACIÓN SOCIALISTA COMERCIAL,507,1,12,446,296,434,0,1,0,0,137,446
EDO. MIRANDA,MP. PLAZA,PQ. GUARENAS,ESCUELA ESTADAL ROSENDO URPIANO ARMAS,2875,5,55,2375,1764,2320,0,14,2,2,538,2375
EDO. MIRANDA,MP. PLAZA,PQ. GUARENAS,ESCUELA ESTADAL NERY RANGEL DE LOPEZ,1306,3,26,1107,793,1081,0,3,1,0,284,1107
EDO. MIRANDA,MP. PLAZA,PQ. GUARENAS,ESCUELA ESTADAL ABEL GONZALEZ LIMA,926,2,20,802,649,782,0,5,0,0,128,802
EDO. MIRANDA,MP. PLAZA,PQ. GUARENAS,CASA TALLER LUISA CACERES DE ARISMENDI,529,1,10,486,308,476,0,2,0,0,166,486
EDO. MIRANDA,MP. PLAZA,PQ. GUARENAS,UNIDAD EDUCATIVA ADVENTISTA ALEJANDRO OROPEZA CASTILLO,663,2,10,612,286,602,0,1,0,0,315,612
EDO. MIRANDA,MP. PLAZA,PQ. GUARENAS,ESCUELA BASICA EXPERIMENTAL CARMEN CABRILES,2914,5,34,2522,1375,2488,0,15,0,3,1095,2522
EDO. MIRANDA,MP. PLAZA,PQ. GUARENAS,UNIDAD EDUCATIVA BENITO CANONICO,3713,7,64,3114,1534,3050,0,7,0,2,1507,3114
EDO. MIRANDA,MP. PLAZA,PQ. GUARENAS,CENTRO DE EDUCACIÓN INICIAL ESTADAL   CARMEN ESPERANZA GARCÍA,196,1,3,179,149,176,0,0,0,0,27,179
EDO. MIRANDA,MP. PLAZA,PQ. GUARENAS,ESCUELA ESTADAL ANTONIO MARIA PIÑATE,1564,3,34,1251,915,1217,0,5,0,0,297,1251
EDO. MIRANDA,MP. PLAZA,PQ. GUARENAS,ESCUELA ESTADAL BASICA ANITA LLANES,1525,3,37,1240,810,1203,1,12,0,2,378,1240
EDO. MIRANDA,MP. PLAZA,PQ. GUARENAS,GRUPO ESCOLAR SIMON RODRIGUEZ,3402,6,51,2710,1888,2659,3,9,1,2,756,2710
EDO. MIRANDA,MP. PLAZA,PQ. GUARENAS,CENTRO CULTURAL MIGUEL PARRA,3465,7,69,2913,1742,2844,1,16,2,3,1080,2913
EDO. MIRANDA,MP. PLAZA,PQ. GUARENAS,SIMONCITO CIUDAD BELEN,1138,2,22,1045,995,1023,0,1,1,0,26,1045
EDO. MIRANDA,MP. PLAZA,PQ. GUARENAS,UNIDAD EDUCATIVA ANTONIO JOSE ROJAS,1669,3,18,1364,949,1346,0,3,0,0,394,1364
EDO. MIRANDA,MP. PLAZA,PQ. GUARENAS,ESCUELA BASICA NACIONAL LAUDELINO MEJIAS,3101,6,43,2704,1478,2661,0,10,0,5,1168,2704
EDO. MIRANDA,MP. PLAZA,PQ. GUARENAS,COLEGIO SAN NICOLAS DE BARI,9456,17,78,8406,1819,8328,0,25,2,4,6478,8406
EDO. MIRANDA,MP. PLAZA,PQ. GUARENAS,UNIDAD ESTADAL FELIX MANUEL LUCES,1134,2,27,997,785,970,0,4,0,0,181,997
EDO. MIRANDA,MP. PLAZA,PQ. GUARENAS,UNIDAD EDUCATIVA PRIVADA  INSTITUTO PREMILITAR  AURELIO BALDOR,234,1,3,219,127,216,0,0,0,0,89,219
EDO. MIRANDA,MP. PLAZA,PQ. GUARENAS,UNIDAD BASICA EDUCATIVA ALBERTO SEQUIN VERA,2728,5,34,2389,1416,2355,0,9,0,4,926,2389
EDO. MIRANDA,MP. PLAZA,PQ. GUARENAS,UNIDAD EDUCATIVA  REGULO RICO,1532,3,15,1314,1001,1299,0,4,1,0,293,1314
EDO. MIRANDA,MP. PLAZA,PQ. GUARENAS,ESCUELA ESTADAL GRADUADA EULALIA BUROZ,3007,6,52,2556,1839,2504,0,11,0,2,652,2556
EDO. MIRANDA,MP. PLAZA,PQ. GUARENAS,ESCUELA TECNICA COMERCIAL ROBINSONIANA NORBERTO PRADO,3335,6,47,2858,1469,2811,0,13,3,3,1323,2858
EDO. MIRANDA,MP. PLAZA,PQ. GUARENAS,UNIDAD EDUCATIVA NACIONAL ALBERTO LOVERA,137,1,8,128,109,120,0,0,0,0,11,128
EDO. MIRANDA,MP. PLAZA,PQ. GUARENAS,LICEO BOLIVARIANO ANTONIO JOSE DE SUCRE,2062,4,49,1732,963,1683,0,7,1,1,711,1732
EDO. MIRANDA,MP. PLAZA,PQ. GUARENAS,CONCENTRACION GUACARAPA,395,1,4,347,302,343,0,0,0,0,41,347
EDO. MIRANDA,MP. PLAZA,PQ. GUARENAS,ESCUELA BASICA PRIVADA  LIBERTADORA MANUELITA SAENZ,347,1,3,290,220,287,0,1,0,0,66,290
EDO. MIRANDA,MP. PLAZA,PQ. GUARENAS,CASA COMUNAL CIUDAD BELEN,703,2,13,626,594,613,0,1,0,0,18,626
EDO. MIRANDA,MP. PLAZA,PQ. GUARENAS,UNIDAD EDUCATIVA MENCA DE LEONI I,5917,11,90,5041,3052,4951,3,25,2,10,1859,5041
EDO. MIRANDA,MP. PLAZA,PQ. GUARENAS,ESCUELA BASICA ESTADAL LINO BRAVO,1663,3,48,1299,906,1251,1,9,0,0,335,1299
EDO. MIRANDA,MP. PLAZA,PQ. GUARENAS,UNIDAD EDUCATIVA BUEN PASTOR PRESBITERIANO,1434,3,19,1174,752,1155,1,7,1,1,393,1174
EDO. MIRANDA,MP. PLAZA,PQ. GUARENAS,ESCUELA BASICA 14 DE FEBRERO,760,2,24,639,503,615,0,4,0,0,108,639
EDO. MIRANDA,MP. PLAZA,PQ. GUARENAS,UNIDAD EDUCATIVA PRIVADA  VICENTE EMILIO SOJO,536,1,6,490,244,484,0,2,0,0,238,490
EDO. MIRANDA,MP. PLAZA,PQ. GUARENAS,UNIDAD EDUCATIVA ANDRES BELLO,1525,3,11,1443,577,1432,1,8,1,1,844,1443
EDO. MIRANDA,MP. PLAZA,PQ. GUARENAS,SIMONCITO COMUNITARIO CRECIENDO FELIZ,464,1,5,432,292,427,0,1,0,0,134,432
EDO. MIRANDA,MP. PLAZA,PQ. GUARENAS,PRE ESCOLAR LA ESTRELLA,1017,2,29,825,608,796,2,7,0,1,178,825
EDO. MIRANDA,MP. PLAZA,PQ. GUARENAS,CENTRO DE EDUCACION INICIAL IRAMA MARTINEZ DE ORTA,471,1,7,437,354,430,0,2,0,1,73,437
EDO. MIRANDA,MP. PLAZA,PQ. GUARENAS,PRE ESCOLAR TERRAZAS DEL ESTE,1669,3,20,1566,524,1546,0,7,2,1,1012,1566
EDO. MIRANDA,MP. PLAZA,PQ. GUARENAS,COLEGIO CIUDAD CASARAPA,3093,6,23,2871,785,2848,1,10,0,3,2049,2871
EDO. MIRANDA,MP. PLAZA,PQ. GUARENAS,UNIDAD EDUCATIVA COLEGIO CEPA,1048,2,11,909,731,898,0,3,0,0,164,909
EDO. MIRANDA,MP. PLAZA,PQ. GUARENAS,ESCUELA NACIONAL EL TAMARINDO,4063,8,95,3309,2430,3214,0,20,2,1,761,3309
EDO. MIRANDA,MP. PLAZA,PQ. GUARENAS,ESCUELA PRIMARIA CREACION TRAPICHITO,4813,9,84,4131,2372,4047,0,13,0,4,1658,4131
EDO. MIRANDA,MP. PLAZA,PQ. GUARENAS,ESCUELA BASICA ZENOBIA VERGARA  DE CHIQUITO,1039,2,12,869,737,857,1,2,2,0,115,869
EDO. MIRANDA,MP. SUCRE,PQ. PETARE,CENTRO DE EDUCACION INICIAL ELVIRA PARILLI DE SENIOR,1252,3,21,1032,583,1011,0,11,0,1,416,1032
EDO. MIRANDA,MP. SUCRE,PQ. PETARE,COLEGIO ARMANDO REVERON,4650,9,58,3756,2394,3698,3,13,0,2,1286,3756
EDO. MIRANDA,MP. SUCRE,PQ. PETARE,COLEGIO CRUZ CARRILLO,2245,4,6,1809,171,1803,0,3,0,1,1628,1809
EDO. MIRANDA,MP. SUCRE,PQ. PETARE,UNIDAD EDUCATIVA RAUL LEONI,3716,7,65,3227,1904,3162,1,5,2,0,1250,3227
EDO. MIRANDA,MP. SUCRE,PQ. PETARE,COLEGIO DULCE NOMBRE DE JESUS,2097,4,43,1723,745,1680,0,2,1,4,928,1723
EDO. MIRANDA,MP. SUCRE,PQ. PETARE,COMEDOR DE LA FORTALEZA CASA BOLIVARIANA,1478,3,22,1191,683,1169,0,7,1,2,476,1191
EDO. MIRANDA,MP. SUCRE,PQ. PETARE,FUERZA SALUD Y VIGOR CLUB DE LOS ABUELOS,49,1,2,39,23,37,0,0,0,1,13,39
EDO. MIRANDA,MP. SUCRE,PQ. PETARE,CENTRO DE EDUCACION INICIAL NACIONAL EL LLANITO,3814,7,40,2887,991,2847,1,8,1,1,1845,2887
EDO. MIRANDA,MP. SUCRE,PQ. PETARE,CASA DE LA CULTURA JOSE FELIX RIBAS,1234,3,15,1046,761,1031,3,4,2,4,257,1046
EDO. MIRANDA,MP. SUCRE,PQ. PETARE,CENTROS DE ESTUDIOS CECILIO ACOSTA,2293,4,19,1743,403,1724,0,7,0,2,1312,1743
EDO. MIRANDA,MP. SUCRE,PQ. PETARE,CASA COMUNAL ANTONIO JOSE DE SUCRE,501,1,6,412,315,406,0,2,0,0,89,412
EDO. MIRANDA,MP. SUCRE,PQ. PETARE,COLEGIO SAN JOSE,4580,8,38,3906,672,3868,1,9,2,2,3182,3906
EDO. MIRANDA,MP. SUCRE,PQ. PETARE,ESCUELA NACIONAL BARTOLOME SALOM,6477,12,82,5178,3257,5096,0,32,4,3,1800,5178
EDO. MIRANDA,MP. SUCRE,PQ. PETARE,UNIVERSIDAD SIMON RODRIGUEZ,3222,6,39,2579,813,2540,0,7,1,2,1717,2579
EDO. MIRANDA,MP. SUCRE,PQ. PETARE,ESCUELA BASICA MUNICIPAL PASTOR OROPEZA,461,1,3,402,329,399,0,1,0,0,69,402
EDO. MIRANDA,MP. SUCRE,PQ. PETARE,UNIDAD EDUCATIVA MUNICIPAL LUIS CORREA,2812,5,38,2245,1620,2207,0,16,2,1,568,2245
EDO. MIRANDA,MP. SUCRE,PQ. PETARE,COLEGIO MANUEL MUNOZ TEBAR,2331,4,10,1747,167,1737,1,4,0,1,1564,1747
EDO. MIRANDA,MP. SUCRE,PQ. PETARE,UNIDAD EDUCATIVA COLEGIO MARA,1767,3,52,1516,906,1464,0,6,0,1,551,1516
EDO. MIRANDA,MP. SUCRE,PQ. PETARE,COLEGIO PRESIDENTE KENNEDY,4052,7,61,3295,2321,3234,0,16,1,3,893,3295
EDO. MIRANDA,MP. SUCRE,PQ. PETARE,PRE ESCOLAR DON BOSCO,358,1,3,296,228,293,2,2,0,0,61,296
EDO. MIRANDA,MP. SUCRE,PQ. PETARE,GRUPO ESCOLAR RAFAEL NAPOLEON BAUTE,9045,17,150,7223,4747,7073,2,50,9,6,2259,7223
EDO. MIRANDA,MP. SUCRE,PQ. PETARE,UNIVERSIDAD SANTA MARIA,3687,7,22,3043,392,3021,1,4,0,1,2623,3043
EDO. MIRANDA,MP. SUCRE,PQ. PETARE,PRE ESCOLAR ADELA DE CALVANI OCASIS,383,1,2,356,277,354,0,0,1,1,75,356
EDO. MIRANDA,MP. SUCRE,PQ. PETARE,UNIDAD BASICA MUNICIPAL SOCORRO GONZALEZ GUINAN,1541,3,18,1262,632,1244,1,5,0,0,606,1262
EDO. MIRANDA,MP. SUCRE,PQ. PETARE,COOPERATIVA 12 DE OCTUBRE,236,1,6,183,109,177,0,0,1,0,67,183
EDO. MIRANDA,MP. SUCRE,PQ. PETARE,BIBLIOTECA JOSE FELIX RIBAS,3008,6,59,2239,1513,2180,1,12,1,3,650,2239
EDO. MIRANDA,MP. SUCRE,PQ. PETARE,UNIDAD EDUCATIVA MUNICIPAL FRANCISCO ESPEJO,3590,7,43,2636,1496,2593,1,12,0,2,1082,2636
EDO. MIRANDA,MP. SUCRE,PQ. PETARE,UNIDAD EDUCATIVA NINO JESUS DE ESCUQUE,1114,2,8,948,218,940,0,0,0,0,722,948
EDO. MIRANDA,MP. SUCRE,PQ. PETARE,COOPERATIVA ZONA 3,381,1,6,320,223,314,0,0,0,0,91,320
EDO. MIRANDA,MP. SUCRE,PQ. PETARE,ESCUELA BASICA NACIONAL COSME DAMIAN PEÑA,2672,5,19,2075,368,2056,0,2,0,0,1686,2075
EDO. MIRANDA,MP. SUCRE,PQ. PETARE,UNIDAD EDUCATIVA MUNICIPAL SIMON BOLIVAR,3747,7,37,3056,1624,3019,2,10,2,3,1378,3056
EDO. MIRANDA,MP. SUCRE,PQ. PETARE,CASA DE LA CULTURA UBALDO LIRA,1159,3,20,864,528,844,1,9,0,1,305,864
EDO. MIRANDA,MP. SUCRE,PQ. PETARE,JARDIN DE INFANCIA AQUILES NAZOA,1671,3,33,1433,850,1400,0,9,0,2,539,1433
EDO. MIRANDA,MP. SUCRE,PQ. PETARE,UNIDAD EDUCATIVA LEONCIO MARTINEZ,1028,2,21,860,329,839,0,2,0,1,507,860
EDO. MIRANDA,MP. SUCRE,PQ. PETARE,ESCUELA GRAN MARISCAL DE AYACUCHO,4212,8,70,3381,1813,3311,0,19,4,0,1475,3381
EDO. MIRANDA,MP. SUCRE,PQ. PETARE,ESCUELA BASICA ESTADAL SIMÓN BOLÍVAR,7712,14,248,5811,3431,5563,3,24,5,7,2093,5811
EDO. MIRANDA,MP. SUCRE,PQ. PETARE,MODULO DE BARRIO ADENTRO CECILIO ACOSTA,599,1,8,420,306,412,1,1,0,0,104,420
EDO. MIRANDA,MP. SUCRE,PQ. PETARE,ESCUELA ESTADAL DON TITO SALAS,3330,6,54,2589,1848,2535,1,12,2,1,671,2589
EDO. MIRANDA,MP. SUCRE,PQ. PETARE,COLEGIO YALE,2488,5,9,1891,132,1882,0,3,0,1,1746,1891
EDO. MIRANDA,MP. SUCRE,PQ. PETARE,ESCUELA ESTADO BARINAS,2966,6,50,2385,1550,2335,0,17,3,1,764,2385
EDO. MIRANDA,MP. SUCRE,PQ. PETARE,ESCUELA BASICA ARMANDO CASTILLO PLAZA,1100,2,9,911,360,902,0,3,0,1,538,911
EDO. MIRANDA,MP. SUCRE,PQ. PETARE,PREESCOLAR MANANTIAL,96,1,1,87,74,86,0,0,0,0,12,87
EDO. MIRANDA,MP. SUCRE,PQ. PETARE,CENTRO DE FORMACIÓN INDUSTRIAL DEL ESTE INCES,2690,5,31,2250,736,2219,0,11,0,3,1469,2250
EDO. MIRANDA,MP. SUCRE,PQ. PETARE,ESCUELA  ROCA VIVA,3658,7,55,2925,1870,2870,0,18,0,2,980,2925
EDO. MIRANDA,MP. SUCRE,PQ. PETARE,DESARROLLO URBANISTICO LA URBINA,111,1,3,106,99,103,0,0,0,0,4,106
EDO. MIRANDA,MP. SUCRE,PQ. PETARE,CASA COMUNAL ALCABALA,589,1,11,506,362,495,0,5,0,0,128,506
EDO. MIRANDA,MP. SUCRE,PQ. PETARE,KINDER LAS CASITAS,89,1,1,71,41,70,0,2,0,0,27,71
EDO. MIRANDA,MP. SUCRE,PQ. PETARE,UNIDAD EDUCATIVA COLEGIO JUAN PABLO II,3733,7,14,2775,306,2761,2,5,1,3,2444,2775
EDO. MIRANDA,MP. SUCRE,PQ. PETARE,CENTRO DE EDUCACION INICIAL NACIONAL JACINTO LARA,2774,5,36,2250,687,2214,0,4,1,3,1519,2250
EDO. MIRANDA,MP. SUCRE,PQ. PETARE,ESCUELA BASICA BARRIO NUEVO,359,1,2,330,252,328,0,0,1,0,75,330
EDO. MIRANDA,MP. SUCRE,PQ. PETARE,COLEGIO FE Y ALEGRIA,4575,8,50,3313,1972,3263,1,12,1,2,1275,3313
EDO. MIRANDA,MP. SUCRE,PQ. PETARE,ESCUELA MUNICIPAL COROMOTO,5579,10,69,4594,3037,4525,3,29,1,6,1449,4594
EDO. MIRANDA,MP. SUCRE,PQ. PETARE,INSTITUTO EDUCATIVO CLAPAREDE,616,2,7,380,133,373,0,0,0,0,240,380
EDO. MIRANDA,MP. SUCRE,PQ. PETARE,ESCUELA BASICA NACIONAL JULIO CALCAÑO,4326,8,67,3401,1990,3334,0,17,2,2,1323,3401
EDO. MIRANDA,MP. SUCRE,PQ. PETARE,ESCUELA ESTADAL GRADUADA CONSUELO NAVAS TOVAR,4757,9,77,3773,2605,3696,0,16,1,3,1071,3773
EDO. MIRANDA,MP. SUCRE,PQ. PETARE,INSTITUTO DIDACTICO ANDRES BELLO,1232,3,8,877,117,869,0,2,0,0,750,877
EDO. MIRANDA,MP. SUCRE,PQ. PETARE,ESCUELA ESTADAL JOSE ANTONIO PAEZ,1657,3,44,1294,903,1250,0,7,0,1,339,1294
EDO. MIRANDA,MP. SUCRE,PQ. PETARE,JARDIN DE INFANCIA CARMEN VERONICA COELLO,1685,3,24,1278,721,1254,1,3,2,1,526,1278
EDO. MIRANDA,MP. SUCRE,PQ. PETARE,COLEGIO JOSE DE JESUS AROCHA,8253,15,120,5848,3433,5728,2,36,2,1,2254,5848
EDO. MIRANDA,MP. SUCRE,PQ. PETARE,UNIDAD EDUCATIVA DOCTOR NUÑEZ PONTE,739,2,8,612,419,604,0,4,0,1,180,612
EDO. MIRANDA,MP. SUCRE,PQ. PETARE,KINDER JOSE GREGORIO MONAGAS,986,2,23,825,395,802,0,3,0,0,404,825
EDO. MIRANDA,MP. SUCRE,PQ. PETARE,COLEGIO MADRE DEL DIVINO PASTOR,6543,12,29,4985,423,4956,2,4,1,2,4524,4985
EDO. MIRANDA,MP. SUCRE,PQ. PETARE,MINI DEPORTIVO CAMELIA DE REGGETTI,847,2,0,686,95,686,1,0,1,0,589,686
EDO. MIRANDA,MP. SUCRE,PQ. PETARE,UNIDAD EDUCATIVA INSTITUTO VENEZUELA NUEVA,2173,4,2,1771,163,1769,0,2,0,2,1602,1771
EDO. MIRANDA,MP. SUCRE,PQ. PETARE,CENTRO EDUCACION INICIAL NACIONAL PEDRO ZARAZO,580,1,8,521,390,513,0,3,3,0,117,521
EDO. MIRANDA,MP. SUCRE,PQ. PETARE,COLEGIO SAN AGUSTIN,1604,3,12,1200,135,1188,1,0,0,1,1051,1200
EDO. MIRANDA,MP. SUCRE,PQ. PETARE,UNIDAD EDUCATIVA MUNICIPAL ROMULO GALLEGOS,2521,5,47,2091,1195,2044,0,12,0,2,835,2091
EDO. MIRANDA,MP. SUCRE,PQ. PETARE,COLEGIO NUESTRA SEÑORA DE LA GUIA,1773,3,18,1406,161,1388,0,1,0,1,1225,1406
EDO. MIRANDA,MP. SUCRE,PQ. PETARE,CASA COMUNITARIA JULIAN BLANCO,888,2,18,685,507,667,0,2,1,0,157,685
EDO. MIRANDA,MP. SUCRE,PQ. PETARE,UNIDAD EDUCATIVA ENRIQUE DE OSSO,359,1,3,324,124,321,0,0,1,1,195,324
EDO. MIRANDA,MP. SUCRE,PQ. PETARE,UNIDAD EDUCATIVA COLEGIO  JOSÉ ANTONIO MAITIN,1127,2,5,965,131,960,0,1,0,1,827,965
EDO. MIRANDA,MP. SUCRE,PQ. PETARE,UNIDAD EDUCATIVA NACIONAL LICEO MARIANO PICON SALAS,4041,7,49,3234,1624,3185,1,16,3,4,1537,3234
EDO. MIRANDA,MP. SUCRE,PQ. PETARE,COLEGIO MANUEL PIAR,1682,3,26,1356,426,1330,0,4,1,0,899,1356
EDO. MIRANDA,MP. SUCRE,PQ. PETARE,GUARDERIA Y PREESCOLAR MI BELLA ILUCION,1023,2,14,813,553,799,0,2,1,2,241,813
EDO. MIRANDA,MP. SUCRE,PQ. PETARE,COLEGIO UNIVERSITARIO PROFESOR LORENZO PEREZ RODRIGUEZ,456,1,9,390,136,381,1,0,0,0,244,390
EDO. MIRANDA,MP. SUCRE,PQ. PETARE,BIBLIOTECA MISIA INFANTE,481,1,8,398,255,390,0,1,0,0,134,398
EDO. MIRANDA,MP. SUCRE,PQ. PETARE,UNIDAD EDUCATIVA COLEGIO ESDRAS,1829,4,33,1513,931,1480,1,6,1,0,541,1513
EDO. MIRANDA,MP. SUCRE,PQ. PETARE,ESCUELA NACIONAL MAGALI BURGOS DE LOPEZ,1456,3,22,1057,460,1035,0,1,0,0,574,1057
EDO. MIRANDA,MP. SUCRE,PQ. PETARE,PREESCOLAR MATEA BOLIVAR,620,2,11,548,351,537,0,3,1,0,182,548
EDO. MIRANDA,MP. SUCRE,PQ. PETARE,ESCUELA BASICA NACIONAL . ANTONIO ORDONEZ,4386,8,93,3555,1788,3462,2,12,4,3,1653,3555
EDO. MIRANDA,MP. SUCRE,PQ. PETARE,FUNDACION JOSE ANGEL LAMAS,887,2,8,675,376,667,0,2,1,4,284,675
EDO. MIRANDA,MP. SUCRE,PQ. PETARE,INSTITUTO NACIONAL DE CAPACITACION SOCIALISTA,3369,6,31,2580,390,2549,0,3,1,2,2153,2580
EDO. MIRANDA,MP. SUCRE,PQ. PETARE,ESCUELA MUNICIPAL 5 DE JULIO,3583,7,85,2761,1597,2676,0,13,2,0,1064,2761
EDO. MIRANDA,MP. SUCRE,PQ. PETARE,JARDIN DE INFANCIA AGUSTIN AVELEDO,1389,3,26,1037,589,1011,0,1,1,0,420,1037
EDO. MIRANDA,MP. SUCRE,PQ. PETARE,UNIDAD EDUCATIVA ESTADAL 12 DE FEBRERO,2001,4,52,1639,913,1587,1,12,2,1,658,1639
EDO. MIRANDA,MP. SUCRE,PQ. PETARE,PREESCOLAR AMINTA DE MANZANILLA,1033,2,8,791,134,783,1,1,1,0,646,791
EDO. MIRANDA,MP. SUCRE,PQ. PETARE,CANCHA TECHADA LA BOMBILLA SECTOR 3,1879,4,27,1665,1303,1638,0,6,0,0,329,1665
EDO. MIRANDA,MP. SUCRE,PQ. PETARE,UNIDAD EDUCATIVA INSTITUTO SAN LUCAS,4916,9,54,4042,1256,3988,0,6,2,2,2722,4042
EDO. MIRANDA,MP. SUCRE,PQ. PETARE,CANCHA ASOCIACION DE VECINOS URBANIZACION EL LLANITO,134,1,1,116,36,115,0,0,0,0,79,116
EDO. MIRANDA,MP. SUCRE,PQ. PETARE,UNIDAD EDUCATIVA MUNICIPAL LISANDRO ALVARADO,3556,7,89,2753,1663,2664,0,17,2,2,980,2753
EDO. MIRANDA,MP. SUCRE,PQ. PETARE,UNIDAD EDUCATIVA NACIONAL ELISA RISKEL DOMINGUEZ,3971,7,84,3265,1934,3181,0,11,0,1,1235,3265
EDO. MIRANDA,MP. SUCRE,PQ. PETARE,UNIDAD EDUCATIVA COLEGIO MARIA SANTISIMA,1795,4,7,1472,102,1465,0,1,0,0,1362,1472
EDO. MIRANDA,MP. SUCRE,PQ. PETARE,ESCUELA MUNICIPAL ANDRES ELOY BLANCO,5169,9,66,4259,1619,4193,0,15,4,4,2551,4259
EDO. MIRANDA,MP. SUCRE,PQ. PETARE,UNIDAD EDUCATIVA  COLEGIO  SIMON BOLIVAR Y GARIBALDI,2121,4,11,1614,112,1603,0,1,1,2,1487,1614
EDO. MIRANDA,MP. SUCRE,PQ. PETARE,UNIDAD EDUCATIVA MUNICIPAL GUAICAIPURO,1904,4,33,1569,1016,1536,0,3,0,0,517,1569
EDO. MIRANDA,MP. SUCRE,PQ. PETARE,UNIDAD EDUCATIVA PRIVADA MIGUEL SURIAGA,228,1,2,192,137,190,0,2,0,0,51,192
EDO. MIRANDA,MP. SUCRE,PQ. PETARE,BIBLIOTECA PUBLICA PAUL HARRIS,740,2,9,669,455,660,0,2,0,0,203,669
EDO. MIRANDA,MP. SUCRE,PQ. PETARE,UNIDAD EDUCATIVA MUNICIPAL ABAJO CADENAS,5132,9,59,4044,2748,3985,9,18,7,2,1201,4044
EDO. MIRANDA,MP. SUCRE,PQ. PETARE,UNIDAD EDUCATIVA ESTADAL.GENERAL SANTIAGO MARIÑO,1674,3,29,1332,910,1303,0,5,0,1,387,1332
EDO. MIRANDA,MP. SUCRE,PQ. PETARE,UNIDAD EDUCATIVA PREESCOLAR AMALIVAC,1131,2,5,905,135,900,0,1,0,0,764,905
EDO. MIRANDA,MP. SUCRE,PQ. PETARE,LICEO BOLIVARIANO LINO DE CLEMENTE,4399,8,26,3335,530,3309,1,3,1,5,2769,3335
EDO. MIRANDA,MP. SUCRE,PQ. PETARE,ESCUELA MUNICIPAL FERMIN TORO,3967,7,51,3199,2078,3148,1,18,1,1,1049,3199
EDO. MIRANDA,MP. SUCRE,PQ. PETARE,PREESCOLAR MIRIAM ACUÑA,245,1,5,214,173,209,0,2,0,0,34,214
EDO. MIRANDA,MP. SUCRE,PQ. PETARE,ESCUELA TECNICA LEONARDO INFANTE,3745,7,47,2936,1510,2889,1,9,0,7,1362,2936
EDO. MIRANDA,MP. SUCRE,PQ. PETARE,TEATRO CESAR RENGIFO,1963,4,38,1507,880,1469,1,4,3,1,580,1507
EDO. MIRANDA,MP. SUCRE,PQ. PETARE,JARDIN DE INFANCIA CADAFITO,3505,6,17,2622,585,2605,0,5,1,3,2011,2622
EDO. MIRANDA,MP. SUCRE,PQ. PETARE,CENTRO DE EDUCACION INICIAL PRE ESCOLAR CINTHIA ROSEMBERG,3826,7,23,3143,430,3120,1,7,2,1,2679,3143
EDO. MIRANDA,MP. SUCRE,PQ. PETARE,BIBLIOTECA PUBLICA CAMPO RICO,158,1,0,134,94,134,0,1,0,1,38,134
EDO. MIRANDA,MP. SUCRE,PQ. PETARE,UNIDAD EDUCATIVA ALBERTO RAVELL,5701,10,66,4495,2705,4429,3,20,6,4,1691,4495
EDO. MIRANDA,MP. SUCRE,PQ. PETARE,CENTRO EDUCATIVO RECREACIONAL LUISA CACERES DE ARISMENDI,4907,9,108,3865,2361,3757,0,24,1,0,1371,3865
EDO. MIRANDA,MP. SUCRE,PQ. PETARE,PREESCOLAR DOÑA CARMEN,115,1,7,102,62,95,0,1,0,0,32,102
EDO. MIRANDA,MP. SUCRE,PQ. PETARE,UNIDAD EDUCATIVA COLEGIO BELTRAN RUSSEL,2134,4,17,1803,405,1786,0,2,0,1,1378,1803
EDO. MIRANDA,MP. SUCRE,PQ. PETARE,UNIDAD EDUCATIVA MUNICIPAL SIMON RODRIGUEZ,1962,4,16,1575,244,1559,0,0,0,0,1315,1575
EDO. MIRANDA,MP. SUCRE,PQ. PETARE,CENTRO DE EDUCACION INICIAL ESTADAL EZEQUIEL ZAMORA,604,2,15,550,409,535,0,2,0,0,124,550
EDO. MIRANDA,MP. SUCRE,PQ. PETARE,CANCHA DEL BARRIO METROPOLITANO,477,1,2,388,286,386,1,4,1,0,94,388
EDO. MIRANDA,MP. SUCRE,PQ. PETARE,UNIVERSIDAD METROPOLITANA,7138,13,41,5937,514,5896,1,8,1,0,5372,5937
EDO. MIRANDA,MP. SUCRE,PQ. PETARE,ESCUELA JOSE MERCEDES SANTELIZ,1260,3,12,1105,642,1093,0,3,0,1,447,1105
EDO. MIRANDA,MP. SUCRE,PQ. PETARE,UNIDAD EDUCATIVA MUNICIPAL AGUSTIN AVELEDO,2426,5,25,1922,992,1897,0,7,0,5,893,1922
EDO. MIRANDA,MP. SUCRE,PQ. PETARE,CENTRO COMUNITARIO C E N C O N,1056,2,32,862,449,830,0,3,1,1,376,862
EDO. MIRANDA,MP. SUCRE,PQ. PETARE,ESCUELA NACIONAL MANUEL AGUIRRE ELORRIAGA,5266,10,69,4237,3092,4168,0,14,2,2,1058,4237
EDO. MIRANDA,MP. SUCRE,PQ. PETARE,UNIDAD EDUCATIVA ALTERNATIVA EL CARMEN,627,2,7,543,435,536,0,2,0,1,98,543
EDO. MIRANDA,MP. SUCRE,PQ. PETARE,CENTRO DE ORIENTACION Y EDUCACION COMUNITARIA,1323,3,23,1137,837,1114,0,6,1,2,268,1137
EDO. MIRANDA,MP. SUCRE,PQ. PETARE,UNIDAD EDUCATIVA COLEGIO MACARACUAY,2444,5,6,1889,149,1883,0,1,1,0,1732,1889
EDO. MIRANDA,MP. SUCRE,PQ. PETARE,BIBLIOTECA PUBLICA PILOTO LA URBINA,404,1,9,346,245,337,0,2,0,0,90,346
EDO. MIRANDA,MP. SUCRE,PQ. PETARE,CASA CUNA PETARE,1699,3,24,1298,791,1274,0,3,0,1,479,1298
EDO. MIRANDA,MP. SUCRE,PQ. PETARE,COLEGIO JESUS MAESTRO,2992,6,58,2377,1645,2319,1,14,1,1,657,2377
EDO. MIRANDA,MP. SUCRE,PQ. PETARE,INSTITUTO EDUCATIVO SAN JUDAS TADEO,1317,3,13,1128,252,1115,0,4,2,0,857,1128
EDO. MIRANDA,MP. SUCRE,PQ. PETARE,INSTITUTO MAGISTERIAL VENEZUELA,981,2,16,752,349,736,1,4,1,1,380,752
EDO. MIRANDA,MP. SUCRE,PQ. PETARE,TECNICA.TITO SPORT,385,1,10,322,224,312,0,0,0,1,87,322
EDO. MIRANDA,MP. SUCRE,PQ. PETARE,UNIDAD EDUCATIVA COLEGIO SAN ANTONIO DE MACARACUAY,7692,14,36,5981,486,5945,0,9,0,6,5444,5981
EDO. MIRANDA,MP. SUCRE,PQ. PETARE,DESARROLLO URBANISTICO CIUDAD LEBRUN,78,1,1,76,75,75,0,0,0,0,0,76
EDO. MIRANDA,MP. SUCRE,PQ. PETARE,UNIDAD EDUCATIVA MUNICIPAL ROMULO BETANCOURT,722,2,15,654,507,639,0,2,0,0,130,654
EDO. MIRANDA,MP. SUCRE,PQ. PETARE,UNIDAD EDUCATIVA MUNICIPAL CECILIO ACOSTA,3407,6,78,2788,1553,2710,0,11,2,2,1142,2788
EDO. MIRANDA,MP. SUCRE,PQ. CAUCAGUITA,UNIDAD EDUCATIVA FE Y ALEGRIA PADRE JOAQUIN LOPEZ,4482,8,66,3767,1955,3701,1,11,0,4,1730,3767
EDO. MIRANDA,MP. SUCRE,PQ. CAUCAGUITA,LICEO NEGRO PRIMERO,3452,6,56,2697,1748,2641,0,12,3,3,875,2697
EDO. MIRANDA,MP. SUCRE,PQ. CAUCAGUITA,DOÑA MENCA DE LEONI,123,1,5,105,62,100,0,0,0,0,38,105
EDO. MIRANDA,MP. SUCRE,PQ. CAUCAGUITA,ESCUELA MUNICIPAL ANTONIO JOSE DE SUCRE,5818,11,132,4556,3181,4424,2,18,0,5,1218,4556
EDO. MIRANDA,MP. SUCRE,PQ. CAUCAGUITA,FUNDACION NACIONAL EL NINO SIMON CENTRO EDUCACION INICIAL LAS AVEJITAS,1561,3,29,1358,1027,1329,1,8,2,2,289,1358
EDO. MIRANDA,MP. SUCRE,PQ. CAUCAGUITA,CENTRO MARITIMO DE VENEZUELA,3891,7,79,3027,1329,2948,0,8,0,1,1610,3027
EDO. MIRANDA,MP. SUCRE,PQ. CAUCAGUITA,ESCUELA BASICA ESTADAL NEGRO PRIMERO II,4949,9,95,3941,2657,3846,2,11,4,2,1170,3941
EDO. MIRANDA,MP. SUCRE,PQ. CAUCAGUITA,CENTRO DE ATENCION INTEGRAL AL CIUDADANO,373,1,2,323,251,321,0,1,0,0,69,323
EDO. MIRANDA,MP. SUCRE,PQ. CAUCAGUITA,UNIDAD EDUCATIVA MUNICIPAL JOSE ANTONIO CALCAÑO,4176,8,110,3285,1826,3175,1,25,1,2,1320,3285
EDO. MIRANDA,MP. SUCRE,PQ. CAUCAGUITA,GRUPO ESCOLAR DOCTOR JOSE MARIA VARGAS,1639,3,28,1344,998,1316,1,6,1,0,310,1344
EDO. MIRANDA,MP. SUCRE,PQ. CAUCAGUITA,ESCUELA BASICA NACIONAL LICEO JOSE ANTONIO CALCAÑO,792,2,20,620,361,600,0,4,0,0,235,620
EDO. MIRANDA,MP. SUCRE,PQ. CAUCAGUITA,UNIDAD EDUCATIVA NACIONAL TURUMO,1546,3,32,1162,654,1130,0,5,1,1,469,1162
EDO. MIRANDA,MP. SUCRE,PQ. LEONCIO MARTINEZ,ESCUELA MUNICIPAL FRANCISCO DE MIRANDA,2264,4,36,1718,711,1682,0,2,0,0,969,1718
EDO. MIRANDA,MP. SUCRE,PQ. LEONCIO MARTINEZ,INSTITUTO MEJORAMIENTO PROFESIONAL DEL MAGISTERIO,2675,5,18,1978,362,1960,0,5,2,2,1589,1978
EDO. MIRANDA,MP. SUCRE,PQ. LEONCIO MARTINEZ,INSTITUTO NUESTRA SEÑORA DE FATIMA,786,2,6,637,103,631,0,2,0,0,526,637
EDO. MIRANDA,MP. SUCRE,PQ. LEONCIO MARTINEZ,COLEGIO FRANCIA,6216,12,91,4630,1071,4539,0,5,3,1,3459,4630
EDO. MIRANDA,MP. SUCRE,PQ. LEONCIO MARTINEZ,INSTITUTO CICLO BASICO ESTEBAN GIL BORGES,1514,3,15,1074,287,1059,0,2,0,1,769,1074
EDO. MIRANDA,MP. SUCRE,PQ. LEONCIO MARTINEZ,COLEGIO AMERICO VESPUCIO,2047,4,16,1556,219,1540,1,0,0,2,1318,1556
EDO. MIRANDA,MP. SUCRE,PQ. LEONCIO MARTINEZ,COLEGIO RODRIGUEZ PAZ,1257,3,8,958,157,950,0,1,0,1,791,958
EDO. MIRANDA,MP. SUCRE,PQ. LEONCIO MARTINEZ,COLEGIO MARIA AUXILIADORA,2195,4,25,1785,322,1760,0,1,0,1,1436,1785
EDO. MIRANDA,MP. SUCRE,PQ. LEONCIO MARTINEZ,ESCUELA NACIONAL RICARDO ZULUAGA,1647,3,14,1257,277,1243,1,6,0,3,956,1257
EDO. MIRANDA,MP. SUCRE,PQ. LEONCIO MARTINEZ,COLEGIO MADRE EMILIA,4329,8,30,3293,610,3263,1,11,0,2,2639,3293
EDO. MIRANDA,MP. SUCRE,PQ. LEONCIO MARTINEZ,COLEGIO MARIA INMACULADA,1639,3,10,1278,187,1268,1,1,2,1,1076,1278
EDO. MIRANDA,MP. SUCRE,PQ. LEONCIO MARTINEZ,INSTITUTO DE NUEVAS PROFESIONES,4131,8,41,3038,478,2997,3,5,1,1,2509,3038
EDO. MIRANDA,MP. SUCRE,PQ. LEONCIO MARTINEZ,PREESCOLAR EUGENIA RABASCO,1075,2,4,850,96,846,0,2,0,1,747,850
EDO. MIRANDA,MP. SUCRE,PQ. LEONCIO MARTINEZ,COLEGIO ALA BLANCA,1451,3,11,1093,322,1082,0,4,1,1,754,1093
EDO. MIRANDA,MP. SUCRE,PQ. LEONCIO MARTINEZ,INSTITUTO MARIA MICAELA,2173,4,25,1742,416,1717,0,6,0,1,1294,1742
EDO. MIRANDA,MP. SUCRE,PQ. LEONCIO MARTINEZ,LICEO JUAN BAUTISTA PLAZA,845,2,12,633,176,621,0,0,0,2,443,633
EDO. MIRANDA,MP. SUCRE,PQ. LEONCIO MARTINEZ,CENTRO DE EDUCACIÓN INICIAL BASE AÉREA GENERALISIMO FRANCISCO DE MIRANDA,286,1,2,271,255,269,0,0,0,0,14,271
EDO. MIRANDA,MP. SUCRE,PQ. LEONCIO MARTINEZ,CENTRO DE FORMACION SOCIALISTA LOS RUICES,173,1,2,164,159,162,0,0,0,0,3,164
EDO. MIRANDA,MP. SUCRE,PQ. LEONCIO MARTINEZ,INSTITUTO DE FORMACION INTEGRAL LOS PROCERES,520,1,5,423,53,418,0,0,0,1,364,423
EDO. MIRANDA,MP. SUCRE,PQ. LEONCIO MARTINEZ,ESCUELA TECNICA POPULAR DON BOSCO,9607,18,108,7191,1505,7083,0,18,2,5,5553,7191
EDO. MIRANDA,MP. SUCRE,PQ. LEONCIO MARTINEZ,UNIDAD  EDUCATIVA COLEGIO SANTA GEMA,5151,9,30,3919,443,3889,2,4,0,6,3434,3919
EDO. MIRANDA,MP. SUCRE,PQ. LEONCIO MARTINEZ,COLEGIO NUESTRA SEÑORA DE COROMOTO,1118,2,5,796,159,791,0,3,0,0,629,796
EDO. MIRANDA,MP. SUCRE,PQ. LEONCIO MARTINEZ,COLEGIO PATRIA,1111,2,3,914,123,911,0,1,1,1,785,914
EDO. MIRANDA,MP. SUCRE,PQ. LEONCIO MARTINEZ,UNIDAD EDUCATIVA ESTADAL MARIA ANGELICA LUSINCHI,1748,3,29,1490,751,1461,0,6,0,2,702,1490
EDO. MIRANDA,MP. SUCRE,PQ. LEONCIO MARTINEZ,COLEGIO ELENA DE BUENO,1345,3,5,1060,70,1055,0,0,0,1,984,1060
EDO. MIRANDA,MP. SUCRE,PQ. LEONCIO MARTINEZ,UNIDAD EDUCATIVA NACIONAL MARTINEZ CENTENO,2767,5,9,2013,305,2004,0,3,0,1,1695,2013
EDO. MIRANDA,MP. SUCRE,PQ. LEONCIO MARTINEZ,UNIDAD EDUCATIVA EXPERIMENTAL NACIONAL LUIS BELTRAN PRIETO FIGUEROA,559,1,12,507,272,495,1,1,0,0,221,507
EDO. MIRANDA,MP. SUCRE,PQ. LA DOLORITA,UNIDAD EDUCATIVA NACIONAL JERMAN UBALDO LIRA,4008,7,70,3218,2208,3148,4,22,4,3,907,3218
EDO. MIRANDA,MP. SUCRE,PQ. LA DOLORITA,UNIDAD EDUCATIVA JUAN XXIII,734,2,12,640,476,628,0,2,0,0,150,640
EDO. MIRANDA,MP. SUCRE,PQ. LA DOLORITA,ESCUELA  ESTADAL FRANCISCO ISNARDI,2491,5,76,2059,1509,1983,2,13,5,3,451,2059
EDO. MIRANDA,MP. SUCRE,PQ. LA DOLORITA,ESCUELA MUNICIPAL CARMEN BALVERDE,2284,4,60,1837,1182,1777,2,7,1,0,585,1837
EDO. MIRANDA,MP. SUCRE,PQ. LA DOLORITA,CASA DE LA CULTURA ARMANDO REVERON,776,2,17,669,537,652,1,9,0,0,105,669
EDO. MIRANDA,MP. SUCRE,PQ. LA DOLORITA,UNIDAD EDUCATIVA NACIONAL MARISCAL SUCRE,5191,10,85,4047,2842,3962,1,27,3,6,1083,4047
EDO. MIRANDA,MP. SUCRE,PQ. LA DOLORITA,CENTRO EDUCATIVO INICIAL MUNICIPAL ZAIDA LAGER,567,1,14,466,366,452,0,2,0,0,84,466
EDO. MIRANDA,MP. SUCRE,PQ. LA DOLORITA,ESCUELA BASICA JOSE NICOMEDES MARRERO,2030,4,55,1677,1066,1622,0,9,1,1,545,1677
EDO. MIRANDA,MP. SUCRE,PQ. LA DOLORITA,JARDIN DE INFANCIA JUAN PABLO PEREZ ALFONSO,590,1,4,426,283,422,0,1,1,0,137,426
EDO. MIRANDA,MP. SUCRE,PQ. LA DOLORITA,ESCUELA MUNICIPAL PAZ CASTILLO,1226,3,23,1028,511,1005,0,3,0,0,491,1028
EDO. MIRANDA,MP. SUCRE,PQ. LA DOLORITA,UNIDAD EDUCATIVA COLEGIO FUENTE DE SALVACION,1516,3,45,1267,775,1222,0,4,2,0,441,1267
EDO. MIRANDA,MP. SUCRE,PQ. FILAS DE MARICHES,MARIA TERESA NEZER,2202,4,32,1774,1159,1742,1,6,0,1,575,1774
EDO. MIRANDA,MP. SUCRE,PQ. FILAS DE MARICHES,CENTRO DE EDUCACION INICIAL NACIONAL CIUDAD MARICHE,677,2,5,635,611,630,0,1,1,0,17,635
EDO. MIRANDA,MP. SUCRE,PQ. FILAS DE MARICHES,UNIDAD EDUCATIVA NACIONAL CECILIO ACOSTA,1488,3,22,1104,891,1082,1,4,1,0,185,1104
EDO. MIRANDA,MP. SUCRE,PQ. FILAS DE MARICHES,CENTRO DE CAPACITACION INDUSTRIAL DON BOSCO,3316,6,75,2569,1309,2494,0,8,3,0,1174,2569
EDO. MIRANDA,MP. SUCRE,PQ. FILAS DE MARICHES,COLEGIO GENERALISIMO FRANCISCO DE MIRANDA,3894,7,70,3182,2467,3112,3,16,1,2,623,3182
EDO. MIRANDA,MP. SUCRE,PQ. FILAS DE MARICHES,ESCUELA MUNICIPAL TITO SALAS,4935,9,80,3679,2567,3599,4,20,5,0,1003,3679
EDO. MIRANDA,MP. SUCRE,PQ. FILAS DE MARICHES,CASA COMUNAL LA ARBOLEDA,496,1,9,418,361,409,0,2,0,0,46,418
EDO. MIRANDA,MP. SUCRE,PQ. FILAS DE MARICHES,UNIDAD EDUCATIVA NACIONAL BOLIVARIANA ANA MARIA CAMPOS,347,1,6,289,221,283,0,1,1,0,60,289
EDO. MIRANDA,MP. SUCRE,PQ. FILAS DE MARICHES,UNIDAD EDUCATIVA ALMIRANTE LUIS BRION,3849,7,52,3046,2241,2994,0,17,2,1,733,3046
EDO. MIRANDA,MP. SUCRE,PQ. FILAS DE MARICHES,DESARROLLO URBANISTICO LA HACIENDITA,123,1,1,117,115,116,0,0,0,0,1,117
EDO. MIRANDA,MP. SUCRE,PQ. FILAS DE MARICHES,UNIDAD EDUCATIVA PROFESORA BELEN SAN JUAN,315,1,8,261,207,253,0,0,0,0,46,261
EDO. MIRANDA,MP. BUROZ,PQ. MAMPORAL,CONCENTRACION ESTADAL BOLIVARIANA LOS SERRANOS,188,1,9,161,122,152,0,1,0,0,29,161
EDO. MIRANDA,MP. BUROZ,PQ. MAMPORAL,UNIDAD EDUCATIVA EULALIA SANCHEZ DE CHAMBERLAIN,1120,2,12,937,653,925,0,2,0,1,269,937
EDO. MIRANDA,MP. BUROZ,PQ. MAMPORAL,ESCUELA UNITARIA NACIONAL SIN NUMERO,225,1,3,149,136,146,0,1,0,0,9,149
EDO. MIRANDA,MP. BUROZ,PQ. MAMPORAL,CONCENTRACION ESTADADAL SIN NUMERO BELEN LA VEGA,319,1,7,278,230,271,0,1,0,1,39,278
EDO. MIRANDA,MP. BUROZ,PQ. MAMPORAL,LICEO BOLIVARIANO ALMIRANTE LUIS BRION,1037,2,17,843,575,826,1,1,0,1,248,843
EDO. MIRANDA,MP. BUROZ,PQ. MAMPORAL,CENTRO DE EDUCACION INICIAL AGUSTIN PAEZ,670,2,12,551,379,539,0,2,0,0,158,551
EDO. MIRANDA,MP. BUROZ,PQ. MAMPORAL,ESCUELA BASICA MAMPORAL,3783,7,78,2959,1778,2881,0,21,2,1,1079,2959
EDO. MIRANDA,MP. BUROZ,PQ. MAMPORAL,CONCENTRACION NACIONAL BASICA 28,1552,3,49,1201,873,1152,0,4,0,0,275,1201
EDO. MIRANDA,MP. BUROZ,PQ. MAMPORAL,ESCUELA ESTADAL EL BAMBU,358,1,8,282,202,274,0,2,1,0,69,282
EDO. MIRANDA,MP. BUROZ,PQ. MAMPORAL,CONCENTRACION ESCOLAR ESTATAL SIN NUMERO,522,1,12,429,253,417,0,0,0,0,164,429
EDO. MIRANDA,MP. BUROZ,PQ. MAMPORAL,ESCUELA GASPAR LANDAEZ,1077,2,24,821,588,797,0,3,0,0,206,821
EDO. MIRANDA,MP. BUROZ,PQ. MAMPORAL,UNIDAD EDUCATIVA LOS VELASQUEZ,318,1,4,288,243,284,0,0,0,0,41,288
EDO. MIRANDA,MP. BUROZ,PQ. MAMPORAL,UNIDAD EDUCATIVA PRIVADA PEDRO VICENTE SOSA HERNANDEZ,386,1,14,324,203,310,0,0,0,0,107,324
EDO. MIRANDA,MP. BUROZ,PQ. MAMPORAL,ESCUELA ESTATAL UNITARIA NUMERO 32,355,1,6,294,186,288,0,0,1,0,101,294
EDO. MIRANDA,MP. BUROZ,PQ. MAMPORAL,CONCENTRACION ESTADAL LOS HERNANDEZ,159,1,3,152,133,149,0,2,0,0,14,152
EDO. MIRANDA,MP. BUROZ,PQ. MAMPORAL,UNIDAD EDUCATIVA NUMERO 31,1443,3,20,1073,790,1053,0,3,1,0,259,1073
EDO. MIRANDA,MP. BUROZ,PQ. MAMPORAL,GRUPO ESCOLAR SAN JUAN,882,2,12,656,426,644,0,2,0,0,216,656
EDO. MIRANDA,MP. BUROZ,PQ. MAMPORAL,UNIDAD EDUCATIVA MAURICA,1715,3,36,1448,958,1412,0,6,0,0,448,1448
EDO. MIRANDA,MP. EL HATILLO,PQ. EL HATILLO,UNIDAD EDUCATIVA COLEGIO ACADEMIA MERICI,1918,4,13,1566,62,1553,0,4,0,0,1487,1566
EDO. MIRANDA,MP. EL HATILLO,PQ. EL HATILLO,POLIDEPORTIVO LA BOYERA,6110,11,14,4942,369,4928,0,5,1,1,4552,4942
EDO. MIRANDA,MP. EL HATILLO,PQ. EL HATILLO,CENTRO CIVICO MANUEL RAMOS MARCOS,2316,4,20,1776,358,1756,0,0,0,1,1397,1776
EDO. MIRANDA,MP. EL HATILLO,PQ. EL HATILLO,ESCUELA MUNICIPAL GRADUADA MARIA MAY,1975,4,27,1629,624,1602,1,3,1,1,972,1629
EDO. MIRANDA,MP. EL HATILLO,PQ. EL HATILLO,COLEGIO CLARET,2749,5,14,2266,110,2252,0,1,0,0,2141,2266
EDO. MIRANDA,MP. EL HATILLO,PQ. EL HATILLO,CONCENTRACION NACIONAL TURGUA,1158,2,27,909,615,882,0,4,0,0,263,909
EDO. MIRANDA,MP. EL HATILLO,PQ. EL HATILLO,CENTRO DEPORTIVO VINICIO MATA,748,2,6,648,185,642,0,0,0,2,455,648
EDO. MIRANDA,MP. EL HATILLO,PQ. EL HATILLO,CLUB URBANIZACION EL TREBOL,2330,4,10,1838,150,1828,0,1,0,0,1677,1838
EDO. MIRANDA,MP. EL HATILLO,PQ. EL HATILLO,ESCUELA MUNICIPAL JUAN MANUEL CAJIGAL,3311,6,48,2684,659,2636,0,8,1,1,1967,2684
EDO. MIRANDA,MP. EL HATILLO,PQ. EL HATILLO,COLEGIO CANIGUA,3720,7,33,3074,421,3041,0,10,0,3,2607,3074
EDO. MIRANDA,MP. EL HATILLO,PQ. EL HATILLO,UNIDAD EDUCATIVA NACIONAL JUAN DE ESCALONA,1912,4,18,1465,345,1447,0,4,0,1,1097,1465
EDO. MIRANDA,MP. EL HATILLO,PQ. EL HATILLO,UNIVERSIDAD NUEVA ESPARTA,7951,15,23,6391,307,6368,1,5,5,4,6046,6391
EDO. MIRANDA,MP. EL HATILLO,PQ. EL HATILLO,CLUB LA LAGUNITA,3444,6,11,2842,113,2831,0,3,0,0,2715,2842
EDO. MIRANDA,MP. EL HATILLO,PQ. EL HATILLO,UNIDAD EDUCATIVA NACIONAL BOLIVARIANA LA UNION,573,1,5,513,199,508,0,2,0,1,306,513
EDO. MIRANDA,MP. EL HATILLO,PQ. EL HATILLO,UNIDAD EDUCATIVA NACIONAL BOLIVARIANA CONOPOIMA,5375,10,37,4216,422,4179,0,11,0,1,3745,4216
EDO. MIRANDA,MP. EL HATILLO,PQ. EL HATILLO,ESCUELA ESTADAL GRADUADA ABILIO REYES OCHOA,3407,6,73,2759,1486,2686,1,16,5,2,1176,2759
EDO. MIRANDA,MP. EL HATILLO,PQ. EL HATILLO,COMPLEJO GUSTAVO GARCIA LUJAN (SALESIANAS),338,1,9,292,175,283,0,2,1,0,105,292
EDO. MIRANDA,MP. EL HATILLO,PQ. EL HATILLO,UNIDAD EDUCATIVA MUNICIPAL ARMANDO REVERON,1319,3,19,996,729,977,1,3,2,0,242,996
EDO. MIRANDA,MP. LOS SALIAS,PQ. SAN ANTONIO LOS ALTOS,UNIDAD EDUCATIVA ESTADAL ESTADO ARAGUA,2194,4,33,1763,646,1730,1,3,0,4,1076,1763
EDO. MIRANDA,MP. LOS SALIAS,PQ. SAN ANTONIO LOS ALTOS,UNIDAD EDUCATIVA MARIANO PICON SALAS,1264,3,12,1005,542,993,1,6,1,0,443,1005
EDO. MIRANDA,MP. LOS SALIAS,PQ. SAN ANTONIO LOS ALTOS,UNIDAD EDUCATIVA LUIS EDUARDO EGUI,6278,12,52,5277,999,5225,0,5,2,4,4215,5277
EDO. MIRANDA,MP. LOS SALIAS,PQ. SAN ANTONIO LOS ALTOS,UNIDAD EDUCATIVA ESTADAL DILIA DELGADO DE BELLO,1837,4,28,1510,302,1482,0,0,2,1,1177,1510
EDO. MIRANDA,MP. LOS SALIAS,PQ. SAN ANTONIO LOS ALTOS,COLEGIO EL BUEN CONSEJO,5357,10,40,4333,988,4293,1,8,0,3,3293,4333
EDO. MIRANDA,MP. LOS SALIAS,PQ. SAN ANTONIO LOS ALTOS,UNIDAD EDUCATIVA ESTADAL BOLIVARIANA NUESTRA SEÑORA DE LOS DOLORES,1571,3,13,1353,323,1340,0,2,0,1,1014,1353
EDO. MIRANDA,MP. LOS SALIAS,PQ. SAN ANTONIO LOS ALTOS,LICEO JOSE MIGUEL SANZ,4199,8,25,3573,686,3548,0,7,1,2,2852,3573
EDO. MIRANDA,MP. LOS SALIAS,PQ. SAN ANTONIO LOS ALTOS,CENTRO EDUCATIVO INTEGRAL SIMONCITO LA ROSALEDA,5554,10,39,4978,1678,4939,2,7,3,5,3244,4978
EDO. MIRANDA,MP. LOS SALIAS,PQ. SAN ANTONIO LOS ALTOS,UNIDAD EDUCATIVA PROFESOR BORIS BOSSIO VIVAS,4944,9,27,3921,596,3894,1,7,1,4,3285,3921
EDO. MIRANDA,MP. LOS SALIAS,PQ. SAN ANTONIO LOS ALTOS,ESCUELA BASICA LOS SALIAS,3675,7,19,3003,801,2984,0,8,2,3,2170,3003
EDO. MIRANDA,MP. LOS SALIAS,PQ. SAN ANTONIO LOS ALTOS,UNIDAD EDUCATIVA DON GUADALUPE HERNANDEZ,1777,3,19,1471,407,1452,0,4,1,1,1039,1471
EDO. MIRANDA,MP. LOS SALIAS,PQ. SAN ANTONIO LOS ALTOS,ESCUELA DE DANZA LOS CASTORES,540,1,4,481,101,477,0,1,0,1,374,481
EDO. MIRANDA,MP. LOS SALIAS,PQ. SAN ANTONIO LOS ALTOS,UNIDAD EDUCATIVA JOSE MANUEL SISO MARTINEZ,3032,6,16,2570,483,2554,1,4,2,5,2059,2570
EDO. MIRANDA,MP. LOS SALIAS,PQ. SAN ANTONIO LOS ALTOS,UNIDAD EDUCATIVA MUNICIPAL ELSA NUÑEZ VARGAS,570,1,7,505,234,498,0,0,0,1,263,505
EDO. MIRANDA,MP. LOS SALIAS,PQ. SAN ANTONIO LOS ALTOS,COLEGIO MASTER DEY,4559,8,37,3915,446,3878,1,4,1,4,3422,3915
EDO. MIRANDA,MP. LOS SALIAS,PQ. SAN ANTONIO LOS ALTOS,UNIDAD EDUCATIVA LOS CASTORES,3426,6,20,2833,417,2813,0,1,2,3,2390,2833
EDO. MIRANDA,MP. LOS SALIAS,PQ. SAN ANTONIO LOS ALTOS,UNIDAD EDUCATIVA ENRIQUE MARIA DUBUC,1266,3,8,1129,171,1121,1,0,2,0,947,1129
EDO. MIRANDA,MP. LOS SALIAS,PQ. SAN ANTONIO LOS ALTOS,UNIDAD EDUCUCATIVA LAS MINAS,2071,4,70,1676,875,1606,0,6,1,0,724,1676
EDO. MIRANDA,MP. LOS SALIAS,PQ. SAN ANTONIO LOS ALTOS,PRE ESCOLAR TIA ALICIA POJAN,992,2,5,926,167,921,0,1,0,0,753,926
EDO. MIRANDA,MP. ANDRES BELLO,PQ. CUMBO,UNIDAD EDUCATIVA COTO PAÚL,863,2,23,622,345,599,1,2,0,0,251,622
EDO. MIRANDA,MP. ANDRES BELLO,PQ.SAN JOSE DE BARLOVENTO,CONCENTRACION ESCOLAR NO 23,822,2,4,623,543,619,1,1,1,0,73,623
EDO. MIRANDA,MP. ANDRES BELLO,PQ.SAN JOSE DE BARLOVENTO,CONCENTRACION ESTADAL SIN NUMERO EL MANGUITO,103,1,1,86,63,85,0,1,0,0,21,86
EDO. MIRANDA,MP. ANDRES BELLO,PQ.SAN JOSE DE BARLOVENTO,CONCENTRACION ESTADAL SIN NUMERO  LA LUCHA,285,1,9,258,211,249,1,0,0,0,37,258
EDO. MIRANDA,MP. ANDRES BELLO,PQ.SAN JOSE DE BARLOVENTO,JARDIN DE INFANCIA CARLOS HERNANDEZ BAEZ,1181,3,23,946,614,923,0,2,0,0,307,946
EDO. MIRANDA,MP. ANDRES BELLO,PQ.SAN JOSE DE BARLOVENTO,ESCUELA INTEGRAL BOLIVARIANA LOS GALPONES ADSCRITA AL NUCLEO ESCOLAR RURAL  026,162,1,6,153,120,147,0,2,0,0,25,153
EDO. MIRANDA,MP. ANDRES BELLO,PQ.SAN JOSE DE BARLOVENTO,CONCENTRACION ESTADAL NO 81 26,777,2,10,559,420,549,1,4,0,1,123,559
EDO. MIRANDA,MP. ANDRES BELLO,PQ.SAN JOSE DE BARLOVENTO,CENTRO DE EDUCACION INICIAL SIMONCITO LUISA ARRAMBIDE DE PACANINS,265,1,3,247,209,244,0,1,0,0,34,247
EDO. MIRANDA,MP. ANDRES BELLO,PQ.SAN JOSE DE BARLOVENTO,ESCUELA UNITARIA NACIONAL Nº 22,396,1,3,303,186,300,0,0,0,0,114,303
EDO. MIRANDA,MP. ANDRES BELLO,PQ.SAN JOSE DE BARLOVENTO,CONCENTRACION ESTADAL SIN NUMERO  LA DEFENSA,84,1,0,82,77,82,0,0,0,0,5,82
EDO. MIRANDA,MP. ANDRES BELLO,PQ.SAN JOSE DE BARLOVENTO,ESCUELA BOLIVARIANA ESTADAL ELIA MARQUEZ DE ESPINOZA,387,1,6,344,304,338,0,0,0,0,34,344
EDO. MIRANDA,MP. ANDRES BELLO,PQ.SAN JOSE DE BARLOVENTO,ESCUELA INTEGRAL BOLIVARIANA BURGUILLOS,426,1,13,292,178,279,0,0,1,0,100,292
EDO. MIRANDA,MP. ANDRES BELLO,PQ.SAN JOSE DE BARLOVENTO,ESCUELA BÁSICA LANDER,2454,5,42,1979,1208,1937,1,11,1,1,715,1979
EDO. MIRANDA,MP. ANDRES BELLO,PQ.SAN JOSE DE BARLOVENTO,INSTITUTO DE EDUCACION ESPECIAL BOLIVARIANO OSWALDO MIJARES,939,2,11,802,526,791,0,3,0,1,261,802
EDO. MIRANDA,MP. ANDRES BELLO,PQ.SAN JOSE DE BARLOVENTO,CASA DE LA CULTURA ANDRES BELLO,1400,3,46,1176,773,1130,0,4,2,0,351,1176
EDO. MIRANDA,MP. ANDRES BELLO,PQ.SAN JOSE DE BARLOVENTO,ESCUELA CONCENTRADA NACIONAL S N,311,1,9,230,156,221,0,0,0,0,65,230
EDO. MIRANDA,MP. ANDRES BELLO,PQ.SAN JOSE DE BARLOVENTO,ESCUELA UNITARIA NUMERO  145
EDO. MIRANDA,MP. ANDRES BELLO,PQ.SAN JOSE DE BARLOVENTO,CONCENTRACIÓN ESTADAL S N EL DELIRIO,614,2,20,501,369,481,0,0,0,0,112,501
EDO. MIRANDA,MP. ANDRES BELLO,PQ.SAN JOSE DE BARLOVENTO,ESCUELA BOLIVARIANA SAN JOSÉ,1835,4,56,1407,854,1351,0,6,0,0,491,1407
EDO. MIRANDA,MP. ANDRES BELLO,PQ.SAN JOSE DE BARLOVENTO,ESCUELA FRAY JOSE ZAPICO,1712,3,30,1353,792,1323,0,6,1,1,523,1353
EDO. MIRANDA,MP. PEDRO GUAL,PQ. CUPIRA,ESCUELA  NACIONAL BOLIVARIANA BARTOLOME BLANDIN,2099,4,49,1656,959,1607,0,8,0,0,640,1656
EDO. MIRANDA,MP. PEDRO GUAL,PQ. CUPIRA,UNIDAD EDUCATIVA SAN JUAN
EDO. MIRANDA,MP. PEDRO GUAL,PQ. CUPIRA,CONCENTRACION ESTADAL RURAL SIN NUMERO GOLFO RICO,523,1,5,379,182,374,0,3,1,1,187,379
EDO. MIRANDA,MP. PEDRO GUAL,PQ. CUPIRA,CONCENTRACION ESTADAL SIN NUMERO ONOVA,794,2,22,606,253,584,0,7,0,1,323,606
EDO. MIRANDA,MP. PEDRO GUAL,PQ. CUPIRA,ESCUELA PALO BLANCO,903,2,27,681,396,654,2,7,0,0,249,681
EDO. MIRANDA,MP. PEDRO GUAL,PQ. CUPIRA,JARDÍN DE INFANCIA BOLIVARIANO CABO CODERA,246,1,2,191,108,189,0,0,0,0,81,191
EDO. MIRANDA,MP. PEDRO GUAL,PQ. CUPIRA,ESCUELA  ESTADAL DEL CASERIO BOCA DE CASUPO,381,1,0,291,209,291,0,0,0,0,82,291
EDO. MIRANDA,MP. PEDRO GUAL,PQ. CUPIRA,CONCENTRACION ESTADAL SIN NUMERO LA COLOMBINA,159,1,2,96,39,94,0,0,0,0,55,96
EDO. MIRANDA,MP. PEDRO GUAL,PQ. CUPIRA,ESCUELA BOLIVARIANA CALABAZA,741,2,16,573,360,557,0,3,1,0,193,573
EDO. MIRANDA,MP. PEDRO GUAL,PQ. CUPIRA,JARDIN DE INFANCIA COLINAS DE CUPIRA,176,1,4,153,105,149,1,1,0,0,42,153
EDO. MIRANDA,MP. PEDRO GUAL,PQ. CUPIRA,ESCUELA NER 131 PALO QUEMAO,382,1,13,280,176,267,0,3,0,0,88,280
EDO. MIRANDA,MP. PEDRO GUAL,PQ. CUPIRA,ESCUELA GRADUADA JUAN VICENTE GONZALEZ,2232,4,39,1649,1175,1610,0,10,1,1,423,1649
EDO. MIRANDA,MP. PEDRO GUAL,PQ. CUPIRA,ESCUELA NACIONAL BASICA CUPIRA,2429,5,65,1863,1076,1798,1,13,1,0,707,1863
EDO. MIRANDA,MP. PEDRO GUAL,PQ. CUPIRA,ESCUELA INTEGRAL BOLIVARIANA Nº 39 32 EL GUACUCO,618,2,12,491,335,479,1,1,0,0,142,491
EDO. MIRANDA,MP. PEDRO GUAL,PQ. CUPIRA,CONCENTRADA ESTADAL NUMERO 78,436,1,10,386,257,376,0,1,0,1,117,386
EDO. MIRANDA,MP. PEDRO GUAL,PQ. CUPIRA,INSTITUTO AUTONOMO CULTURA PEDRO GUAL,152,1,3,120,79,117,0,2,0,0,36,120
EDO. MIRANDA,MP. PEDRO GUAL,PQ. CUPIRA,LICEO BOLIVARIANO 8 DE DICIEMBRE,464,1,13,359,227,346,0,3,0,0,116,359
EDO. MIRANDA,MP. PEDRO GUAL,PQ. MACHURUCUTO,ESCUELA INTEGRAL BOLIVARIANA PEDRO GUAL,944,2,15,741,380,726,0,3,0,0,343,741
EDO. MIRANDA,MP. PAZ CASTILLO,PQ. SANTA LUCIA,CENTRO DE EDUCACION INICIAL GUAICAIPURO,396,1,4,336,275,332,0,1,0,0,56,336
EDO. MIRANDA,MP. PAZ CASTILLO,PQ. SANTA LUCIA,ESCUELA BASICA NACIONAL NINOS DE LA PATRIA,300,1,6,268,243,262,0,0,0,0,19,268
EDO. MIRANDA,MP. PAZ CASTILLO,PQ. SANTA LUCIA,UNIDAD EDUCATIVA ESTADAL CONCENTRACION ARENAZA,277,1,4,254,230,250,0,2,0,0,18,254
EDO. MIRANDA,MP. PAZ CASTILLO,PQ. SANTA LUCIA,ESCUELA BASICA BOLIVARIANA LA CALCETA,2322,4,54,1833,1260,1779,0,3,2,2,512,1833
EDO. MIRANDA,MP. PAZ CASTILLO,PQ. SANTA LUCIA,UNIDAD EDUCATIVA JOSE MANUEL DE LOS RIOS,2145,4,65,1792,1085,1727,0,8,0,3,631,1792
EDO. MIRANDA,MP. PAZ CASTILLO,PQ. SANTA LUCIA,CONCENTRACION SIN NUMERO LA FLORIDA,267,1,3,242,220,239,0,0,0,0,19,242
EDO. MIRANDA,MP. PAZ CASTILLO,PQ. SANTA LUCIA,UNIDAD EDUCATIVA ESTADAL XIOMARA DEL CARMEN MOLLETON,1292,3,37,1136,843,1099,0,9,1,2,244,1136
EDO. MIRANDA,MP. PAZ CASTILLO,PQ. SANTA LUCIA,ESCUELA BASICA ESTADAL EL ROSARIO,711,2,11,630,465,619,0,1,1,0,152,630
EDO. MIRANDA,MP. PAZ CASTILLO,PQ. SANTA LUCIA,ESCUELA BASICA GENARO GOMEZ,2888,5,46,2405,1860,2359,1,13,4,0,481,2405
EDO. MIRANDA,MP. PAZ CASTILLO,PQ. SANTA LUCIA,ESCUELA BASICA NACIONAL DOCTOR FCO. ESPEJO,3094,6,58,2409,1568,2351,0,6,0,1,776,2409
EDO. MIRANDA,MP. PAZ CASTILLO,PQ. SANTA LUCIA,UNIDAD EDUCATIVA PRIVADA PRINCIPE DE PAZ,599,1,10,510,382,500,0,3,0,0,115,510
EDO. MIRANDA,MP. PAZ CASTILLO,PQ. SANTA LUCIA,LICEO DOCTOR JOSE FRANCISCO TORREALBA,1439,3,16,1141,578,1125,2,10,0,2,533,1141
EDO. MIRANDA,MP. PAZ CASTILLO,PQ. SANTA LUCIA,UNIDAD EDUCATIVA BOLIVARIANA TERESA CARRENO,2298,4,34,1821,1435,1787,0,8,0,1,343,1821
EDO. MIRANDA,MP. PAZ CASTILLO,PQ. SANTA LUCIA,CENTRO DE EDUCACION INICIAL NACIONAL DOCTOR FRANCISCO ESPEJO,482,1,14,379,257,365,0,3,0,0,105,379
EDO. MIRANDA,MP. PAZ CASTILLO,PQ. SANTA LUCIA,NUCLEO ESCOLAR RURAL  225 CONCENTRADA ALICIA PIETRI DE CALDERA,774,2,9,660,521,651,0,2,0,0,128,660
EDO. MIRANDA,MP. PAZ CASTILLO,PQ. SANTA LUCIA,ESCUELA BASICA BOLIVARIANA POTRERITO,439,1,5,381,314,376,0,3,1,0,58,381
EDO. MIRANDA,MP. PAZ CASTILLO,PQ. SANTA LUCIA,ESCUELA TECNICA AGRICOLA NACIONAL SANTA RITA,269,1,2,224,201,222,0,1,0,0,20,224
EDO. MIRANDA,MP. PAZ CASTILLO,PQ. SANTA LUCIA,JARDIN DE INFANCIA MANGUITO 1,661,2,14,589,409,575,0,6,1,1,158,589
EDO. MIRANDA,MP. PAZ CASTILLO,PQ. SANTA LUCIA,UNIDAD EDUCATIVA ESTADO VARGAS,1816,4,23,1602,1254,1579,0,11,0,1,313,1602
EDO. MIRANDA,MP. PAZ CASTILLO,PQ. SANTA LUCIA,UNIDAD EDUCATIVA CENTRO PROFESIONAL SANTA LUCIA,1754,3,33,1410,872,1377,0,5,0,0,500,1410
EDO. MIRANDA,MP. PAZ CASTILLO,PQ. SANTA LUCIA,ESCUELA BASICA VENEZUELA,1222,3,23,1059,807,1036,0,12,0,1,216,1059
EDO. MIRANDA,MP. PAZ CASTILLO,PQ. SANTA LUCIA,CONCENTRACION ESCOLAR LOS GUAYABITOS,126,1,1,122,121,121,0,0,0,0,0,122
EDO. MIRANDA,MP. PAZ CASTILLO,PQ. SANTA LUCIA,UNIDAD EDUCATIVA NACIONAL BOLIVARIANA GUAICAIPURO,886,2,9,756,647,747,0,1,0,0,99,756
EDO. MIRANDA,MP. PAZ CASTILLO,PQ. SANTA LUCIA,ESCUELA BASICA CESAR ARMANDO CISNEROS,3519,7,35,2723,2362,2688,1,4,0,0,321,2723
EDO. MIRANDA,MP. PAZ CASTILLO,PQ. SANTA LUCIA,ESCUELA BASICA NACIONAL LA CEIBA DEL ALTO,7272,13,111,5909,4539,5798,3,36,2,4,1214,5909
EDO. MIRANDA,MP. PAZ CASTILLO,PQ. SANTA LUCIA,UNIDAD EDUCATIVA CREACION SOAPIRE,840,2,7,724,632,717,0,1,0,1,83,724
EDO. MIRANDA,MP. PAZ CASTILLO,PQ. SANTA LUCIA,UNIDAD EDUCATIVA ESTADAL EL LIMON,463,1,12,416,349,404,0,2,0,0,53,416
EDO. MIRANDA,MP. PAZ CASTILLO,PQ. SANTA LUCIA,UNIDAD EDUCATIVA ESTADAL FRANCISCO DE MIRANDA,2536,5,45,2062,1139,2017,1,7,2,2,866,2062
EDO. MIRANDA,MP. PAZ CASTILLO,PQ. SANTA LUCIA,UNIDAD EDUCATIVA ESTADAL LIA IMBER DE CORONIL,3893,7,75,3233,2358,3158,1,16,3,1,779,3233
EDO. MIRANDA,MP. PAZ CASTILLO,PQ. SANTA LUCIA,UNIDAD EDUCATIVA  JUANA TERESA HERRERA,1504,3,28,1310,715,1282,0,2,0,0,565,1310
EDO. MIRANDA,MP. PAZ CASTILLO,PQ. SANTA LUCIA,UNIDAD EDUCATIVA ESTADAL ROMULO GALLEGOS,857,2,11,700,526,689,0,5,1,0,157,700
EDO. MIRANDA,MP. PAZ CASTILLO,PQ. SANTA LUCIA,ESCUELA ESTADO YARACUY,1786,3,26,1313,972,1287,0,6,0,1,308,1313
EDO. MIRANDA,MP. PAZ CASTILLO,PQ. SANTA LUCIA,UNIDAD EDUCATIVA NACIONAL BOLIVARIANA CREACION NUEVA VIRGINIA,613,2,10,558,474,548,0,4,0,1,69,558
EDO. MIRANDA,MP. PAZ CASTILLO,PQ. SANTA LUCIA,ESCUELA BASICA RURAL SAN BENITO,407,1,20,363,291,343,0,1,0,1,50,363
EDO. MIRANDA,MP. PAZ CASTILLO,PQ. SANTA LUCIA,CONCENTRACION NACIONAL NO 6 LA MOCA,1000,2,28,770,642,742,0,2,0,0,98,770
EDO. MIRANDA,MP. PAZ CASTILLO,PQ. SANTA LUCIA,ESCUELA NACIONAL MANUEL PIAR,2651,5,48,2163,1747,2115,0,11,1,1,355,2163
EDO. MIRANDA,MP. PAZ CASTILLO,PQ. SANTA LUCIA,ESCUELA BASICA MANGUITO I,3469,6,59,2868,2089,2809,0,17,3,4,696,2868
EDO. MIRANDA,MP. PAZ CASTILLO,PQ. SANTA LUCIA,CASA MUNICIPAL DE LAS MISIONES,217,1,0,179,120,179,0,2,0,0,57,179
EDO. MIRANDA,MP. PAZ CASTILLO,PQ. SANTA LUCIA,ESCUELA RURAL NACIONAL BOLIVARIANA INES MARIA BOLIVAR,1213,3,41,994,677,953,0,2,2,0,272,994
EDO. MIRANDA,MP. PAZ CASTILLO,PQ. SANTA LUCIA,UNIDAD EDUCATIVA ESTADAL ESTADO MERIDA,3507,6,37,2741,2093,2704,2,5,4,3,597,2741
EDO. MIRANDA,MP. PAZ CASTILLO,PQ. SANTA LUCIA,UNIDAD EDUCATIVA ARMANDO ESCOBAR,895,2,4,732,665,728,2,3,1,0,57,732
EDO. MIRANDA,MP. CRISTOBAL ROJAS,PQ. CHARALLAVE,CENTRO DE FORMACION SOCIALISTA  EZEQUIEL ZAMORA,239,1,0,223,167,223,0,0,0,0,56,223
EDO. MIRANDA,MP. CRISTOBAL ROJAS,PQ. CHARALLAVE,UNIDAD EDUCATIVA ESTADAL CARMEN RUIZ,4099,8,72,3378,2237,3306,2,16,1,4,1046,3378
EDO. MIRANDA,MP. CRISTOBAL ROJAS,PQ. CHARALLAVE,UNIDAD EDUCATIVA ESTADAL CAUJARITO,3569,7,71,2889,2389,2818,1,16,2,3,407,2889
EDO. MIRANDA,MP. CRISTOBAL ROJAS,PQ. CHARALLAVE,UNIDAD EDUCATIVA NACIONAL CECILIO ACOSTA,5001,9,75,4375,3459,4300,2,19,2,2,816,4375
EDO. MIRANDA,MP. CRISTOBAL ROJAS,PQ. CHARALLAVE,ESCUELA BOLIVARIANA POLICARPO FARRERA,3781,7,62,3141,1566,3079,0,26,3,3,1481,3141
EDO. MIRANDA,MP. CRISTOBAL ROJAS,PQ. CHARALLAVE,PREESCOLAR JUAN ESPAÑA,212,1,8,184,130,176,0,0,0,0,46,184
EDO. MIRANDA,MP. CRISTOBAL ROJAS,PQ. CHARALLAVE,ESCUELA BASICA ESTADAL JABILLITO,3225,6,92,2617,2037,2525,1,9,2,2,474,2617
EDO. MIRANDA,MP. CRISTOBAL ROJAS,PQ. CHARALLAVE,INSTITUTO DE EDUCACION ESPECIAL VIRGEN DEL CARMEN,145,1,2,124,73,122,0,0,0,0,49,124
EDO. MIRANDA,MP. CRISTOBAL ROJAS,PQ. CHARALLAVE,UNIDAD EDUCATIVA PRIVADA NUESTRA SEÑORA DE LA COROMOTO,3531,7,89,3021,1369,2932,1,7,0,3,1552,3021
EDO. MIRANDA,MP. CRISTOBAL ROJAS,PQ. CHARALLAVE,UNIDAD EDUCATIVA ESTADAL BOLIVARIANA ARICHUNA,570,1,5,515,284,510,0,0,1,0,225,515
EDO. MIRANDA,MP. CRISTOBAL ROJAS,PQ. CHARALLAVE,UNIDAD EDUCATIVA PRIVADA COLEGIO SAGRADO CORAZON DE JESUS,4945,9,63,4205,1571,4142,2,24,0,2,2543,4205
EDO. MIRANDA,MP. CRISTOBAL ROJAS,PQ. CHARALLAVE,LICEO NOCTURNO FRANCISCO TOSTA GARCIA,39,1,1,34,19,33,1,1,0,0,12,34
EDO. MIRANDA,MP. CRISTOBAL ROJAS,PQ. CHARALLAVE,UNIDAD EDUCATIVA PRIVADA DOCTOR JOSE GREGORIO HERNANDEZ,3339,6,57,2786,1236,2729,0,5,1,2,1485,2786
EDO. MIRANDA,MP. CRISTOBAL ROJAS,PQ. CHARALLAVE,CONCENTRACION ESCOLAR SIN NUMERO LA CHIVERA,688,2,8,566,390,558,0,2,2,0,164,566
EDO. MIRANDA,MP. CRISTOBAL ROJAS,PQ. CHARALLAVE,UNIDAD EDUCATIVA NACIONAL EXTENCION TERESA DE BOLIVAR,485,1,7,410,218,403,0,2,0,0,183,410
EDO. MIRANDA,MP. CRISTOBAL ROJAS,PQ. CHARALLAVE,ESCUELA BOLIVARIANA DOCTOR CARLOS AROCHA LUNA,1137,2,23,1028,691,1005,0,3,0,1,310,1028
EDO. MIRANDA,MP. CRISTOBAL ROJAS,PQ. CHARALLAVE,UNIVERSIDAD NACIONAL EXPERIMENTAL ANTONIO JOSE DE SUCRE,984,2,24,902,570,878,0,3,0,0,305,902
EDO. MIRANDA,MP. CRISTOBAL ROJAS,PQ. CHARALLAVE,UNIDAD EDUCATIVA BOLIVARIANA MARIA TERESA DEL TORO,639,2,9,506,414,497,0,3,2,0,78,506
EDO. MIRANDA,MP. CRISTOBAL ROJAS,PQ. CHARALLAVE,CENTRO DE EDUCACION INICIAL ALI PRIMERA,365,1,6,317,249,311,0,1,0,0,61,317
EDO. MIRANDA,MP. CRISTOBAL ROJAS,PQ. CHARALLAVE,CENTRO DE  EDUCACION INICIAL ESTE NIÑO DON SIMON,2971,6,32,2668,1339,2636,1,9,1,2,1284,2668
EDO. MIRANDA,MP. CRISTOBAL ROJAS,PQ. CHARALLAVE,COMPLEJO EDUCATIVO NACIONAL JUAN ESPANA,3853,7,82,3104,2257,3022,1,17,1,1,745,3104
EDO. MIRANDA,MP. CRISTOBAL ROJAS,PQ. CHARALLAVE,DESARROLLO URBANISTICO CHARALLAVE NORTE,64,1,2,51,47,49,0,0,0,1,1,51
EDO. MIRANDA,MP. CRISTOBAL ROJAS,PQ. CHARALLAVE,UNIDAD EDUCATIVA ESTADAL TEOTISTA AROCHA DE GALLEGOS,1204,3,36,1027,755,991,0,7,0,3,226,1027
EDO. MIRANDA,MP. CRISTOBAL ROJAS,PQ. CHARALLAVE,UNIDAD EDUCATIVA PRIVADA SAGRADO CORAZON DE JESUS,2509,5,40,2111,998,2071,0,5,1,3,1064,2111
EDO. MIRANDA,MP. CRISTOBAL ROJAS,PQ. CHARALLAVE,CENTRO DE EDUCACION INICIAL JARDIN DE INFANCIA JABILLITO,649,2,27,538,418,511,0,1,0,0,92,538
EDO. MIRANDA,MP. CRISTOBAL ROJAS,PQ. CHARALLAVE,ESCUELA PITAHAYA,3923,7,60,3254,2250,3194,0,12,1,2,929,3254
EDO. MIRANDA,MP. CRISTOBAL ROJAS,PQ. CHARALLAVE,JARDIN DE INFANCIA CHARALLAVE,369,1,4,332,192,328,0,4,0,1,131,332
EDO. MIRANDA,MP. CRISTOBAL ROJAS,PQ. CHARALLAVE,COMPLEJO EDUCATIVO ESTADAL JUAN GERMAN ROSCIO,3042,6,62,2428,1875,2366,2,17,0,2,470,2428
EDO. MIRANDA,MP. CRISTOBAL ROJAS,PQ. CHARALLAVE,UNIDAD EDUCATIVA NACIONAL FRANCISCO TOSTA GARCIA,425,1,6,381,181,375,0,1,0,1,192,381
EDO. MIRANDA,MP. CRISTOBAL ROJAS,PQ. CHARALLAVE,GRUPO ESCOLAR TERESA DE BOLIVAR,3070,6,55,2546,1258,2491,2,12,2,1,1216,2546
EDO. MIRANDA,MP. CRISTOBAL ROJAS,PQ. CHARALLAVE,UNIDAD EDUCATIVA ESTADAL DIVIDIVI,1766,3,73,1488,1185,1415,0,7,2,0,221,1488
EDO. MIRANDA,MP. CRISTOBAL ROJAS,PQ. CHARALLAVE,ESCUELA BASICA ESTADAL CHARALLAVE,2399,5,68,2014,1579,1946,0,7,0,3,357,2014
EDO. MIRANDA,MP. CRISTOBAL ROJAS,PQ. CHARALLAVE,UNNIDAD EDUCATIVA NACIONAL BOLIVARIANA CREACION CHARALLAVE,4581,8,92,3961,2139,3869,1,26,1,6,1696,3961
EDO. MIRANDA,MP. CRISTOBAL ROJAS,PQ. LAS BRISAS,COMPLEJO EDUCATIVO ANDRES ELOY BLANCO,975,2,16,816,603,800,1,2,0,1,193,816
EDO. MIRANDA,MP. CRISTOBAL ROJAS,PQ. LAS BRISAS,CONCETRACION ESCOLAR RURAL SABANETA,829,2,14,653,292,639,0,3,0,1,343,653
EDO. MIRANDA,MP. CRISTOBAL ROJAS,PQ. LAS BRISAS,UNIDAD EDUCATIVA ESTADAL BOLIVARIANA TERESA DE LA PARRA,345,1,16,305,189,289,0,0,1,1,98,305
EDO. MIRANDA,MP. CRISTOBAL ROJAS,PQ. LAS BRISAS,UNIDAD EDUCATIVA ESPECIAL DE DEFICIENCIA AUDITIVA TURPIALITO,343,1,3,268,205,265,0,0,0,0,60,268
EDO. MIRANDA,MP. CRISTOBAL ROJAS,PQ. LAS BRISAS,UNIDAD EDUCATIVA ESTADAL LUIS D' ZUSE NAVARRO,1680,3,36,1376,1052,1340,0,7,1,1,279,1376
EDO. MIRANDA,MP. CRISTOBAL ROJAS,PQ. LAS BRISAS,UNIDAD EDUCATIVA ESTADAL  ANDRES ELOY BLANCO,3557,7,74,2749,1717,2675,3,15,1,4,935,2749
EDO. MIRANDA,MP. CRISTOBAL ROJAS,PQ. LAS BRISAS,UNIDAD EDUCATIVA ESTADAL LUISA CACERES DE ARISMENDI,713,2,26,553,419,527,0,5,0,2,101,553
EDO. MIRANDA,MP. CRISTOBAL ROJAS,PQ. LAS BRISAS,UNIDAD EDUCATIVA ESTADAL CRISTOBAL ROJAS,2226,4,62,1770,1384,1708,1,9,3,0,311,1770
EDO. MIRANDA,MP. CARRIZAL,PQ. CARRIZAL,UNIDAD EDUCATIVA NACIONAL ANEXO ANDRES BELLO,354,1,5,283,168,278,0,1,0,0,109,283
EDO. MIRANDA,MP. CARRIZAL,PQ. CARRIZAL,CENTRO DE EDUCACIÓN INICIAL MONTAÑA ALTA,3735,7,30,3223,820,3193,0,9,1,6,2357,3223
EDO. MIRANDA,MP. CARRIZAL,PQ. CARRIZAL,UNIDAD ESCOLAR ESTADAL SIMON BOLIVAR,251,1,8,218,122,210,0,0,0,0,88,218
EDO. MIRANDA,MP. CARRIZAL,PQ. CARRIZAL,ESCUELA BÁSICA TERRITORIO FEDERAL DELTA AMACURO,1701,3,21,1429,717,1408,0,5,0,1,685,1429
EDO. MIRANDA,MP. CARRIZAL,PQ. CARRIZAL,UNIDAD EDUCATIVA NACIONAL ANDRÉS BELLO,3278,6,81,2695,1761,2614,1,7,1,0,844,2695
EDO. MIRANDA,MP. CARRIZAL,PQ. CARRIZAL,UNIDAD EDUCATIVA COLEGIO JESUS ADOLECENTE,1270,3,20,1120,733,1100,0,5,0,0,362,1120
EDO. MIRANDA,MP. CARRIZAL,PQ. CARRIZAL,UNIDAD EDUCATIVA PRIVADA THOMAS DE JESUS QUINTERO,390,1,6,363,117,357,0,0,0,1,239,363
EDO. MIRANDA,MP. CARRIZAL,PQ. CARRIZAL,CENTRO DE EDUCACION INICIAL SIMONCITO CACIQUE EPOIMA,262,1,5,228,154,223,0,2,0,0,67,228
EDO. MIRANDA,MP. CARRIZAL,PQ. CARRIZAL,INSTITUTO MADRE ISABEL,2021,4,25,1631,427,1606,1,3,0,6,1169,1631
EDO. MIRANDA,MP. CARRIZAL,PQ. CARRIZAL,PRE ESCOLAR MARTHA DE CALECA,474,1,9,440,271,431,0,2,1,0,157,440
EDO. MIRANDA,MP. CARRIZAL,PQ. CARRIZAL,CICLO BASICO CARLOS GAUNA,3802,7,38,3238,910,3200,0,1,1,4,2284,3238
EDO. MIRANDA,MP. CARRIZAL,PQ. CARRIZAL,UNIDAD  EDUCATIVA NACIONAL JOSE  MANUEL ALVAREZ,3325,6,73,2669,1165,2596,2,12,4,2,1411,2669
EDO. MIRANDA,MP. CARRIZAL,PQ. CARRIZAL,UNIDAD EDUCATIVA COLEGIO VALLE ALTO,1393,3,8,1283,244,1275,0,1,0,5,1025,1283
EDO. MIRANDA,MP. CARRIZAL,PQ. CARRIZAL,UNIDAD EDUCATIVA PRIVADA VIRGEN DE LA CONSAGRACIÓN,3530,6,54,2814,1118,2760,3,12,4,5,1618,2814
EDO. MIRANDA,MP. CARRIZAL,PQ. CARRIZAL,UNIDAD EDUCATIVA VICTOR PADILLA,4185,8,70,3563,1670,3493,0,10,2,1,1810,3563
EDO. MIRANDA,MP. CARRIZAL,PQ. CARRIZAL,LICEO MANUEL MARIA VILLALOBOS,2568,5,33,2061,1080,2028,1,8,6,3,930,2061
EDO. MIRANDA,MP. CARRIZAL,PQ. CARRIZAL,ESCUELA TECNICA AGROPECUARIA CARRIZAL,222,1,10,186,119,176,0,0,0,0,57,186
EDO. MIRANDA,MP. CARRIZAL,PQ. CARRIZAL,UNIDAD EDUCATIVA ESTADAL FRANCISCO DE MIRANDA,3115,6,33,2538,1222,2505,0,23,1,5,1254,2538
EDO. MIRANDA,MP. CHACAO,PQ. CHACAO,GIMNASIO VERTICAL,668,2,11,572,310,561,0,2,2,0,247,572
EDO. MIRANDA,MP. CHACAO,PQ. CHACAO,CENTRO DEPORTIVO EUGENIO MENDOZA,204,1,5,186,41,181,0,0,0,0,140,186
EDO. MIRANDA,MP. CHACAO,PQ. CHACAO,ESCUELA BASICA FERNANDO PEÑALVER,1742,3,20,1252,302,1232,0,1,1,0,928,1252
EDO. MIRANDA,MP. CHACAO,PQ. CHACAO,UNIDAD EDUCATIVA COLEGIO BASICA MUNICIPAL CARLOS SOUBLETTE,1335,3,42,1020,338,978,1,4,2,3,630,1020
EDO. MIRANDA,MP. CHACAO,PQ. CHACAO,CENTRO MEDICO CARLOS DIEZ DEL INSTITUTO VENEZOLANO DE SEGURO SOCIAL CHACAO,295,1,8,253,141,245,0,2,0,1,101,253
EDO. MIRANDA,MP. CHACAO,PQ. CHACAO,UNIDAD EDUCATIVA POPULAR COLEGIO EL ALBA,2194,4,19,1602,188,1583,1,4,0,0,1390,1602
EDO. MIRANDA,MP. CHACAO,PQ. CHACAO,UNIDAD EDUCATIVA COLEGIO PARROQUIAL SAGRADO CORAZON DE JESUS,734,2,10,651,147,641,0,2,1,0,491,651
EDO. MIRANDA,MP. CHACAO,PQ. CHACAO,UNIDAD EDUCATIVA POPULAR SANTO TOMAS DE AQUINO,2038,4,14,1691,143,1677,0,3,1,1,1529,1691
EDO. MIRANDA,MP. CHACAO,PQ. CHACAO,INSTITUTO UNIVERSITARIO NUEVAS PROFESIONES,5322,10,37,3687,568,3650,1,8,6,7,3060,3687
EDO. MIRANDA,MP. CHACAO,PQ. CHACAO,INSTITUTO EINSTEIN,3409,6,19,2530,430,2511,2,2,0,3,2074,2530
EDO. MIRANDA,MP. CHACAO,PQ. CHACAO,UNIDAD EDUCATIVA  POPULAR COLEGIO SAN IGNACIO DE LOYOLA,5517,10,40,4221,415,4181,0,8,1,3,3754,4221
EDO. MIRANDA,MP. CHACAO,PQ. CHACAO,INSTITUTO EDUCACIONAL LANDER,951,2,11,700,160,689,0,3,0,0,526,700
EDO. MIRANDA,MP. CHACAO,PQ. CHACAO,UNIDAD EDUCATIVA MUNICIPAL ANDRES BELLO,7899,15,70,5975,1244,5905,0,16,2,4,4639,5975
EDO. MIRANDA,MP. CHACAO,PQ. CHACAO,UNIDAD EDUCATIVA  POPULAR  COLEGIO NUESTRA SEÑORA DE FATIMA,3076,6,28,2353,742,2325,0,7,1,0,1575,2353
EDO. MIRANDA,MP. CHACAO,PQ. CHACAO,UNIDAD EDUCATIVA POPULAR COLEGIO MAS LUZ,3663,7,26,2716,709,2690,1,9,4,1,1966,2716
EDO. MIRANDA,MP. CHACAO,PQ. CHACAO,UNIDAD EDUCATIVA POPULAR CRISTO REY,3141,6,18,2193,137,2175,0,3,1,0,2034,2193
EDO. MIRANDA,MP. CHACAO,PQ. CHACAO,UNIDAD EDUCATIVA GUSTAVO HERRERA,5204,9,75,3508,1145,3433,0,16,0,1,2271,3508
EDO. MIRANDA,MP. CHACAO,PQ. CHACAO,COLEGIO UNIVERSITARIO  MONSEÑOR DE TALAVERA,1230,3,10,824,93,814,1,3,1,1,715,824
EDO. MIRANDA,MP. CHACAO,PQ. CHACAO,UNIDAD EDUCATIVA POPULAR COLEGIO DON BOSCO,3813,7,19,2645,315,2626,0,3,1,1,2306,2645
EDO. MIRANDA,MP. CHACAO,PQ. CHACAO,JARDIN DE INFANCIA EL LIBERTADOR.,1246,3,13,969,263,956,0,2,1,0,690,969
EDO. MIRANDA,MP. CHACAO,PQ. CHACAO,UNIDAD EDUCATIVA POPULAR SAN FRANCISCO DE ASIS,1921,4,12,1363,150,1351,0,2,0,2,1197,1363
EDO. MIRANDA,MP. CHACAO,PQ. CHACAO,UNIVERSIDAD  JOSE MARIA VARGAS,735,2,5,496,110,491,1,3,0,0,377,496
EDO. MIRANDA,MP. CHACAO,PQ. CHACAO,COLEGIO SANTO DOMINGO DE GUZMAN,2631,5,14,1976,198,1962,0,2,0,2,1760,1976
EDO. MIRANDA,MP. CHACAO,PQ. CHACAO,UNIDAD EDUCATIVA BASICA MUNICIPAL JUAN DE DIOS GUANCHE,2688,5,45,2209,589,2164,0,4,0,2,1569,2209
EDO. MIRANDA,MP. CHACAO,PQ. CHACAO,UNIDAD EDUCATIVA COLEGIO SANTIAGO DE LEON CARACAS,3140,6,19,2378,243,2359,2,0,0,0,2114,2378
EDO. MIRANDA,MP. CHACAO,PQ. CHACAO,UNIDAD EDUCATIVA EL LIBERTADOR,5086,9,43,3636,894,3593,1,7,1,3,2687,3636
EDO. MIRANDA,MP. CHACAO,PQ. CHACAO,COLEGIO SCHONTHAL,7133,13,47,5383,607,5336,2,6,0,3,4718,5383
EDO. MIRANDA,MP. CHACAO,PQ. CHACAO,UNIDAD EDUCATIVA POPULAR MARIA AUXILIADORA,4565,8,18,3088,288,3070,0,6,0,2,2774,3088
EDO. MIRANDA,MP. ZAMORA,PQ. BOLIVAR,NUCLEO ESCOLAR RURAL 020 ORUSA,251,1,0,228,222,228,0,0,0,0,6,228
EDO. MIRANDA,MP. ZAMORA,PQ. BOLIVAR,UNIDAD EDUCATIVA  JORGE ANTONIO RODRIGUEZ,112,1,5,84,62,79,0,0,0,0,17,84
EDO. MIRANDA,MP. ZAMORA,PQ. BOLIVAR,CONCENTRACION BOLIVARIANA RURAL REBENTON,197,1,4,177,142,173,0,0,1,0,30,177
EDO. MIRANDA,MP. ZAMORA,PQ. BOLIVAR,UNIDAD EDUCATIVA CONCENTRADA NUMERO 3619,607,2,7,430,348,423,0,2,0,1,72,430
EDO. MIRANDA,MP. ZAMORA,PQ. BOLIVAR,CONCENTRACION ESTADAL NUMERO 11,1662,3,23,1178,920,1155,1,3,0,1,230,1178
EDO. MIRANDA,MP. ZAMORA,PQ. BOLIVAR,ESCUELA ESTADAL LAS TEJERIAS,235,1,1,176,158,175,0,1,0,0,16,176
EDO. MIRANDA,MP. ZAMORA,PQ. BOLIVAR,ESCUELA BASICA ESTADAL CONCENTRADA MACANILLAR (NUCLEO ESCOLAR RURAL 030),248,1,2,222,209,220,0,0,0,0,11,222
EDO. MIRANDA,MP. ZAMORA,PQ. BOLIVAR,UNIDAD EDUCATIVA  NACIONAL BOLIVARIANA ARAIRA,4708,9,78,3821,2104,3743,0,13,2,6,1618,3821
EDO. MIRANDA,MP. ZAMORA,PQ. BOLIVAR,COLEGIO DE EDUCACION INICIAL QUEBRADA SECA NUMERO 021,297,1,7,258,211,251,0,1,1,0,38,258
EDO. MIRANDA,MP. ZAMORA,PQ. BOLIVAR,UNIDAD EDUCATIVA BASICA SANTA ROSALIA,401,1,4,364,256,360,0,1,0,0,103,364
EDO. MIRANDA,MP. ZAMORA,PQ. BOLIVAR,UNIDAD EDUCATIVA 030 LA LUCHA,136,1,1,110,102,109,1,0,0,0,6,110
EDO. MIRANDA,MP. ZAMORA,PQ. BOLIVAR,ESCUELA CONCENTRADA SIN NUMERO,250,1,5,176,108,171,0,2,1,0,60,176
EDO. MIRANDA,MP. ZAMORA,PQ. BOLIVAR,UNIDAD EDUCATIVA NACIONAL BOLIVARIANA TERESA DE LA PARRA,1241,3,23,1037,720,1014,0,4,0,1,289,1037
EDO. MIRANDA,MP. ZAMORA,PQ. BOLIVAR,GRUPO ESCOLAR GUZMAN BLANCO,2710,5,42,2202,1617,2160,0,7,1,0,535,2202
EDO. MIRANDA,MP. ZAMORA,PQ. BOLIVAR,JOSEFINA GUTIERREZ DE RUIZ NUCLEO ESCOLAR RURAL 029,225,1,3,182,158,179,0,0,0,0,21,182
EDO. MIRANDA,MP. ZAMORA,PQ. BOLIVAR,LICEO BOLIVARIANO PAZ CASTILLO, EXTENSION LAS LUISAS,605,2,16,498,392,482,0,0,1,1,88,498
EDO. MIRANDA,MP. ZAMORA,PQ. GUATIRE,PEESCOLAR BOLIVARIANO,1957,4,43,1577,1275,1534,1,8,0,0,250,1577
EDO. MIRANDA,MP. ZAMORA,PQ. GUATIRE,UNIDAD EDUCATIVA MARIA TERESA TORO,1685,3,17,1559,871,1542,0,3,0,3,665,1559
EDO. MIRANDA,MP. ZAMORA,PQ. GUATIRE,ESCUELA EL INGENIO,5826,11,149,5185,2615,5036,0,11,2,5,2403,5185
EDO. MIRANDA,MP. ZAMORA,PQ. GUATIRE,CENTRO DE EDUCACION INICIAL PRIVADA SANTA CRUZ DE PACAIRIGUA,364,1,8,322,251,314,0,2,0,1,60,322
EDO. MIRANDA,MP. ZAMORA,PQ. GUATIRE,COLEGIO ROMULO BETANCOURT,6980,13,113,6092,2563,5979,2,20,1,5,3388,6092
EDO. MIRANDA,MP. ZAMORA,PQ. GUATIRE,PRE ESCOLAR UNIDAD EDUCATIVA MANUELITA SAENZ,4037,7,76,3636,1282,3560,1,11,1,2,2263,3636
EDO. MIRANDA,MP. ZAMORA,PQ. GUATIRE,COLEGIO PACARIGUA II,6805,12,62,6086,1959,6024,0,21,2,12,4030,6086
EDO. MIRANDA,MP. ZAMORA,PQ. GUATIRE,COLEGIO VILLA HEROICA,784,2,8,708,454,700,0,3,2,0,241,708
EDO. MIRANDA,MP. ZAMORA,PQ. GUATIRE,GRUPO ESCOLAR GUATIRE,3205,6,66,2633,1967,2567,0,19,0,0,581,2633
EDO. MIRANDA,MP. ZAMORA,PQ. GUATIRE,CASA PARROQUIAL DE GUATIRE,1443,3,28,1163,618,1135,1,8,1,3,504,1163
EDO. MIRANDA,MP. ZAMORA,PQ. GUATIRE,COLEGIO SAN JOSE,329,1,7,296,113,289,0,1,0,0,175,296
EDO. MIRANDA,MP. ZAMORA,PQ. GUATIRE,ESCUELA ESTADAL ESTADO MONAGAS,3358,6,78,2713,2044,2635,0,7,4,0,580,2713
EDO. MIRANDA,MP. ZAMORA,PQ. GUATIRE,ESCUELA NACIONAL EDUARDO CHURION,4409,8,63,3511,2768,3448,0,22,2,1,655,3511
EDO. MIRANDA,MP. ZAMORA,PQ. GUATIRE,INTERNADO JUDICIAL EL RODEO,1219,3,21,336,255,315,0,0,0,0,60,336
EDO. MIRANDA,MP. ZAMORA,PQ. GUATIRE,INSTITUTO DE CICLO BASICO JUAN JOSE ABREU,4810,9,98,3985,2259,3887,0,16,1,3,1608,3985
EDO. MIRANDA,MP. ZAMORA,PQ. GUATIRE,UNIDAD EDUCATIVA EZEQUIEL ZAMORA,713,2,12,652,511,640,0,5,2,1,121,652
EDO. MIRANDA,MP. ZAMORA,PQ. GUATIRE,GRUPO ESCOLAR RAMON ALFONZO BLANCO,2371,5,47,2049,1365,2002,1,10,2,1,623,2049
EDO. MIRANDA,MP. ZAMORA,PQ. GUATIRE,GRUPO ESCOLAR ELIAS CALIXTO POMPA,4066,8,85,3297,1614,3212,0,11,2,1,1584,3297
EDO. MIRANDA,MP. ZAMORA,PQ. GUATIRE,COLEGIO PACAIRIGUA,5888,11,81,5187,2000,5106,0,12,1,5,3088,5187
EDO. MIRANDA,MP. ZAMORA,PQ. GUATIRE,ESCUELA CONCENTRADA ESTADAL NUMERO 266 166,575,1,7,344,293,337,1,5,0,0,38,344
EDO. MIRANDA,MP. ZAMORA,PQ. GUATIRE,COMPLEJO EDUCATIVO ARTISTICO,954,2,23,780,363,757,0,2,1,0,391,780
EDO. MIRANDA,MP. ZAMORA,PQ. GUATIRE,UNIDAD EDUACATIVA BASICA LIGIA GOUBERNIER,1505,3,41,1399,743,1358,0,8,2,1,604,1399
EDO. MIRANDA,MP. ZAMORA,PQ. GUATIRE,UNIDAD EDUCATIVA NUESTRA SEÑORA DEL CAMINO,5657,10,58,5267,948,5209,0,7,1,7,4246,5267
EDO. MIRANDA,MP. ZAMORA,PQ. GUATIRE,UNIDAD EDUCATIVA PRIVADA BELAGUA,2728,5,54,2481,957,2427,0,5,0,4,1461,2481
EDO. MIRANDA,MP. ZAMORA,PQ. GUATIRE,CASA DE LA CULTURA SAN PEDRO,1162,2,22,999,673,977,0,4,2,1,297,999
EDO. MIRANDA,MP. ZAMORA,PQ. GUATIRE,CENTRO DE EDUCACION INICIAL  VICTORIA MACHADO DE PLAZA,361,1,6,322,260,316,0,0,1,0,55,322
EDO. MIRANDA,MP. ZAMORA,PQ. GUATIRE,UNIDAD EDUCATIVA ESTADAL EUGENIO P` DE BELLARD,5655,10,121,4674,3391,4553,2,27,4,2,1127,4674
EDO. MIRANDA,MP. ZAMORA,PQ. GUATIRE,UNIDAD EDUCATIVA BASICA PRE ESCOLAR ARTURO MICHELENA,541,1,16,485,433,469,0,0,1,0,35,485
EDO. MIRANDA,MP. ZAMORA,PQ. GUATIRE,LICEO VICENTE EMILIO SOJO,2529,5,36,2249,1168,2213,0,7,0,2,1036,2249
EDO. MIRANDA,MP. ZAMORA,PQ. GUATIRE,ESCUELA ESTADAL SANTA MARIA GORETTI,8605,16,103,7391,2599,7288,1,30,3,6,4649,7391
EDO. MIRANDA,MP. ZAMORA,PQ. GUATIRE,INTERNADO JUDICIAL EL RODEO II,82,1,0,37,32,37,0,0,0,0,5,37
EDO. MIRANDA,MP. ZAMORA,PQ. GUATIRE,UNIDAD EDUCATIVA PRIVADA  CIUDAD FAJARDO DE GUATIRE,139,1,1,125,61,124,0,0,0,1,62,125
EDO. MIRANDA,MP. ZAMORA,PQ. GUATIRE,ESCUELA ESTADAL  VICENTE EMILIO SOJO,1321,3,38,1060,795,1022,0,3,0,3,221,1060
EDO. MIRANDA,MP. ZAMORA,PQ. GUATIRE,CAPILLA NUESTRA SEÑORA DEL CARMEN,485,1,5,412,364,407,0,2,1,0,40,412
EDO. MIRANDA,MP. ZAMORA,PQ. GUATIRE,LICEO JOSE FRANCISCO BERMUDEZ,2954,6,95,2425,1895,2330,0,7,0,0,428,2425
EDO. MIRANDA,MP. ZAMORA,PQ. GUATIRE,CASA SINDICAL LUIS MORENO,667,2,10,598,367,588,0,4,0,0,217,598
EDO. MIRANDA,MP. ZAMORA,PQ. GUATIRE,ESCUELA BASICA PRIVADA  SAN VICENTE DE PAUL,189,1,4,166,108,162,0,0,0,0,54,166
EDO. MIRANDA,MP. ZAMORA,PQ. GUATIRE,COLEGIO SAN MARTIN DE PORRES,3971,7,38,3442,979,3404,0,11,1,3,2410,3442
EDO. MIRANDA,MP. ZAMORA,PQ. GUATIRE,UNIVERSIDAD NACIONAL EXPERIMENTAL DE LA FUERZA ARMADA NACIONAL  UNEFA,1173,2,26,1073,921,1047,0,1,1,0,124,1073
EDO. MIRANDA,MP. ZAMORA,PQ. GUATIRE,SERVICIO DE PROTECCIÒN INTEGRAL A LA NIÑEZ Y ADOLESCENCIA,944,2,19,824,558,805,0,3,0,0,244,824
EDO. MIRANDA,MP. ZAMORA,PQ. GUATIRE,CONCENTRACION ESTADAL SIN NUMERO ARENALES,1221,3,26,1003,802,977,1,5,0,0,169,1003
EDO. MIRANDA,MP. BRION,PQ. HIGUEROTE,UNIDAD EDUCATIVA ESTADAL INDALECIA MEJIA GARCIA,550,1,10,444,321,434,0,2,0,0,111,444
EDO. MIRANDA,MP. BRION,PQ. HIGUEROTE,UNIDAD EDUCATIVA NUMERO 3 DE JUNIO,524,1,6,464,332,458,1,2,1,0,122,464
EDO. MIRANDA,MP. BRION,PQ. HIGUEROTE,ESCUELA NACIONAL BOLIVARIANA CHIRIMENA,829,2,24,669,401,645,0,5,0,0,239,669
EDO. MIRANDA,MP. BRION,PQ. HIGUEROTE,ESCUELA BASICA CARMEN HELENA SOTO DE TERAN,2233,4,67,1787,1155,1720,0,8,0,2,555,1787
EDO. MIRANDA,MP. BRION,PQ. HIGUEROTE,ESCUELA EL CARMEN GUEDEZ GOPAR,2047,4,40,1643,883,1603,0,6,1,0,713,1643
EDO. MIRANDA,MP. BRION,PQ. HIGUEROTE,UNIDAD EDUCATIVA NUESTRA SEÑORA DEL CARMEN,800,2,9,650,335,641,1,2,1,0,302,650
EDO. MIRANDA,MP. BRION,PQ. HIGUEROTE,ESCUELA BASICA GABRIEL EMILIO MUÑOZ,5009,9,126,4034,2078,3908,0,18,5,1,1806,4034
EDO. MIRANDA,MP. BRION,PQ. HIGUEROTE,CONCENTRACIÓN NACIONAL BOLIVARIANA NUMEROº 19,529,1,4,432,262,428,0,0,0,0,166,432
EDO. MIRANDA,MP. BRION,PQ. HIGUEROTE,UNIDAD EDUCATIVA FERMIN TORO,1697,3,30,1382,826,1352,1,6,0,2,517,1382
EDO. MIRANDA,MP. BRION,PQ. HIGUEROTE,CONCENTRACION ESCOLAR NUMERO 34,382,1,2,280,164,278,0,2,1,1,110,280
EDO. MIRANDA,MP. BRION,PQ. HIGUEROTE,UNIDAD EDUCATIVA AREVALO GONZALEZ,4037,7,106,3242,1686,3136,1,12,1,3,1433,3242
EDO. MIRANDA,MP. BRION,PQ. HIGUEROTE,UNIDAD EDUCATIVA ESTADAL MESA GRANDE,512,1,18,432,294,414,0,1,0,2,117,432
EDO. MIRANDA,MP. BRION,PQ. HIGUEROTE,CENTRO DE EDUCACION INICIAL GABRIEL EMILIO MUÑOZ,1081,2,34,897,511,863,0,4,1,0,347,897
EDO. MIRANDA,MP. BRION,PQ. HIGUEROTE,UNIVERSIDAD PEDAGOGICA ARGELIA LAYA,866,2,27,735,390,708,0,6,1,0,311,735
EDO. MIRANDA,MP. BRION,PQ. CURIEPE,UNIDAD EDUCATIVA JUAN PABLO SOJO,2461,5,52,1926,1223,1874,0,6,3,1,641,1926
EDO. MIRANDA,MP. BRION,PQ. CURIEPE,ESCUELA GRADUADA ESTADO TRUJILLO,885,2,15,676,382,661,1,7,0,1,270,676
EDO. MIRANDA,MP. BRION,PQ. CURIEPE,ESCUELA CONCENTRACION SIN NUMERO,247,1,7,187,135,180,0,0,0,0,45,187
EDO. MIRANDA,MP. BRION,PQ. CURIEPE,PRE ESCOLAR JARDIN DE INFANCIA SIXTO DOMINGO LOPEZ,1934,4,50,1619,1120,1569,0,10,2,1,436,1619
EDO. MIRANDA,MP. BRION,PQ. CURIEPE,LICEO NACIONAL PEDRO MARIA JOSE,1436,3,20,1130,918,1110,0,3,0,0,189,1130
EDO. MIRANDA,MP. BRION,PQ. CURIEPE,ESCUELA BASICA MORON,681,2,16,552,419,536,0,1,0,0,116,552
EDO. MIRANDA,MP. BRION,PQ. CURIEPE,ESCUELA ESTADAL BOLIVARIANA TACARIGUITA,641,2,15,503,318,488,1,0,1,0,168,503
EDO. MIRANDA,MP. BRION,PQ. TACARIGUA,UNIDAD EDUCATIVA GAMELOTAL,1064,2,28,857,561,829,0,7,0,2,259,857
EDO. MIRANDA,MP. BRION,PQ. TACARIGUA,ESCUELA BOLIVARIANA LA FUNDACIÓN,614,2,20,490,299,470,0,1,0,1,169,490
EDO. MIRANDA,MP. BRION,PQ. TACARIGUA,CENTRO TECNOLOGICO LA ARBOLEDA,339,1,19,301,212,282,0,1,0,0,69,301
EDO. MIRANDA,MP. BRION,PQ. TACARIGUA,ESCUELA BOLIVARIANA ESTILITO DIAZ APONTE,661,2,18,542,331,524,0,5,0,0,188,542
EDO. MIRANDA,MP. BRION,PQ. TACARIGUA,BIBLIOTECA LAS CORALIAS,357,1,5,313,253,308,0,1,0,0,54,313
EDO. MIRANDA,MP. BRION,PQ. TACARIGUA,ESCUELA BOLIVARIANA LAS GONZÁLEZ,648,2,25,545,303,520,0,4,0,0,213,545
EDO. MIRANDA,MP. BRION,PQ. TACARIGUA,ESCUELA BOLIVARIANA LAS MARTINEZ,1019,2,22,844,543,822,0,3,0,0,276,844
EDO. MIRANDA,MP. BRION,PQ. TACARIGUA,UNIDAD EDUCATIVA ESTADAL MATURIN,567,1,5,500,397,495,0,2,1,0,95,500
EDO. MIRANDA,MP. BRION,PQ. TACARIGUA,UNIDAD EDUCATIVA BARLOVENTO,4158,8,46,3276,1784,3230,0,18,1,5,1422,3276
EDO. MIRANDA,MP. URDANETA,PQ. NUEVA CUA,UNIDAD EDUCATIVA NACIONAL EXTENSION RAFAEL RAFAEL RANGEL,483,1,7,419,336,412,0,3,0,0,73,419
EDO. MIRANDA,MP. URDANETA,PQ. NUEVA CUA,CONCENTRACION ESCOLAR ESTADAL SIN NUMERO ANIAGUA NUCLEO ESCOLAR RURAL 127,404,1,8,274,217,266,0,2,0,0,47,274
EDO. MIRANDA,MP. URDANETA,PQ. NUEVA CUA,ESCUELA BASICA ESTADAL NUEVA CUA,342,1,5,277,236,272,0,1,0,0,35,277
EDO. MIRANDA,MP. URDANETA,PQ. NUEVA CUA,ESCUELA BASICA CREACION CUA,3967,7,71,3382,2390,3311,3,18,0,3,897,3382
EDO. MIRANDA,MP. URDANETA,PQ. NUEVA CUA,UNIDAD EDUCATIVA RURAL BOLIVARIANA QUEBRADA HONDA,1169,2,36,884,665,848,0,6,1,0,176,884
EDO. MIRANDA,MP. URDANETA,PQ. NUEVA CUA,CONCENTRACION ESTADAL SIN NUMERO LOS ROSOS,654,2,9,497,370,488,0,1,1,0,116,497
EDO. MIRANDA,MP. URDANETA,PQ. NUEVA CUA,ESCUELA BASICA NACIONAL NUEVA CUA,3069,6,76,2507,1883,2431,1,10,1,2,534,2507
EDO. MIRANDA,MP. URDANETA,PQ. NUEVA CUA,ESCUELA BASICA ESTADAL BOLIVARIANA LA PROVIDENCIA,589,1,15,422,346,407,0,4,1,0,56,422
EDO. MIRANDA,MP. URDANETA,PQ. NUEVA CUA,ESCUELA BASICA BOLIVARIANA JOSE LEONARDO CHIRINOS,2206,4,35,1855,1366,1820,0,7,0,0,447,1855
EDO. MIRANDA,MP. URDANETA,PQ. NUEVA CUA,CASA DE LA CULTURA,971,2,13,792,605,779,1,6,2,1,164,792
EDO. MIRANDA,MP. URDANETA,PQ. NUEVA CUA,SIMONCITO COMUNITARIO SIMON BOLIVAR,108,1,3,78,63,75,0,0,0,0,12,78
EDO. MIRANDA,MP. URDANETA,PQ. NUEVA CUA,CONCENTRACION ESCOLAR ESTADAL SIN NUMERO LA PALMA,68,1,4,63,58,59,0,0,0,0,1,63
EDO. MIRANDA,MP. URDANETA,PQ. NUEVA CUA,CONCENTRACION ESTADAL SUTIL,142,1,5,128,105,123,0,0,0,0,18,128
EDO. MIRANDA,MP. URDANETA,PQ. NUEVA CUA,UNIDAD EDUCATIVA ESTADAL ANDRES BELLO,1614,3,38,1372,978,1334,2,6,2,3,343,1372
EDO. MIRANDA,MP. URDANETA,PQ. NUEVA CUA,UNIDAD EDUCATIVA ESTADAL LA GUADALUPE,807,2,16,668,517,652,0,3,1,0,131,668
EDO. MIRANDA,MP. URDANETA,PQ. NUEVA CUA,UNIDAD EDUCATIVA ESTADAL BOLIVARIANA SAN JUAN BAUTISTA,371,1,9,328,263,319,0,3,1,0,52,328
EDO. MIRANDA,MP. URDANETA,PQ. NUEVA CUA,UNIDAD EDUCATIVA ESTADAL JOSE GIL FORTOUL,1111,2,17,911,723,894,1,2,1,0,167,911
EDO. MIRANDA,MP. URDANETA,PQ. NUEVA CUA,CONCENTRACION ESCOLAR NUMERO 110 CAMPO VERDE,211,1,3,173,137,170,1,2,0,0,30,173
EDO. MIRANDA,MP. URDANETA,PQ. NUEVA CUA,CONCENTRACION ESCOLAR ESTADAL SIN NUMERO PALMIRA,167,1,0,129,78,129,0,2,0,0,49,129
EDO. MIRANDA,MP. URDANETA,PQ. NUEVA CUA,CONCENTRACION ESCOLAR ESTADAL BOLIVARIANA LOS CHAGUARAMOS,242,1,10,215,169,205,0,1,0,0,35,215
EDO. MIRANDA,MP. URDANETA,PQ. NUEVA CUA,ESCUELA NACIONAL BOLIVARIANA MANUELITA SAENZ,1237,3,23,915,698,892,1,4,1,1,187,915
EDO. MIRANDA,MP. URDANETA,PQ. NUEVA CUA,CONCENTRACION ESCOLAR SIN NUMERO AGUA AMARILLA DEL NER 27,274,1,4,211,175,207,0,3,0,0,29,211
EDO. MIRANDA,MP. URDANETA,PQ. NUEVA CUA,UNIDAD EDUCATIVA NACIONAL RAFAEL RANGEL,2520,5,54,1995,1479,1941,1,4,1,0,456,1995
EDO. MIRANDA,MP. URDANETA,PQ. NUEVA CUA,UNIDAD EDUCATIVA NACIONAL 12  DE OCTUBRE,352,1,9,258,215,249,0,0,0,0,34,258
EDO. MIRANDA,MP. URDANETA,PQ. NUEVA CUA,UNIVERSIDAD SISO MARTINEZ,2596,5,32,2147,1638,2115,3,14,0,2,458,2147
EDO. MIRANDA,MP. URDANETA,PQ. CUA,UNIDAD EDUCATIVA NACIONAL BOLIVARINA EZEQUIEL ZAMORA,3748,7,61,3107,2115,3046,1,21,2,4,903,3107
EDO. MIRANDA,MP. URDANETA,PQ. CUA,CENTRO DE EDUCACION INICIAL FELIPA TORO,383,1,6,337,223,331,0,1,2,0,105,337
EDO. MIRANDA,MP. URDANETA,PQ. CUA,ESCUELA BASICA NACIONAL CRISTOBAL ROJAS,3630,7,66,2976,1605,2910,0,5,3,1,1296,2976
EDO. MIRANDA,MP. URDANETA,PQ. CUA,UNIDAD ESTADAL MINISTERIO DE AGRICULTURA Y TIERRA,609,2,5,531,280,526,0,1,1,2,242,531
EDO. MIRANDA,MP. URDANETA,PQ. CUA,CONCENTRACION ESCOLAR ESTADAL SIN NUMERO SACUA,222,1,7,129,105,122,0,0,0,0,17,129
EDO. MIRANDA,MP. URDANETA,PQ. CUA,ESCUELA NACIONAL LESBIA PLATERS,3940,7,77,3316,2032,3239,2,23,3,2,1177,3316
EDO. MIRANDA,MP. URDANETA,PQ. CUA,UNIDAD EDUCATIVA NACIONAL VICENTE LECUNA,568,1,6,506,403,500,0,0,0,1,96,506
EDO. MIRANDA,MP. URDANETA,PQ. CUA,UNIDAD EDUCATIVA NACIONAL BOLIVARIANA LIBERTADOR SIMON BOLIVAR,1986,4,22,1630,1115,1608,1,7,1,1,483,1630
EDO. MIRANDA,MP. URDANETA,PQ. CUA,ESCUELA ESTADAL CONSUELO HERNANDEZ,4761,9,127,3852,2312,3725,1,15,2,2,1393,3852
EDO. MIRANDA,MP. URDANETA,PQ. CUA,ESCUELA BASICA ESTADAL CREACION BICENTENARIA,1693,3,46,1408,1199,1362,1,3,0,1,158,1408
EDO. MIRANDA,MP. URDANETA,PQ. CUA,UNIDAD EDUCATIVA NACIONAL RAFAEL URDANETA EXTENCION ATENEO,3253,6,64,2719,1264,2655,1,18,3,6,1363,2719
EDO. MIRANDA,MP. URDANETA,PQ. CUA,ESCUELA BASICA ESTADAL  JOSE MARIA CARRE O,2732,5,46,2213,1624,2167,1,9,0,0,533,2213
EDO. MIRANDA,MP. URDANETA,PQ. CUA,PREESCOLAR NACIONAL CRISTOBAL ROJAS,1150,2,22,950,499,928,0,3,0,0,426,950
EDO. MIRANDA,MP. URDANETA,PQ. CUA,CONCENTRACION ESCOLAR SIN NUMERO MUME ABAJO,268,1,2,231,211,229,0,2,0,0,16,231
EDO. MIRANDA,MP. URDANETA,PQ. CUA,UNIDAD EDUCATIVA NACIONAL RAFAEL URDANETA,1460,3,16,1362,596,1346,1,4,0,2,743,1362
EDO. MIRANDA,MP. URDANETA,PQ. CUA,UNIDAD EDUCATIVA ESTADAL CONSUELO PORTILLO,936,2,18,760,565,742,0,4,1,0,172,760
EDO. MIRANDA,MP. URDANETA,PQ. CUA,CONCENTRACION ESCOLAR RURAL NUMERO 17,2102,4,31,1659,1177,1628,1,5,1,0,444,1659
EDO. MIRANDA,MP. URDANETA,PQ. CUA,UNIDAD EDUCATIVA ESTADAL GENERAL RAFAEL URDANETA,2417,5,42,2222,851,2180,2,3,0,3,1321,2222
EDO. MIRANDA,MP. URDANETA,PQ. CUA,UNIDAD ESCOLAR NACIONAL DISTRITO CAPITAL,2213,4,82,1858,1472,1776,0,9,1,1,293,1858
EDO. MIRANDA,MP. URDANETA,PQ. CUA,CENTRO INFANTIL EDUCATIVO EULALIA BUROZ,2467,5,51,1985,976,1934,0,7,0,4,947,1985
EDO. MIRANDA,MP. URDANETA,PQ. CUA,UNIDAD EDUCATIVA NACIONAL JOSE DE SAN MARTIN,4641,9,65,3857,2385,3792,1,19,2,3,1382,3857
EDO. MIRANDA,MP. URDANETA,PQ. CUA,ESCUELA TECNICA INDUSTRIAL CRUZ VILLEGAS,1916,4,60,1723,1016,1663,0,8,1,2,636,1723
EDO. MIRANDA,MP. URDANETA,PQ. CUA,CASA DE LA CULTURA PANCHO PRIN,957,2,21,850,385,829,0,5,1,1,437,850
EDO. MIRANDA,MP. URDANETA,PQ. CUA,COMEDOR MUNICIPAL PAULA CORREA,1269,3,29,1120,756,1091,1,5,0,1,328,1120
EDO. MIRANDA,MP. URDANETA,PQ. CUA,CICLO BASICO CUA,3200,6,66,2892,1270,2826,0,8,3,6,1539,2892
EDO. MIRANDA,MP. URDANETA,PQ. CUA,PLAZA BOLIVAR DE CUA,115,1,5,88,52,83,0,1,0,0,30,88
EDO. MIRANDA,MP. URDANETA,PQ. CUA,ESCUELA BOLIVARIANA CONCENTRACION ESCOLAR RURAL LAS CASITAS,51,1,1,47,37,46,0,0,0,0,9,47
EDO. MIRANDA,MP. URDANETA,PQ. CUA,UNIDAD EDUCATIVA NACIONAL EZEQUIEL ZAMORA,2529,5,50,2090,1303,2040,0,12,1,6,718,2090
EDO. MIRANDA,MP. URDANETA,PQ. CUA,ESCUELA BASICA ESTADAL PROFESOR JESUS MARIA RANGEL,365,1,7,334,273,327,0,0,0,0,54,334
EDO. MIRANDA,MP. LANDER,PQ. LA DEMOCRACIA,CONCENTRACION ESCOLAR LOS CONFINES N.E.R 011,294,1,6,189,155,183,0,0,0,0,28,189
EDO. MIRANDA,MP. LANDER,PQ. LA DEMOCRACIA,CONCENTRACION ESCOLAR NUMERO 69 QUIRIPITAL,429,1,10,282,204,272,0,0,0,0,68,282
EDO. MIRANDA,MP. LANDER,PQ. LA DEMOCRACIA,ESCUELA BOLIVARIANA ESTADAL SAN VICENTE,195,1,1,176,137,175,0,0,0,0,38,176
EDO. MIRANDA,MP. LANDER,PQ. LA DEMOCRACIA,CONCENTRACION ESCOLAR SIN NUMERO GUAYAMURAL,367,1,3,272,210,269,0,2,0,0,57,272
EDO. MIRANDA,MP. LANDER,PQ. SANTA BARBARA,UNIDAD EDUCATIVA NACIONAL LILIA DE PIÑERO,3681,7,62,2986,2142,2924,0,12,1,2,767,2986
EDO. MIRANDA,MP. LANDER,PQ. SANTA BARBARA,UNIDAD EDUCATIVA ESTADAL  MATA PRINERA,541,1,6,483,413,477,0,1,0,0,63,483
EDO. MIRANDA,MP. LANDER,PQ. SANTA BARBARA,UNIDAD EDUCATIVA NACIONAL JUANA RAMIREZ,2108,4,42,1910,1806,1868,2,1,2,1,56,1910
EDO. MIRANDA,MP. LANDER,PQ. SANTA BARBARA,UNIDAD EDUCATIVA TECNICA AGROPECUARIA PIÑATE,1537,3,44,1290,870,1246,0,4,2,2,368,1290
EDO. MIRANDA,MP. LANDER,PQ. OCUMARE DEL TUY,UNIDAD EDUCATIVA NACIONAL BOLIVARIANA BATALLA DE CARABOBO,612,2,6,453,411,447,1,0,1,1,33,453
EDO. MIRANDA,MP. LANDER,PQ. OCUMARE DEL TUY,ESCUELA BASICA  SAN BASILIO,146,1,1,121,109,120,0,0,0,0,11,121
EDO. MIRANDA,MP. LANDER,PQ. OCUMARE DEL TUY,CENTRO DE EDUCACION INICIAL VALLECITO,706,2,9,629,523,620,1,2,0,0,94,629
EDO. MIRANDA,MP. LANDER,PQ. OCUMARE DEL TUY,UNIDAD EDUCATIVA ESTADAL ESTADO TACHIRA,2849,5,27,2186,1663,2159,2,13,0,1,480,2186
EDO. MIRANDA,MP. LANDER,PQ. OCUMARE DEL TUY,ESCUELA BASICA ESTADAL DOCTOR JOSE MARIA VARGAS,903,2,8,781,699,773,0,1,0,0,73,781
EDO. MIRANDA,MP. LANDER,PQ. OCUMARE DEL TUY,UNIDAD EDUCATIVA ESTADAL PABLO CALZADILLA,404,1,4,332,279,328,0,1,1,0,47,332
EDO. MIRANDA,MP. LANDER,PQ. OCUMARE DEL TUY,CENTRO DE EDUCACION INICIAL BOLIVARIANO SENDERO DE LUZ,481,1,7,420,361,413,1,1,0,0,50,420
EDO. MIRANDA,MP. LANDER,PQ. OCUMARE DEL TUY,CONCENTRACION ESCOLAR CAICITA,625,2,8,444,374,436,0,3,0,0,59,444
EDO. MIRANDA,MP. LANDER,PQ. OCUMARE DEL TUY,UNIDAD EDUCATIVA NACIONAL MANUEL DE ALESON,939,2,14,736,421,722,0,5,1,0,295,736
EDO. MIRANDA,MP. LANDER,PQ. OCUMARE DEL TUY,CENTRO DE EDUCACION INICIAL  MATA DE COCO,762,2,14,681,595,667,0,7,2,0,63,681
EDO. MIRANDA,MP. LANDER,PQ. OCUMARE DEL TUY,UNIDAD EDUCATIVA ESTADAL JOSE FELIX RIBAS,2539,5,28,2054,1767,2026,0,12,3,0,244,2054
EDO. MIRANDA,MP. LANDER,PQ. OCUMARE DEL TUY,INSTITUTO UNIVERSITARIO TOMAS LANDER,1302,3,17,1177,467,1160,0,1,0,0,692,1177
EDO. MIRANDA,MP. LANDER,PQ. OCUMARE DEL TUY,UNIDAD EDUCATIVA COLEGIO TOMAS LANDER,1655,3,37,1349,657,1312,1,7,0,1,646,1349
EDO. MIRANDA,MP. LANDER,PQ. OCUMARE DEL TUY,UNIDAD EDUCATIVA ESTADAL ANA MARIA DE DELGADO,1600,3,26,1455,795,1429,0,7,0,3,624,1455
EDO. MIRANDA,MP. LANDER,PQ. OCUMARE DEL TUY,CENTRO DE EDUCACION INICIAL  MARIA SOSA DE BELVIS,2247,4,28,1915,1608,1887,1,6,0,0,272,1915
EDO. MIRANDA,MP. LANDER,PQ. OCUMARE DEL TUY,ESCUELA BASICA ESTADAL MERCEDEZ DE PEREZ,3153,6,51,2608,1930,2557,1,20,0,2,604,2608
EDO. MIRANDA,MP. LANDER,PQ. OCUMARE DEL TUY,COMPLEJO EDUCATIVO NACIONAL ALBERTO SMITH,5667,10,123,4662,3080,4539,0,27,5,3,1424,4662
EDO. MIRANDA,MP. LANDER,PQ. OCUMARE DEL TUY,CENTRO DE EDUCACION INICIAL NACIONAL 13 DE MARZO DE 1814,507,1,10,454,411,444,0,0,0,0,33,454
EDO. MIRANDA,MP. LANDER,PQ. OCUMARE DEL TUY,UNIDAD EDUCATIVA ESTADAL ARAGUITA I,2151,4,54,1839,1130,1785,0,6,0,0,649,1839
EDO. MIRANDA,MP. LANDER,PQ. OCUMARE DEL TUY,CASA DE LA CULTURA JOSE FELIX RIBAS,2117,4,31,1769,1041,1738,0,5,0,0,692,1769
EDO. MIRANDA,MP. LANDER,PQ. OCUMARE DEL TUY,CENTRO DE FORMACION DE RECURSOS HUMANOS SAN JUAN BAUTISTA DE LA SALLE,388,1,11,361,238,350,0,0,0,0,112,361
EDO. MIRANDA,MP. LANDER,PQ. OCUMARE DEL TUY,UNIDAD EDUCATIVA ESTADAL MONSEÑOR RAFAEL PEREZ LEON,3141,6,61,2554,1867,2493,0,14,1,3,608,2554
EDO. MIRANDA,MP. LANDER,PQ. OCUMARE DEL TUY,CONCENTRACION EDUCATIVO VALLES DEL TUY,3084,6,66,2438,1794,2372,2,10,4,2,560,2438
EDO. MIRANDA,MP. LANDER,PQ. OCUMARE DEL TUY,COMPLEJO EDUCATIVO NACIONAL MERCEDES RASCO,5704,10,100,4665,3834,4565,2,14,3,5,707,4665
EDO. MIRANDA,MP. LANDER,PQ. OCUMARE DEL TUY,UNIDAD EDUCATIVA ESTADAL BOLIVARIANA LA UVERITA,335,1,15,300,269,285,0,0,0,0,16,300
EDO. MIRANDA,MP. LANDER,PQ. OCUMARE DEL TUY,GRUPO ESCOLAR DOCTOR  OBDULIO ALVAREZ,2749,5,41,2245,1456,2204,0,7,0,3,738,2245
EDO. MIRANDA,MP. LANDER,PQ. OCUMARE DEL TUY,IPASME OCUMARE DEL TUY,1724,3,50,1411,980,1361,0,9,0,2,370,1411
EDO. MIRANDA,MP. LANDER,PQ. OCUMARE DEL TUY,CONCETRACION ESCOLAR QUEBRADA DE MIGUEL,180,1,0,116,110,116,0,0,0,1,5,116
EDO. MIRANDA,MP. LANDER,PQ. OCUMARE DEL TUY,ESCUELA BASICA ESTADAL CHAMICERO,2230,4,56,1824,1298,1768,1,10,3,1,455,1824
EDO. MIRANDA,MP. LANDER,PQ. OCUMARE DEL TUY,CENTRO DE EDUCACION INICIAL VIRGEN DE BETANIA,1174,2,12,1019,939,1007,1,4,0,0,63,1019
EDO. MIRANDA,MP. LANDER,PQ. OCUMARE DEL TUY,UNIDAD EDUCATIVA ESTADAL ANTONIO JOSE DE SUCRE,2193,4,38,1763,1419,1725,0,14,1,0,291,1763
EDO. MIRANDA,MP. LANDER,PQ. OCUMARE DEL TUY,ESCUELA BASICA NACIONAL ARAGUITA,3526,7,72,2836,2020,2764,0,12,1,3,728,2836
EDO. MIRANDA,MP. LANDER,PQ. OCUMARE DEL TUY,UNIDAD EDUCATIVA NACIONAL EXTENSION ROSA PENA,548,1,10,475,410,465,0,2,0,0,53,475
EDO. MIRANDA,MP. LANDER,PQ. OCUMARE DEL TUY,UNIDAD EDUCATIVA ESTADAL PILONCITO,1039,2,32,893,679,861,0,3,2,1,176,893
EDO. MIRANDA,MP. LANDER,PQ. OCUMARE DEL TUY,ESCUELA PRIMARIA BOLIVARIANA MIRANDA,2931,6,52,2370,1359,2318,0,8,0,2,949,2370
EDO. MIRANDA,MP. LANDER,PQ. OCUMARE DEL TUY,UNIDAD EDUCATIVA NACIONAL  JUAN ANTONIO PEREZ BONALDE,2635,5,63,2207,1281,2144,1,14,4,2,842,2207
EDO. MIRANDA,MP. LANDER,PQ. OCUMARE DEL TUY,UNIDAD EDUCATIVA FE Y ALEGRIA PAMPERO,3599,7,61,2974,2196,2913,1,8,2,3,703,2974
EDO. MIRANDA,MP. LANDER,PQ. OCUMARE DEL TUY,UNIDAD EDUCATIVA ESTADAL EVA DE TERAN,2578,5,73,2033,1372,1960,0,15,1,1,571,2033
EDO. MIRANDA,MP. LANDER,PQ. OCUMARE DEL TUY,UNIDAD EDUCATIVA NACIONAL OCUMARE,1407,3,43,1081,744,1038,0,5,1,0,288,1081
EDO. MIRANDA,MP. LANDER,PQ. OCUMARE DEL TUY,CASA COMUNAL LA VERANIEGA,245,1,3,222,207,219,0,1,0,0,11,222
EDO. MIRANDA,MP. LANDER,PQ. OCUMARE DEL TUY,ESCUELA BASICA ESTADAL TERRITORIO FEDERAL  AMAZONAS,2210,4,27,1793,1536,1766,2,9,0,3,216,1793
EDO. MIRANDA,MP. LANDER,PQ. OCUMARE DEL TUY,UNIDAD EDUCATIVA NACIONAL BOLIVARIANA DOCTOR LUIS RAZETTI,844,2,24,688,548,664,0,3,0,1,112,688
EDO. MIRANDA,MP. LANDER,PQ. OCUMARE DEL TUY,UNIDAD EDUCATIVA ESTADAL GRAN MARISCAL DE AYACUCHO,309,1,10,297,262,287,0,2,0,0,23,297
EDO. MIRANDA,MP. LANDER,PQ. OCUMARE DEL TUY,UNIDAD EDUCATIVA NACIONAL  ROSA PEÑA,3475,6,46,2888,1889,2842,0,21,2,0,930,2888
EDO. MIRANDA,MP. ACEVEDO,PQ. AREVALO GONZALEZ,CONCENTRACION NACIONAL NUMERO 1827 LA CONCEPCION,278,1,7,220,159,213,0,0,0,0,54,220
EDO. MIRANDA,MP. ACEVEDO,PQ. AREVALO GONZALEZ,ESCUELA UNITARIA NACIONAL NUMERO 1734 LAS BRISAS DE BURGUILLOS,295,1,3,185,125,182,0,0,0,0,57,185
EDO. MIRANDA,MP. ACEVEDO,PQ. AREVALO GONZALEZ,CONCENTRACION NACIONAL NUMERO 77 MARCELO,569,1,8,426,353,418,0,2,0,0,63,426
EDO. MIRANDA,MP. ACEVEDO,PQ. AREVALO GONZALEZ,ESCUELA  BOLIVARIANA. NACIONAL  VALLE DE URAPE (NUCLEO ENDOGENO RURAL  096),81,1,4,67,29,63,0,1,0,0,33,67
EDO. MIRANDA,MP. ACEVEDO,PQ. AREVALO GONZALEZ,ESCUELA BOLIVARIANA ESTADAL CONCENTRACION CAÑO NEGRO (NUCLEO ENDOGENO RURAL 010),100,1,2,89,79,87,0,1,0,0,7,89
EDO. MIRANDA,MP. ACEVEDO,PQ. AREVALO GONZALEZ,UNIDAD EDUCATIVA BOLIVARIANA PEDRO JOSE RODRIGUEZ,1365,3,28,1050,735,1022,0,4,0,0,283,1050
EDO. MIRANDA,MP. ACEVEDO,PQ. AREVALO GONZALEZ,UNIDAD EDUCATIVA CREACION EL CLAVO,213,1,3,140,112,137,0,0,0,0,25,140
EDO. MIRANDA,MP. ACEVEDO,PQ. AREVALO GONZALEZ,ESCUELA GRADUADA MERECURE REMOLINO,732,2,21,569,466,548,1,3,2,0,76,569
EDO. MIRANDA,MP. ACEVEDO,PQ. AREVALO GONZALEZ,CONCENTRACION  ESTADAL SIN NUMERO POTRERO RUBINO,155,1,4,114,53,110,0,0,2,0,55,114
EDO. MIRANDA,MP. ACEVEDO,PQ. AREVALO GONZALEZ,UNIDAD EDUCATIVA CABANO CARPIO,405,1,9,295,200,286,0,2,0,0,84,295
EDO. MIRANDA,MP. ACEVEDO,PQ. PANAQUIRE,CONCENTRACION ESTATAL NUMERO  23,213,1,1,143,92,142,1,2,0,0,47,143
EDO. MIRANDA,MP. ACEVEDO,PQ. PANAQUIRE,ESCUELA UNITARIA NACIONAL NUMERO  575,281,1,7,246,181,239,0,1,0,0,57,246
EDO. MIRANDA,MP. ACEVEDO,PQ. PANAQUIRE,UNIDAD EDUCATIVA NACIONAL BOLIVARIANA JOSE MARIA VARGAS,548,1,11,453,395,442,0,0,0,0,47,453
EDO. MIRANDA,MP. ACEVEDO,PQ. PANAQUIRE,UNIDAD EDUCATIVA LICEO BOLIVARIANO PANAQUIRE,298,1,1,245,204,244,0,2,0,0,38,245
EDO. MIRANDA,MP. ACEVEDO,PQ. PANAQUIRE,ESCUELA BASICA ESTADAL  CONCENTRADA EL SAPO BAMBU NUCLEO ESTUDIANTIL  RURAL 010,86,1,0,77,72,77,0,0,0,0,5,77
EDO. MIRANDA,MP. ACEVEDO,PQ. PANAQUIRE,CONCENTRACION ESTADAL NUMERO 3,169,1,1,114,95,113,0,0,0,0,18,114
EDO. MIRANDA,MP. ACEVEDO,PQ. PANAQUIRE,ESCUELA BASICA CREACION LA BALZA,557,1,20,447,333,427,0,1,0,0,93,447
EDO. MIRANDA,MP. ACEVEDO,PQ. PANAQUIRE,GRUPO ESCOLAR NACIONAL JOSE NICOMEDES MARRERO,2016,4,62,1551,849,1489,0,6,2,0,632,1551
EDO. MIRANDA,MP. ACEVEDO,PQ. PANAQUIRE,ESCUELA BASICA ESTADAL CONCENTRACION URBA NUCLEO ESCOLAR RURAL 010,118,1,2,100,81,98,0,0,0,0,17,100
EDO. MIRANDA,MP. ACEVEDO,PQ. PANAQUIRE,CONCENTRACION ESTADAL BOLIVARIANA MANGO DE OCOITA,343,1,4,274,247,270,0,1,1,0,21,274
EDO. MIRANDA,MP. ACEVEDO,PQ. PANAQUIRE,CONCENTRACION ESTATAL NUMERO 16,198,1,3,134,100,131,0,0,0,1,30,134
EDO. MIRANDA,MP. ACEVEDO,PQ. ARAGUITA,CONCENTRACION ESTADAL SIN NUMERO CUPATA,355,1,11,277,241,266,0,0,0,0,25,277
EDO. MIRANDA,MP. ACEVEDO,PQ. ARAGUITA,UNIDAD EDUCATIVA LA FILA,782,2,23,609,497,586,0,1,1,0,87,609
EDO. MIRANDA,MP. ACEVEDO,PQ. ARAGUITA,ESCUELA BASICA CONCENTRACION EL SOCORRO EL PEINE,150,1,7,133,105,126,0,2,0,0,19,133
EDO. MIRANDA,MP. ACEVEDO,PQ. ARAGUITA,UNIDAD EDUCATIVA JULIAN OJEDA,2051,4,34,1537,1045,1503,0,7,1,0,450,1537
EDO. MIRANDA,MP. ACEVEDO,PQ. ARAGUITA,ESCUELA BASICA ESTADAL CONCENTRACION EL LATON NUCLEO ENDOGENO RURAL 09,251,1,3,211,162,208,0,1,0,0,45,211
EDO. MIRANDA,MP. ACEVEDO,PQ. ARAGUITA,CONCENTRACION ESTATAL NUMERO 26 EL PEÑON,709,2,2,516,384,514,0,1,0,0,129,516
EDO. MIRANDA,MP. ACEVEDO,PQ. ARAGUITA,CONCENTRACION ESTADAL NUMERO 18 EL SOCORRO,598,1,10,405,307,395,1,1,1,0,85,405
EDO. MIRANDA,MP. ACEVEDO,PQ. MARIZAPA,ESCUELA ESTADAL GRADUADA DOCTOR ARNALDO AROCHA VARGAS,3511,6,150,2834,1762,2684,0,15,1,1,905,2834
EDO. MIRANDA,MP. ACEVEDO,PQ. MARIZAPA,CONCENTRACION ESTADAL SIN LOS COCOS,614,2,14,527,466,513,0,4,1,0,42,527
EDO. MIRANDA,MP. ACEVEDO,PQ. MARIZAPA,UNIDAD EDUCATIVA ARGELIA LAYA,732,2,24,601,395,577,1,1,0,1,179,601
EDO. MIRANDA,MP. ACEVEDO,PQ. MARIZAPA,ESCUELA BASICA ESTADAL CONCENTRADA  SIN NUMERO CUPO,792,2,11,674,557,663,0,2,0,0,104,674
EDO. MIRANDA,MP. ACEVEDO,PQ. CAUCAGUA,COLEGIO LA ENCARNACION,2110,4,35,1725,697,1690,1,11,1,0,980,1725
EDO. MIRANDA,MP. ACEVEDO,PQ. CAUCAGUA,ESCUELA BOLIVARIANA LA COTARA,966,2,13,837,664,824,0,9,1,2,148,837
EDO. MIRANDA,MP. ACEVEDO,PQ. CAUCAGUA,ESCUELA NACIONAL JOSE MARIA CARREÑO MENDOZA,495,1,11,403,303,392,0,2,0,0,87,403
EDO. MIRANDA,MP. ACEVEDO,PQ. CAUCAGUA,ESCUELA  BOLIVARIANA NACIONAL EL MARQUEZ,489,1,8,416,260,408,0,2,1,1,144,416
EDO. MIRANDA,MP. ACEVEDO,PQ. CAUCAGUA,CONCENTRACION ESTATAL NUMERO 25,1153,2,13,824,591,811,1,7,1,0,211,824
EDO. MIRANDA,MP. ACEVEDO,PQ. CAUCAGUA,UNIDAD EDUCATIVA ROSCIO,4792,9,105,3528,1786,3423,1,23,5,2,1606,3528
EDO. MIRANDA,MP. ACEVEDO,PQ. CAUCAGUA,ESCUELA BASICA ESTADAL CONCENTRADA LA CALIFORNIA NUCLEO ESCOLAR RURAL 011,169,1,8,138,104,130,0,1,0,0,25,138
EDO. MIRANDA,MP. ACEVEDO,PQ. CAUCAGUA,CONCENTRACION ESTATAL NUMERO 27 LOS CERRITOS,845,2,27,614,416,587,1,6,0,4,160,614
EDO. MIRANDA,MP. ACEVEDO,PQ. CAUCAGUA,CONCENTRACION ESTADAL NUMERO 4 CHUSPITA,1191,3,14,911,572,897,0,3,0,0,322,911
EDO. MIRANDA,MP. ACEVEDO,PQ. CAUCAGUA,ESCUELA BASICA ESTADAL CONCENTRADA LA BOCA NUCLEO ESCOLAR RURAL  013,232,1,4,206,193,202,0,0,0,0,9,206
EDO. MIRANDA,MP. ACEVEDO,PQ. CAUCAGUA,CONCENTRADA ESTADAL SIN NUMERO AGUA FRIA,436,1,12,303,249,291,0,2,0,0,40,303
EDO. MIRANDA,MP. ACEVEDO,PQ. CAUCAGUA,ESCUELA BASICA ESCOLAR  CONCENTRADA  SAN RAFAEL  NUCLEO ESCOLAR RURAL  011,261,1,5,235,201,230,0,1,1,0,27,235
EDO. MIRANDA,MP. ACEVEDO,PQ. CAUCAGUA,ESCUELA UNITARIA ESTADAL NUMERO 11,1043,2,30,828,578,798,0,4,0,0,216,828
EDO. MIRANDA,MP. ACEVEDO,PQ. CAUCAGUA,ESCUELA ESTADAL UNITARIA NUMERO 2316 MERCURE CENTRO,461,1,11,346,282,335,2,0,1,0,50,346
EDO. MIRANDA,MP. ACEVEDO,PQ. CAUCAGUA,UNIDAD EDUCATIVA RICARDA TOVAR,1039,2,16,836,704,820,0,2,0,0,114,836
EDO. MIRANDA,MP. ACEVEDO,PQ. CAUCAGUA,UNIDAD EDUCATIVA ALTAGRACIA,978,2,21,739,568,718,0,7,1,0,142,739
EDO. MIRANDA,MP. ACEVEDO,PQ. CAUCAGUA,UNIDAD EDUCATIVA MARIA ENRIQUETA SARRATUD,323,1,5,246,140,241,0,0,0,0,101,246
EDO. MIRANDA,MP. ACEVEDO,PQ. CAUCAGUA,UNIDAD EDUCATIVA BOLIVARIANA PANTOJA,1600,3,34,1261,753,1227,0,2,0,4,468,1261
EDO. MIRANDA,MP. ACEVEDO,PQ. CAUCAGUA,UNIDAD EDUCATIVA CAUCAGUA,466,1,9,334,211,325,0,0,0,1,113,334
EDO. MIRANDA,MP. ACEVEDO,PQ. RIBAS,CONCENTRACION ESTADAL SIN NUMERO EL PILAR,264,1,4,231,181,227,0,0,0,2,44,231
EDO. MIRANDA,MP. ACEVEDO,PQ. RIBAS,ESCUELA NUEVA ESPERANZA LOS ROSALES,175,1,0,116,103,116,0,0,0,0,13,116
EDO. MIRANDA,MP. ACEVEDO,PQ. RIBAS,CASA COMUNAL LA PUERTA,105,1,2,92,65,90,0,0,0,0,25,92
EDO. MIRANDA,MP. ACEVEDO,PQ. RIBAS,CASA DE LA CULTURA DE TAPIPA EL PUEBLO,100,1,2,82,45,80,0,0,0,0,35,82
EDO. MIRANDA,MP. ACEVEDO,PQ. RIBAS,ESCUELA BOLIVARIANA SIN NUMERO TAGUAY,255,1,1,188,156,187,1,1,0,0,29,188
EDO. MIRANDA,MP. ACEVEDO,PQ. RIBAS,ESCUELA BASICA ESTADAL CASUPITO,47,1,3,42,37,39,0,0,0,0,2,42
EDO. MIRANDA,MP. ACEVEDO,PQ. RIBAS,UNIDAD EDUCATIVA TAPIPA GRANDE,640,2,11,486,402,475,0,4,0,0,69,486
EDO. MIRANDA,MP. ACEVEDO,PQ. RIBAS,CONCENTRACION ESTADAL NUMERO 22 SANTA ANA,147,1,6,107,90,101,0,1,0,0,10,107
EDO. MIRANDA,MP. ACEVEDO,PQ. RIBAS,ESCUELA ESTADAL DEL CASERIO MACANILLA,481,1,7,318,259,311,0,0,0,0,52,318
EDO. MIRANDA,MP. ACEVEDO,PQ. RIBAS,CONCENTRADA ESTADAL NUMERO 24 EL JOVITO,31,1,1,18,14,17,0,0,0,0,3,18
EDO. MIRANDA,MP. ACEVEDO,PQ. RIBAS,ESCUELA BASICA ESTADAL CONCENTRADA  SAN JORGE NUCLEO ESCOLAR RURAL 013,93,1,0,79,43,79,0,1,0,1,34,79
EDO. MIRANDA,MP. ACEVEDO,PQ. RIBAS,ESCUELA BASICA CONCENTRACION LA MARINERA,633,2,5,426,364,421,0,0,1,0,56,426
EDO. MIRANDA,MP. ACEVEDO,PQ. RIBAS,ESCUELA BASICA ESTADAL  CONCENTRADA EL MILANO NUCLEO ESCOLAR RURAL 013,191,1,5,163,137,158,0,1,0,0,20,163
EDO. MIRANDA,MP. ACEVEDO,PQ. RIBAS,GRUPO ESCOLAR MARTIN HERNANDEZ BLANCO,1057,2,12,816,422,804,0,2,0,0,380,816
EDO. MIRANDA,MP. ACEVEDO,PQ. RIBAS,ESCUELA DEL CASERIO CAÑO NEGRO,521,1,3,418,255,415,0,3,0,0,157,418
EDO. MIRANDA,MP. ACEVEDO,PQ. RIBAS,CONCENTRACION ESTADAL NUMERO 24,279,1,1,155,137,154,0,0,1,0,16,155
EDO. MIRANDA,MP. ACEVEDO,PQ. RIBAS,ESCUELA UNITARIA ESTATAL NUMERO 16,204,1,4,146,117,142,0,0,0,0,25,146
EDO. MIRANDA,MP. ACEVEDO,PQ. RIBAS,ESCUELA UNITARIA ESTADAL SIN NUMERO,180,1,1,109,91,108,0,0,0,0,17,109
EDO. MIRANDA,MP. ACEVEDO,PQ. EL CAFE,CENTRO ESTADAL  SIN NUMERO FILA PEÑORAL,91,1,0,67,59,67,0,0,0,0,8,67
EDO. MIRANDA,MP. ACEVEDO,PQ. EL CAFE,UNIDAD EDUCATIVA ROSA HENRRIQUEZ DE BANDRES,1368,3,14,1034,704,1020,0,9,2,0,305,1034
EDO. MIRANDA,MP. ACEVEDO,PQ. EL CAFE,GRUPO ESCOLAR NARVARTE,1410,3,18,1084,755,1066,0,4,0,0,307,1084
EDO. MIRANDA,MP. ACEVEDO,PQ. EL CAFE,ESCUELA BOLIVARIANA QUEBRADA FOFA,539,1,11,392,314,381,0,0,0,0,67,392
EDO. MIRANDA,MP. ACEVEDO,PQ. EL CAFE,CONCENTRACION ESTADAL S N TOTUMITO,76,1,2,65,63,63,0,0,0,0,0,65
EDO. MIRANDA,MP. ACEVEDO,PQ. EL CAFE,ESCUELA CASERIO DE MACANILLA,360,1,9,264,204,255,0,1,0,0,50,264
EDO. MIRANDA,MP. ACEVEDO,PQ. EL CAFE,ESCUELA BASICA ESCOLAR  CONCENTRADA  ARAMINA EL LUCERO SEDE NUCLEO ESCOLAR RURAL  014,140,1,2,123,101,121,0,0,0,0,20,123
EDO. MIRANDA,MP. ACEVEDO,PQ. CAPAYA,CASA DE LA CULTURA,1884,4,72,1423,769,1351,0,5,1,0,576,1423
EDO. MIRANDA,MP. ACEVEDO,PQ. CAPAYA,UNIDAD EDUCATIVA ESCOLAR CARLOS EDUARDO RENGIFO,458,1,6,411,306,405,0,2,0,0,97,411
EDO. MIRANDA,MP. ACEVEDO,PQ. CAPAYA,CONCENTRACION ESTATAL NUMERO 8 LAS MOROCHAS,470,1,8,371,267,363,0,2,0,1,93,371
EDO. MIRANDA,MP. ACEVEDO,PQ. CAPAYA,ESCUELA BASICA ESTADAL CONCENTRADA  5 DE JULIO SEDE NUCLEO ESCOLAR REGIONAL  012,221,1,4,187,157,183,0,0,1,0,25,187
EDO. MIRANDA,MP. ACEVEDO,PQ. CAPAYA,CASA DE LOS ABUELOS FELIX EDMUNDO RONDON,763,2,25,531,353,506,0,2,1,0,150,531
EDO. MIRANDA,MP. ACEVEDO,PQ. CAPAYA,CONCENTRADA ESTADAL SIN NUMERO LA MARTURETERA,337,1,2,293,239,291,0,1,0,0,51,293
EDO. MIRANDA,MP. ACEVEDO,PQ. CAPAYA,CONCENTRACION ESTADAL  GUATIRITO,118,1,0,104,55,104,0,0,0,0,49,104
EDO. MIRANDA,MP. ACEVEDO,PQ. CAPAYA,UNIDAD EDUCATIVA CAPAYA,412,1,7,325,219,318,0,3,0,0,96,325
EDO. MIRANDA,MP. ACEVEDO,PQ. CAPAYA,CONCENTRACION NACIONAL NUMERO  68,826,2,22,650,416,628,0,2,1,1,208,650
EDO. MIRANDA,MP. ACEVEDO,PQ. CAPAYA,CONCENTRACION ESTADAL SIN NUMERO,222,1,5,164,123,159,0,3,0,0,33,164
EDO. MIRANDA,MP. ACEVEDO,PQ. CAPAYA,ESCUELA UNITARIA ESTATAL NUMERO 8,170,1,0,0,0,0,0,0,0,0,0,0
EDO. MIRANDA,MP. ACEVEDO,PQ. CAPAYA,ESCUELA BASICA ESTADAL  ARAMINA LA COROÑA NUCLE ESCOLAR RURAL  012,207,1,6,180,129,174,0,0,0,0,45,180
EDO. MIRANDA,MP. ACEVEDO,PQ. CAPAYA,CONCENTRACION NACIONAL SIN NUMERO,591,1,16,444,333,428,0,1,1,0,93,444
EDO. MIRANDA,MP. ACEVEDO,PQ. CAPAYA,UNIDAD  BASASICA  LA CARAMERA,1098,2,37,840,472,803,0,2,0,2,327,840
EDO. MIRANDA,MP. ACEVEDO,PQ. CAPAYA,ESCUELA BASICA ESTADAL AGUA AMARILLA  NUCLEO ESCOLAR RURAL 012,73,1,5,55,44,50,0,0,0,0,6,55
EDO. MIRANDA,CE. GUAICAIPURO,PQ. SAN PEDRO,CONCENTRACION RURAL BOLIVARIANA GARABATO,705,2,12,564,261,552,0,3,1,2,285,564
EDO. MIRANDA,CE. GUAICAIPURO,PQ. SAN PEDRO,UNIDAD EDUCATIVA JUAN DE DIOS GUANCHEZ,3266,6,70,2731,1209,2661,1,14,2,0,1435,2731
EDO. MIRANDA,CE. GUAICAIPURO,PQ. SAN PEDRO,UNIDAD EDUCATIVA NACIONAL BOLIVARIANA SAN PEDRO DE LOS ALTOS,2650,5,66,2176,1058,2110,1,6,2,1,1042,2176
EDO. MIRANDA,CE. GUAICAIPURO,PQ. SAN PEDRO,UNIDAD EDUCATIVA ESTADAL URQUIA,938,2,12,706,387,694,0,6,0,2,299,706
EDO. MIRANDA,CE. GUAICAIPURO,PQ. EL JARILLO,UNIDAD EDUCATIVA ESTADAL EL JARILLO,2320,4,61,1744,814,1683,2,6,0,1,860,1744
EDO. MIRANDA,CE. GUAICAIPURO,PQ. LOS TEQUES,CENTRO EDUCATIVO INTEGRAL CLARITA DE ALAYON,890,2,25,785,562,760,0,2,0,0,196,785
EDO. MIRANDA,CE. GUAICAIPURO,PQ. LOS TEQUES,UNIDAD EDUCATIVA ESTADAL OBDULIA DE ARRIOJAS,3170,6,68,2663,1720,2595,1,22,4,0,848,2663
EDO. MIRANDA,CE. GUAICAIPURO,PQ. LOS TEQUES,ESCUELA DE GUARDIAS NACIONALES CORONEL MARTIN BASTIDAS TORRES,2154,4,45,1425,1070,1380,1,3,0,1,305,1425
EDO. MIRANDA,CE. GUAICAIPURO,PQ. LOS TEQUES,UNIDAD EDUCATIVA NACIONAL BOLIVARIANA VICENTE SALIAS,1169,2,8,969,345,961,1,3,4,0,608,969
EDO. MIRANDA,CE. GUAICAIPURO,PQ. LOS TEQUES,UNIDAD EDUCATIVA ESTADAL TALLER GENERAL RAFAEL URDANETA,3106,6,54,2556,1160,2502,1,11,0,3,1327,2556
EDO. MIRANDA,CE. GUAICAIPURO,PQ. LOS TEQUES,UNIDAD EDUCATIVA ESTADAL BOLIVARIANA CAÑAOTE,391,1,8,346,292,338,0,0,0,0,46,346
EDO. MIRANDA,CE. GUAICAIPURO,PQ. LOS TEQUES,UNIDAD EDUCATIVA NACIONAL GUAICAIPURO,2914,5,45,2353,990,2308,1,7,0,1,1309,2353
EDO. MIRANDA,CE. GUAICAIPURO,PQ. LOS TEQUES,UNIDAD EDUCATIVA ESTADAL MONSEÑOR ARIAS BLANCO,3358,6,34,2778,1502,2744,3,15,0,2,1222,2778
EDO. MIRANDA,CE. GUAICAIPURO,PQ. LOS TEQUES,UNIDAD EDUCATIVA NACIONAL LUIS CORREA,4376,8,35,3686,1683,3651,0,15,1,6,1946,3686
EDO. MIRANDA,CE. GUAICAIPURO,PQ. LOS TEQUES,UNIDAD EDUCATIVA MANUEL DIAZ RODRIGUEZ,1110,2,13,951,423,938,0,2,0,2,511,951
EDO. MIRANDA,CE. GUAICAIPURO,PQ. LOS TEQUES,UNIDAD EDUCATIVA ESTADAL JUAN BAUTISTA ARISMENDI,2078,4,26,1824,910,1798,0,5,1,1,881,1824
EDO. MIRANDA,CE. GUAICAIPURO,PQ. LOS TEQUES,COLEGIO UNIVERSITARIO DE LOS TEQUES CECILIO ACOSTA,6024,11,112,4938,2200,4826,2,19,3,3,2599,4938
EDO. MIRANDA,CE. GUAICAIPURO,PQ. LOS TEQUES,INSTITUTO UNIVERSITARIO TECNICO DE ADMINISTRACION IUTA,2652,5,59,2283,971,2224,0,6,0,4,1243,2283
EDO. MIRANDA,CE. GUAICAIPURO,PQ. LOS TEQUES,TERMINAL DE PASAJEROS DE LOS TEQUES,1412,3,25,1160,636,1135,0,4,1,1,493,1160
EDO. MIRANDA,CE. GUAICAIPURO,PQ. LOS TEQUES,UNIDAD EDUCATIVA ESTADAL CRUZ DEL VALLE RODRIGUEZ,3580,7,51,2910,1880,2859,1,10,0,0,968,2910
EDO. MIRANDA,CE. GUAICAIPURO,PQ. LOS TEQUES,UNIDAD EDUCATIVA COLEGIO SAGRADA FAMILIA,1993,4,28,1707,666,1679,0,3,1,1,1008,1707
EDO. MIRANDA,CE. GUAICAIPURO,PQ. LOS TEQUES,UNIDAD EDUCATIVA ESTADAL BUENOS AIRES,521,1,6,482,321,476,0,0,1,1,153,482
EDO. MIRANDA,CE. GUAICAIPURO,PQ. LOS TEQUES,CICLO BASICO COMUN JULIO ROSALES,2385,5,32,1928,899,1896,0,6,1,2,988,1928
EDO. MIRANDA,CE. GUAICAIPURO,PQ. LOS TEQUES,UNIDAD EDUCATIVA ESTADAL ROMULO GALLEGOS,1496,3,24,1257,808,1233,2,4,3,0,416,1257
EDO. MIRANDA,CE. GUAICAIPURO,PQ. LOS TEQUES,UNIDAD EDUCATIVA ESTADAL TOMAS RAFAEL JIMENEZ,5071,9,105,4204,2021,4099,3,19,1,2,2053,4204
EDO. MIRANDA,CE. GUAICAIPURO,PQ. LOS TEQUES,CENTRO DE EDUCACION INICIAL NEGRA HIPOLITA,1932,4,22,1676,796,1654,1,8,1,0,848,1676
EDO. MIRANDA,CE. GUAICAIPURO,PQ. LOS TEQUES,CENTRO NACIONAL DE PROCESADOS MILITARES,521,1,5,272,157,267,0,2,1,0,107,272
EDO. MIRANDA,CE. GUAICAIPURO,PQ. LOS TEQUES,COLEGIO AMBROSIO PLAZA,2849,5,24,2409,700,2385,1,7,0,1,1676,2409
EDO. MIRANDA,CE. GUAICAIPURO,PQ. LOS TEQUES,LICEO SAN JOSE,1070,2,14,926,373,912,2,2,0,2,533,926
EDO. MIRANDA,CE. GUAICAIPURO,PQ. LOS TEQUES,UNIDAD EDUCATIVA NACIONAL BOLIVARIANA REPUBLICA DEL PARAGUAY,2759,5,26,2104,704,2078,0,3,1,1,1369,2104
EDO. MIRANDA,CE. GUAICAIPURO,PQ. LOS TEQUES,ESCUELA ESTADAL JOSE ANTONIO  RODRIGUEZ LOPEZ,3467,6,43,2906,1104,2863,0,13,1,1,1744,2906
EDO. MIRANDA,CE. GUAICAIPURO,PQ. LOS TEQUES,COLEGIO ILUSTRE AMERICANO,2355,4,32,2051,548,2019,3,4,0,0,1464,2051
EDO. MIRANDA,CE. GUAICAIPURO,PQ. LOS TEQUES,UNIVERSIDAD NACIONAL EXPERIMENTAL SIMON RODRIGUEZ,366,1,4,332,252,328,0,1,0,0,75,332
EDO. MIRANDA,CE. GUAICAIPURO,PQ. LOS TEQUES,LANEX,494,1,12,479,445,467,0,3,0,0,19,479
EDO. MIRANDA,CE. GUAICAIPURO,PQ. LOS TEQUES,AMBULATORIO DOCTOR ANGEL LARRALDE,1438,3,20,1217,592,1197,2,4,0,2,597,1217
EDO. MIRANDA,CE. GUAICAIPURO,PQ. LOS TEQUES,INSTITUTO NACIONAL DE ORIENTACION FEMENINA INOF,501,1,6,371,195,365,0,1,0,0,169,371
EDO. MIRANDA,CE. GUAICAIPURO,PQ. LOS TEQUES,UNIDAD EDUCATIVA ESTADAL RAMO VERDE,1735,3,41,1472,831,1431,0,15,2,2,581,1472
EDO. MIRANDA,CE. GUAICAIPURO,PQ. LOS TEQUES,UNIDAD EDUCATIVA NACIONAL CARMEN ROSALES GOMEZ,3966,7,69,3089,2053,3020,2,22,2,2,939,3089
EDO. MIRANDA,CE. GUAICAIPURO,PQ. LOS TEQUES,ESCUELA NACIONAL BOLIVARIANA EL VIGIA,3310,6,39,2837,1111,2798,0,20,1,3,1663,2837
EDO. MIRANDA,CE. GUAICAIPURO,PQ. LOS TEQUES,UNIDAD EDUCATIVA PRIVADA BELLA VISTA,457,1,3,411,216,408,0,2,0,0,190,411
EDO. MIRANDA,CE. GUAICAIPURO,PQ. LOS TEQUES,UNIADAD EDUCATIVA NACIONAL GUARENAS,2784,5,42,2262,1007,2220,1,12,0,1,1199,2262
EDO. MIRANDA,CE. GUAICAIPURO,PQ. LOS TEQUES,UNIDAD EDUCATIVA NACIONAL MANUEL CLEMENTE URBANEJA,4146,8,49,3391,1598,3342,3,11,1,4,1725,3391
EDO. MIRANDA,CE. GUAICAIPURO,PQ. LOS TEQUES,COLEGIO NUESTRA SEÑORA DEL CARMEN,161,1,1,142,65,141,0,1,0,0,75,142
EDO. MIRANDA,CE. GUAICAIPURO,PQ. LOS TEQUES,CASA DE LA CULTURA DEL PASO ALI LANDAETA,1526,3,23,1319,631,1296,2,7,0,2,654,1319
EDO. MIRANDA,CE. GUAICAIPURO,PQ. LOS TEQUES,UNIDAD EDUCATIVA ESTADAL OCUMARE DEL TUY,2174,4,21,1786,1165,1765,0,11,3,2,584,1786
EDO. MIRANDA,CE. GUAICAIPURO,PQ. LOS TEQUES,UNIDAD EDUCATIVA INSTITUTO PRIVADO BOYACA,1927,4,20,1652,420,1632,0,3,2,2,1205,1652
EDO. MIRANDA,CE. GUAICAIPURO,PQ. LOS TEQUES,UNIDAD EDUCATIVA NACIONAL DOCTOR SIMON BARRETO RAMOS,2567,5,70,2058,1321,1988,2,11,1,3,650,2058
EDO. MIRANDA,CE. GUAICAIPURO,PQ. LOS TEQUES,ATENEO LOS TEQUES ANTIGUA QUINTA SAN JOSE,2525,5,30,2076,936,2046,0,5,2,0,1103,2076
EDO. MIRANDA,CE. GUAICAIPURO,PQ. LOS TEQUES,INSTITUTO NACIONAL DE CAPACITACION Y EDUCACION SOCIALISTA,821,2,21,712,388,691,0,3,0,0,300,712
EDO. MIRANDA,CE. GUAICAIPURO,PQ. LOS TEQUES,UNIDAD EDUCATIVA COLEGIO JESUS DE NAZARET,518,1,4,489,122,485,0,1,0,1,361,489
EDO. MIRANDA,CE. GUAICAIPURO,PQ. LOS TEQUES,INTERNADO JUDICIAL DE LOS TEQUES,237,1,2,87,53,85,0,0,0,0,32,87
EDO. MIRANDA,CE. GUAICAIPURO,PQ. LOS TEQUES,UNIDAD EDUCATIVA  JOSE GREGORIO HERNANDEZ,2051,4,39,1731,1106,1692,1,4,1,4,576,1731
EDO. MIRANDA,CE. GUAICAIPURO,PQ. LOS TEQUES,ESCUELA NACIONAL TACATA,2212,4,47,1832,1018,1785,0,6,1,3,757,1832
EDO. MIRANDA,CE. GUAICAIPURO,PQ. LOS TEQUES,CENTRO DE EDUCACION INICIAL GABRIELA MISTRAL,1526,3,31,1315,742,1284,0,7,0,0,535,1315
EDO. MIRANDA,CE. GUAICAIPURO,PQ. LOS TEQUES,UNIDAD EDUCATIVA NACIONAL LICEO FRANCISCO DE MIRANDA,3235,6,51,2797,1078,2746,0,7,4,2,1655,2797
EDO. MIRANDA,CE. GUAICAIPURO,PQ. LOS TEQUES,UNIDAD EDUCATIVA ESTADAL EL NACIONAL,3301,6,53,2646,1963,2593,0,22,2,1,605,2646
EDO. MIRANDA,CE. GUAICAIPURO,PQ. LOS TEQUES,ESCUELA TECNICA COMERCIAL DOCTOR JESUS MUÑOZ TEBAR,226,1,4,197,86,193,0,0,0,0,107,197
EDO. MIRANDA,CE. GUAICAIPURO,PQ. LOS TEQUES,UNIDAD EDUCATIVA EL ENCANTO,2228,4,32,1928,833,1896,1,10,0,3,1049,1928
EDO. MIRANDA,CE. GUAICAIPURO,PQ. LOS TEQUES,UNIDAD EDUCATIVA  ESTADAL ANITA ESPINAL,2691,5,38,2321,864,2283,0,9,2,3,1405,2321
EDO. MIRANDA,CE. GUAICAIPURO,PQ. LOS TEQUES,CONCENTRACION RURAL BOLIVARIANA COLINA DEL ANGEL,889,2,22,742,482,720,1,4,2,0,231,742
EDO. MIRANDA,CE. GUAICAIPURO,PQ. LOS TEQUES,COLEGIO SAGRADO CORAZON DE JESUS,1207,3,25,1018,388,993,0,6,1,2,596,1018
EDO. MIRANDA,CE. GUAICAIPURO,PQ. LOS TEQUES,UNIDAD EDUCATIVA SAGRADO CORAZON DE JESUS II,194,1,2,173,99,171,0,1,1,0,70,173
EDO. MIRANDA,CE. GUAICAIPURO,PQ. LOS TEQUES,UNIDAD EDUCATIVA ANDRES ELOY BLANCO,1359,3,19,1101,829,1082,1,4,0,1,247,1101
EDO. MIRANDA,CE. GUAICAIPURO,PQ. LOS TEQUES,UNIDAD EDUCATIVA NACIONAL JESUS MARIA SIFONTES,2840,5,46,2207,649,2161,3,3,1,2,1503,2207
EDO. MIRANDA,CE. GUAICAIPURO,PQ. LOS TEQUES,UNIDAD EDUCATIVA ESATADAL DOCTOR FRANCISCO ESPEJO,3549,7,62,2999,1292,2937,0,7,0,3,1635,2999
EDO. MIRANDA,CE. GUAICAIPURO,PQ. LOS TEQUES,UNIDAD EDUCATIVA MARIA TERESA DE NEZER,407,1,8,378,147,370,0,0,0,0,223,378
EDO. MIRANDA,CE. GUAICAIPURO,PQ. LOS TEQUES,UNIDAD EDUCATIVA ESTADAL NICANOR BOLET PERAZA,980,2,27,829,544,802,0,3,0,0,255,829
EDO. MIRANDA,CE. GUAICAIPURO,PQ. LOS TEQUES,UNIDAD ESTADAL EDUCATIVA CECILIO ACOSTA 1,4091,8,81,3261,1672,3180,2,8,3,5,1490,3261
EDO. MIRANDA,CE. GUAICAIPURO,PQ. LOS TEQUES,CENTRO EDUCACION INICIAL NACIONAL BOLIVARIANA FILOMENA DE CORONEL,171,1,1,158,76,157,0,1,0,0,80,158
EDO. MIRANDA,CE. GUAICAIPURO,PQ. LOS TEQUES,UNIDAD EDUCATIVA ESTADAL JOSE MANUEL SISO MARTINEZ,2332,4,46,1871,1356,1825,1,4,3,0,461,1871
EDO. MIRANDA,CE. GUAICAIPURO,PQ. LOS TEQUES,UNIDAD EDUCATIVA INSTITUTO VICTEGUI,609,2,6,567,174,561,0,2,0,1,384,567
EDO. MIRANDA,CE. GUAICAIPURO,PQ. LOS TEQUES,COLEGIO NUESTRA SEÑORA DE FATIMA,2287,4,20,1964,1022,1944,0,9,1,3,909,1964
EDO. MIRANDA,CE. GUAICAIPURO,PQ. LOS TEQUES,UNIDAD EDUCATIVA NACIONAL PRESBITERO MANUEL CAÑIZALES,1446,3,40,1263,556,1223,0,8,0,1,658,1263
EDO. MIRANDA,CE. GUAICAIPURO,PQ. LOS TEQUES,UNIDAD EDUCATIVA ESTATAL BOLIVARIANA ESTADO SUCRE,1628,3,46,1317,820,1271,1,6,2,0,442,1317
EDO. MIRANDA,CE. GUAICAIPURO,PQ. LOS TEQUES,SEDE ADMINISTRATIVA DEL COLEGIO UNIVERSITARIO DE LOS TEQUES CECILIO ACOSTA,1822,4,14,1508,393,1494,0,6,0,2,1093,1508
EDO. MIRANDA,CE. GUAICAIPURO,PQ. LOS TEQUES,ESCUELA TECNICA INDUSTRIAL ROQUE PINTO,2741,5,49,2297,949,2248,2,11,0,6,1280,2297
EDO. MIRANDA,CE. GUAICAIPURO,PQ. LOS TEQUES,UNIDAD EDUCATIVA ESTADAL LUISA CACERES DE ARISMENDI,3143,6,31,2411,1689,2380,2,13,4,3,669,2411
EDO. MIRANDA,CE. GUAICAIPURO,PQ. LOS TEQUES,GRUPO ESCOLAR SIMON BOLIVAR,3725,7,61,3160,1683,3099,0,16,0,2,1398,3160
EDO. MIRANDA,CE. GUAICAIPURO,PQ. LOS TEQUES,UNIDAD EDUCATIVA COLEGIO PARROQUIAL SAN FELIPE NERY,1458,3,20,1373,494,1353,1,6,2,2,848,1373
EDO. MIRANDA,CE. GUAICAIPURO,PQ. ALTAGRACIA DE LA M,CONCENTRACION NACIONAL BOLIVARIANA LOS AMARILLOS,375,1,7,283,157,276,1,2,0,0,116,283
EDO. MIRANDA,CE. GUAICAIPURO,PQ. ALTAGRACIA DE LA M,CONCENTRACION BOLIVARIANA SAN DANIEL,456,1,22,357,186,335,0,1,0,0,148,357
EDO. MIRANDA,CE. GUAICAIPURO,PQ. ALTAGRACIA DE LA M,CONCENTRACION BOLIVARIANA EL CASCAJO,226,1,4,158,77,154,0,0,1,0,76,158
EDO. MIRANDA,CE. GUAICAIPURO,PQ. ALTAGRACIA DE LA M,UNIDAD EDUCATIVA ESTADAL EVARISTO GONZALEZ PALMA,1552,3,41,1219,761,1178,0,8,1,0,408,1219
EDO. MIRANDA,CE. GUAICAIPURO,PQ. TACATA,UNIDAD EDUCATIVA NACIONAL CALAZAN HERRERA,3028,6,44,2507,1653,2463,0,10,2,3,795,2507
EDO. MIRANDA,CE. GUAICAIPURO,PQ. CECILIO ACOSTA,UNIDAD EDUCATIVA NACIONAL RURAL NUESTRA SEÑORA DEL CARMEN,560,1,6,444,342,438,0,1,0,0,95,444
EDO. MIRANDA,CE. GUAICAIPURO,PQ. CECILIO ACOSTA,COLEGIO CECILIO ACOSTA DOS,2899,5,38,2362,657,2324,0,3,1,0,1663,2362
EDO. MIRANDA,CE. GUAICAIPURO,PQ. CECILIO ACOSTA,UNIDAD EDUCATIVA BOLIVARIAN RURAL EL NARANJAL,1289,3,14,1028,642,1014,1,1,1,3,366,1028
EDO. MIRANDA,CE. GUAICAIPURO,PQ. CECILIO ACOSTA,UNIDAD EDUCATIVA AGUA FRIA,935,2,18,784,583,766,0,7,0,1,175,784
EDO. MIRANDA,CE. GUAICAIPURO,PQ. CECILIO ACOSTA,GRUPO ESCOLAR SAN DIEGO DE ALCALA,3828,7,44,2982,1243,2938,0,13,3,1,1678,2982
EDO. MIRANDA,CE. GUAICAIPURO,PQ. CECILIO ACOSTA,CONCENTRACION SIN NUMERO GUAREGUARE NUCLEO ESCOLAR RURAL 05,822,2,20,627,360,607,0,7,0,1,239,627
EDO. MIRANDA,CE. GUAICAIPURO,PQ. CECILIO ACOSTA,ESCUELA MUNICIPAL RURAL AQUILES NAZOA,1133,2,7,934,572,927,0,4,1,0,350,934
EDO. MIRANDA,CE. GUAICAIPURO,PQ. CECILIO ACOSTA,MODULO BARRIO ADENTRO LOS OCUMITOS,229,1,6,213,186,207,0,0,0,0,21,213
EDO. MIRANDA,CE. GUAICAIPURO,PQ. PARACOTOS,CENTRO DE EDUCACION INICIAL ZOILA DE RINCON,288,1,4,257,182,253,0,1,0,0,70,257
EDO. MIRANDA,CE. GUAICAIPURO,PQ. PARACOTOS,CONCENTRACION ESTADAL RURAL SATUQUE,128,1,1,121,108,120,0,0,1,0,11,121
EDO. MIRANDA,CE. GUAICAIPURO,PQ. PARACOTOS,CASA DE LA CULTURA,826,2,23,721,517,698,0,1,1,0,179,721
EDO. MIRANDA,CE. GUAICAIPURO,PQ. PARACOTOS,ESCUELA BASICA ESTADAL CONCENTRADA EL HATO,160,1,5,145,92,140,0,1,0,0,47,145
EDO. MIRANDA,CE. GUAICAIPURO,PQ. PARACOTOS,UNIDAD EDUCATIVA ESTADAL BOLIVARIANA PALO NEGRO,728,2,8,552,353,544,0,3,1,0,187,552
EDO. MIRANDA,CE. GUAICAIPURO,PQ. PARACOTOS,ESCUELA ESTADAL ALEJANDRINA DE LUGO,1869,4,37,1542,838,1505,0,3,0,1,663,1542
EDO. MIRANDA,CE. GUAICAIPURO,PQ. PARACOTOS,GRUPO ESCOLAR PARACOTOS,3292,6,58,2612,1402,2554,0,8,5,1,1138,2612
EDO. MIRANDA,CE. GUAICAIPURO,PQ. PARACOTOS,UNIDAD EDUCATIVA NACIONAL BOLIVARIANA JOSE FELIX RIBAS,784,2,19,651,493,632,0,1,1,0,137,651
EDO. MIRANDA,CE. GUAICAIPURO,PQ. PARACOTOS,CONCENTRACION ESCOLAR NUMERO 38,407,1,5,314,142,309,0,2,1,2,162,314
EDO. MIRANDA,MP. PAEZ,PQ. RIO CHICO,CONCENTRACIÓN NACIONAL SIN NÚMERO,1172,2,13,987,748,974,0,4,1,0,221,987
EDO. MIRANDA,MP. PAEZ,PQ. RIO CHICO,CONCENTRACION  ESCOLAR NACIONAL NUMERO 79 NUCLEO NUMERO 18,1302,3,42,1082,678,1040,1,6,1,0,354,1082
EDO. MIRANDA,MP. PAEZ,PQ. RIO CHICO,CENTRO DE EDUCACIÓN INICIAL JOSÉ ANTONIO PÁEZ,1244,3,36,1009,499,973,0,2,1,0,471,1009
EDO. MIRANDA,MP. PAEZ,PQ. RIO CHICO,ESCUELA ESTADAL UNITARIA NUMERO 130,548,1,4,449,304,445,0,2,0,0,139,449
EDO. MIRANDA,MP. PAEZ,PQ. RIO CHICO,COLEGIO SAN PABLO DE LA CRUZ,828,2,29,695,343,666,0,1,0,0,322,695
EDO. MIRANDA,MP. PAEZ,PQ. RIO CHICO,CONCENTRACION ESCOLAR NUMERO 74,581,1,6,458,399,452,0,1,1,0,51,458
EDO. MIRANDA,MP. PAEZ,PQ. RIO CHICO,ESCUELA BÁSICA ESTADAL LOS CERROS,597,1,21,445,287,424,0,2,0,0,135,445
EDO. MIRANDA,MP. PAEZ,PQ. RIO CHICO,GRUPO ESCOLAR RAFAEL AREVALO GONZALEZ,2604,5,46,2057,967,2011,0,9,0,1,1034,2057
EDO. MIRANDA,MP. PAEZ,PQ. RIO CHICO,ESCUELA ESTADAL ANDRES BELLO,1304,3,44,1024,659,980,1,5,0,0,315,1024
EDO. MIRANDA,MP. PAEZ,PQ. RIO CHICO,CENTRO DE EDUCACION INICIAL LA VIRGINIA,484,1,12,406,253,394,0,0,0,0,141,406
EDO. MIRANDA,MP. PAEZ,PQ. RIO CHICO,UNIDAD EDUCATIVA 13 DE JUNIO,2279,4,61,1822,878,1761,2,2,1,1,877,1822
EDO. MIRANDA,MP. PAEZ,PQ. RIO CHICO,CONCENTRACION ESTADAL NUMERO 73,1021,2,14,842,564,828,0,3,0,0,261,842
EDO. MIRANDA,MP. PAEZ,PQ. EL GUAPO,CONCENTRACION NACIONAL NUMERO 31 CASERIO EL ROSARIO,577,1,4,447,369,443,0,3,0,0,71,447
EDO. MIRANDA,MP. PAEZ,PQ. EL GUAPO,UNIDAD EDUCATIVA AMELIA FERRER,909,2,12,735,550,723,0,3,0,1,169,735
EDO. MIRANDA,MP. PAEZ,PQ. EL GUAPO,ESCUELA RURAL UNITARIA,529,1,14,393,296,379,0,1,0,0,82,393
EDO. MIRANDA,MP. PAEZ,PQ. EL GUAPO,CONCENTRACIÓN ESTADAL BATATAL,187,1,3,122,83,119,0,1,0,0,35,122
EDO. MIRANDA,MP. PAEZ,PQ. EL GUAPO,CONCENTRACION ESTADADAL SIN NUMERO EL NISPERO,213,1,2,186,151,184,0,0,0,0,33,186
EDO. MIRANDA,MP. PAEZ,PQ. EL GUAPO,ESCUELA BOLIVARIANA FELIPE NERI,2405,5,41,1866,1256,1825,0,5,1,1,562,1866
EDO. MIRANDA,MP. PAEZ,PQ. EL GUAPO,ESCUELA UNITARIA NUMERO 76,279,1,1,229,191,228,0,1,0,0,36,229
EDO. MIRANDA,MP. PAEZ,PQ. EL GUAPO,CONCENTRACION ESTADAL BOLIVARIANA 128,149,1,2,142,112,140,0,0,1,0,27,142
EDO. MIRANDA,MP. PAEZ,PQ. EL GUAPO,CONCENTRACION ESTADAL BOLIVARIANA LOS MEDANOS,158,1,1,141,131,140,0,0,1,0,8,141
EDO. MIRANDA,MP. PAEZ,PQ. SN FERNANDO DEL GUAPO,GRUPO ESCOLAR NACIONAL PADRE SALDIVAR,1848,4,51,1453,921,1402,1,12,1,0,467,1453
EDO. MIRANDA,MP. PAEZ,PQ. SN FERNANDO DEL GUAPO,CONCENTRACION NACIONAL  NUMERO65 EL CRISTO,484,1,6,384,281,378,0,2,0,0,95,384
EDO. MIRANDA,MP. PAEZ,PQ.TACARIGUA DE LA LAGUNA,LICEO BOLIVARIANO ESTADAL DANILO ANDERSON,404,1,4,349,217,345,0,0,0,0,128,349
EDO. MIRANDA,MP. PAEZ,PQ.TACARIGUA DE LA LAGUNA,ESCUELA CONCENTRADA ESTADAL SIN NUMERO,1118,2,32,940,620,908,0,8,0,2,278,940
EDO. MIRANDA,MP. PAEZ,PQ.TACARIGUA DE LA LAGUNA,ESCUELA ESTADAL GRADUADA JUAN FRANCISCO DE LEON,1702,3,27,1376,622,1349,0,4,1,0,722,1376
EDO. MIRANDA,MP. PAEZ,PQ. PAPARO,CONCENTRACION NACIONAL NUMERO 24,1029,2,17,866,532,849,0,5,0,0,312,866
