Estado,Municipio,Parroquia,Centro,Número de Electores escrutados.,Número de Actas Procesadas.,Número total de Votos Nulos.,Número Total de Votantes que votaron realmente.,HUGO CHAVEZ,Número total de Votos Válidos.,ORLANDO CHIRINO,REINA SEQUERA,LUIS REYES,MARIA BOLIVAR,HENRIQUE CAPRILES RADONSKI,Número de Votos Escrutados.
EDO. MERIDA,CE. LIBERTADOR,PQ. ARIAS,UNIDAD EDUCATIVA TULIO FEBRES CORDERO,3007,6,41,2499,740,2458,0,12,0,1,1705,2499
EDO. MERIDA,CE. LIBERTADOR,PQ. ARIAS,COLEGIO NUESTRA SEÑORA DE BELEN,1400,3,29,1192,387,1163,0,5,0,0,771,1192
EDO. MERIDA,CE. LIBERTADOR,PQ. ARIAS,COLEGIO PRIVADO JARDIN FRANCISCANO,2954,6,81,2483,1205,2402,1,12,2,2,1180,2483
EDO. MERIDA,CE. LIBERTADOR,PQ. ARIAS,LICEO TULIO FEBRES CORDERO (B),480,1,8,413,158,405,1,5,0,2,239,413
EDO. MERIDA,CE. LIBERTADOR,PQ. ARIAS,ESCUELA BASICA NACIONAL RIVAS DAVILA,1102,2,8,911,335,903,1,0,0,0,567,911
EDO. MERIDA,CE. LIBERTADOR,PQ. ARIAS,UNIDAD EDUCATIVA EZEQUIEL ZAMORA,689,2,9,612,316,603,0,1,0,2,284,612
EDO. MERIDA,CE. LIBERTADOR,PQ. ARIAS,UNIDAD EDUCATIVA LA PUEBLITA,559,1,6,484,262,478,0,1,0,0,215,484
EDO. MERIDA,CE. LIBERTADOR,PQ. ARIAS,UNIDAD EDUC ELOY CHALBAUD,1992,4,32,1762,847,1730,0,3,1,1,878,1762
EDO. MERIDA,CE. LIBERTADOR,PQ. EL MORRO,ESCUELA ESTADAL NO 255,269,1,3,226,173,223,0,1,0,0,49,226
EDO. MERIDA,CE. LIBERTADOR,PQ. EL MORRO,ESCUELA BAS EST EL HATICO,82,1,3,59,49,56,0,0,0,0,7,59
EDO. MERIDA,CE. LIBERTADOR,PQ. EL MORRO,CONC AUGUSTO MALAVE VILLALBA,153,1,0,116,95,116,0,0,0,0,21,116
EDO. MERIDA,CE. LIBERTADOR,PQ. EL MORRO,GRUPO ESCOLAR JUAN DE DIOS DAVILA,795,2,13,642,356,629,0,1,0,0,272,642
EDO. MERIDA,CE. LIBERTADOR,PQ. EL MORRO,ESCUELA ESTADAL NO 384
EDO. MERIDA,CE. LIBERTADOR,PQ. CARACCIOLO PARRA P,ESCUELA BASICA FERMIN RUIZ VALERO B,1471,3,16,1331,289,1315,1,2,1,1,1021,1331
EDO. MERIDA,CE. LIBERTADOR,PQ. CARACCIOLO PARRA P,JARDIN DE INF ELOY PAREDES,1744,3,15,1548,288,1533,0,1,0,0,1244,1548
EDO. MERIDA,CE. LIBERTADOR,PQ. CARACCIOLO PARRA P,ESCUELA BASICA FERMIN RUIZ VALERO,3213,6,24,2767,662,2743,0,5,2,2,2072,2767
EDO. MERIDA,CE. LIBERTADOR,PQ. CARACCIOLO PARRA P,ESCUELA. BASICA. ELOY PAREDES,3269,6,37,2731,505,2694,1,7,1,3,2177,2731
EDO. MERIDA,CE. LIBERTADOR,PQ. CARACCIOLO PARRA P,ESCUELA BASICA ELOY PAREDES (B),1260,3,9,1144,258,1135,0,2,0,1,874,1144
EDO. MERIDA,CE. LIBERTADOR,PQ. LOS NEVADOS,ESCUELA ESTADAL NUMERO 152,619,2,15,476,350,461,0,0,0,0,111,476
EDO. MERIDA,CE. LIBERTADOR,PQ. GONZALO PICON FEBRES,ESCUELA MUNICIPAL MARIA ADELA DE VIELMA,865,2,30,755,334,725,0,3,0,0,388,755
EDO. MERIDA,CE. LIBERTADOR,PQ. GONZALO PICON FEBRES,ESCUELA ESTADAL NUMERO 398,616,2,9,536,238,527,0,0,0,0,289,536
EDO. MERIDA,CE. LIBERTADOR,PQ. GONZALO PICON FEBRES,UNIDAD EDUCATIVA VITALIA GUTIERREZ DE R,2329,4,33,1941,911,1908,3,7,0,0,987,1941
EDO. MERIDA,CE. LIBERTADOR,PQ. GONZALO PICON FEBRES,ESCUELA BASICA EL PLAYON NUMERO 94,1103,2,17,950,381,933,1,4,2,0,545,950
EDO. MERIDA,CE. LIBERTADOR,PQ. MILLA,UNIDAD EDUCATIVA DOCTOR RAMON REINOZO NUÑEZ (B),945,2,10,839,331,829,1,5,0,1,491,839
EDO. MERIDA,CE. LIBERTADOR,PQ. MILLA,COLEGIO SAN JOSE DE LA SIERRA,1388,3,18,1225,325,1207,2,3,0,2,875,1225
EDO. MERIDA,CE. LIBERTADOR,PQ. MILLA,ESCUELA BASICA CAMILO CONTRERAS,2571,5,53,2182,926,2129,0,7,0,0,1196,2182
EDO. MERIDA,CE. LIBERTADOR,PQ. MILLA,JARDIN DE INFANCIA VICENTE DAVILA,1026,2,7,865,339,858,0,6,0,1,512,865
EDO. MERIDA,CE. LIBERTADOR,PQ. MILLA,ESCUELA BASICA DOCTOR RAMON REINOSO NUEZ,3292,6,47,2766,1075,2719,1,16,1,0,1626,2766
EDO. MERIDA,CE. LIBERTADOR,PQ. MILLA,ESCUELA BASICA VICENTE DAVILA,3645,7,52,2897,900,2845,4,15,2,4,1920,2897
EDO. MERIDA,CE. LIBERTADOR,PQ. MILLA,LICEO ROMULO GALLEGOS,2246,4,20,1931,536,1911,1,3,0,2,1369,1931
EDO. MERIDA,CE. LIBERTADOR,PQ. MILLA,ESCUELA BASICA GLADYS C LOBO DE CARNEVALLI,2009,4,31,1681,564,1650,1,5,0,0,1080,1681
EDO. MERIDA,CE. LIBERTADOR,PQ. MILLA,UNIDAD EDUCATIVA COLEGIO SAGRADA FAMILIA
EDO. MERIDA,CE. LIBERTADOR,PQ. MARIANO PICON SALAS,ESCUELA BOLIVARIANA HUMBERTO TEJERA,3424,6,44,2996,781,2952,1,9,0,0,2161,2996
EDO. MERIDA,CE. LIBERTADOR,PQ. MARIANO PICON SALAS,ESCUELA DEPORTIVA,2863,5,26,2502,606,2476,2,9,1,2,1856,2502
EDO. MERIDA,CE. LIBERTADOR,PQ. MARIANO PICON SALAS,ESCUELA BASICA AMADO GONZALEZ,1522,3,21,1270,362,1249,1,4,0,0,882,1270
EDO. MERIDA,CE. LIBERTADOR,PQ. MARIANO PICON SALAS,LICEO EXPERIM FRAY J RAMOS DE LORA,1124,2,18,963,297,945,2,3,0,0,643,963
EDO. MERIDA,CE. LIBERTADOR,PQ. MARIANO PICON SALAS,UNID EDUC EL RINCON,820,2,10,705,343,695,0,0,0,0,352,705
EDO. MERIDA,CE. LIBERTADOR,PQ. EL LLANO,LICEO LIBERTADOR (B),2017,4,15,1745,523,1730,0,10,1,0,1196,1745
EDO. MERIDA,CE. LIBERTADOR,PQ. EL LLANO,UNIDAD EDUCATIVA NUESTRA SEÑORA  DE FATIMA,1650,3,13,1450,273,1437,0,1,1,2,1160,1450
EDO. MERIDA,CE. LIBERTADOR,PQ. EL LLANO,UNIDAD EDUCATIVA LA SALLE,3037,6,37,2535,571,2498,0,8,0,1,1918,2535
EDO. MERIDA,CE. LIBERTADOR,PQ. EL LLANO,UNIDAD EDUCATIVA. COLEGIO LA SALLE B,707,2,3,652,114,649,0,1,1,1,532,652
EDO. MERIDA,CE. LIBERTADOR,PQ. EL LLANO,LICEO NACIONAL LIBERTADOR,3914,7,45,3116,834,3071,1,10,1,1,2224,3116
EDO. MERIDA,CE. LIBERTADOR,PQ. DOMINGO PE#A,ESCUELA  BASICA GONZALO PICON FEBRES,1490,3,12,1268,396,1256,1,8,0,0,851,1268
EDO. MERIDA,CE. LIBERTADOR,PQ. DOMINGO PE#A,PRE ESCOLAR NIÑO SIMON,224,1,5,199,85,194,0,0,0,0,109,199
EDO. MERIDA,CE. LIBERTADOR,PQ. DOMINGO PE#A,DEPARTAMENTO DE EDUCACION PARA ADULTO,434,1,4,357,106,353,0,0,0,0,247,357
EDO. MERIDA,CE. LIBERTADOR,PQ. DOMINGO PE#A,ESCUELA BASICA NACIONAL JUAN RUIZ FAJARDO,3010,6,42,2623,860,2581,0,7,1,1,1712,2623
EDO. MERIDA,CE. LIBERTADOR,PQ. DOMINGO PE#A,ESCUELA TECNICA MANUEL ANTONIO PULIDO MENDEZ,3387,6,24,3018,920,2994,1,6,0,2,2065,3018
EDO. MERIDA,CE. LIBERTADOR,PQ. DOMINGO PE#A,UNIDAD  EDUCATIVA 5 DE JULIO,1706,3,17,1419,529,1402,1,4,0,1,867,1419
EDO. MERIDA,CE. LIBERTADOR,PQ. DOMINGO PE#A,ESCUELA  BASICA FILOMENA DAVILA,1954,4,27,1755,629,1728,0,8,1,2,1088,1755
EDO. MERIDA,CE. LIBERTADOR,PQ. DOMINGO PE#A,UNIDAD EDUCATIVA MARIA MOZZARELLO,1595,3,38,1436,619,1398,0,5,0,0,774,1436
EDO. MERIDA,CE. LIBERTADOR,PQ. DOMINGO PE#A,ESCUELA  BASICA 15 DE ENERO,937,2,14,845,433,831,0,4,1,1,392,845
EDO. MERIDA,CE. LIBERTADOR,PQ. DOMINGO PE#A,ESCUELA  BASICA RAFAEL ANTONIO GODOY,3037,6,36,2509,774,2473,2,8,1,3,1685,2509
EDO. MERIDA,CE. LIBERTADOR,PQ. DOMINGO PE#A,UNIDAD  EDUCATIVA ANTONIO N RANGEL,1497,3,19,1291,574,1272,0,6,0,0,692,1291
EDO. MERIDA,CE. LIBERTADOR,PQ. JACINTO PLAZA,GRUPO ESCOLAR EL EDUCADOR (B),435,1,2,372,220,370,0,1,0,0,149,372
EDO. MERIDA,CE. LIBERTADOR,PQ. JACINTO PLAZA,U.E. BOLIVARIANA MAHATMA GANDHI,455,1,9,395,280,386,0,3,0,0,103,395
EDO. MERIDA,CE. LIBERTADOR,PQ. JACINTO PLAZA,GRUPO ESCOLAR EL EDUCADOR,3755,7,67,3164,1493,3097,1,21,0,0,1582,3164
EDO. MERIDA,CE. LIBERTADOR,PQ. JACINTO PLAZA,ESC BAS JUAN DE ARCO,2882,5,52,2380,1256,2328,1,9,4,0,1058,2380
EDO. MERIDA,CE. LIBERTADOR,PQ. JACINTO PLAZA,ESCUELA BASICA GRADUADA SIMON RODRIGUEZ,3816,7,62,3087,1721,3025,1,12,4,2,1285,3087
EDO. MERIDA,CE. LIBERTADOR,PQ. JACINTO PLAZA,UNIDAD EDUCATIVASAN RAFAEL DEL CHAMA,287,1,4,265,178,261,0,1,0,0,82,265
EDO. MERIDA,CE. LIBERTADOR,PQ. JACINTO PLAZA,UNID EDUC ANDRES ELOY BLANCO,4399,8,75,3730,1831,3655,3,17,0,1,1803,3730
EDO. MERIDA,CE. LIBERTADOR,PQ. JACINTO PLAZA,UNIDAD EDUCATIVA JUANA DE ARCO (B),1421,3,24,1220,704,1196,0,1,3,0,488,1220
EDO. MERIDA,CE. LIBERTADOR,PQ. ANTONIO SPINETTI DINI,LICEO PRIVADO MONSEÑOR SILVA,4019,7,37,3360,751,3323,0,6,0,4,2562,3360
EDO. MERIDA,CE. LIBERTADOR,PQ. ANTONIO SPINETTI DINI,UNIDAD LARGA ESTANCIA,544,1,3,442,227,439,0,1,1,0,210,442
EDO. MERIDA,CE. LIBERTADOR,PQ. ANTONIO SPINETTI DINI,ESCUELA BASICA ELEAZAR LOPEZ CONTRERAS,2656,5,45,2237,712,2192,1,6,1,2,1470,2237
EDO. MERIDA,CE. LIBERTADOR,PQ. ANTONIO SPINETTI DINI,UNIDAD EDUCATIVA EMIRO FUENMAYOR,2799,5,47,2259,1091,2212,1,10,0,4,1106,2259
EDO. MERIDA,CE. LIBERTADOR,PQ. ANTONIO SPINETTI DINI,ESCUELA BASICA JOSEFA MOLINA DE DUQUE,2912,5,35,2488,778,2453,0,5,3,0,1667,2488
EDO. MERIDA,CE. LIBERTADOR,PQ. ANTONIO SPINETTI DINI,UNIDAD EDUCATIVA ALBERTO CARNEVALI,2038,4,29,1804,751,1775,1,3,0,1,1019,1804
EDO. MERIDA,CE. LIBERTADOR,PQ. ANTONIO SPINETTI DINI,ESCUELA BASICA DOÑA MARCOLINA DE LAMUS,1004,2,15,856,398,841,1,1,0,0,441,856
EDO. MERIDA,CE. LIBERTADOR,PQ. ANTONIO SPINETTI DINI,UNIDAD EDUCATIVA COLEGIO MADRE EMILIA,2166,4,10,1971,413,1961,0,3,0,0,1545,1971
EDO. MERIDA,CE. LIBERTADOR,PQ. ANTONIO SPINETTI DINI,ESCUELA TECNICA  ROBINSONIANA SIMON RODRIGUEZ,415,1,7,364,165,357,0,1,0,0,191,364
EDO. MERIDA,CE. LIBERTADOR,PQ. ANTONIO SPINETTI DINI,UNIDAD EDUCATIVA BASICA MONSEÑOR DOCTOR  SANTIAGO HERNANDEZ MILANEZ,1652,3,25,1415,643,1390,0,6,0,0,741,1415
EDO. MERIDA,CE. LIBERTADOR,PQ. JUAN RODRIGUEZ SUAREZ,CICLO BASICO CARACCIOLO PARRA OLMEDO,3539,7,34,2972,502,2938,1,7,1,2,2425,2972
EDO. MERIDA,CE. LIBERTADOR,PQ. JUAN RODRIGUEZ SUAREZ,ESCUELA BASICA CECILIO ACOSTA,1955,4,17,1711,290,1694,0,3,0,1,1400,1711
EDO. MERIDA,CE. LIBERTADOR,PQ. JUAN RODRIGUEZ SUAREZ,UNIDAD EDUCATIVA CARACIOLO PARRA Y OLMEDO (B),1325,3,12,1193,244,1181,2,3,1,1,930,1193
EDO. MERIDA,CE. LIBERTADOR,PQ. JUAN RODRIGUEZ SUAREZ,PRE ESCOLAR DON ANDRES BELLO,805,2,4,744,165,740,0,1,0,0,574,744
EDO. MERIDA,CE. LIBERTADOR,PQ. JUAN RODRIGUEZ SUAREZ,ESCUELA  BASICA ZUMBA,1578,3,23,1384,436,1361,1,5,1,0,918,1384
EDO. MERIDA,CE. LIBERTADOR,PQ. JUAN RODRIGUEZ SUAREZ,COLEGIO N SRA DEL ROSARIO,2163,4,21,1889,339,1868,0,3,1,2,1523,1889
EDO. MERIDA,CE. LIBERTADOR,PQ. JUAN RODRIGUEZ SUAREZ,GRUPO ESCOLAR ESTADO LARA,2353,4,16,2040,341,2024,0,3,1,0,1679,2040
EDO. MERIDA,CE. LIBERTADOR,PQ. LASSO DE LA VEGA,ESC BAS RAMON PARRA PICON,3300,6,40,2784,1053,2744,0,8,1,2,1680,2784
EDO. MERIDA,CE. LIBERTADOR,PQ. LASSO DE LA VEGA,UNIDAD EDUCATIVA RAMON IGNAGIO GUERRA (B),2253,4,35,2020,622,1985,1,8,1,0,1353,2020
EDO. MERIDA,CE. LIBERTADOR,PQ. LASSO DE LA VEGA,ESCUELA BASICA RAMON IGNACIO GUERRA.,3019,6,41,2560,763,2519,0,6,0,3,1747,2560
EDO. MERIDA,CE. LIBERTADOR,PQ. OSUNA RODRIGUEZ,ESCUELA BASICA LOS CUROS,3242,6,41,2709,1175,2668,2,8,1,0,1482,2709
EDO. MERIDA,CE. LIBERTADOR,PQ. OSUNA RODRIGUEZ,UNIDAD EDUCATIVA  BICENTENARIO DEL LIBERTADOR,866,2,14,778,403,764,0,5,0,0,356,778
EDO. MERIDA,CE. LIBERTADOR,PQ. OSUNA RODRIGUEZ,ESCUELA BASICA 10 DE DICIEMBRE,2139,4,37,1816,809,1779,0,5,2,0,963,1816
EDO. MERIDA,CE. LIBERTADOR,PQ. OSUNA RODRIGUEZ,UNIDAD EDUCATIVA ROMULO BETANCOURT B,804,2,11,712,334,701,0,3,1,0,363,712
EDO. MERIDA,CE. LIBERTADOR,PQ. OSUNA RODRIGUEZ,UNIDAD EDUCATIVA ROMULO BETANCOURT,2984,6,53,2579,1170,2526,0,7,1,0,1348,2579
EDO. MERIDA,CE. LIBERTADOR,PQ. OSUNA RODRIGUEZ,ESCUELA BASICA LOS CUROS (B),1919,4,32,1654,829,1622,0,2,1,1,789,1654
EDO. MERIDA,CE. LIBERTADOR,PQ. SAGRARIO,ESCUELA UNIDAD EDUCATIVA ESTADAL COROMOTO,2438,5,42,1981,618,1939,0,4,1,3,1313,1981
EDO. MERIDA,CE. LIBERTADOR,PQ. SAGRARIO,ESCUELA BASICA  GABRIEL PICON GONZALEZ,2773,5,31,2274,597,2243,0,8,1,2,1635,2274
EDO. MERIDA,MP. PUEBLO LLANO,CM. PUEBLO LLANO,ESCUELA BOLIVARIANA ADELA BASTIDAS,180,1,2,166,103,164,0,0,0,0,61,166
EDO. MERIDA,MP. PUEBLO LLANO,CM. PUEBLO LLANO,ESCUELA BASICA BOLIVARIANA  FOCION F CORDERO,2751,5,45,2272,1004,2227,1,6,0,0,1216,2272
EDO. MERIDA,MP. PUEBLO LLANO,CM. PUEBLO LLANO,UNIDAD EDUCATIVA BOLIVARIANA MUTUS,1143,2,19,983,472,964,0,1,0,0,491,983
EDO. MERIDA,MP. PUEBLO LLANO,CM. PUEBLO LLANO,UNIDAD EDUCATIVA LA CULATA,1412,3,27,1169,658,1142,0,5,0,0,479,1169
EDO. MERIDA,MP. PUEBLO LLANO,CM. PUEBLO LLANO,UNIDAD DUCATIVA BOLIVARIANA MIYOY,125,1,3,116,73,113,0,0,0,0,40,116
EDO. MERIDA,MP. PUEBLO LLANO,CM. PUEBLO LLANO,ESCUELA BOLIVARIANA LA CAPELLANIA,1538,3,17,1256,707,1239,0,1,1,0,530,1256
EDO. MERIDA,MP.OB. RAMOS DE LORA,PQ. PQ R DE ALCAZAR,ESC BAS CONC MIXTA MATA DE COCO,887,2,8,674,406,666,0,2,0,0,258,674
EDO. MERIDA,MP.OB. RAMOS DE LORA,PQ. PQ R DE ALCAZAR,UNIDAD EDUCATIVA BOLIVARIANA PUEBLO NUEVO 1,141,1,1,127,86,126,0,1,0,0,39,127
EDO. MERIDA,MP.OB. RAMOS DE LORA,PQ. PQ R DE ALCAZAR,UNIDAD EDUCATIVA LA PROVIDENCIA,522,1,9,380,231,371,0,1,0,0,139,380
EDO. MERIDA,MP.OB. RAMOS DE LORA,PQ. PQ R DE ALCAZAR,ESC BAS COMB GUACHIZON II,651,2,6,509,263,503,0,2,1,0,237,509
EDO. MERIDA,MP.OB. RAMOS DE LORA,PQ. PQ R DE ALCAZAR,ESCUELA BASICA SAN RAFAEL DE ALCAZAR,1670,3,27,1306,815,1279,0,1,0,0,463,1306
EDO. MERIDA,MP.OB. RAMOS DE LORA,CM. STA ELENA DE ARENALES,INSTITUTO DE EDUCACION ESPECIAL BOLIVARIANO IROSKA APOLINAR DE PORRAS,348,1,6,288,191,282,0,2,0,0,89,288
EDO. MERIDA,MP.OB. RAMOS DE LORA,CM. STA ELENA DE ARENALES,UNIDAD EDUCATIVA BOLIVARIANA CAPAZON ARRIBA,707,2,8,554,340,546,0,1,0,0,205,554
EDO. MERIDA,MP.OB. RAMOS DE LORA,CM. STA ELENA DE ARENALES,UNIDAD EDUCATIVA BOLIVARIANA MARIA DE JESUS NOGUERA DE TORRES,399,1,4,306,203,302,0,0,1,0,98,306
EDO. MERIDA,MP.OB. RAMOS DE LORA,CM. STA ELENA DE ARENALES,UNIDAD EDUCATIVA J J OSUNA RODRIGUEZ,1519,3,23,1291,674,1268,0,8,0,3,583,1291
EDO. MERIDA,MP.OB. RAMOS DE LORA,CM. STA ELENA DE ARENALES,ESCUELA BOLIVARIANA MARIA TERESA DEL TORO,308,1,8,283,222,275,0,0,0,0,53,283
EDO. MERIDA,MP.OB. RAMOS DE LORA,CM. STA ELENA DE ARENALES,ESCUELA ESTADAL SANTA ELENA ABAJO,205,1,1,186,172,185,0,0,0,0,13,186
EDO. MERIDA,MP.OB. RAMOS DE LORA,CM. STA ELENA DE ARENALES,ESCUELA BASICA DOCTOR MARIANO UZCATEGUI,2534,5,31,2060,1018,2029,0,5,1,0,1005,2060
EDO. MERIDA,MP.OB. RAMOS DE LORA,CM. STA ELENA DE ARENALES,ESCUELA NACIONAL NO 1427,678,2,5,555,319,550,0,2,0,0,229,555
EDO. MERIDA,MP.OB. RAMOS DE LORA,CM. STA ELENA DE ARENALES,NER 109,1044,2,6,795,564,789,0,7,1,0,217,795
EDO. MERIDA,MP.OB. RAMOS DE LORA,CM. STA ELENA DE ARENALES,ESC BAS CONC MIXTA,884,2,10,707,323,697,0,1,0,0,373,707
EDO. MERIDA,MP.OB. RAMOS DE LORA,CM. STA ELENA DE ARENALES,UNIDAD EDUCATIVA COLEGIO CRISTO REY,833,2,15,716,427,701,0,5,0,0,269,716
EDO. MERIDA,MP.OB. RAMOS DE LORA,PQ. ELOY PAREDES,UNIDAD EDUCATIVA BOLIVARIANA ANTONIO VERDI,788,2,2,640,413,638,0,6,0,0,219,640
EDO. MERIDA,MP.OB. RAMOS DE LORA,PQ. ELOY PAREDES,LICEO CARLOS ERNESTO MORALES,604,2,11,506,305,495,0,1,0,0,189,506
EDO. MERIDA,MP.OB. RAMOS DE LORA,PQ. ELOY PAREDES,UNIDAD EDUCATIVA DON PEDRO JESUS PINO,2166,4,23,1772,944,1749,0,14,2,1,788,1772
EDO. MERIDA,MP.OB. RAMOS DE LORA,PQ. ELOY PAREDES,UNIDAD EDUCATIVA BOLIVARIANA CAÑO RICO,695,2,6,561,368,555,0,2,0,0,185,561
EDO. MERIDA,MP.OB. RAMOS DE LORA,PQ. ELOY PAREDES,UNIDAD EDUCATIVA BOLIVARIANA CANO OBISPO,88,1,1,82,57,81,0,0,0,0,24,82
EDO. MERIDA,MP.OB. RAMOS DE LORA,PQ. ELOY PAREDES,ESCUELA ESTADAL CANO RICITO,119,1,0,107,97,107,0,0,0,0,10,107
EDO. MERIDA,MP.OB. RAMOS DE LORA,PQ. ELOY PAREDES,UNIDAD EDUCATIVA BOLIVARIANA EL CRUCERO,278,1,3,190,132,187,0,0,0,0,55,190
EDO. MERIDA,MP.OB. RAMOS DE LORA,PQ. ELOY PAREDES,ESCUELA BOLIVARIANA LOMA DE PIEDRA,436,1,3,358,206,355,0,1,0,0,148,358
EDO. MERIDA,MP. SUCRE,PQ. CHIGUARA,UNIDAD EDUCATIVA LLANO EL ANIS,885,2,27,760,459,733,0,3,0,0,271,760
EDO. MERIDA,MP. SUCRE,PQ. CHIGUARA,ESC BAS NAC 242 SAN JOSE,241,1,2,190,161,188,0,0,0,0,27,190
EDO. MERIDA,MP. SUCRE,PQ. CHIGUARA,GRUPO ESCOLAR ESTADO NUEVA ESPARTA,3205,6,71,2597,1183,2526,1,4,1,1,1336,2597
EDO. MERIDA,MP. SUCRE,PQ. CHIGUARA,UNIDAD EDUCATIVA LICEO BOLIVARIANO FRANCISCO A UZCATEGUI,266,1,5,238,119,233,0,0,0,0,114,238
EDO. MERIDA,MP. SUCRE,PQ. CHIGUARA,ES EST BAS EL REMOLINO,454,1,4,337,246,333,0,4,2,0,81,337
EDO. MERIDA,MP. SUCRE,PQ. CHIGUARA,ESCUELA ESTADAL BASICA NUMERO 1294,153,1,4,98,82,94,0,0,0,0,12,98
EDO. MERIDA,MP. SUCRE,PQ. CHIGUARA,U E AGUA LINDA,401,1,5,342,215,337,0,0,0,0,122,342
EDO. MERIDA,MP. SUCRE,PQ. CHIGUARA,ESCUELA ESTADAL EL VERDE,185,1,2,134,45,132,0,0,0,0,87,134
EDO. MERIDA,MP. SUCRE,PQ. PUEBLO NUEVO DEL SUR,ESCUELA ESTADAL BOLIVARIANA LOS AMARILLOS,580,1,5,422,292,417,0,1,1,0,123,422
EDO. MERIDA,MP. SUCRE,PQ. PUEBLO NUEVO DEL SUR,ESCUELA NACIONAL UNITARIA NO 1273,165,1,2,98,72,96,0,0,1,0,23,98
EDO. MERIDA,MP. SUCRE,PQ. PUEBLO NUEVO DEL SUR,ESCUELA ESTADAL BOLIVARIANA EL HORCAZ,139,1,1,128,90,127,0,2,0,0,35,128
EDO. MERIDA,MP. SUCRE,PQ. PUEBLO NUEVO DEL SUR,UNIDAD EDUCATIVA GENARINA DUGARTE C,870,2,8,636,322,628,0,3,0,2,301,636
EDO. MERIDA,MP. SUCRE,PQ. PUEBLO NUEVO DEL SUR,ESCUELA CONCENTRADA MIXTA,246,1,2,174,111,172,0,0,0,0,61,174
EDO. MERIDA,MP. SUCRE,PQ. PUEBLO NUEVO DEL SUR,UNIDAD EDUCATIVA BOLIVARIANA EL CAMBUR 2380,294,1,2,218,215,216,0,0,0,0,1,218
EDO. MERIDA,MP. SUCRE,PQ. PUEBLO NUEVO DEL SUR,UNIDAD EDUCATIVA LA AGUADA,131,1,0,90,82,90,0,0,0,0,8,90
EDO. MERIDA,MP. SUCRE,PQ. PUEBLO NUEVO DEL SUR,ESCUELA ESTADAL NO 126,229,1,2,190,165,188,0,0,0,0,23,190
EDO. MERIDA,MP. SUCRE,CM. LAGUNILLAS,UNIDA EDUCATIVA BOLIVARAIANA EL MOLINO,2310,4,25,1881,1104,1856,0,9,0,0,743,1881
EDO. MERIDA,MP. SUCRE,CM. LAGUNILLAS,U.E.COLEGIO CIUDAD DE LAGUNILLAS,1877,4,43,1504,721,1461,1,6,1,1,731,1504
EDO. MERIDA,MP. SUCRE,CM. LAGUNILLAS,ESC BASICA MANUEL GUAL,3124,6,49,2597,1363,2548,1,10,0,1,1173,2597
EDO. MERIDA,MP. SUCRE,CM. LAGUNILLAS,LICEO BOLIVARIANO LUIS E MARQUEZ B,2598,5,32,2045,1002,2013,2,9,1,1,998,2045
EDO. MERIDA,MP. SUCRE,CM. LAGUNILLAS,ESCUELA BASICA UNIDAD EDUCATIVA LOS ARAQUES,608,2,11,495,322,484,0,2,0,0,160,495
EDO. MERIDA,MP. SUCRE,CM. LAGUNILLAS,ESCUELA BASICA MANUEL GUAL (B),1214,3,17,1019,582,1002,0,3,1,1,415,1019
EDO. MERIDA,MP. SUCRE,CM. LAGUNILLAS,UNIDAD EDUCATIVA FERMIN TORO,766,2,12,684,486,672,0,3,0,0,183,684
EDO. MERIDA,MP. SUCRE,CM. LAGUNILLAS,JARDIN INFANCIA MANUEL GUAL ANEXO SAN MARTIN,400,1,5,339,266,334,0,1,0,0,67,339
EDO. MERIDA,MP. SUCRE,CM. LAGUNILLAS,ESCUELA BASICA ESTADAL UNITARIA LOS UVITOS,225,1,3,124,83,121,0,0,0,0,38,124
EDO. MERIDA,MP. SUCRE,CM. LAGUNILLAS,UNIDAD EDUCATIVA BOLIVARIANA 24 DE JUNIO,891,2,28,788,435,760,0,8,0,1,316,788
EDO. MERIDA,MP. SUCRE,PQ. SAN JUAN,INTERNADO JUDICIAL,164,1,1,45,31,44,0,0,0,0,13,45
EDO. MERIDA,MP. SUCRE,PQ. SAN JUAN,JARDIN DE INFANCIA ESTADO PORTUGUESA,221,1,2,191,126,189,0,0,0,0,63,191
EDO. MERIDA,MP. SUCRE,PQ. SAN JUAN,PRE ESCOLAR VILLA LIBERTAD,596,1,9,506,278,497,0,2,0,0,217,506
EDO. MERIDA,MP. SUCRE,PQ. SAN JUAN,E.B. ESTADO PORTUGUESA B,619,2,16,536,302,520,0,3,0,0,215,536
EDO. MERIDA,MP. SUCRE,PQ. SAN JUAN,UNIDAD EDUCATIVA FRANCISCO DE MIRANDA,671,2,27,602,385,575,0,4,0,0,186,602
EDO. MERIDA,MP. SUCRE,PQ. SAN JUAN,U E OBISPO ARIAS,522,1,13,436,235,423,0,1,0,0,187,436
EDO. MERIDA,MP. SUCRE,PQ. SAN JUAN,ESCUELA BASICA ESTADAL PORTUGUESA (B),1776,3,29,1524,877,1495,0,11,0,0,607,1524
EDO. MERIDA,MP. SUCRE,PQ. SAN JUAN,ESCUELA BASICA ESTADO PORTUGUESA,2838,5,41,2188,1200,2147,0,10,2,1,934,2188
EDO. MERIDA,MP. SUCRE,PQ. ESTANQUES,ESC BAS EST NO 246,419,1,8,338,160,330,2,1,0,0,167,338
EDO. MERIDA,MP. SUCRE,PQ. ESTANQUES,ESCUELA ESTADAL BASICA 1133 RINCON DEL PALMAR,336,1,0,225,199,225,0,0,0,0,26,225
EDO. MERIDA,MP. SUCRE,PQ. ESTANQUES,ESCUELA ESTADAL NUMERO 107,286,1,1,205,173,204,0,0,0,0,31,205
EDO. MERIDA,MP. SUCRE,PQ. ESTANQUES,UNIDAD EDUCATIVA SANTO DOMINGO,151,1,1,131,94,130,0,0,0,0,36,131
EDO. MERIDA,MP. SUCRE,PQ. ESTANQUES,CONCENTRACION ESCOLAR ESTANQUEZ,995,2,14,793,424,779,0,3,0,0,352,793
EDO. MERIDA,MP. SUCRE,PQ. ESTANQUES,ESCUELA ESTADAL LAS LABRANZAS NUMERO 058,204,1,3,153,111,150,0,1,0,0,38,153
EDO. MERIDA,MP. SUCRE,PQ. ESTANQUES,ESCUELA ESTADAL EL HATO,329,1,3,264,123,261,0,4,0,0,134,264
EDO. MERIDA,MP. SUCRE,PQ. ESTANQUES,ESCUELA ESTADAL SAN ANTONIO,211,1,5,171,139,166,0,0,0,0,27,171
EDO. MERIDA,MP. SUCRE,PQ. ESTANQUES,ESCUELA ESTADAL SAN PABLO ALTO,206,1,5,152,112,147,0,0,0,0,35,152
EDO. MERIDA,MP. SUCRE,PQ. LA TRAMPA,ESC BAS ESTADAL NO 51,377,1,6,256,184,250,0,2,0,0,64,256
EDO. MERIDA,MP. SUCRE,PQ. LA TRAMPA,UNIDAD EDUCATIVA LA TRAMPA,500,1,3,374,209,371,0,2,2,0,158,374
EDO. MERIDA,MP. SUCRE,PQ. LA TRAMPA,ESC BASICA ESTADAL NO 441,373,1,2,273,229,271,0,2,2,0,38,273
EDO. MERIDA,MP. SUCRE,PQ. LA TRAMPA,ESCUELA BASICA EL ESTANQUILLO,189,1,5,139,90,134,0,0,0,0,44,139
EDO. MERIDA,MP. SUCRE,PQ. LA TRAMPA,ESCUELA BASICA ESTADAL BELEN,133,1,2,107,51,105,0,0,0,0,54,107
EDO. MERIDA,MP. SUCRE,PQ. LA TRAMPA,ESCUELA BASICA ESTADAL NO 174,148,1,7,103,81,96,0,1,0,0,14,103
EDO. MERIDA,MP. MIRANDA,PQ. PI#ANGO,UNIDAD EDUCATIVA BOLIVARIANA DR IGNACIO FERNANDEZ PENA,524,1,6,449,227,443,0,3,0,0,213,449
EDO. MERIDA,MP. MIRANDA,PQ. PI#ANGO,UNIDAD EDUCATIVA EL ARBOLITO,259,1,3,216,180,213,0,0,0,0,33,216
EDO. MERIDA,MP. MIRANDA,PQ. PI#ANGO,ESCUELA ESTADAL NO 108,164,1,1,136,96,135,1,0,0,0,38,136
EDO. MERIDA,MP. MIRANDA,PQ. PI#ANGO,ESCUELA LAS TAPIAS,135,1,4,119,41,115,0,0,0,1,73,119
EDO. MERIDA,MP. MIRANDA,PQ. LA VENTA,UNIDAD EDUCATIVA BOLIVARIANA LA VENTA,950,2,17,794,309,777,0,7,0,0,461,794
EDO. MERIDA,MP. MIRANDA,PQ. LA VENTA,ESCUELA ESTADAL BOLIVARIANA CRUZ CHIQUITA,307,1,8,239,116,231,0,1,0,0,114,239
EDO. MERIDA,MP. MIRANDA,PQ. ANDRES ELOY BLANCO,UNIDAD EDUCATIVA EMILIO MALDONADO,1594,3,33,1242,554,1209,0,10,1,1,643,1242
EDO. MERIDA,MP. MIRANDA,CM. CHACHOPO,ESCUELA BASICA FILOMENA RUIZ DE RODRIGUEZ,2360,4,37,2051,924,2014,0,5,0,1,1084,2051
EDO. MERIDA,MP. MIRANDA,CM. CHACHOPO,UNIDAD EDUCATIVA FRANCISCO DE PAULA ANDRADE,2414,5,71,2057,866,1986,0,7,1,0,1112,2057
EDO. MERIDA,MP. MIRANDA,CM. CHACHOPO,ESCUELA ESTADAL TAFALLEZ,288,1,4,257,177,253,0,0,0,0,76,257
EDO. MERIDA,MP. MIRANDA,CM. CHACHOPO,GRUPO ESCOLAR CANONIGO UZCATEGUI,2515,5,56,2033,1019,1977,0,6,0,1,951,2033
EDO. MERIDA,MP. MIRANDA,CM. CHACHOPO,UNIDAD EDUCATIVA LA JOYA,658,2,13,551,223,538,0,4,2,0,309,551
EDO. MERIDA,MP. MIRANDA,CM. CHACHOPO,ESCUELA NACIONAL BOLIVARIANA LAS MESAS,280,1,3,237,88,234,0,0,0,0,146,237
EDO. MERIDA,MP. MIRANDA,CM. CHACHOPO,UNIDAD EDUCATIVA LA VEGA,199,1,2,180,134,178,1,0,1,1,41,180
EDO. MERIDA,MP. MIRANDA,CM. CHACHOPO,ESCUELA ESTADAL BOLIVARIANA MESA CERRADA,749,2,15,656,438,641,1,3,2,0,197,656
EDO. MERIDA,MP. MIRANDA,CM. CHACHOPO,ESCUELA  ESTADAL SANTA CRUZ DE TAFALLEZ,187,1,5,133,94,128,0,1,0,0,33,133
EDO. MERIDA,MP. MIRANDA,CM. CHACHOPO,UNIDAD EDUCATIVA NACIONAL CHIJOS,1300,3,32,1139,663,1107,1,4,1,0,438,1139
EDO. MERIDA,MP.JULIO CESAR SALAS,PQ. PALMIRA,ESCUELA PRIMARIA ESTADAL EL CERRO,703,2,3,547,299,544,0,2,0,0,243,547
EDO. MERIDA,MP.JULIO CESAR SALAS,PQ. PALMIRA,UNIDAD EDUCATIVA PALMIRA,1057,2,8,859,562,851,0,3,0,0,286,859
EDO. MERIDA,MP.JULIO CESAR SALAS,PQ. PALMIRA,UNIDAD EDUCATIVA PALMIRA B,159,1,1,140,92,139,0,0,0,0,47,140
EDO. MERIDA,MP.JULIO CESAR SALAS,CM. ARAPUEY,INSTITUTO DE EDUCACION ESPECIAL ARAPUEY,1230,3,42,944,601,902,0,0,1,0,300,944
EDO. MERIDA,MP.JULIO CESAR SALAS,CM. ARAPUEY,ESCUELA ESTADAL LA ARENOSA,171,1,3,149,121,146,0,1,0,0,24,149
EDO. MERIDA,MP.JULIO CESAR SALAS,CM. ARAPUEY,ESCUELA ESTADAL SAN MIGUEL,899,2,15,699,402,684,0,2,0,0,280,699
EDO. MERIDA,MP.JULIO CESAR SALAS,CM. ARAPUEY,ESCUELA PRIMARIA ROBERTO PICON LARES,2480,5,24,1765,1071,1741,0,5,0,0,665,1765
EDO. MERIDA,MP.JULIO CESAR SALAS,CM. ARAPUEY,ESCUELA ESTADAL EL POCO,160,1,5,137,107,132,0,1,0,0,24,137
EDO. MERIDA,MP.JULIO CESAR SALAS,CM. ARAPUEY,LICEO BOLIVARIANO ROBERTO PICON LARES,1285,3,21,1039,681,1018,0,6,0,0,331,1039
EDO. MERIDA,MP.JULIO CESAR SALAS,CM. ARAPUEY,ESCUELA ESTADAL EL QUINCE,778,2,15,576,423,561,0,3,0,0,135,576
EDO. MERIDA,MP.JULIO CESAR SALAS,CM. ARAPUEY,ESCUELA ESTADAL BOLIVARIANA 23 DE ENERO,656,2,8,518,329,510,1,0,0,0,180,518
EDO. MERIDA,MP.JULIO CESAR SALAS,CM. ARAPUEY,ESCUELA ESTADAL LA ALCABALA,285,1,3,251,175,248,1,1,0,0,71,251
EDO. MERIDA,MP.JULIO CESAR SALAS,CM. ARAPUEY,ESCUELA ESTADAL MESA BONITA,81,1,2,73,59,71,0,0,0,0,12,73
EDO. MERIDA,MP. SANTOS MARQUINA,CM. TABAY,UNID EDUC SAN RAFAEL DE TABAY,2383,5,33,1998,974,1965,0,6,0,0,985,1998
EDO. MERIDA,MP. SANTOS MARQUINA,CM. TABAY,ESCUELA ESTADO APURE,3569,7,51,3026,1396,2975,3,8,2,2,1564,3026
EDO. MERIDA,MP. SANTOS MARQUINA,CM. TABAY,ESCUELA BASICA 21 DE NOVIEMBRE,2144,4,58,1836,933,1778,1,5,3,1,835,1836
EDO. MERIDA,MP. SANTOS MARQUINA,CM. TABAY,UNIDAD EDUCATIVA FRANCISCO ZERPA,1016,2,17,873,492,856,0,1,0,1,362,873
EDO. MERIDA,MP. SANTOS MARQUINA,CM. TABAY,ESC BAS NAC 2206 475 Y MUNC 18,837,2,13,722,315,709,1,3,3,1,386,722
EDO. MERIDA,MP. SANTOS MARQUINA,CM. TABAY,LICEO MIGUEL OTERO SILVA,760,2,16,654,406,638,1,3,0,1,227,654
EDO. MERIDA,MP. SANTOS MARQUINA,CM. TABAY,ESC BAS INTEGRAL EL PEDREGAL,834,2,22,709,451,687,0,4,1,0,231,709
EDO. MERIDA,MP. SANTOS MARQUINA,CM. TABAY,UNIDAD EDUCATIVA AQUILES NAZOA,458,1,9,423,238,414,0,2,1,0,173,423
EDO. MERIDA,MP. JUSTO BRICE#O,CM. TORONDOY,ESCUELA BASICA ESTADAL CEIBAL,333,1,3,279,196,276,0,1,0,1,78,279
EDO. MERIDA,MP. JUSTO BRICE#O,CM. TORONDOY,UNIDAD EDUCATIVA ESTADAL SANTA ROSA,635,2,14,494,303,480,0,0,0,0,177,494
EDO. MERIDA,MP. JUSTO BRICE#O,CM. TORONDOY,UNIDAD EDUCATIVA EL JUMANGAL,146,1,2,131,100,129,0,0,0,0,29,131
EDO. MERIDA,MP. JUSTO BRICE#O,CM. TORONDOY,LICEO BOLIVARIANO TORONDOY,1866,4,22,1459,855,1437,0,7,1,0,574,1459
EDO. MERIDA,MP. JUSTO BRICE#O,CM. TORONDOY,ESCUELA BASICA OFICIAL COMBINADA,191,1,0,138,93,138,0,0,0,0,45,138
EDO. MERIDA,MP. JUSTO BRICE#O,CM. TORONDOY,ESCUELA BASICA SANTA ANA,305,1,4,234,172,230,0,1,1,0,56,234
EDO. MERIDA,MP. JUSTO BRICE#O,CM. TORONDOY,UNIDAD EDUCATIVA MUNICIPAL COGOLLAL,225,1,4,179,121,175,0,1,0,0,53,179
EDO. MERIDA,MP. JUSTO BRICE#O,PQ. SAN CRISTOBAL DE T,UNIDAD EDUCATIVA SAN CRISTOBAL,1311,3,21,1082,645,1061,1,0,0,0,415,1082
EDO. MERIDA,MP. CAMPO ELIAS,PQ. MONTALBAN,LICEO EJIDO,3730,7,52,3207,1266,3155,0,6,1,1,1881,3207
EDO. MERIDA,MP. CAMPO ELIAS,PQ. MONTALBAN,ESCUELA BASICA EL SALADO,2460,5,40,2067,1128,2027,0,5,1,0,893,2067
EDO. MERIDA,MP. CAMPO ELIAS,PQ. MONTALBAN,UNIDAD  EDUCATIVA MANZANO BAJO,2311,4,33,1975,999,1942,1,4,0,0,938,1975
EDO. MERIDA,MP. CAMPO ELIAS,PQ. MONTALBAN,UNIDAD GERONTOLOGICA DR RICARDO SERGENT,1328,3,7,1132,448,1125,0,2,0,0,675,1132
EDO. MERIDA,MP. CAMPO ELIAS,PQ. MONTALBAN,UNIDAD EDUCATIVA INTEGRAL JUAN XXIII,1077,2,28,910,456,882,0,1,0,1,424,910
EDO. MERIDA,MP. CAMPO ELIAS,PQ. MONTALBAN,ESCUELA BASICA MONSEÑOR JAUREGUI,4406,8,55,3707,1146,3652,1,9,0,2,2494,3707
EDO. MERIDA,MP. CAMPO ELIAS,PQ. MONTALBAN,ESCUELA BASICA MONSEÑOR JAUREGUI (B),1918,4,28,1736,680,1708,0,4,0,0,1024,1736
EDO. MERIDA,MP. CAMPO ELIAS,PQ. MONTALBAN,ESCUELA NACIONAL DOÑA EDELMIRA QUINTERO DE LOBO,1053,2,11,964,475,953,0,2,0,0,476,964
EDO. MERIDA,MP. CAMPO ELIAS,PQ. MONTALBAN,UNIDAD EDUCATIVA PEDRO J ANDRADE,1503,3,18,1242,722,1224,1,7,0,0,494,1242
EDO. MERIDA,MP. CAMPO ELIAS,PQ. JAJI,UNID EDUCT LOMA DEL CARMEN,317,1,4,253,161,249,0,0,0,0,88,253
EDO. MERIDA,MP. CAMPO ELIAS,PQ. JAJI,ESC EST UNIT S N,395,1,7,332,179,325,0,1,0,0,145,332
EDO. MERIDA,MP. CAMPO ELIAS,PQ. JAJI,UNIDAD EDUCATIVA BOLIVARIANA JAJI,1236,3,19,1006,475,987,2,1,1,0,508,1006
EDO. MERIDA,MP. CAMPO ELIAS,PQ. JAJI,UNID EDUCT PIEDRAS BLANCAS,326,1,3,267,174,264,0,0,0,0,90,267
EDO. MERIDA,MP. CAMPO ELIAS,PQ. JAJI,ESCUELA BASICA CONCENTRADA EL MACHO,231,1,1,195,97,194,0,1,0,0,96,195
EDO. MERIDA,MP. CAMPO ELIAS,PQ. MATRIZ,ESCUELA  BASICA CAMPO ELIAS,2979,6,28,2313,868,2285,2,10,2,0,1403,2313
EDO. MERIDA,MP. CAMPO ELIAS,PQ. MATRIZ,ESCUELA TECNICA ROBINSONIANA PROFESOR  JOSE RICARDO GUILEN SUAREZ,1543,3,14,1337,514,1323,1,3,0,0,805,1337
EDO. MERIDA,MP. CAMPO ELIAS,PQ. MATRIZ,ESCUELA BOLIVARIANA LOS GUAIMAROS,1138,2,21,969,581,948,0,5,0,0,362,969
EDO. MERIDA,MP. CAMPO ELIAS,PQ. MATRIZ,ESC BAS MIXTA LA RANCHERIA,1494,3,27,1230,815,1203,0,3,0,1,384,1230
EDO. MERIDA,MP. CAMPO ELIAS,PQ. MATRIZ,ESCUELA BASICA CAMPO ELIAS (B),997,2,12,860,412,848,0,1,0,1,434,860
EDO. MERIDA,MP. CAMPO ELIAS,PQ. MATRIZ,ESCUELA BASICA GRAN MARISCAL DE AYACUCHO (B),1832,4,39,1577,840,1538,0,3,1,2,692,1577
EDO. MERIDA,MP. CAMPO ELIAS,PQ. MATRIZ,ESC BAS 19 DE ABRIL,2216,4,45,1801,1232,1756,0,10,0,1,513,1801
EDO. MERIDA,MP. CAMPO ELIAS,PQ. MATRIZ,UND ED HERMANAS ALMARZA,2338,4,53,1932,1175,1879,2,11,3,4,684,1932
EDO. MERIDA,MP. CAMPO ELIAS,PQ. MATRIZ,ESCUELA  BASICA GRAN MARISCAL DE AYACUCHO,3167,6,53,2615,1143,2562,1,10,1,1,1406,2615
EDO. MERIDA,MP. CAMPO ELIAS,PQ. MATRIZ,AULAS ANEXAS EDELMIRA LOBO,3311,6,54,2866,1462,2812,1,13,2,0,1334,2866
EDO. MERIDA,MP. CAMPO ELIAS,PQ. MATRIZ,UNIDAD EDUCATIVA 5 DE JULIO,1194,2,17,1036,532,1019,0,5,0,0,482,1036
EDO. MERIDA,MP. CAMPO ELIAS,PQ. MATRIZ,COLEGIO SAN PIO X (B),2326,4,40,2033,829,1993,0,12,1,2,1149,2033
EDO. MERIDA,MP. CAMPO ELIAS,PQ. MATRIZ,UNIDAD EDUCATIVA BOLIVARIANA SAN MIGUEL DE EJIDO,852,2,12,774,448,762,0,3,0,1,310,774
EDO. MERIDA,MP. CAMPO ELIAS,PQ. MATRIZ,COLEGIO SAN PIO X,3409,6,45,2860,1059,2815,2,15,0,2,1737,2860
EDO. MERIDA,MP. CAMPO ELIAS,PQ. SAN JOSE,ESCUELA BASICA TOSTOS,149,1,4,100,46,96,0,1,0,0,49,100
EDO. MERIDA,MP. CAMPO ELIAS,PQ. SAN JOSE,ESCUELA BASICA MUCUMPIZ,259,1,1,191,114,190,0,0,0,0,76,191
EDO. MERIDA,MP. CAMPO ELIAS,PQ. SAN JOSE,UNIDAD EDUCATIVA BOLIVARIANA SAN JOSE,493,1,7,367,169,360,0,0,0,0,191,367
EDO. MERIDA,MP. CAMPO ELIAS,PQ. LA MESA,ESCUELA ESTADAL LAS GONZALEZ,1172,2,29,893,447,864,0,3,0,0,414,893
EDO. MERIDA,MP. CAMPO ELIAS,PQ. LA MESA,UNIDAD ESCOLAR JULIO CESAR DAVILA,1566,3,25,1265,693,1240,0,1,0,0,546,1265
EDO. MERIDA,MP. CAMPO ELIAS,PQ. LA MESA,UNIDAD EDUCATIVA MUCUSURI,693,2,7,566,389,559,1,1,0,0,168,566
EDO. MERIDA,MP. CAMPO ELIAS,PQ. FERNANDEZ PE#A,UNIDAD EDUCATIVA HIPOLITO E GONZALEZ,3197,6,54,2748,1145,2694,1,8,2,1,1537,2748
EDO. MERIDA,MP. CAMPO ELIAS,PQ. FERNANDEZ PE#A,UNIDAD EDUCATIVA POZO HONDO,2134,4,47,1846,798,1799,0,7,0,6,988,1846
EDO. MERIDA,MP. CAMPO ELIAS,PQ. FERNANDEZ PE#A,UNIDAD EDUCATIVA BOLIVARIANA LLANO GRANDE,303,1,9,220,124,211,0,1,0,1,85,220
EDO. MERIDA,MP. CAMPO ELIAS,PQ. FERNANDEZ PE#A,ESCUELA BASICA RURAL ESCUQUE,104,1,2,85,42,83,0,0,0,0,41,85
EDO. MERIDA,MP. CAMPO ELIAS,PQ. FERNANDEZ PE#A,UNID EDUCATIVA SAN ONOFRE,560,1,23,462,276,439,0,0,2,0,161,462
EDO. MERIDA,MP. CAMPO ELIAS,PQ. FERNANDEZ PE#A,U.E. HIPOLITO GONZALEZ B,1884,4,38,1672,665,1634,0,4,0,0,965,1672
EDO. MERIDA,MP. CAMPO ELIAS,PQ. ACEQUIAS,ESCUELA NACIONAL ACEQUIAS,429,1,5,317,203,312,0,2,0,0,107,317
EDO. MERIDA,MP. CAMPO ELIAS,PQ. ACEQUIAS,ESCUELA ESTADAL SAN PEDRO,211,1,1,129,89,128,0,2,0,0,37,129
EDO. MERIDA,MP. ARICAGUA,PQ. SAN ANTONIO,ESCUELA CONCENTRADA NACIONAL MIXTA,922,2,7,671,335,664,0,1,1,0,327,671
EDO. MERIDA,MP. ARICAGUA,CM. ARICAGUA,ESCUELA BASICA INTEGRAL LOS AZULES,709,2,6,572,211,566,0,0,0,0,355,572
EDO. MERIDA,MP. ARICAGUA,CM. ARICAGUA,ESCUELA BASICA FRANCISCO UZCATEGUI DAVILA,1708,3,27,1390,527,1363,0,6,1,0,829,1390
EDO. MERIDA,MP. ARICAGUA,CM. ARICAGUA,ESC BAS CONC NAC,366,1,3,283,189,280,0,0,0,0,91,283
EDO. MERIDA,MP. ARICAGUA,CM. ARICAGUA,ESC CONC NAC. MIXTA,119,1,1,75,23,74,0,0,0,0,51,75
EDO. MERIDA,MP. ARZOBISPO CHACON,PQ. CAPURI,UNIDAD EDUCATIVA BOLIVARIANA LAS TIENDAS,464,1,4,326,185,322,0,0,0,0,137,326
EDO. MERIDA,MP. ARZOBISPO CHACON,PQ. CAPURI,UNIDAD EDUCATIVA BOLIVARIANA MESITAS DE CAPURI,132,1,1,117,105,116,0,0,0,0,11,117
EDO. MERIDA,MP. ARZOBISPO CHACON,PQ. EL MOLINO,ESCUELA BASICA EL MOLINO II,1264,3,21,1004,486,983,0,3,0,0,494,1004
EDO. MERIDA,MP. ARZOBISPO CHACON,CM. CANAGUA,CICLO BASICO HECTOR GARCIA CHUECOS,504,1,8,460,260,452,1,0,1,0,190,460
EDO. MERIDA,MP. ARZOBISPO CHACON,CM. CANAGUA,ESCUELA BOLIVARIANA ESTADO BARINAS,1821,4,24,1444,754,1420,1,3,0,0,662,1444
EDO. MERIDA,MP. ARZOBISPO CHACON,CM. CANAGUA,UNIDAD EDUCATIVA BOLIVARIANA EL RINCON,230,1,12,204,92,192,0,2,0,0,98,204
EDO. MERIDA,MP. ARZOBISPO CHACON,PQ. CHACANTA,UNIDAD EDUCATIVA LOS UVITOS,360,1,3,273,187,270,0,1,0,0,82,273
EDO. MERIDA,MP. ARZOBISPO CHACON,PQ. CHACANTA,ESCUELA ESTADAL BASICA LOS RASTROJOS,212,1,2,138,63,136,0,0,1,0,72,138
EDO. MERIDA,MP. ARZOBISPO CHACON,PQ. CHACANTA,UNIDAD EDUCATIVA BOLIVARIANA CHACANTA,725,2,1,561,390,560,0,4,0,1,165,561
EDO. MERIDA,MP. ARZOBISPO CHACON,PQ. CHACANTA,UNIDAD EDUCATIVA EL CURO,107,1,1,98,81,97,0,0,0,0,16,98
EDO. MERIDA,MP. ARZOBISPO CHACON,PQ. GUAIMARAL,ESCUELA ESTADAL EL ENCIERRO,87,1,0,60,22,60,0,0,0,0,38,60
EDO. MERIDA,MP. ARZOBISPO CHACON,PQ. GUAIMARAL,ESCUELA BASICA ESTADAL LOS CUROS,240,1,1,173,79,172,0,0,0,0,93,173
EDO. MERIDA,MP. ARZOBISPO CHACON,PQ. GUAIMARAL,UNIDAD EDUCATIVA BOLIVARIANA EL VIENTO,335,1,1,228,105,227,0,1,0,0,121,228
EDO. MERIDA,MP. ARZOBISPO CHACON,PQ. MUCUTUY,ESCUELA BOLIVARIANA MALDONADO LOPEZ,947,2,30,699,415,669,0,5,1,1,247,699
EDO. MERIDA,MP. ARZOBISPO CHACON,PQ. MUCUTUY,ESCUELA ESTADAL BASICA MUCUCHARANI,159,1,0,108,70,108,0,0,0,0,38,108
EDO. MERIDA,MP. ARZOBISPO CHACON,PQ. MUCUTUY,UNIDAD EDUCATIVA BOLIVARIANA SAN MIGUEL,145,1,3,101,24,98,0,0,0,0,74,101
EDO. MERIDA,MP. ARZOBISPO CHACON,PQ. MUCUTUY,UNIDAD EDUCATIVA BOLIVARIANA LA PROVIDENCIA,75,1,1,55,14,54,0,0,0,0,40,55
EDO. MERIDA,MP. ARZOBISPO CHACON,PQ. MUCUTUY,UNIDAD EDUCATIVA BOLIVARIANA EL PANTANO DE MIJARA,362,1,2,249,111,247,0,0,0,0,136,249
EDO. MERIDA,MP. ARZOBISPO CHACON,PQ. MUCUTUY,ESCUELA ESTADAL LA VEGUILLA,329,1,20,267,88,247,0,0,0,0,159,267
EDO. MERIDA,MP. ARZOBISPO CHACON,PQ. MUCUCHACHI,ESC BAS SANTA INES,69,1,0,41,18,41,0,0,0,0,23,41
EDO. MERIDA,MP. ARZOBISPO CHACON,PQ. MUCUCHACHI,ESCUELA BASICA AGUA BLANCA,54,1,0,40,26,40,0,0,0,0,14,40
EDO. MERIDA,MP. ARZOBISPO CHACON,PQ. MUCUCHACHI,ESCUELA BASICA SANTA ROSA,42,1,0,17,12,17,0,0,0,0,5,17
EDO. MERIDA,MP. ARZOBISPO CHACON,PQ. MUCUCHACHI,ESCUELA ESTADAL BASICA EL PORTACHUELO,137,1,2,85,64,83,0,4,0,0,15,85
EDO. MERIDA,MP. ARZOBISPO CHACON,PQ. MUCUCHACHI,UNIDAD EDUCATIVA BOLIVARIANA ESTADO COJEDES,1101,2,10,833,503,823,0,2,0,0,318,833
EDO. MERIDA,MP. ARZOBISPO CHACON,PQ. MUCUCHACHI,UNIDAD EDUCATIVA BOLIVARIANA SANTA LUCIA,100,1,2,68,27,66,0,0,0,0,39,68
EDO. MERIDA,MP. RANGEL,CM. MUCUCHIES,ESCUELA INTEGRAL MISINTA,595,1,18,543,263,525,0,2,0,0,260,543
EDO. MERIDA,MP. RANGEL,CM. MUCUCHIES,UNIDAD EDUCATIVA GAVIDIA,394,1,7,340,263,333,1,0,0,0,69,340
EDO. MERIDA,MP. RANGEL,CM. MUCUCHIES,ESCUELA  BASICA ARTESANAL,2554,5,59,2215,1006,2156,0,5,0,0,1145,2215
EDO. MERIDA,MP. RANGEL,CM. MUCUCHIES,LICEO COMBINADO MUCUCHIES,1697,3,20,1503,599,1483,2,3,0,0,879,1503
EDO. MERIDA,MP. RANGEL,PQ. SAN RAFAEL,ESCUELA ESTADAL CONCENTRADA 029 LLANO DEL HATO,240,1,5,208,115,203,0,2,1,0,85,208
EDO. MERIDA,MP. RANGEL,PQ. SAN RAFAEL,UNIDAD EDUCATIVA BOLIVARIANA LUIS ORLANDO MONSALVE,1545,3,48,1305,579,1257,0,7,2,0,669,1305
EDO. MERIDA,MP. RANGEL,PQ. SAN RAFAEL,U.E BOLIVARIANA MUCUCHIES,919,2,26,765,410,739,0,8,0,0,321,765
EDO. MERIDA,MP. RANGEL,PQ. LA TOMA,UNIDAD EDUCATIVA LA TOMA,1346,3,56,1156,635,1100,0,2,0,1,462,1156
EDO. MERIDA,MP. RANGEL,PQ. CACUTE,UNIDAD EDUCATIVA CACUTE,1044,2,37,879,482,842,0,3,0,0,357,879
EDO. MERIDA,MP. RANGEL,PQ. MUCURUBA,UNIDAD EDUCATIVA ESCAGUEY,669,2,16,555,251,539,1,4,1,0,282,555
EDO. MERIDA,MP. RANGEL,PQ. MUCURUBA,ESCUELA BASICA ESTADO ANZOATEGUI,1841,4,30,1572,801,1542,0,6,0,1,734,1572
EDO. MERIDA,MP. PADRE NOGUERA,CM. STA MARIA DE CAPARO,ESCUELA BASICA ESTADAL JOSE VICENTE NUCETE,2531,5,32,2106,1054,2074,0,15,1,0,1004,2106
EDO. MERIDA,MP. GUARAQUE,PQ. MESA DE QUINTERO,UNIDAD EDUCATIVA BOLIVARIANA LIGIA ESPERANZA MOLINA,890,2,8,691,438,683,0,0,0,0,245,691
EDO. MERIDA,MP. GUARAQUE,CM. GUARAQUE,UNIDAD EDUCATIVA BOLIVARIANA ESTADO ARAGUA,1638,3,21,1219,802,1198,0,2,0,0,394,1219
EDO. MERIDA,MP. GUARAQUE,CM. GUARAQUE,ESCUELA ESTADAL EL MORAL,378,1,1,295,155,294,0,0,0,0,139,295
EDO. MERIDA,MP. GUARAQUE,CM. GUARAQUE,ESCUELA ESTADAL LOS RASTROJOS,448,1,4,343,172,339,1,0,0,0,166,343
EDO. MERIDA,MP. GUARAQUE,CM. GUARAQUE,UNIDAD EDUCATIVA LOS CAÑUTALES,536,1,7,437,252,430,0,0,0,0,178,437
EDO. MERIDA,MP. GUARAQUE,CM. GUARAQUE,ESCUELA ESTADAL MESA DE MORENO,443,1,16,339,253,323,0,0,0,0,70,339
EDO. MERIDA,MP. GUARAQUE,CM. GUARAQUE,UNIDAD EDUCATIVA BOLIVARIANA QUEBRADA SECA,362,1,2,261,159,259,0,0,0,0,100,261
EDO. MERIDA,MP. GUARAQUE,PQ. RIO NEGRO,ESCUELA ESTADAL  EL AMPARO,423,1,20,342,128,322,0,0,0,0,194,342
EDO. MERIDA,MP. GUARAQUE,PQ. RIO NEGRO,UNIDAD EDUCATIVA BOLIVARIANA EL PUEBLITO,1252,3,8,978,495,970,0,0,1,0,474,978
EDO. MERIDA,MP. GUARAQUE,PQ. RIO NEGRO,UNIDAD EDUCATIVA BOLIVARIANA LAS LOMAS,540,1,1,457,260,456,0,0,0,0,196,457
EDO. MERIDA,MP. GUARAQUE,PQ. RIO NEGRO,UNIDAD EDUCATIVA BOLIVARIANA PIE DE CUESTA,467,1,1,359,135,358,0,0,0,0,223,359
EDO. MERIDA,MP. TULIO F CORDERO,CM. NUEVA BOLIVIA,ESCUELA BASICA PRESBISTERO TOMAS AGUSTIN CASTELAO FERNANDEZ,477,1,13,411,249,398,0,0,1,0,148,411
EDO. MERIDA,MP. TULIO F CORDERO,CM. NUEVA BOLIVIA,UNIDAD EDUCATIVA BOLIVARIANA MIGUEL ARISMENDI, ANEXO LICEO.,66,1,0,59,35,59,0,1,0,0,23,59
EDO. MERIDA,MP. TULIO F CORDERO,CM. NUEVA BOLIVIA,UNIDAD EDUCATIVA CAÑO DE AGUA,463,1,7,371,222,364,0,0,0,0,142,371
EDO. MERIDA,MP. TULIO F CORDERO,CM. NUEVA BOLIVIA,UNIDAD EDUCATIVA NUEVA BOLIVIA,2219,4,23,1835,1046,1812,1,12,1,0,752,1835
EDO. MERIDA,MP. TULIO F CORDERO,CM. NUEVA BOLIVIA,UNIDAD EDUCATIVA ESTADAL PALMICHOSO,851,2,13,709,461,696,0,1,0,0,234,709
EDO. MERIDA,MP. TULIO F CORDERO,CM. NUEVA BOLIVIA,UNIDAD EDUCATIVA BOLIVARIANA  LA MACARENA,407,1,7,366,288,359,0,2,0,0,69,366
EDO. MERIDA,MP. TULIO F CORDERO,CM. NUEVA BOLIVIA,LICEO BOLIVARIANO JOSE MANUEL BRICEÑO MONZILLO,2693,5,49,2162,1155,2113,1,16,2,0,939,2162
EDO. MERIDA,MP. TULIO F CORDERO,CM. NUEVA BOLIVIA,ESCUELA BASICA MIGUEL ARISMENDI,1569,3,21,1311,762,1290,1,4,0,2,521,1311
EDO. MERIDA,MP. TULIO F CORDERO,CM. NUEVA BOLIVIA,LICEO BOLIVARIANO JOSE MANUEL BRICEÑO MONZILLO (B),1337,3,31,1148,690,1117,1,5,0,1,420,1148
EDO. MERIDA,MP. TULIO F CORDERO,PQ. SANTA APOLONIA,ESCUELA BASICA ESTADO MONAGAS,951,2,11,740,402,729,0,0,0,0,327,740
EDO. MERIDA,MP. TULIO F CORDERO,PQ. SANTA APOLONIA,ESCUELA BASICA PRIMARIA LA PUEBLITA,189,1,2,172,129,170,0,2,0,0,39,172
EDO. MERIDA,MP. TULIO F CORDERO,PQ. SANTA APOLONIA,ESCUELA ESTADAL BOLIVARIANA MONTE AVENTINO CONCENTRADA,592,1,10,473,263,463,0,0,1,0,199,473
EDO. MERIDA,MP. TULIO F CORDERO,PQ. SANTA APOLONIA,ESCUELA BASICA ESTADAL UNITARIA NUMERO 115,257,1,3,182,95,179,0,1,0,1,82,182
EDO. MERIDA,MP. TULIO F CORDERO,PQ. SANTA APOLONIA,ESCUELA BASICA ESTADAL UNITARIA NUMERO 255,244,1,2,171,113,169,0,1,0,0,55,171
EDO. MERIDA,MP. TULIO F CORDERO,PQ. MARIA C PALACIOS,ESCUELA BASICA CONCENTRADA LA PICA,139,1,0,109,93,109,0,0,0,0,16,109
EDO. MERIDA,MP. TULIO F CORDERO,PQ. MARIA C PALACIOS,ESCUELA BASICA UNITARIA ESTADAL,238,1,8,183,156,175,0,0,0,0,19,183
EDO. MERIDA,MP. TULIO F CORDERO,PQ. MARIA C PALACIOS,ESCUELA BASICA MIXTA PUEBLO NUEVO,710,2,35,596,468,561,0,1,0,0,92,596
EDO. MERIDA,MP. TULIO F CORDERO,PQ. MARIA C PALACIOS,UNIDAD EDUCATIVA DORLISA GUERRA,1385,3,14,1071,674,1057,0,5,0,0,378,1071
EDO. MERIDA,MP. TULIO F CORDERO,PQ. MARIA C PALACIOS,UNIDAD EDUCATIVA LAS TRINCHERAS,104,1,4,99,85,95,0,0,1,0,9,99
EDO. MERIDA,MP. TULIO F CORDERO,PQ. MARIA C PALACIOS,ESCUELA CONCENTRADA 209845,28,1,2,25,21,23,0,0,0,0,2,25
EDO. MERIDA,MP. TULIO F CORDERO,PQ. MARIA C PALACIOS,UNIDAD EDUCATIVA OFICIAL COMBINADA NUMERO 3554 361,260,1,9,201,161,192,0,1,0,0,30,201
EDO. MERIDA,MP. TULIO F CORDERO,PQ. INDEPENDENCIA,UNIDAD EDUCATIVA MIGUEL M CANDALES,1914,4,48,1568,1083,1520,0,3,1,0,433,1568
EDO. MERIDA,MP. TULIO F CORDERO,PQ. INDEPENDENCIA,ESCUELA BASICA OFICIAL COMBINADA NACIONAL 223 SIN NUMERO NUCLEO ESCOLAR RURAL 106,559,1,6,444,329,438,0,4,1,0,104,444
EDO. MERIDA,MP. TULIO F CORDERO,PQ. INDEPENDENCIA,UNIDAD EDUCATIVA NUMERO 472 616,698,2,7,579,467,572,0,5,0,0,100,579
EDO. MERIDA,MP. TULIO F CORDERO,PQ. INDEPENDENCIA,ESCUELA CONCENTRADA MIXTA NOS 90 4350 1231,757,2,21,596,326,575,0,0,0,0,249,596
EDO. MERIDA,MP. TULIO F CORDERO,PQ. INDEPENDENCIA,ESCUELA BASICA PALMARITO,1483,3,25,1185,905,1160,0,7,0,0,248,1185
EDO. MERIDA,MP. TULIO F CORDERO,PQ. INDEPENDENCIA,LICEO BOLIVARIANO INDEPENDENCIA,73,1,1,65,53,64,0,0,0,0,11,65
EDO. MERIDA,MP. ANTONIO PINTO S.,PQ. MESA DE LAS PALMAS,ESCUELA ESTADAL LA ESTRELLA,103,1,4,96,74,92,0,0,0,0,18,96
EDO. MERIDA,MP. ANTONIO PINTO S.,PQ. MESA DE LAS PALMAS,ESCUELA ESTADAL CAMPO ALEGRE,200,1,5,170,123,165,0,0,0,0,42,170
EDO. MERIDA,MP. ANTONIO PINTO S.,PQ. MESA DE LAS PALMAS,UNIDAD EDUCATIVA BOLIVARIANA SAN JOSE DE CAMPO ALEGRE,180,1,0,138,97,138,0,0,0,0,41,138
EDO. MERIDA,MP. ANTONIO PINTO S.,PQ. MESA DE LAS PALMAS,ESCUELA ESTADAL FRANCISCO DE ASISS,181,1,1,168,102,167,0,0,0,0,65,168
EDO. MERIDA,MP. ANTONIO PINTO S.,PQ. MESA DE LAS PALMAS,ESCUELA BOLIVARIANA MESAS DE LAS PALMAS,1183,2,22,995,578,973,0,0,0,1,394,995
EDO. MERIDA,MP. ANTONIO PINTO S.,PQ. MESA BOLIVAR,UNIDAD EDUCATIVA BOLIVARIANA SAN JOSE,542,1,6,438,302,432,0,0,0,0,130,438
EDO. MERIDA,MP. ANTONIO PINTO S.,PQ. MESA BOLIVAR,UNIDAD EDUCATIVA LA PROVIDENCIA,194,1,2,180,128,178,0,0,0,0,50,180
EDO. MERIDA,MP. ANTONIO PINTO S.,PQ. MESA BOLIVAR,ESCUELA BASICA ESTADAL BOLERO BAJO,337,1,2,265,196,263,0,4,0,0,63,265
EDO. MERIDA,MP. ANTONIO PINTO S.,PQ. MESA BOLIVAR,ESCUELA BOLIVARIANA RAFAEL ANTONIO GONZALEZ,2250,4,48,1781,916,1733,0,6,0,0,811,1781
EDO. MERIDA,MP. ANTONIO PINTO S.,PQ. MESA BOLIVAR,LICEO BOLIVARIANO SANTOS MARQUINA,215,1,6,195,123,189,0,0,0,1,65,195
EDO. MERIDA,MP. ANTONIO PINTO S.,CM. STA CRUZ DE MORA,LICEO BOLIVARIANO EUTIMIO RIVAS,807,2,20,713,317,693,0,3,0,0,373,713
EDO. MERIDA,MP. ANTONIO PINTO S.,CM. STA CRUZ DE MORA,UNIDAD EDUCATIVA PAIVA,521,1,9,468,277,459,0,1,0,0,181,468
EDO. MERIDA,MP. ANTONIO PINTO S.,CM. STA CRUZ DE MORA,UNIDAD EDUCATIVA COLEGIO NUESTRA SRA. DEL CARMEN,1228,3,11,1126,495,1115,0,6,1,0,613,1126
EDO. MERIDA,MP. ANTONIO PINTO S.,CM. STA CRUZ DE MORA,PREESCOLAR CARLOS ZERPA,2395,5,41,1975,767,1934,0,5,0,0,1162,1975
EDO. MERIDA,MP. ANTONIO PINTO S.,CM. STA CRUZ DE MORA,UNIDAD EDUCATIVA BOLIVARIANA SAN ISIDRO ALTO,560,1,4,481,276,477,0,0,0,0,201,481
EDO. MERIDA,MP. ANTONIO PINTO S.,CM. STA CRUZ DE MORA,ESCUELA ESTADAL LIBERTAD,492,1,5,358,245,353,0,3,1,0,104,358
EDO. MERIDA,MP. ANTONIO PINTO S.,CM. STA CRUZ DE MORA,UNIDAD EDUCATIVA ESTADAL 740 1007 PREESCOLAR SANTA MARTA BAJA,596,1,7,510,271,503,0,0,0,0,232,510
EDO. MERIDA,MP. ANTONIO PINTO S.,CM. STA CRUZ DE MORA,GRUPO ESCOLAR CARLOS ZERPA,1991,4,26,1627,607,1601,1,7,1,0,985,1627
EDO. MERIDA,MP. ANTONIO PINTO S.,CM. STA CRUZ DE MORA,UNIDAD EDUCATIVA CUCHILLA DE HUACAS,597,1,3,455,321,452,0,4,0,0,127,455
EDO. MERIDA,MP. ANTONIO PINTO S.,CM. STA CRUZ DE MORA,UNIDAD EDUCATIVA QUEBRADA DEL BARRO,1092,2,16,911,483,895,0,2,0,0,410,911
EDO. MERIDA,MP. ANTONIO PINTO S.,CM. STA CRUZ DE MORA,UNIDAD EDUCATIVA BOLIVARIANA EL GUAYABAL,963,2,10,812,449,802,0,2,0,0,351,812
EDO. MERIDA,MP. ANTONIO PINTO S.,CM. STA CRUZ DE MORA,UNIDAD EDUCATIVA BOLIVARIANA EL PORTON,964,2,14,766,495,752,0,4,0,0,253,766
EDO. MERIDA,MP. ANTONIO PINTO S.,CM. STA CRUZ DE MORA,UNIDAD EDUCATIVA BOLIVARIANA LOS AMOGRES,536,1,14,428,267,414,0,1,0,0,146,428
EDO. MERIDA,MP. ANDRES BELLO,CM. LA AZULITA,UNIDAD EDUCATIVA RAFAEL MARIA TORRES,2715,5,47,2227,1078,2180,0,12,0,2,1088,2227
EDO. MERIDA,MP. ANDRES BELLO,CM. LA AZULITA,UNIDAD EDUCATIVA BOLIVARIANA GRAN MARISCAL DE AYACUCHO,435,1,4,373,220,369,0,2,0,0,147,373
EDO. MERIDA,MP. ANDRES BELLO,CM. LA AZULITA,UNIDAD EDUCATIVA BOLIVARIANA HOLANDA,719,2,11,558,358,547,0,2,0,0,187,558
EDO. MERIDA,MP. ANDRES BELLO,CM. LA AZULITA,LICEO UNIDAD EDUCATIVA LA AZULITA,890,2,12,783,419,771,0,1,0,1,350,783
EDO. MERIDA,MP. ANDRES BELLO,CM. LA AZULITA,ESCUELA ESTADAL JOSE FELIX RIVAS,95,1,3,93,63,90,0,0,0,0,27,93
EDO. MERIDA,MP. ANDRES BELLO,CM. LA AZULITA,UNIDAD EDUCATIVA SIMON RODRIGUEZ,340,1,3,266,189,263,0,0,0,0,74,266
EDO. MERIDA,MP. ANDRES BELLO,CM. LA AZULITA,UNIDAD EDUCATIVA EL PARAMITO,239,1,2,199,115,197,0,0,0,0,82,199
EDO. MERIDA,MP. ANDRES BELLO,CM. LA AZULITA,UNIDAD EDUCATIVA BOLIVARIANA CARLOS SOUBLETTE,266,1,2,226,204,224,0,0,0,0,20,226
EDO. MERIDA,MP. ANDRES BELLO,CM. LA AZULITA,ESCUELA ESTADAL SIMONCITO ANDRES BELLO,256,1,7,242,213,235,0,1,0,0,21,242
EDO. MERIDA,MP. ANDRES BELLO,CM. LA AZULITA,UNIDAD EDUCATIVA MARIA CONCEPCION PALACIOS,345,1,1,275,206,274,0,0,0,0,68,275
EDO. MERIDA,MP. ANDRES BELLO,CM. LA AZULITA,UNIDAD EDUCATIVA BOLIVARIANA LA UVA,478,1,8,375,220,367,0,0,0,0,147,375
EDO. MERIDA,MP. ANDRES BELLO,CM. LA AZULITA,UNIDAD EDUCATIVA OLINDA II
EDO. MERIDA,MP. ANDRES BELLO,CM. LA AZULITA,UNIDAD EDUCATIVA ESTADAL EL MAPORA,339,1,12,272,234,260,0,0,0,0,26,272
EDO. MERIDA,MP. ANDRES BELLO,CM. LA AZULITA,UNIDAD EDUCATIVA LUISA CACERES DE ARISMENDI,274,1,2,219,149,217,0,0,0,0,68,219
EDO. MERIDA,MP. ANDRES BELLO,CM. LA AZULITA,ESCUELA BASICA SAN EUSEBIO,300,1,7,247,108,240,0,1,0,0,131,247
EDO. MERIDA,MP. ANDRES BELLO,CM. LA AZULITA,UNIDAD EDUCATIVA BOLIVARIANA MESA ALTA,509,1,10,452,274,442,0,4,0,0,164,452
EDO. MERIDA,MP. ANDRES BELLO,CM. LA AZULITA,ESCUELA ESTADAL CAÑO GUAYABO ALTO,144,1,2,138,110,136,0,0,0,0,26,138
EDO. MERIDA,MP. ANDRES BELLO,CM. LA AZULITA,UNIDAD EDUCATIVA ANDRES BELLO,284,1,3,227,135,224,0,1,0,0,88,227
EDO. MERIDA,MP. ANDRES BELLO,CM. LA AZULITA,UNIDAD EDUCATIVA QUEBRADA AZUL,455,1,6,337,231,331,0,0,0,0,100,337
EDO. MERIDA,MP. ANDRES BELLO,CM. LA AZULITA,ESC BAS EST CONC 979 Y SN,242,1,3,191,103,188,0,0,0,0,85,191
EDO. MERIDA,MP. ANDRES BELLO,CM. LA AZULITA,UNIDAD EDUCATIVA CAPAZ,327,1,0,273,156,273,0,2,0,0,115,273
EDO. MERIDA,MP. TOVAR,PQ. EL LLANO,ESCUELA BASICA ANANIAS AVENDAÑO (B),1774,3,13,1555,609,1542,1,2,0,0,930,1555
EDO. MERIDA,MP. TOVAR,PQ. EL LLANO,ESCUELA BASICA ANANIAS AVENDAÑO,2667,5,31,2225,848,2194,2,9,0,1,1334,2225
EDO. MERIDA,MP. TOVAR,PQ. EL LLANO,PREESCOLAR ANANIAS AVENDAÑO,1946,4,22,1682,676,1660,0,4,1,0,979,1682
EDO. MERIDA,MP. TOVAR,PQ. SAN FRANCISCO,ESCUELA BASICA NACIONAL GRADUADA SAN FRANCISCO,1232,3,8,1034,567,1026,0,1,0,1,457,1034
EDO. MERIDA,MP. TOVAR,PQ. SAN FRANCISCO,LICEO BOLIVARIANO SAN FRANCISCO I,150,1,0,130,68,130,0,0,0,0,62,130
EDO. MERIDA,MP. TOVAR,PQ. SAN FRANCISCO,ESCUELA CONCENTRADA NUMERO 72 212 592 JARDIN DE INFANCIA EL CARRIZAL,451,1,5,398,231,393,0,1,0,0,161,398
EDO. MERIDA,MP. TOVAR,PQ. EL AMPARO,ESCUELA BOLIVARIANA JUAN PICON GONZALEZ,1434,3,24,1148,658,1124,0,2,0,0,464,1148
EDO. MERIDA,MP. TOVAR,PQ. EL AMPARO,ESCUELA TECNICA ROBINSONIANA GENOVEVA MONTERO DE VEGA,166,1,5,147,91,142,0,1,0,0,50,147
EDO. MERIDA,MP. TOVAR,PQ. TOVAR,UNIDAD EDUCATIVA COLEGIO FE Y ALEGRIA (B),385,1,3,341,137,338,0,0,0,0,201,341
EDO. MERIDA,MP. TOVAR,PQ. TOVAR,CICLO BASICO FELIX ROMAN DUQUE,1915,4,29,1603,629,1574,0,6,2,0,937,1603
EDO. MERIDA,MP. TOVAR,PQ. TOVAR,UNIDAD EDUCATIVA BOLIVARIANA MONSENOR MORENO,1074,2,19,904,532,885,0,1,0,0,352,904
EDO. MERIDA,MP. TOVAR,PQ. TOVAR,UNIDAD EDUCATIVA BOLIVARIANA EL PENON,920,2,27,754,451,727,0,2,0,0,274,754
EDO. MERIDA,MP. TOVAR,PQ. TOVAR,ESCUELA BASICA SIN NUMERO NUCLEO 015,229,1,1,170,125,169,0,0,0,1,43,170
EDO. MERIDA,MP. TOVAR,PQ. TOVAR,ESCUELA BASICA CORONEL ANTONIO RANGEL,2065,4,24,1674,633,1650,0,5,0,0,1012,1674
EDO. MERIDA,MP. TOVAR,PQ. TOVAR,UNIDAD EDUCATIVA COLEGIO FE Y ALEGRIA,2289,4,34,1952,716,1918,0,6,0,1,1195,1952
EDO. MERIDA,MP. TOVAR,PQ. TOVAR,ESCUELA BASICA CLAUDIO VIVAS (B),540,1,5,481,222,476,0,2,0,1,251,481
EDO. MERIDA,MP. TOVAR,PQ. TOVAR,ESCUELA ESTADAL BOLIVARIANA EL CACIQUE,304,1,5,253,140,248,0,1,0,0,107,253
EDO. MERIDA,MP. TOVAR,PQ. TOVAR,ESCUELA BASICA CLAUDIO VIVAS,3308,6,43,2708,1090,2665,0,6,0,0,1569,2708
EDO. MERIDA,MP. TOVAR,PQ. TOVAR,UNIDAD EDUCATIVA MONSE OR CHACON,2050,4,34,1797,828,1763,0,12,2,0,921,1797
EDO. MERIDA,MP. TOVAR,PQ. TOVAR,CONC MIXTA PATA DE GALLINA,560,1,4,441,344,437,0,1,0,0,92,441
EDO. MERIDA,MP. TOVAR,PQ. TOVAR,ESCUELA NACIONAL UNITARIA NO 461,873,2,12,680,466,668,0,2,2,0,198,680
EDO. MERIDA,MP. CARACCIOLO PARRA,CM. TUCANI,UNIDAD EDUC. EL CHARAL,987,2,17,780,498,763,0,3,3,1,258,780
EDO. MERIDA,MP. CARACCIOLO PARRA,CM. TUCANI,LICEO BOLIVARIANO  VICENTE CAMPO ELIAS (B),792,2,17,638,327,621,0,5,1,0,288,638
EDO. MERIDA,MP. CARACCIOLO PARRA,CM. TUCANI,UNIDAD EDUCATIVA TUCANICITO NER 042,617,2,17,530,344,513,1,1,0,0,167,530
EDO. MERIDA,MP. CARACCIOLO PARRA,CM. TUCANI,UNIDAD EDUCATIVA  BOLIVARIANA EL VIJAO,227,1,5,195,92,190,0,0,0,0,98,195
EDO. MERIDA,MP. CARACCIOLO PARRA,CM. TUCANI,ESCUELA ESTADAL MONTE BELLO BAJO,732,2,13,605,461,592,0,2,0,0,129,605
EDO. MERIDA,MP. CARACCIOLO PARRA,CM. TUCANI,ESCUELA ESTADAL BOLIVARIANA PROF ANTONIO MORALES,142,1,7,126,84,119,0,0,0,0,35,126
EDO. MERIDA,MP. CARACCIOLO PARRA,CM. TUCANI,UNIDAD EDUCATIVA MESA DE JULIA,1549,3,21,1216,648,1195,1,2,1,0,543,1216
EDO. MERIDA,MP. CARACCIOLO PARRA,CM. TUCANI,ESCUELA ESTADAL PASCUAL I VILLAZMIL,2664,5,59,2043,943,1984,0,12,1,0,1028,2043
EDO. MERIDA,MP. CARACCIOLO PARRA,CM. TUCANI,ESCULA ESTADAL PASCUAL VILLASMIL,569,1,22,472,236,450,0,0,0,0,214,472
EDO. MERIDA,MP. CARACCIOLO PARRA,CM. TUCANI,LICEO BOLIVARIANO VICENTE CAMPO ELIAS,2589,5,59,1948,1005,1889,1,6,1,0,876,1948
EDO. MERIDA,MP. CARACCIOLO PARRA,CM. TUCANI,CENTRO EDUCACION  INICIAL PREESCOLAR LOS APAMATES,734,2,26,609,329,583,0,1,0,0,253,609
EDO. MERIDA,MP. CARACCIOLO PARRA,CM. TUCANI,UNIDAD EDUCACION BOLIVARIANA  LA CHIQUINQUIRA,264,1,9,218,155,209,0,1,0,0,53,218
EDO. MERIDA,MP. CARACCIOLO PARRA,PQ. FLORENCIO RAMIREZ,ESC BAS OF CONB RIO FRIO,1371,3,21,1117,666,1096,0,1,1,0,428,1117
EDO. MERIDA,MP. CARACCIOLO PARRA,PQ. FLORENCIO RAMIREZ,IUTE EXTENCION TUCANI,597,1,13,476,351,463,0,2,0,0,110,476
EDO. MERIDA,MP. CARACCIOLO PARRA,PQ. FLORENCIO RAMIREZ,UNIDAD EDUCATIVA JOSE ANTONIO PAEZ,2155,4,24,1643,1126,1619,0,7,0,1,485,1643
EDO. MERIDA,MP. ZEA,CM. ZEA,CONC NAC SANTA BARBARA,297,1,2,220,135,218,1,0,0,0,82,220
EDO. MERIDA,MP. ZEA,CM. ZEA,CASA DE LOS NI OS LOS TUCUSITOS,867,2,11,747,245,736,0,1,0,0,490,747
EDO. MERIDA,MP. ZEA,CM. ZEA,COLEGIO RITA MORA DE BARRIOS,386,1,6,346,138,340,0,3,0,1,198,346
EDO. MERIDA,MP. ZEA,CM. ZEA,ESCUELA BOLIVARIANA MARUJA VELAZCO DE RAMIREZ (SAN MIGUEL),349,1,3,307,192,304,0,1,0,0,111,307
EDO. MERIDA,MP. ZEA,CM. ZEA,ESCUELA BOLIVARIANA FELIX ROMAN DUQUE,1840,4,14,1536,535,1522,0,7,2,2,976,1536
EDO. MERIDA,MP. ZEA,CM. ZEA,UNIDAD EDUCATIVA DOCTOR JOSE RAMON VEGAS,1487,3,9,1288,601,1279,0,3,1,0,674,1288
EDO. MERIDA,MP. ZEA,CM. ZEA,ESCUELA NACIONAL NO 1351,455,1,6,350,187,344,0,1,0,0,156,350
EDO. MERIDA,MP. ZEA,CM. ZEA,UNIDAD EDUCATIVA LAS COCUIZAS NUCLEO ESTADAL RURAL 017,168,1,5,148,100,143,0,0,0,0,43,148
EDO. MERIDA,MP. ZEA,PQ. CA#O EL TIGRE,UNIDAD EDUCATIVA BOLIVARIANA SANTA LUCIA,433,1,7,384,241,377,0,2,1,0,133,384
EDO. MERIDA,MP. ZEA,PQ. CA#O EL TIGRE,ESCUELA BOLIVARIANA CAÑO DE TIGRE,1719,3,24,1394,805,1370,0,6,0,0,559,1394
EDO. MERIDA,MP.CARDENAL QUINTERO,CM. SANTO DOMINGO,ESCUELA BASICA MARTHA GONZALEZ,2625,5,66,2184,1118,2118,0,9,1,0,990,2184
EDO. MERIDA,MP.CARDENAL QUINTERO,CM. SANTO DOMINGO,PREESCOLAR BOLIVARIANO MARTHA GONZALEZ,417,1,11,371,224,360,0,0,0,0,136,371
EDO. MERIDA,MP.CARDENAL QUINTERO,CM. SANTO DOMINGO,ESCUELA ESTADAL NO 369,797,2,25,690,447,665,0,0,0,0,218,690
EDO. MERIDA,MP.CARDENAL QUINTERO,PQ. LAS PIEDRAS,ESCUELA BASICA ESTADAL NUMERO 861 LAS MESAS,291,1,11,236,147,225,0,3,0,0,75,236
EDO. MERIDA,MP.CARDENAL QUINTERO,PQ. LAS PIEDRAS,ESCUELA ESTADAL NUMERO 1039 EL CONEJO,362,1,5,296,262,291,0,3,1,0,25,296
EDO. MERIDA,MP.CARDENAL QUINTERO,PQ. LAS PIEDRAS,UNIDAD EDUCATIVA BOLIVARIANA  LAS PIEDRAS,1526,3,23,1218,773,1195,0,2,0,0,420,1218
EDO. MERIDA,MP.CARDENAL QUINTERO,PQ. LAS PIEDRAS,ESCUELA . BASICA OFICIAL COMBINADA NUMERO 802 1463,429,1,5,346,197,341,0,1,0,0,143,346
EDO. MERIDA,MP.CARDENAL QUINTERO,PQ. LAS PIEDRAS,ESCUELA BASICA ESTADAL  CONCENTRADA 1345 EL CAÑUTAL  (NUCLEO ESTADAL RURAL 028),243,1,3,206,179,203,0,1,0,1,22,206
EDO. MERIDA,MP.CARDENAL QUINTERO,PQ. LAS PIEDRAS,ESCUELA ESTADAL EL CANEY,136,1,3,127,82,124,0,1,0,0,41,127
EDO. MERIDA,MP.CARDENAL QUINTERO,PQ. LAS PIEDRAS,ESCUELA BOLIVARIANA LA MITISUS,125,1,0,111,73,111,0,0,0,0,38,111
EDO. MERIDA,MP. RIVAS DAVILA,CM. BAILADORES,UNIDAD EDUCATIVA ESTADAL BOLIVARIANA PRESBISTERO DR EZEQUIEL ARELLANO,1129,2,18,996,520,978,1,5,0,1,451,996
EDO. MERIDA,MP. RIVAS DAVILA,CM. BAILADORES,UND EDUC OFC COMB LAS PLAYITAS,978,2,24,784,252,760,1,6,0,0,501,784
EDO. MERIDA,MP. RIVAS DAVILA,CM. BAILADORES,LICEO BOLIVARIANO DR GERONIMO MALDONADO,3470,6,41,2727,1256,2686,0,8,1,3,1418,2727
EDO. MERIDA,MP. RIVAS DAVILA,CM. BAILADORES,UNIDAD EDUCATIVA BOLIVARIANA OTRA BANDA,234,1,2,216,121,214,0,2,1,0,90,216
EDO. MERIDA,MP. RIVAS DAVILA,CM. BAILADORES,UNIDAD EDUCATIVA TULIO FEBRES CORDERO,887,2,17,776,316,759,0,4,0,0,439,776
EDO. MERIDA,MP. RIVAS DAVILA,CM. BAILADORES,CONCENTRADA MIXTA MARINO NUMERO 58,603,2,25,520,364,495,0,0,0,0,131,520
EDO. MERIDA,MP. RIVAS DAVILA,CM. BAILADORES,ESCUELA GRADUADA JOSE GREGORIO RAMIREZ,962,2,10,810,402,800,0,1,0,1,396,810
EDO. MERIDA,MP. RIVAS DAVILA,CM. BAILADORES,ESCUELA BOLIVARIANA SAN PABLO,328,1,4,306,201,302,0,0,0,0,101,306
EDO. MERIDA,MP. RIVAS DAVILA,CM. BAILADORES,UNIDAD EDUCATIVA BOLIVARIANA PROFESOR   VICTOR EVENCIO CASTILLO,130,1,3,122,91,119,0,2,0,0,26,122
EDO. MERIDA,MP. RIVAS DAVILA,CM. BAILADORES,E.B. APOLONIO ROSALES,996,2,15,859,359,844,0,3,0,0,482,859
EDO. MERIDA,MP. RIVAS DAVILA,CM. BAILADORES,ESCUELA ESTADAL UNITARIA LOS QUEMADOS,165,1,3,125,91,122,0,0,0,0,31,125
EDO. MERIDA,MP. RIVAS DAVILA,CM. BAILADORES,UNID EDUC PROF. FELIZ MANUEL LUCES,917,2,14,750,496,736,0,4,0,0,236,750
EDO. MERIDA,MP. RIVAS DAVILA,CM. BAILADORES,ESCUELA ESTADAL BORDO SECO,207,1,5,185,137,180,0,0,0,0,43,185
EDO. MERIDA,MP. RIVAS DAVILA,PQ. GERONIMO MALDONADO,ESCUELA BASICA BOLIVARIANA FLOR DE MALDONADO,2665,5,28,2257,1042,2229,0,9,0,1,1177,2257
EDO. MERIDA,MP. ALBERTO ADRIANI,PQ. PRESIDENTE PAEZ,COLEGIO PRIVADO ROMULO GALLEGOS,954,2,7,763,219,756,0,5,0,0,532,763
EDO. MERIDA,MP. ALBERTO ADRIANI,PQ. PRESIDENTE PAEZ,UNIDAD EDUCATIVA ESPERANZA BOLIVARIANA,994,2,15,840,683,825,0,3,0,0,139,840
EDO. MERIDA,MP. ALBERTO ADRIANI,PQ. PRESIDENTE PAEZ,UNIDAD EDUCATIVA ANDRES BELLO (B),1937,4,25,1595,874,1570,1,5,0,0,690,1595
EDO. MERIDA,MP. ALBERTO ADRIANI,PQ. PRESIDENTE PAEZ,ESCUELA BASICA ANDRES BELLO,4493,8,67,3587,1854,3520,1,12,1,0,1652,3587
EDO. MERIDA,MP. ALBERTO ADRIANI,PQ. PRESIDENTE PAEZ,UNIDAD EDUCATIVA LIBERTADOR BOLIVAR,2170,4,53,1816,796,1763,1,9,1,1,955,1816
EDO. MERIDA,MP. ALBERTO ADRIANI,PQ. PRESIDENTE PAEZ,COLEGIO DR. RAMON REINOSO NUÑEZ,73,1,3,65,33,62,0,0,0,0,29,65
EDO. MERIDA,MP. ALBERTO ADRIANI,PQ. PRESIDENTE PAEZ,ESCUELA BASICA 12 DE FEBRERO,1124,2,15,949,432,934,0,4,0,0,498,949
EDO. MERIDA,MP. ALBERTO ADRIANI,PQ. PRESIDENTE PAEZ,ESCUELA BASICA 24 DE JULIO,223,1,6,196,118,190,1,2,0,0,69,196
EDO. MERIDA,MP. ALBERTO ADRIANI,PQ. PRESIDENTE PAEZ,UNIDAD EDUCATIVA ESTADAL LA PEDREGOSA,2432,5,35,2046,1372,2011,1,10,0,1,627,2046
EDO. MERIDA,MP. ALBERTO ADRIANI,PQ. PRESIDENTE PAEZ,ESCUELA BASICA CONCENTRADA DANTAS,739,2,27,556,321,529,1,1,2,0,204,556
EDO. MERIDA,MP. ALBERTO ADRIANI,PQ. PRESIDENTE PAEZ,UNIDAD EDUCATIVA ARTURO MICHELENA,310,1,8,283,226,275,0,1,0,0,48,283
EDO. MERIDA,MP. ALBERTO ADRIANI,PQ. PRESIDENTE PAEZ,UNIDAD EDUCATIVA BOLIVARIANA LUISA CACERES DE ARISMENDI,254,1,2,230,183,228,0,4,0,0,41,230
EDO. MERIDA,MP. ALBERTO ADRIANI,PQ. PRESIDENTE PAEZ,UNIDAD EDUC. MAURICIO ENCINOSO,3036,6,45,2433,841,2388,1,13,1,1,1531,2433
EDO. MERIDA,MP. ALBERTO ADRIANI,PQ. PRESIDENTE PAEZ,UNIDAD EDUCATIVA COLEGIO CECILIO ACOSTA,100,1,3,91,39,88,0,0,0,1,48,91
EDO. MERIDA,MP. ALBERTO ADRIANI,PQ. PRESIDENTE PAEZ,UNIDAD EDUCATIVA BOLIVARIANA ONIA CAÑO ISABEL,1330,3,21,1059,672,1038,0,4,0,0,362,1059
EDO. MERIDA,MP. ALBERTO ADRIANI,PQ. PRESIDENTE PAEZ,PREESCOLAR BUBUQUI III,174,1,2,153,67,151,0,0,0,0,84,153
EDO. MERIDA,MP. ALBERTO ADRIANI,PQ. PRESIDENTE PAEZ,JARDIN DE INFANCIA MAURICIO ENCINOSA,738,2,9,637,249,628,0,0,0,0,379,637
EDO. MERIDA,MP. ALBERTO ADRIANI,PQ. PRESIDENTE PAEZ,ESCUELA BASICA SUR AMERICA,2715,5,38,2231,890,2193,1,14,5,0,1283,2231
EDO. MERIDA,MP. ALBERTO ADRIANI,PQ. PTE. ROMULO GALLEGOS,LICEO BOLIVARIANO DOCTOR ARTURO USLAR PIETRI,2960,6,31,2456,1003,2425,2,9,1,1,1409,2456
EDO. MERIDA,MP. ALBERTO ADRIANI,PQ. PTE. ROMULO GALLEGOS,PREESCOLAR CARLOS SOUBLETTE,2725,5,50,2334,1401,2284,2,7,1,1,872,2334
EDO. MERIDA,MP. ALBERTO ADRIANI,PQ. PTE. ROMULO GALLEGOS,ESCUELA BASICA PRESBISTERO JOSE IGNACIO OLIVARES,2753,5,33,2343,1045,2310,1,5,1,0,1258,2343
EDO. MERIDA,MP. ALBERTO ADRIANI,PQ. PTE. ROMULO GALLEGOS,UNIDAD EDUCATIVA BOLIVARIANA LA VEGA I,893,2,14,733,397,719,0,4,0,0,318,733
EDO. MERIDA,MP. ALBERTO ADRIANI,PQ. PTE. ROMULO GALLEGOS,UNIDAD EDUCATIVA  23 DE ENERO,1004,2,12,851,559,839,0,2,1,0,277,851
EDO. MERIDA,MP. ALBERTO ADRIANI,PQ. PTE. ROMULO GALLEGOS,ESCUELA BOLIVARIANA EL CIMIENTO,379,1,4,320,232,316,0,1,0,0,83,320
EDO. MERIDA,MP. ALBERTO ADRIANI,PQ. PTE. ROMULO GALLEGOS,ESCUELA BASICA PRIMERO DE MAYO,3016,6,46,2435,1063,2389,1,9,3,0,1313,2435
EDO. MERIDA,MP. ALBERTO ADRIANI,PQ. PTE. ROMULO GALLEGOS,UNIDAD EDUCATIVA KILOMETRO 15,1038,2,18,813,542,795,0,5,0,0,248,813
EDO. MERIDA,MP. ALBERTO ADRIANI,PQ. PTE. ROMULO GALLEGOS,LICEO BOLIVARIANO EL VIGIA,2548,5,49,2117,1035,2068,0,10,0,0,1023,2117
EDO. MERIDA,MP. ALBERTO ADRIANI,PQ. HECTOR AMABLE MORA,ESCUELA BASICA SIMON RODRIGUEZ,3267,6,48,2585,1465,2537,1,10,3,2,1056,2585
EDO. MERIDA,MP. ALBERTO ADRIANI,PQ. HECTOR AMABLE MORA,UNIDAD EDUCATIVA BOLIVARIANA CAÑO BLANCO ABAJO,404,1,4,316,171,312,0,1,0,0,140,316
EDO. MERIDA,MP. ALBERTO ADRIANI,PQ. HECTOR AMABLE MORA,UNIDAD EDUCATIVA BOLIVARIANA EL CEIBAL,481,1,10,376,230,366,0,0,0,0,136,376
EDO. MERIDA,MP. ALBERTO ADRIANI,PQ. HECTOR AMABLE MORA,UNIDAD EDUCATIVA BOLIVARIANA QUEBRADA BLANCA,386,1,4,317,208,313,0,4,1,0,100,317
EDO. MERIDA,MP. ALBERTO ADRIANI,PQ. HECTOR AMABLE MORA,UNIDAD EDUCATIVA FRANCISCO DE MIRANDA,837,2,19,657,424,638,0,0,0,1,213,657
EDO. MERIDA,MP. ALBERTO ADRIANI,PQ. HECTOR AMABLE MORA,L.B. RAFAEL ANGEL RONDON MARQUEZ,641,2,12,536,373,524,0,1,0,0,150,536
EDO. MERIDA,MP. ALBERTO ADRIANI,PQ. HECTOR AMABLE MORA,ESCUELA BASICA UNITARIA 774 CAÑO BLANCO ALTO,66,1,1,58,47,57,0,0,0,0,10,58
EDO. MERIDA,MP. ALBERTO ADRIANI,PQ. HECTOR AMABLE MORA,UNIDAD EDUCATIVA BOLIVARIANA EZEQUIEL ZAMORA,214,1,4,180,110,176,0,0,0,0,66,180
EDO. MERIDA,MP. ALBERTO ADRIANI,PQ. HECTOR AMABLE MORA,ESCUELA ESTADAL CANO ARENA,293,1,7,244,158,237,0,1,0,0,78,244
EDO. MERIDA,MP. ALBERTO ADRIANI,PQ. JOSE NUCETE SARDI,ESCUELA BOLIVARIANA JOSE FELIX RIBAS,333,1,12,270,200,258,0,3,0,0,55,270
EDO. MERIDA,MP. ALBERTO ADRIANI,PQ. JOSE NUCETE SARDI,LICEO ESTADAL MARIA FLORA OVALLES,1215,3,13,936,768,923,0,1,0,0,154,936
EDO. MERIDA,MP. ALBERTO ADRIANI,PQ. PULIDO MENDEZ,ESCUELA BASICA CAÑO SECO,1457,3,19,1227,706,1208,0,7,0,0,495,1227
EDO. MERIDA,MP. ALBERTO ADRIANI,PQ. PULIDO MENDEZ,UNIDAD EDUCATIVA BOLIVARIANA ANTONIO JOSE DE SUCRE,264,1,9,232,182,223,0,0,0,0,41,232
EDO. MERIDA,MP. ALBERTO ADRIANI,PQ. PULIDO MENDEZ,ESCUELA BASICA LUIS BELTRAN PRIETO FIGUEROA,2139,4,54,1789,1030,1735,0,11,0,0,694,1789
EDO. MERIDA,MP. ALBERTO ADRIANI,PQ. PULIDO MENDEZ,UNIDAD EDUCATIVA VILLA DE LOS ANGELES,702,2,12,607,410,595,0,1,0,0,184,607
EDO. MERIDA,MP. ALBERTO ADRIANI,PQ. PULIDO MENDEZ,ESCUELA BASICA MOCACAY,319,1,16,228,120,212,0,0,0,1,91,228
EDO. MERIDA,MP. ALBERTO ADRIANI,PQ. PULIDO MENDEZ,UND EDUC BOLIVARIANA JOSEFA CAMEJO,498,1,5,451,248,446,0,0,0,0,198,451
EDO. MERIDA,MP. ALBERTO ADRIANI,PQ. PULIDO MENDEZ,ESC. NAC. BAS. 12 DE OCTUBRE.,3635,7,73,2973,1715,2900,2,8,0,0,1175,2973
EDO. MERIDA,MP. ALBERTO ADRIANI,PQ. PULIDO MENDEZ,SIMONCITO NANCY MORA,207,1,5,182,113,177,0,1,0,0,63,182
EDO. MERIDA,MP. ALBERTO ADRIANI,PQ. PULIDO MENDEZ,UNIDAD BASICA LA BLANCA,3595,7,55,2953,1598,2898,1,12,0,0,1287,2953
EDO. MERIDA,MP. ALBERTO ADRIANI,PQ. PULIDO MENDEZ,UNIDAD EDUCATIVA MI ABUELA ROSA INES CHAVEZ,194,1,8,164,112,156,0,0,0,0,44,164
EDO. MERIDA,MP. ALBERTO ADRIANI,PQ. PULIDO MENDEZ,ARQUITECTO CLAUDIO CORREDOR MULLER,2109,4,33,1816,899,1783,1,6,0,0,877,1816
EDO. MERIDA,MP. ALBERTO ADRIANI,PQ. PRESIDENTE BETANCOURT,UNIDAD EDUCATIVA TOVAR B,892,2,13,743,320,730,0,4,0,0,406,743
EDO. MERIDA,MP. ALBERTO ADRIANI,PQ. PRESIDENTE BETANCOURT,ESCUELA BASICA LA CAÑA BRAVA,186,1,3,117,74,114,0,0,0,0,40,117
EDO. MERIDA,MP. ALBERTO ADRIANI,PQ. PRESIDENTE BETANCOURT,UNIDAD EDUCATIVA TOVAR,2682,5,39,2142,868,2103,1,7,1,0,1226,2142
EDO. MERIDA,MP. ALBERTO ADRIANI,PQ. PRESIDENTE BETANCOURT,UNIDAD EDUCATIVA 1630 ANEXO EL TAPARO,549,1,4,448,269,444,0,3,0,0,172,448
EDO. MERIDA,MP. ALBERTO ADRIANI,PQ. PRESIDENTE BETANCOURT,UNIDAD EDUCATIVA JOSE MARTI,805,2,15,730,299,715,0,5,0,0,411,730
EDO. MERIDA,MP. ALBERTO ADRIANI,PQ. PRESIDENTE BETANCOURT,UNIDAD EDUCATIVA ESTADAL BOLIVARIANA FELIX MARIA RUIZ,313,1,4,274,151,270,0,0,0,0,119,274
EDO. MERIDA,MP. ALBERTO ADRIANI,PQ. PRESIDENTE BETANCOURT,UNIDAD EDUCATIVA CHIGUARA,1137,2,18,922,391,904,1,2,0,1,509,922
EDO. MERIDA,MP. ALBERTO ADRIANI,PQ. PRESIDENTE BETANCOURT,UNIDAD EDUCATIVA OFELIA TANCREDI CORREDOR,3197,6,69,2617,1470,2548,0,12,4,2,1060,2617
EDO. MERIDA,MP. ALBERTO ADRIANI,PQ. PRESIDENTE BETANCOURT,LICEO DR ALBERTO ADRIANI,3593,7,87,3063,1231,2976,0,14,1,2,1728,3063
EDO. MERIDA,MP. ALBERTO ADRIANI,PQ. PRESIDENTE BETANCOURT,UNIDAD EDUCATIVA BOLIVARIANA MANUELITA SAENZ,2564,5,42,1931,1164,1889,2,8,2,0,713,1931
EDO. MERIDA,MP. ALBERTO ADRIANI,PQ. GABRIEL PICON G.,ESCUELA BASICA LA PALMITA,1940,4,26,1470,790,1444,2,4,0,0,648,1470
EDO. MERIDA,MP. ALBERTO ADRIANI,PQ. GABRIEL PICON G.,UNIDAD EDUCATIVA BOLIVARIANA LA COROMOTO,66,1,3,59,38,56,0,1,0,0,17,59
EDO. MERIDA,MP. ALBERTO ADRIANI,PQ. GABRIEL PICON G.,ESCUELA ESTADAL LA LAGUNITA,631,2,9,528,293,519,0,6,0,0,220,528
EDO. MERIDA,MP. ALBERTO ADRIANI,PQ. GABRIEL PICON G.,ESCUELA BASICA LA HONDA,523,1,15,384,240,369,0,1,1,0,127,384
EDO. MERIDA,MP. ALBERTO ADRIANI,PQ. GABRIEL PICON G.,UNIDAD EDUCATIVA PALO QUEMADO,59,1,2,53,38,51,0,0,0,0,13,53
