Estado,Municipio,Número de Electores escrutados.,Número de Actas Procesadas.,Número total de Votos Nulos.,Número Total de Votantes que votaron realmente.,HUGO CHAVEZ,Número total de Votos Válidos.,ORLANDO CHIRINO,REINA SEQUERA,LUIS REYES,Número de Actas Esperadas.,Número de Electores Esperados.,MARIA BOLIVAR,HENRIQUE CAPRILES RADONSKI,Número de Votos Escrutados.
DTTO. CAPITAL,CE. BLVNO LIBERTADOR,1608976,3207,25237,1292524,695162,1267287,440,5324,796,3207,1608976,1253,564312,1292524
EDO. AMAZONAS,MP. ATABAPO,5664,15,132,4206,1775,4074,3,50,2,17,6104,6,2238,4206
EDO. AMAZONAS,MP. RIO NEGRO,2303,8,49,1585,628,1536,1,32,0,8,2303,0,875,1585
EDO. AMAZONAS,CE. ATURES,61094,132,1536,49476,25605,47940,16,343,16,154,69772,20,21940,49476
EDO. AMAZONAS,MP. MANAPIARE,2833,7,52,2060,1444,2008,1,17,1,14,4901,0,545,2060
EDO. AMAZONAS,MP. ALTO ORINOCO,919,3,12,538,355,526,0,9,0,17,4718,0,162,538
EDO. AMAZONAS,MP. MAROA,2153,6,24,1622,996,1598,0,11,0,6,2153,1,590,1622
EDO. AMAZONAS,MP. AUTANA,5248,14,111,4225,2093,4114,1,32,4,16,6339,1,1983,4225
EDO. ANZOATEGUI,MP. INDEPENDENCIA,22783,50,452,17767,12443,17315,4,98,15,53,23883,8,4747,17767
EDO. ANZOATEGUI,MP. ARAGUA,21354,51,326,17398,10078,17072,11,113,14,52,21820,5,6851,17398
EDO. ANZOATEGUI,MP. MC GREGOR,7583,16,103,5777,4120,5674,2,27,7,16,7583,0,1518,5777
EDO. ANZOATEGUI,MP. PE#ALVER,21499,42,397,17720,8920,17323,6,134,10,42,21499,5,8248,17720
EDO. ANZOATEGUI,MP. MIRANDA,31474,65,632,25010,13935,24378,4,172,20,66,32065,7,10240,25010
EDO. ANZOATEGUI,MP. BRUZUAL,21720,47,398,17667,8649,17269,5,85,12,47,21720,3,8515,17667
EDO. ANZOATEGUI,MP.S JUAN CAPISTRANO,6874,14,130,5463,2964,5333,3,34,3,14,6874,1,2328,5463
EDO. ANZOATEGUI,MP. SIMON RODRIGUEZ,113514,221,1973,92728,42636,90755,25,619,35,222,113972,29,47411,92728
EDO. ANZOATEGUI,MP. LIBERTAD,11879,23,157,9078,5160,8921,0,57,4,25,12878,0,3700,9078
EDO. ANZOATEGUI,MP. CAJIGAL,9472,21,150,7451,4637,7301,3,50,4,22,9818,2,2605,7451
EDO. ANZOATEGUI,MP. SOTILLO,167214,330,2550,134785,66581,132235,56,768,75,334,169154,73,64682,134785
EDO. ANZOATEGUI,MP. CARVAJAL,9832,20,145,8089,4284,7944,1,32,4,20,9832,2,3621,8089
EDO. ANZOATEGUI,MP. SANTA ANA,7832,17,122,6368,3221,6246,3,45,5,17,7832,1,2971,6368
EDO. ANZOATEGUI,MP. ANACO,85754,165,1646,70832,34341,69186,16,566,44,167,86692,32,34187,70832
EDO. ANZOATEGUI,MP. FREITES,50553,102,746,41610,22932,40864,12,237,23,107,52968,7,17653,41610
EDO. ANZOATEGUI,MP. GUANTA,24357,50,498,20373,10729,19875,3,105,4,50,24357,5,9029,20373
EDO. ANZOATEGUI,CE. BOLIVAR,261237,511,4373,211853,107115,207480,68,1403,117,522,266290,83,98694,211853
EDO. ANZOATEGUI,MP. L/DIEGO BAUTISTA,32128,63,197,26809,4705,26612,3,57,2,63,32128,13,21832,26809
EDO. ANZOATEGUI,MP. PIRITU,17596,36,349,14689,7965,14340,1,71,9,37,18040,6,6288,14689
EDO. ANZOATEGUI,MP. GUANIPA,50706,101,789,41800,22772,41011,6,298,14,103,51674,14,17907,41800
EDO. ANZOATEGUI,MP. MONAGAS,14579,32,314,11218,7241,10904,3,63,9,34,15430,2,3586,11218
EDO. APURE,MP. PEDRO CAMEJO,19401,45,272,14578,9517,14306,2,45,5,50,21277,2,4735,14578
EDO. APURE,MP. MU#OZ,20251,50,253,15615,11593,15362,3,86,6,51,20680,1,3673,15615
EDO. APURE,MP. ROMULO GALLEGOS,17939,39,275,13202,9102,12927,3,67,11,39,17939,1,3743,13202
EDO. APURE,CE. SAN FERNANDO,105661,219,1714,86992,54368,85278,13,474,53,227,108601,29,30341,86992
EDO. APURE,MP. PAEZ,64496,142,1150,47906,28462,46756,21,377,33,145,66086,16,17847,47906
EDO. APURE,MP. ACHAGUAS,37203,86,529,29035,20699,28506,7,182,23,94,39580,5,7590,29035
EDO. APURE,MP. BIRUACA,35884,82,630,29352,19146,28722,4,147,10,82,35884,7,9408,29352
EDO. ARAGUA,MP.OCUMARE D L COSTA,8585,18,140,6661,4057,6521,2,26,2,18,8585,2,2432,6661
EDO. ARAGUA,MP. SANTOS MICHELENA,24282,51,536,19732,14941,19196,8,60,10,51,24282,5,4172,19732
EDO. ARAGUA,MP. ZAMORA,93246,186,1764,76938,52112,75174,28,423,69,186,93246,38,22504,76938
EDO. ARAGUA,MP. JOSE ANGEL LAMAS,22721,48,302,19354,11485,19052,4,94,15,48,22721,9,7445,19354
EDO. ARAGUA,MP. CAMATAGUA,11826,26,208,9314,6153,9106,1,61,4,26,11826,1,2886,9314
EDO. ARAGUA,MP.FRANCISCO LINARES,82289,161,1471,68221,46753,66750,12,344,49,163,83422,47,19545,68221
EDO. ARAGUA,MP. JOSE R REVENGA,30956,63,528,26069,19022,25541,12,104,22,63,30956,12,6369,26069
EDO. ARAGUA,MP. SUCRE,82748,159,1398,69744,36755,68346,19,328,29,159,82748,49,31166,69744
EDO. ARAGUA,MP. LIBERTADOR,60141,118,997,50374,32399,49377,10,241,31,118,60141,39,16657,50374
EDO. ARAGUA,MP. TOVAR,12296,31,237,9552,4874,9315,7,40,9,32,12552,4,4381,9552
EDO. ARAGUA,MP. BOLIVAR,28943,57,734,23271,16072,22537,4,101,13,58,29497,6,6341,23271
EDO. ARAGUA,MP. MARIO B IRAGORRY,76918,147,1005,65829,31444,64824,15,239,48,149,77982,53,33025,65829
EDO. ARAGUA,MP. URDANETA,15607,34,386,12882,8850,12496,2,60,6,34,15607,7,3571,12882
EDO. ARAGUA,MP. JOSE FELIX RIVAS,101606,199,1730,85077,49431,83347,21,391,51,203,103622,55,33398,85077
EDO. ARAGUA,MP. SAN SEBASTIAN,16236,34,244,13213,8062,12969,3,39,11,34,16236,5,4849,13213
EDO. ARAGUA,MP. SAN CASIMIRO,18428,42,391,15051,10050,14660,5,60,11,42,18428,6,4528,15051
EDO. ARAGUA,MP. SANTIAGO MARI#O,129840,251,1999,106405,61618,104406,25,488,64,254,131534,63,42148,106405
EDO. ARAGUA,CE. GIRARDOT,340842,656,4397,280308,136159,275911,71,1178,154,657,341329,171,138178,280308
EDO. BARINAS,CE. BARINAS,215853,433,3853,178755,94895,174902,39,891,85,445,220598,63,78929,178755
EDO. BARINAS,MP. CRUZ PAREDES,17452,46,284,14196,10158,13912,2,84,7,50,17969,1,3660,14196
EDO. BARINAS,MP. PEDRAZA,42180,98,732,32851,17651,32119,4,141,27,101,42724,2,14294,32851
EDO. BARINAS,MP. ROJAS,26544,61,391,20841,14914,20450,4,121,11,61,26544,2,5398,20841
EDO. BARINAS,MP. ARISMENDI,15882,52,233,11029,7676,10796,4,60,9,56,17459,2,3045,11029
EDO. BARINAS,MP. ALBERTO ARVELO T,27077,59,472,22454,17900,21982,2,103,7,60,27655,6,3964,22454
EDO. BARINAS,MP. ANDRES E. BLANCO,10722,27,146,8339,4968,8193,1,47,2,29,11841,2,3173,8339
EDO. BARINAS,MP. A JOSE DE SUCRE,46449,94,816,36641,19621,35825,11,182,24,95,47014,6,15981,36641
EDO. BARINAS,MP. SOSA,16048,38,240,12549,7999,12309,0,60,4,40,16983,2,4244,12549
EDO. BARINAS,MP. BOLIVAR,35833,87,572,29372,17116,28800,7,141,13,87,35833,9,11514,29372
EDO. BARINAS,MP. EZEQUIEL ZAMORA,34446,77,623,27263,13840,26640,4,121,19,81,36296,4,12652,27263
EDO. BARINAS,MP. OBISPOS,19240,44,294,15640,10390,15346,2,107,9,59,24236,4,4834,15640
EDO. BOLIVAR,MP. BLVNO ANGOSTURA,24304,58,378,17546,9464,17168,5,117,15,69,27764,6,7561,17546
EDO. BOLIVAR,MP. GRAN SABANA,18292,46,309,12060,6919,11751,17,98,21,53,20767,12,4684,12060
EDO. BOLIVAR,MP. ROSCIO,16958,36,364,13085,6028,12721,2,81,8,36,16958,2,6600,13085
EDO. BOLIVAR,MP. CEDE#O,41021,96,644,29373,20274,28729,9,124,27,111,44642,6,8289,29373
EDO. BOLIVAR,MP. PIAR,70533,142,1288,55597,24100,54309,13,389,31,146,71693,9,29767,55597
EDO. BOLIVAR,MP. SIFONTES,29827,61,514,19595,10608,19081,17,184,14,62,29913,7,8251,19595
EDO. BOLIVAR,MP. EL CALLAO,16364,34,375,12334,4664,11959,7,68,3,34,16364,3,7214,12334
EDO. BOLIVAR,MP. CARONI,443196,871,6434,364658,197067,358224,89,2306,215,907,461166,165,158382,364658
EDO. BOLIVAR,MP. SUCRE,16306,42,321,10934,7411,10613,3,67,12,46,17411,4,3116,10934
EDO. BOLIVAR,MP.PADRE PEDRO CHIEN,8957,20,135,6974,3714,6839,0,39,6,26,11594,1,3079,6974
EDO. BOLIVAR,CE. HERES,222367,498,3784,176829,86200,173045,52,1217,76,500,223425,96,85404,176829
EDO. CARABOBO,MP. SAN DIEGO,59286,110,555,51837,14289,51282,9,184,31,110,59286,30,36739,51837
EDO. CARABOBO,MP. LOS GUAYOS,96651,184,1506,78243,48671,76737,19,428,36,184,96651,47,27536,78243
EDO. CARABOBO,MP. BEJUMA,32827,69,403,26416,13476,26013,8,89,13,69,32827,12,12415,26416
EDO. CARABOBO,MP. NAGUANAGUA,98332,184,1173,81531,32100,80358,29,298,40,186,99406,42,47849,81531
EDO. CARABOBO,MP. CARLOS ARVELO,98214,198,1677,75462,52255,73785,26,439,52,200,98917,34,20979,75462
EDO. CARABOBO,MP. LIBERTADOR,108480,209,1563,84813,53709,83250,45,385,64,210,109006,46,29001,84813
EDO. CARABOBO,MP. MIRANDA,19116,38,272,15188,9829,14916,2,64,5,38,19116,5,5011,15188
EDO. CARABOBO,MP. SAN JOAQUIN,38296,74,573,31631,18013,31058,9,151,18,75,38795,23,12844,31631
EDO. CARABOBO,MP. DIEGO IBARRA,66668,126,1184,54282,38290,53098,12,273,42,126,66668,24,14457,54282
EDO. CARABOBO,CE. VALENCIA,563816,1065,7237,449228,210401,441991,138,2223,197,1091,573991,249,228783,449228
EDO. CARABOBO,MP. JUAN JOSE MORA,48361,104,769,40003,29047,39234,28,157,23,105,48822,21,9958,40003
EDO. CARABOBO,MP. GUACARA,114093,216,1526,94538,50813,93012,23,474,51,218,115155,44,41607,94538
EDO. CARABOBO,MP. MONTALBAN,16769,35,250,13660,7394,13410,2,46,5,35,16769,3,5960,13660
EDO. CARABOBO,MP. PUERTO CABELLO,140535,275,2006,113148,68576,111142,42,426,46,276,140831,58,41994,113148
EDO. COJEDES,MP. GIRARDOT,9212,21,147,7337,4942,7190,1,46,5,21,9212,4,2192,7337
EDO. COJEDES,MP. TINACO,23109,50,471,18988,12204,18517,2,104,13,50,23109,6,6188,18988
EDO. COJEDES,CE. EZEQUIEL ZAMORA,69367,153,1356,58054,33357,56698,29,397,22,155,70471,26,22867,58054
EDO. COJEDES,MP. RICAURTE,10302,23,177,8384,6544,8207,2,52,4,23,10302,2,1603,8384
EDO. COJEDES,MP. ROMULO GALLEGOS,13397,28,276,10908,7312,10632,2,87,6,29,13984,1,3224,10908
EDO. COJEDES,MP. PAO S J BAUTISTA,12105,41,268,9870,7543,9602,8,59,6,43,12439,3,1983,9870
EDO. COJEDES,MP. LIMA BLANCO,8651,18,171,7241,4812,7070,1,26,3,18,8651,2,2226,7241
EDO. COJEDES,MP. ANZOATEGUI,11833,28,282,9795,6737,9513,2,44,0,28,11833,3,2727,9795
EDO. COJEDES,MP. TINAQUILLO,62694,133,1348,51505,32437,50157,23,281,22,134,63027,22,17372,51505
EDO. DELTA AMAC,CE. TUCUPITA,59555,155,1311,48383,27011,47072,29,453,32,166,62829,20,19527,48383
EDO. DELTA AMAC,MP. PEDERNALES,8695,18,84,5358,4111,5274,0,21,1,18,8695,2,1139,5358
EDO. DELTA AMAC,MP. ANTONIO DIAZ,10759,27,54,6408,5408,6354,2,26,4,53,19913,0,914,6408
EDO. DELTA AMAC,MP. CASACOIMA,21260,52,408,16067,11959,15659,8,98,19,53,21809,3,3572,16067
EDO. FALCON,MP. MAUROA,16506,45,342,13352,7943,13010,8,74,9,46,16998,1,4975,13352
EDO. FALCON,MP. SUCRE,5566,16,45,4283,3194,4238,1,18,3,17,5927,0,1022,4283
EDO. FALCON,MP. FALCON,36721,89,578,29965,18785,29387,9,163,16,90,37251,7,10407,29965
EDO. FALCON,MP. MONS. ITURRIZA,14335,31,261,10966,6021,10705,3,44,2,31,14335,0,4635,10966
EDO. FALCON,MP. TOCOPERO,5895,13,128,4723,3433,4595,1,16,0,13,5895,0,1145,4723
EDO. FALCON,MP. SILVA,21427,49,444,14650,7580,14206,4,86,13,50,21955,3,6520,14650
EDO. FALCON,MP. COLINA,26143,52,374,21159,12324,20785,2,118,4,53,26528,4,8333,21159
EDO. FALCON,MP. FEDERACION,20605,60,384,15902,9656,15518,8,80,15,60,20605,4,5755,15902
EDO. FALCON,MP. LOS TAQUES,32190,63,563,26957,16091,26394,5,145,6,64,32719,9,10138,26957
EDO. FALCON,MP. CARIRUBANA,157164,306,2542,130757,75638,128215,27,697,60,312,160367,66,51727,130757
EDO. FALCON,MP. DABAJURO,13825,30,244,11030,6020,10786,1,60,4,33,15197,3,4698,11030
EDO. FALCON,MP. CACIQUE MANAURE,8049,16,244,6318,3577,6074,0,30,2,16,8049,1,2464,6318
EDO. FALCON,MP. JACURA,8362,22,118,6078,4109,5960,1,40,1,23,8461,3,1806,6078
EDO. FALCON,MP. PALMA SOLA,3754,13,46,3034,2482,2988,1,14,2,13,3754,1,488,3034
EDO. FALCON,MP. ACOSTA,14547,36,230,11019,6507,10789,4,46,5,36,14547,2,4225,11019
EDO. FALCON,MP. DEMOCRACIA,7265,26,89,5731,3737,5642,2,29,1,35,8966,1,1872,5731
EDO. FALCON,MP. ZAMORA,22749,60,270,17896,10842,17626,7,112,3,60,22749,7,6655,17896
EDO. FALCON,MP. UNION,10869,35,143,8168,5499,8025,1,51,7,36,11389,1,2466,8168
EDO. FALCON,MP. URUMACO,6477,21,96,5404,3367,5308,1,17,1,22,6671,0,1922,5404
EDO. FALCON,MP. PETIT,10221,31,172,7646,5569,7474,1,39,7,32,10796,2,1856,7646
EDO. FALCON,MP. PIRITU,9122,29,176,6747,4922,6571,2,47,6,29,9122,2,1592,6747
EDO. FALCON,MP. SAN FRANCISCO,9219,23,122,6961,4603,6839,3,26,2,23,9219,2,2203,6961
EDO. FALCON,MP. BOLIVAR,6962,23,114,5683,3920,5569,1,32,4,24,7278,5,1607,5683
EDO. FALCON,MP. BUCHIVACOA,17686,47,275,14123,8607,13848,1,74,6,47,17686,8,5152,14123
EDO. FALCON,CE. MIRANDA,134639,272,2253,109675,57411,107422,44,674,60,282,138150,47,49186,109675
EDO. GUARICO,MP. ZARAZA,38437,81,508,29256,18874,28748,17,199,27,86,40912,10,9621,29256
EDO. GUARICO,MP. CHAGUARAMAS,9737,23,220,7503,4746,7283,2,34,5,24,10270,2,2494,7503
EDO. GUARICO,CE. ROSCIO,83751,171,1244,70529,39864,69285,18,385,26,174,85345,33,28959,70529
EDO. GUARICO,MP. MELLADO,18497,41,282,15024,10105,14742,3,75,9,41,18497,5,4545,15024
EDO. GUARICO,MP.SAN GERONIMO DE G,13509,30,165,9944,6689,9779,0,51,7,31,13976,0,3032,9944
EDO. GUARICO,MP. INFANTE,73330,145,962,61053,34278,60091,17,335,30,161,79652,34,25397,61053
EDO. GUARICO,MP. EL SOCORRO,12240,27,202,9663,6517,9461,1,42,5,29,13306,4,2892,9663
EDO. GUARICO,MP. MIRANDA,73349,146,1083,60151,40196,59068,30,345,30,182,89289,28,18439,60151
EDO. GUARICO,MP. CAMAGUAN,13719,31,280,10847,6897,10567,4,70,11,33,14883,1,3584,10847
EDO. GUARICO,MP. ORTIZ,14138,36,202,11183,7810,10981,1,66,9,39,15434,2,3093,11183
EDO. GUARICO,MP. S MARIA DE IPIRE,10485,26,157,7844,5452,7687,5,53,15,26,10485,2,2160,7844
EDO. GUARICO,MP. LAS MERCEDES,19783,41,421,15020,10317,14599,4,78,12,46,22035,0,4188,15020
EDO. GUARICO,MP.S JOSE DE GUARIBE,8052,20,146,6411,4240,6265,1,40,2,20,8052,1,1981,6411
EDO. GUARICO,MP. MONAGAS,50747,108,859,40622,27064,39763,11,227,28,109,51066,13,12420,40622
EDO. GUARICO,MP. RIBAS,27449,65,382,21658,13293,21276,6,112,15,65,27449,8,7842,21658
EDO. LARA,MP. ANDRES E BLANCO,29516,77,403,23897,15131,23494,14,125,17,83,30883,11,8196,23897
EDO. LARA,MP. MORAN,86288,208,1521,68369,43788,66848,42,420,88,212,87084,25,22485,68369
EDO. LARA,MP. JIMENEZ,64135,137,1116,53026,33266,51910,22,382,48,138,64373,34,18158,53026
EDO. LARA,MP. TORRES,113867,235,1848,92991,49459,91143,35,458,59,289,130764,41,41091,92991
EDO. LARA,MP. SIMON PLANAS,24844,53,438,20194,14634,19756,14,113,18,53,24844,9,4968,20194
EDO. LARA,MP. CRESPO,33240,71,686,27078,13965,26392,10,159,35,72,33728,18,12205,27078
EDO. LARA,MP. PALAVECINO,102297,202,1334,88757,33582,87423,16,448,61,202,102297,39,53277,88757
EDO. LARA,CE. IRIBARREN,665398,1327,10488,555728,256474,545240,169,3503,408,1361,680399,337,284349,555728
EDO. LARA,MP. URDANETA,41703,122,530,33362,21987,32832,13,189,48,127,43318,7,10588,33362
EDO. MERIDA,CE. LIBERTADOR,164552,321,2198,140227,49066,138029,48,439,52,326,166637,73,88351,140227
EDO. MERIDA,MP. PUEBLO LLANO,7149,15,113,5962,3017,5849,1,13,1,15,7149,0,2817,5962
EDO. MERIDA,MP.OB. RAMOS DE LORA,18504,45,217,14953,8776,14736,0,62,6,45,18504,4,5888,14953
EDO. MERIDA,MP. SUCRE,33744,81,564,27112,15443,26548,7,115,14,87,35698,9,10960,27112
EDO. MERIDA,MP. MIRANDA,14883,35,310,12489,6149,12179,4,51,8,36,15387,5,5962,12489
EDO. MERIDA,MP.JULIO CESAR SALAS,9944,26,150,7697,4922,7547,2,24,1,26,9944,0,2598,7697
EDO. MERIDA,MP. SANTOS MARQUINA,12001,25,219,10241,5205,10022,6,32,10,25,12001,6,4763,10241
EDO. MERIDA,MP. JUSTO BRICE#O,5012,14,70,3996,2485,3926,1,10,2,14,5012,1,1427,3996
EDO. MERIDA,MP. CAMPO ELIAS,64241,128,1018,54057,25516,53039,16,177,17,130,65283,27,27286,54057
EDO. MERIDA,MP. ARICAGUA,3824,9,44,2991,1285,2947,0,7,2,9,3824,0,1653,2991
EDO. MERIDA,MP. ARZOBISPO CHACON,9326,27,144,7205,3959,7061,2,21,3,33,10001,2,3074,7205
EDO. MERIDA,MP. RANGEL,12844,27,322,11041,5404,10719,4,42,4,27,12844,2,5263,11041
EDO. MERIDA,MP. PADRE NOGUERA,2531,5,32,2106,1054,2074,0,15,1,5,2531,0,1004,2106
EDO. MERIDA,MP. GUARAQUE,6479,14,80,5023,2838,4943,1,2,1,16,7377,0,2101,5023
EDO. MERIDA,MP. TULIO F CORDERO,20663,50,372,16831,10731,16459,4,71,8,50,20663,4,5641,16831
EDO. MERIDA,MP. ANTONIO PINTO S.,18127,40,276,15056,7909,14780,1,48,3,41,18627,2,6817,15056
EDO. MERIDA,MP. ANDRES BELLO,9652,26,145,7973,4785,7828,0,26,0,27,9909,3,3014,7973
EDO. MERIDA,MP. TOVAR,26332,54,348,22077,10061,21729,3,64,7,56,27362,5,11589,22077
EDO. MERIDA,MP. CARACCIOLO PARRA,15989,35,330,12616,7265,12286,3,43,8,35,15989,2,4965,12616
EDO. MERIDA,MP. ZEA,7423,17,78,6256,2913,6178,1,22,4,18,8001,3,3235,6256
EDO. MERIDA,MP.CARDENAL QUINTERO,6951,17,152,5785,3502,5633,0,20,2,17,6951,1,2108,5785
EDO. MERIDA,MP. RIVAS DAVILA,13671,30,209,11433,5648,11224,2,44,2,30,13671,6,5522,11433
EDO. MERIDA,MP. ALBERTO ADRIANI,83505,178,1410,68510,36069,67100,25,273,30,178,83505,15,30688,68510
EDO. MIRANDA,MP. INDEPENDENCIA,88417,171,1534,72589,51505,71055,21,319,49,176,91010,45,19116,72589
EDO. MIRANDA,MP. BARUTA,226713,429,1719,176777,36343,175058,34,318,49,432,228367,105,138209,176777
EDO. MIRANDA,MP. SIMON BOLIVAR,25756,56,484,21477,15156,20993,4,82,12,56,25756,16,5723,21477
EDO. MIRANDA,MP. PLAZA,134220,257,2234,114141,66334,111907,24,454,48,262,136683,94,44953,114141
EDO. MIRANDA,MP. SUCRE,455590,876,6211,360861,165044,354650,106,1287,182,881,458130,255,187776,360861
EDO. MIRANDA,MP. BUROZ,16109,35,326,12846,8728,12520,1,51,5,35,16109,4,3731,12846
EDO. MIRANDA,MP. EL HATILLO,50654,95,407,40806,7329,40399,4,82,16,96,51215,18,32950,40806
EDO. MIRANDA,MP. LOS SALIAS,55106,104,474,46222,10862,45748,9,74,21,104,55106,42,34740,46222
EDO. MIRANDA,MP. ANDRES BELLO,15016,37,315,11963,7948,11648,5,43,6,39,15904,4,3642,11963
EDO. MIRANDA,MP. PEDRO GUAL,13679,32,297,10515,6316,10218,5,65,4,33,13780,4,3824,10515
EDO. MIRANDA,MP. PAZ CASTILLO,63099,127,1078,51717,38237,50639,13,234,29,127,63099,33,12093,51717
EDO. MIRANDA,MP. CRISTOBAL ROJAS,78486,157,1560,65614,41403,64054,22,303,31,158,79053,58,22237,65614
EDO. MIRANDA,MP. CARRIZAL,35876,70,529,29982,12818,29453,8,101,21,71,36403,39,16466,29982
EDO. MIRANDA,MP. CHACAO,81580,156,698,60077,10910,59379,13,128,26,157,82111,40,48262,60077
EDO. MIRANDA,MP. ZAMORA,116976,233,2022,99170,53039,97148,13,352,47,236,118640,82,43615,99170
EDO. MIRANDA,MP. BRION,38808,80,866,31352,18836,30486,6,143,20,80,38808,22,11459,31352
EDO. MIRANDA,MP. URDANETA,81255,167,1603,67652,43811,66049,28,300,41,168,81789,61,21808,67652
EDO. MIRANDA,MP. LANDER,88765,175,1643,73106,52965,71463,20,329,43,176,89294,49,18057,73106
EDO. MIRANDA,MP. ACEVEDO,55204,140,1206,42646,28857,41440,10,192,33,144,55851,24,12324,42646
EDO. MIRANDA,CE. GUAICAIPURO,186497,364,3019,153829,77121,150810,57,623,94,366,187594,127,72788,153829
EDO. MIRANDA,MP. PAEZ,25955,55,545,20905,12911,20360,5,82,10,55,25955,6,7346,20905
EDO. MONAGAS,MP. SOTILLO,14870,33,234,11113,7599,10879,1,85,10,36,15902,2,3182,11113
EDO. MONAGAS,MP. PUNCERES,21237,46,359,16701,10454,16342,6,116,3,46,21237,7,5756,16701
EDO. MONAGAS,MP. CEDE#O,23542,52,312,18842,9045,18530,1,103,16,57,25364,5,9360,18842
EDO. MONAGAS,MP. PIAR,30782,72,467,24184,15102,23717,7,110,12,74,31535,6,8480,24184
EDO. MONAGAS,MP. ACOSTA,15221,35,265,11729,6088,11464,1,33,4,35,15221,7,5331,11729
EDO. MONAGAS,MP. LIBERTADOR,27199,55,498,21669,15300,21171,7,162,11,58,28703,7,5684,21669
EDO. MONAGAS,MP. SANTA BARBARA,7182,16,151,5845,3522,5694,0,28,1,17,7580,5,2138,5845
EDO. MONAGAS,MP. BOLIVAR,26627,63,438,20659,12845,20221,6,101,4,64,27194,5,7260,20659
EDO. MONAGAS,MP. CARIPE,23655,54,369,17880,10399,17511,7,58,19,56,24618,4,7024,17880
EDO. MONAGAS,MP. URACOA,7404,17,171,5889,2757,5718,1,24,4,17,7404,1,2931,5889
EDO. MONAGAS,CE. MATURIN,324256,651,4695,266843,145434,262148,49,1636,130,680,337596,99,114800,266843
EDO. MONAGAS,MP. EZEQUIEL ZAMORA,40477,81,835,33454,20587,32619,10,181,14,84,42047,9,11818,33454
EDO. MONAGAS,MP. AGUASAY,10684,23,212,8517,5276,8305,1,59,4,23,10684,0,2965,8517
EDO. PORTUGUESA,MP. GUANARITO,24647,58,500,19930,13532,19430,9,85,34,61,25488,3,5767,19930
EDO. PORTUGUESA,MP. OSPINO,31763,91,550,25199,18359,24649,10,174,26,91,31763,6,6074,25199
EDO. PORTUGUESA,MP.GENARO BOCONOITO,16330,36,287,13497,10939,13210,4,75,9,36,16330,1,2182,13497
EDO. PORTUGUESA,MP.S RAFAEL DE ONOTO,12269,27,223,10212,7254,9989,2,69,5,27,12269,2,2657,10212
EDO. PORTUGUESA,CE. GUANARE,119176,257,2403,99137,63471,96734,44,638,77,270,123273,30,32474,99137
EDO. PORTUGUESA,MP. ESTELLER,28848,70,508,23769,18175,23261,14,167,22,71,29052,7,4876,23769
EDO. PORTUGUESA,MP. SANTA ROSALIA,8332,20,112,6760,5347,6648,5,35,2,30,12132,0,1259,6760
EDO. PORTUGUESA,MP. TUREN,41837,91,623,34027,24692,33404,8,220,30,92,42380,11,8443,34027
EDO. PORTUGUESA,MP. PAPELON,9808,25,180,7897,5393,7717,6,44,10,30,11402,1,2263,7897
EDO. PORTUGUESA,MP. AGUA BLANCA,14214,32,285,12205,9578,11920,6,53,11,32,14214,5,2267,12205
EDO. PORTUGUESA,MP. ARAURE,87249,184,1439,73909,50479,72470,32,358,50,185,87790,38,21513,73909
EDO. PORTUGUESA,MP. SUCRE,29695,74,588,23995,15560,23407,7,119,21,78,31853,6,7694,23995
EDO. PORTUGUESA,MP. M.JOSE V DE UNDA,13563,37,256,10365,7624,10109,4,76,7,45,16793,2,2396,10365
EDO. PORTUGUESA,MP. PAEZ,122325,244,2134,101272,69139,99138,40,601,55,245,122850,59,29244,101272
EDO. SUCRE,MP. ANDRES E BLANCO,18261,41,228,13328,7389,13100,7,65,7,44,19202,3,5629,13328
EDO. SUCRE,MP. LIBERTADOR,8165,21,135,6187,3980,6052,2,19,2,21,8165,3,2046,6187
EDO. SUCRE,MP. MARI#O,16551,38,203,11427,7207,11224,1,34,4,38,16551,2,3976,11427
EDO. SUCRE,MP. ARISMENDI,32743,84,358,24026,15558,23668,6,76,6,91,33905,4,8018,24026
EDO. SUCRE,MP. ANDRES MATA,16010,49,198,12035,7767,11837,1,29,4,50,16572,5,4031,12035
EDO. SUCRE,MP. BERMUDEZ,94502,194,1203,74900,44112,73697,14,324,49,198,96625,24,29174,74900
EDO. SUCRE,MP. CAJIGAL,14959,46,216,10791,7615,10575,1,39,1,47,15148,2,2917,10791
EDO. SUCRE,MP. CRUZ S ACOSTA,24673,53,329,19312,12526,18983,3,78,12,53,24673,2,6362,19312
EDO. SUCRE,MP. BOLIVAR,15272,36,221,11874,6355,11653,1,57,4,36,15272,1,5235,11874
EDO. SUCRE,MP. BENITEZ,21838,60,217,16099,10735,15882,4,54,9,63,23288,2,5078,16099
EDO. SUCRE,MP. RIBERO,38651,94,455,27376,18261,26921,5,109,16,95,38789,5,8525,27376
EDO. SUCRE,CE. SUCRE,237097,472,3088,186107,99174,183019,61,966,94,479,240756,73,82651,186107
EDO. SUCRE,MP. MONTES,38940,90,411,28180,18209,27769,11,111,16,93,40017,5,9417,28180
EDO. SUCRE,MP. MEJIA,11394,28,132,8646,5120,8514,2,31,5,29,11813,1,3355,8646
EDO. SUCRE,MP. VALDEZ,26846,61,343,19207,13884,18864,2,60,9,61,26846,5,4904,19207
EDO. TACHIRA,MP. INDEPENDENCIA,24290,49,443,20604,9060,20161,5,103,4,49,24290,6,10983,20604
EDO. TACHIRA,MP. SAN JUDAS TADEO,6821,16,139,5523,3332,5384,0,24,2,17,7314,1,2025,5523
EDO. TACHIRA,CE. SAN CRISTOBAL,201241,390,2574,168994,52493,166420,24,532,53,396,203952,72,113246,168994
EDO. TACHIRA,MP. ANTONIO ROMULO C,7473,17,169,6186,3823,6017,2,27,0,17,7473,2,2163,6186
EDO. TACHIRA,MP. SUCRE,6100,21,65,4958,2879,4893,0,7,0,22,6231,1,2006,4958
EDO. TACHIRA,MP. LIBERTADOR,14539,34,195,12071,5961,11876,4,39,5,34,14539,5,5862,12071
EDO. TACHIRA,MP. PANAMERICANO,18920,42,328,15092,7889,14764,4,72,3,42,18920,2,6794,15092
EDO. TACHIRA,MP. SIMON RODRIGUEZ,2520,5,41,2108,953,2067,0,7,4,5,2520,0,1103,2108
EDO. TACHIRA,MP. ANDRES BELLO,16661,35,310,14205,5740,13895,2,42,6,35,16661,9,8096,14205
EDO. TACHIRA,MP. LIBERTAD,18035,43,368,14956,7545,14588,4,59,4,43,18035,4,6972,14956
EDO. TACHIRA,MP. SAMUEL MALDONADO,10954,28,213,9094,5066,8881,2,20,2,29,11490,4,3787,9094
EDO. TACHIRA,MP. TORBES,26756,51,687,21919,11054,21232,5,83,9,52,27311,10,10071,21919
EDO. TACHIRA,MP. JOSE MARIA VARGA,7536,20,135,6322,3311,6187,0,24,2,20,7536,0,2850,6322
EDO. TACHIRA,MP. LOBATERA,9635,24,145,8081,4564,7936,0,29,1,24,9635,4,3338,8081
EDO. TACHIRA,MP. MICHELENA,13253,30,202,11195,5546,10993,2,40,5,30,13253,9,5391,11195
EDO. TACHIRA,MP. GUASIMOS,27640,56,598,24139,9454,23541,8,71,10,57,28127,13,13985,24139
EDO. TACHIRA,MP. URIBANTE,13868,49,204,10879,5437,10675,2,20,2,52,14679,2,5212,10879
EDO. TACHIRA,MP. GARCIA DE HEVIA,32327,70,492,25753,15006,25261,4,114,5,72,33224,3,10129,25753
EDO. TACHIRA,MP. CORDOBA,20108,41,499,16490,7670,15991,1,62,1,41,20108,10,8247,16490
EDO. TACHIRA,MP. JUNIN,55345,111,980,46941,20974,45961,10,205,17,111,55345,28,24727,46941
EDO. TACHIRA,MP. FERNANDEZ FEO,26531,65,483,21799,11830,21316,5,120,10,65,26531,6,9345,21799
EDO. TACHIRA,MP. AYACUCHO,35485,76,639,29657,13021,29018,5,103,6,77,35996,7,15876,29657
EDO. TACHIRA,MP. JAUREGUI,27057,67,496,22530,10103,22034,7,93,15,67,27057,5,11811,22530
EDO. TACHIRA,MP. FCO DE MIRANDA,3684,9,37,3119,1059,3082,0,10,2,10,3978,0,2011,3119
EDO. TACHIRA,MP. BOLIVAR,49237,99,695,29764,11590,29069,6,138,5,99,49237,7,17323,29764
EDO. TACHIRA,MP. SEBORUCO,6140,17,113,5067,2534,4954,0,14,1,20,7510,0,2405,5067
EDO. TACHIRA,MP. RAFAEL URDANETA,4188,12,90,3422,1915,3332,1,17,3,14,5006,3,1393,3422
EDO. TACHIRA,MP.PEDRO MARIA URE#A,33725,67,498,21326,9368,20828,1,108,10,68,34112,5,11336,21326
EDO. TACHIRA,MP. CARDENAS,67000,132,1136,57603,21859,56467,6,201,14,137,69016,23,34364,57603
EDO. TRUJILLO,MP. PAMPANITO,17286,41,271,14573,9109,14302,4,56,4,41,17286,4,5125,14573
EDO. TRUJILLO,MP. MOTATAN,13044,29,288,11078,7664,10790,2,37,4,29,13044,2,3081,11078
EDO. TRUJILLO,MP. ANDRES BELLO,11722,25,250,8855,5983,8605,0,17,4,25,11722,1,2600,8855
EDO. TRUJILLO,MP. BOCONO,65361,180,1022,50058,34013,49036,19,260,47,184,66836,24,14673,50058
EDO. TRUJILLO,MP. RAFAEL RANGEL,15422,32,269,12722,7041,12453,2,55,4,32,15422,6,5345,12722
EDO. TRUJILLO,MP. BOLIVAR,10613,24,154,8377,6143,8223,0,27,2,24,10613,2,2049,8377
EDO. TRUJILLO,CE. TRUJILLO,42708,99,601,34711,20397,34110,1,146,25,100,42789,20,13521,34711
EDO. TRUJILLO,MP. CARACHE,21818,78,288,16836,12149,16548,3,69,11,78,21818,3,4313,16836
EDO. TRUJILLO,MP. CANDELARIA,19360,58,238,14705,11482,14467,2,57,6,61,20732,1,2919,14705
EDO. TRUJILLO,MP. SUCRE,19391,40,256,15509,9956,15253,7,50,5,40,19391,2,5233,15509
EDO. TRUJILLO,MP. PAMPAN,32904,79,539,26432,17899,25893,6,104,9,81,33706,5,7870,26432
EDO. TRUJILLO,MP. JUAN V CAMPO ELI,5442,14,70,4366,3286,4296,2,11,3,14,5442,2,992,4366
EDO. TRUJILLO,MP. ESCUQUE,19321,48,294,16220,9737,15926,1,73,6,49,19842,4,6105,16220
EDO. TRUJILLO,MP. VALERA,97532,201,1371,81870,42671,80499,21,302,39,205,99540,37,37429,81870
EDO. TRUJILLO,MP. MONTE CARMELO,10920,31,161,8431,6001,8270,1,28,2,31,10920,1,2237,8431
EDO. TRUJILLO,MP. URDANETA,24408,63,351,18563,11783,18212,5,64,19,63,24408,3,6338,18563
EDO. TRUJILLO,MP. LA CEIBA,12776,27,139,9665,7569,9526,3,20,1,27,12776,0,1933,9665
EDO. TRUJILLO,MP. JOSE F M CA#IZAL,4395,9,54,3285,2030,3231,1,11,2,9,4395,0,1187,3285
EDO. TRUJILLO,MP. MIRANDA,14825,33,267,11711,8053,11444,1,47,3,33,14825,1,3339,11711
EDO. TRUJILLO,MP.S RAFAEL CARVAJAL,36009,73,573,30036,17110,29463,3,84,10,73,36009,7,12249,30036
EDO. VARGAS,CE. VARGAS,263656,547,4105,209774,126365,205669,68,1007,133,553,265911,157,77939,209774
EDO. YARACUY,MP. INDEPENDENCIA,38154,81,893,31915,14004,31022,6,178,20,81,38154,15,16799,31915
EDO. YARACUY,MP.JOSE ANTONIO PAEZ,12713,27,257,10678,7305,10421,2,77,7,27,12713,2,3028,10678
EDO. YARACUY,MP. NIRGUA,40676,111,742,32654,20408,31912,14,164,24,113,41623,20,11282,32654
EDO. YARACUY,MP. LA TRINIDAD,11118,25,253,9432,5253,9179,2,46,3,26,11486,3,3872,9432
EDO. YARACUY,MP. VEROES,17918,48,389,14583,11268,14194,3,54,8,50,18425,3,2858,14583
EDO. YARACUY,MP. ARISTIDES BASTID,13828,35,273,11313,7386,11040,4,66,6,35,13828,2,3576,11313
EDO. YARACUY,MP. PE#A,63456,138,1189,52144,32436,50955,15,284,44,139,63893,20,18156,52144
EDO. YARACUY,MP. SUCRE,14178,32,287,12163,6746,11876,4,68,4,32,14178,3,5051,12163
EDO. YARACUY,MP. URACHICHE,14404,34,318,11819,8220,11501,6,61,5,35,15001,2,3207,11819
EDO. YARACUY,MP. BOLIVAR,20744,54,388,16932,10898,16544,7,78,6,55,21269,3,5552,16932
EDO. YARACUY,MP. BRUZUAL,45405,97,804,37290,23687,36486,21,189,29,99,46554,19,12541,37290
EDO. YARACUY,CE. SAN FELIPE,68758,147,1258,56671,27925,55413,14,298,36,148,69304,27,27113,56671
EDO. YARACUY,MP. MANUEL MONGE,11493,27,212,9395,6708,9183,7,33,5,28,12072,3,2427,9395
EDO. YARACUY,MP. COCOROTE,26885,55,660,22210,10455,21550,7,106,11,55,26885,14,10957,22210
EDO. ZULIA,MP. LA CA#ADA DE U.,46316,88,336,37293,19815,36957,1,61,5,89,46796,5,17070,37293
EDO. ZULIA,MP. COLON,67895,138,871,54729,30107,53858,10,160,16,140,68776,9,23556,54729
EDO. ZULIA,MP. JESUS E LOSSADA,63908,127,936,49551,28883,48615,8,128,26,128,64408,13,19557,49551
EDO. ZULIA,MP. SIMON BOLIVAR,32248,62,551,26621,14231,26070,12,85,13,62,32248,10,11719,26621
EDO. ZULIA,MP. SUCRE,39043,84,605,30255,18931,29650,11,81,11,85,39601,8,10608,30255
EDO. ZULIA,MP. MIRANDA,63731,139,831,53716,35172,52885,8,152,18,143,65392,13,17522,53716
EDO. ZULIA,MP. LAGUNILLAS,122234,229,1978,101249,46880,99271,30,363,55,231,123385,40,51903,101249
EDO. ZULIA,MP. CATATUMBO,18006,38,186,13627,6983,13441,1,35,4,44,20052,2,6416,13627
EDO. ZULIA,MP. MACHIQUES DE P,74920,151,896,54541,28706,53645,13,183,30,152,75419,3,24710,54541
EDO. ZULIA,MP. CABIMAS,179263,354,2371,151111,84344,148740,27,541,63,363,182607,57,63708,151111
EDO. ZULIA,MP. BLVNO GUAJIRA,62399,135,621,36050,25124,35429,12,157,27,136,62881,3,10106,36050
EDO. ZULIA,MP. JESUS M SEMPRUN,15349,36,182,12033,8161,11851,1,54,2,39,15892,1,3632,12033
EDO. ZULIA,CE. MARACAIBO,923243,1762,10542,733754,331295,723212,109,1794,299,1768,926484,316,389399,733754
EDO. ZULIA,MP. ALMIRANTE P,9635,19,73,7619,5645,7546,0,15,0,19,9635,0,1886,7619
EDO. ZULIA,MP.ROSARIO DE PERIJA,54057,103,631,40435,22218,39804,7,90,17,106,55692,4,17468,40435
EDO. ZULIA,MP. SAN FRANCISCO,271530,522,3193,221397,123829,218204,25,695,96,525,273207,69,93490,221397
EDO. ZULIA,MP. SANTA RITA,39067,79,496,32205,18422,31709,10,109,8,79,39067,10,13150,32205
EDO. ZULIA,MP. BARALT,55568,118,677,44532,27404,43855,5,186,17,118,55568,6,16237,44532
EDO. ZULIA,MP.VALMORE RODRIGUEZ,36826,73,680,29978,16043,29298,6,136,23,73,36826,7,13083,29978
EDO. ZULIA,MP. FRANCISCO J PULG,18613,39,331,14522,7905,14191,3,26,7,40,18910,2,6248,14522
EDO. ZULIA,MP. MARA,121683,240,1315,95107,65991,93792,20,261,51,240,121683,18,27451,95107
EDO.NVA.ESPARTA,MP.VILLALBA(I.COCHE),7232,14,97,5935,3246,5838,0,22,14,14,7232,1,2555,5935
EDO.NVA.ESPARTA,CE. ARISMENDI,20288,41,294,16942,6839,16648,3,58,6,42,20813,10,9732,16942
EDO.NVA.ESPARTA,MP. MANEIRO,34486,70,350,28322,9166,27972,1,66,2,70,34486,9,18728,28322
EDO.NVA.ESPARTA,MP. GOMEZ,26456,53,295,21822,11988,21527,0,114,3,53,26456,5,9417,21822
EDO.NVA.ESPARTA,MP. GARCIA,38025,74,642,30693,16596,30051,2,157,8,74,38025,13,13275,30693
EDO.NVA.ESPARTA,MP. MARCANO,25301,52,353,20799,11685,20446,4,116,13,52,25301,4,8624,20799
EDO.NVA.ESPARTA,MP. DIAZ,40234,82,919,33266,18812,32347,9,152,5,82,40234,13,13356,33266
EDO.NVA.ESPARTA,MP. TUBORES,22825,48,354,18532,10590,18178,2,73,6,49,23247,3,7504,18532
EDO.NVA.ESPARTA,MP.PENIN. DE MACANAO,17396,40,176,13235,7554,13059,1,56,4,41,17752,7,5437,13235
EDO.NVA.ESPARTA,MP. MARI#O,71928,142,1104,56475,26683,55371,9,247,18,150,75992,16,28398,56475
EDO.NVA.ESPARTA,MP.ANTOLIN DEL CAMPO,20006,42,250,16817,8423,16567,3,80,1,42,20006,8,8052,16817
