Estado,Municipio,Parroquia,Número de Electores escrutados.,Número de Actas Procesadas.,Número total de Votos Nulos.,Número Total de Votantes que votaron realmente.,HUGO CHAVEZ,Número total de Votos Válidos.,ORLANDO CHIRINO,REINA SEQUERA,LUIS REYES,Número de Actas Esperadas.,Número de Electores Esperados.,MARIA BOLIVAR,HENRIQUE CAPRILES RADONSKI,Número de Votos Escrutados.
DTTO. CAPITAL,CE. BLVNO LIBERTADOR,PQ. LA PASTORA,70087,143,975,56625,29109,55650,15,254,39,143,70087,67,26166,56625
DTTO. CAPITAL,CE. BLVNO LIBERTADOR,PQ. CARICUAO,105140,206,1653,89072,45583,87419,27,379,64,206,105140,98,41268,89072
DTTO. CAPITAL,CE. BLVNO LIBERTADOR,PQ. EL PARAISO,90236,175,1074,72830,26591,71756,22,269,28,175,90236,60,44786,72830
DTTO. CAPITAL,CE. BLVNO LIBERTADOR,PQ. ALTAGRACIA,35211,68,440,28340,12975,27900,5,133,11,68,35211,22,14754,28340
DTTO. CAPITAL,CE. BLVNO LIBERTADOR,PQ. SAN PEDRO,58591,116,519,46013,11964,45494,23,103,23,116,58591,46,33335,46013
DTTO. CAPITAL,CE. BLVNO LIBERTADOR,PQ. SAN JOSE,33204,64,532,26395,11442,25863,1,114,16,64,33204,31,14259,26395
DTTO. CAPITAL,CE. BLVNO LIBERTADOR,PQ. EL JUNQUITO,42688,85,685,34310,18317,33625,19,167,21,85,42688,32,15069,34310
DTTO. CAPITAL,CE. BLVNO LIBERTADOR,PQ. SANTA TERESA,20779,41,276,16139,6498,15863,7,71,8,41,20779,17,9262,16139
DTTO. CAPITAL,CE. BLVNO LIBERTADOR,PQ. CANDELARIA,50240,96,731,38775,12527,38044,12,120,23,96,50240,48,25314,38775
DTTO. CAPITAL,CE. BLVNO LIBERTADOR,PQ. ANTIMANO,95159,192,1618,76687,56372,75069,28,320,51,192,95159,57,18241,76687
DTTO. CAPITAL,CE. BLVNO LIBERTADOR,PQ. LA VEGA,96695,189,1461,78905,44943,77444,25,342,44,189,96695,70,32020,78905
DTTO. CAPITAL,CE. BLVNO LIBERTADOR,PQ. MACARAO,45892,96,905,38342,26970,37437,21,155,33,96,45892,37,10221,38342
DTTO. CAPITAL,CE. BLVNO LIBERTADOR,PQ. SAN BERNARDINO,26501,52,255,19632,6273,19377,5,66,5,52,26501,16,13012,19632
DTTO. CAPITAL,CE. BLVNO LIBERTADOR,PQ. 23 DE ENERO,72324,153,1271,59539,38663,58268,23,241,51,153,72324,70,19220,59539
DTTO. CAPITAL,CE. BLVNO LIBERTADOR,PQ. COCHE,52996,113,764,42937,25357,42173,16,162,25,113,52996,39,16574,42937
DTTO. CAPITAL,CE. BLVNO LIBERTADOR,PQ. EL RECREO,94280,185,1005,71101,24965,70096,22,224,24,185,94280,70,44791,71101
DTTO. CAPITAL,CE. BLVNO LIBERTADOR,PQ. CATEDRAL,16891,33,323,12602,8403,12279,6,55,7,33,16891,6,3802,12602
DTTO. CAPITAL,CE. BLVNO LIBERTADOR,PQ. SAN AGUSTIN,32983,65,499,26133,16028,25634,10,88,13,65,32983,17,9478,26133
DTTO. CAPITAL,CE. BLVNO LIBERTADOR,PQ. SAN JUAN,77913,154,1211,62547,32389,61336,21,278,47,154,77913,66,28535,62547
DTTO. CAPITAL,CE. BLVNO LIBERTADOR,PQ. EL VALLE,114667,223,2274,92974,55677,90700,22,361,62,223,114667,81,34497,92974
DTTO. CAPITAL,CE. BLVNO LIBERTADOR,PQ. SANTA ROSALIA,85106,168,1420,67790,36481,66370,18,260,44,168,85106,52,29515,67790
DTTO. CAPITAL,CE. BLVNO LIBERTADOR,PQ. SUCRE,291393,590,5346,234836,147635,229490,92,1162,157,590,291393,251,80193,234836
EDO. AMAZONAS,MP. ATABAPO,PQ. YAPACANA,174,1,11,132,18,121,0,4,0,3,614,0,99,132
EDO. AMAZONAS,MP. ATABAPO,PQ. CANAME,232,1,5,144,76,139,0,0,0,1,232,0,63,144
EDO. AMAZONAS,MP. ATABAPO,PQ. UCATA,674,2,16,531,291,515,0,5,1,2,674,0,218,531
EDO. AMAZONAS,MP. ATABAPO,CM. SAN FERNANDO DE ATABA,4584,11,100,3399,1390,3299,3,41,1,11,4584,6,1858,3399
EDO. AMAZONAS,MP. RIO NEGRO,PQ. SOLANO,329,2,14,247,95,233,1,11,0,2,329,0,126,247
EDO. AMAZONAS,MP. RIO NEGRO,CM. SAN CARLOS DE RIO NEG,1663,4,33,1126,463,1093,0,20,0,4,1663,0,610,1126
EDO. AMAZONAS,MP. RIO NEGRO,PQ. CASIQUIARE,146,1,1,125,46,124,0,0,0,1,146,0,78,125
EDO. AMAZONAS,MP. RIO NEGRO,PQ. COCUY,165,1,1,87,24,86,0,1,0,1,165,0,61,87
EDO. AMAZONAS,CE. ATURES,PQ. FERNANDO GIRON TOVAR,23268,49,591,18420,8574,17829,5,146,2,50,23716,9,9093,18420
EDO. AMAZONAS,CE. ATURES,PQ. PARHUE#A,3556,9,105,2952,1549,2847,0,15,2,17,6738,0,1281,2952
EDO. AMAZONAS,CE. ATURES,PQ. LUIS ALBERTO GOMEZ,30020,63,679,24551,13436,23872,10,158,10,69,32825,11,10247,24551
EDO. AMAZONAS,CE. ATURES,PQ. PLATANILLAL,4250,11,161,3553,2046,3392,1,24,2,18,6493,0,1319,3553
EDO. AMAZONAS,MP. MANAPIARE,PQ. MEDIO VENTUARI,275,1,6,172,98,166,0,4,0,2,593,0,64,172
EDO. AMAZONAS,MP. MANAPIARE,CM. SAN JUAN DE MANAPIARE,2558,6,46,1888,1346,1842,1,13,1,6,2558,0,481,1888
EDO. AMAZONAS,MP. MANAPIARE,PQ. ALTO VENTUARI
EDO. AMAZONAS,MP. MANAPIARE,PQ. BAJO VENTUARI
EDO. AMAZONAS,MP. ALTO ORINOCO,CM. LA ESMERALDA,919,3,12,538,355,526,0,9,0,4,1170,0,162,538
EDO. AMAZONAS,MP. ALTO ORINOCO,PQ. SIERRA PARIMA
EDO. AMAZONAS,MP. ALTO ORINOCO,PQ. MARAWAKA
EDO. AMAZONAS,MP. ALTO ORINOCO,PQ. HUACHAMACARE
EDO. AMAZONAS,MP. ALTO ORINOCO,PQ. MAVACA
EDO. AMAZONAS,MP. MAROA,PQ. VICTORINO,389,2,4,308,202,304,0,1,0,2,389,0,101,308
EDO. AMAZONAS,MP. MAROA,PQ. COMUNIDAD,177,1,1,129,94,128,0,0,0,1,177,0,34,129
EDO. AMAZONAS,MP. MAROA,CM. MAROA,1587,3,19,1185,700,1166,0,10,0,3,1587,1,455,1185
EDO. AMAZONAS,MP. AUTANA,PQ. MUNDUAPO,278,1,3,247,130,244,0,1,0,2,847,0,113,247
EDO. AMAZONAS,MP. AUTANA,PQ. GUAYAPO,810,2,15,632,399,617,0,4,1,2,810,0,213,632
EDO. AMAZONAS,MP. AUTANA,PQ. SIPAPO,924,3,32,831,408,799,0,5,0,3,924,0,386,831
EDO. AMAZONAS,MP. AUTANA,CM. ISLA DE RATON,1487,3,28,1131,469,1103,1,10,1,4,2009,0,622,1131
EDO. AMAZONAS,MP. AUTANA,PQ. SAMARIAPO,1749,5,33,1384,687,1351,0,12,2,5,1749,1,649,1384
EDO. ANZOATEGUI,MP. INDEPENDENCIA,PQ. MAMO,5069,11,120,4136,3345,4016,1,19,6,12,5218,2,643,4136
EDO. ANZOATEGUI,MP. INDEPENDENCIA,CM. SOLEDAD,17714,39,332,13631,9098,13299,3,79,9,41,18665,6,4104,13631
EDO. ANZOATEGUI,MP. ARAGUA,CM. ARAGUA DE BARCELONA,20423,49,305,16649,9537,16344,10,109,14,49,20423,4,6670,16649
EDO. ANZOATEGUI,MP. ARAGUA,PQ. CACHIPO,931,2,21,749,541,728,1,4,0,3,1397,1,181,749
EDO. ANZOATEGUI,MP. MC GREGOR,PQ.TOMAS ALFARO CALATRAVA,1708,3,15,1243,1034,1228,1,9,3,3,1708,0,181,1243
EDO. ANZOATEGUI,MP. MC GREGOR,PQ. EL CHAPARRO,5875,13,88,4534,3086,4446,1,18,4,13,5875,0,1337,4534
EDO. ANZOATEGUI,MP. PE#ALVER,CM. PUERTO PIRITU,16838,32,308,13964,6775,13656,6,112,10,32,16838,5,6748,13964
EDO. ANZOATEGUI,MP. PE#ALVER,PQ. SUCRE,2072,5,33,1656,955,1623,0,8,0,5,2072,0,660,1656
EDO. ANZOATEGUI,MP. PE#ALVER,PQ. SAN MIGUEL,2589,5,56,2100,1190,2044,0,14,0,5,2589,0,840,2100
EDO. ANZOATEGUI,MP. MIRANDA,CM. PARIAGUAN,23049,45,467,18647,10458,18180,3,142,14,46,23640,7,7556,18647
EDO. ANZOATEGUI,MP. MIRANDA,PQ. EL PAO,2837,6,54,2240,1248,2186,0,12,3,6,2837,0,923,2240
EDO. ANZOATEGUI,MP. MIRANDA,PQ. ATAPIRIRE,3387,9,85,2623,1340,2538,1,17,1,9,3387,0,1179,2623
EDO. ANZOATEGUI,MP. MIRANDA,PQ. BOCA DEL PAO,2201,5,26,1500,889,1474,0,1,2,5,2201,0,582,1500
EDO. ANZOATEGUI,MP. BRUZUAL,PQ. GUANAPE,5507,13,87,4297,2250,4210,1,25,5,13,5507,0,1929,4297
EDO. ANZOATEGUI,MP. BRUZUAL,PQ. SABANA DE UCHIRE,4161,9,68,3319,1627,3251,0,24,4,9,4161,1,1595,3319
EDO. ANZOATEGUI,MP. BRUZUAL,CM. CLARINES,12052,25,243,10051,4772,9808,4,36,3,25,12052,2,4991,10051
EDO. ANZOATEGUI,MP.S JUAN CAPISTRANO,PQ. BOCA DE CHAVEZ,833,2,22,668,346,646,0,4,0,2,833,0,296,668
EDO. ANZOATEGUI,MP.S JUAN CAPISTRANO,PQ. BOCA UCHIRE,6041,12,108,4795,2618,4687,3,30,3,12,6041,1,2032,4795
EDO. ANZOATEGUI,MP. SIMON RODRIGUEZ,CM. EL TIGRE,113514,221,1973,92728,42636,90755,25,619,35,222,113972,29,47411,92728
EDO. ANZOATEGUI,MP. LIBERTAD,CM. SAN MATEO,8224,16,121,6360,3625,6239,0,43,3,16,8224,0,2568,6360
EDO. ANZOATEGUI,MP. LIBERTAD,PQ. EL CARITO,1598,3,17,1193,614,1176,0,7,0,3,1598,0,555,1193
EDO. ANZOATEGUI,MP. LIBERTAD,PQ. SANTA INES,2057,4,19,1525,921,1506,0,7,1,6,3056,0,577,1525
EDO. ANZOATEGUI,MP. CAJIGAL,PQ. SAN PABLO,2094,5,28,1727,1188,1699,0,2,2,5,2094,1,506,1727
EDO. ANZOATEGUI,MP. CAJIGAL,CM. ONOTO,7378,16,122,5724,3449,5602,3,48,2,17,7724,1,2099,5724
EDO. ANZOATEGUI,MP. SOTILLO,CM. PUERTO LA CRUZ,56446,108,768,45301,19287,44533,19,230,25,108,56446,22,24950,45301
EDO. ANZOATEGUI,MP. SOTILLO,PQ. POZUELOS,110768,222,1782,89484,47294,87702,37,538,50,226,112708,51,39732,89484
EDO. ANZOATEGUI,MP. CARVAJAL,PQ. SANTA BARBARA,992,2,15,830,478,815,0,0,0,2,992,0,337,830
EDO. ANZOATEGUI,MP. CARVAJAL,PQ. VALLE GUANAPE,8840,18,130,7259,3806,7129,1,32,4,18,8840,2,3284,7259
EDO. ANZOATEGUI,MP. SANTA ANA,PQ. SANTA ANA,6877,14,95,5652,2777,5557,2,41,4,14,6877,0,2733,5652
EDO. ANZOATEGUI,MP. SANTA ANA,PQ. PUEBLO NUEVO,955,3,27,716,444,689,1,4,1,3,955,1,238,716
EDO. ANZOATEGUI,MP. ANACO,PQ. SAN JOAQUIN,6197,11,120,4986,2841,4866,1,41,3,12,6536,0,1980,4986
EDO. ANZOATEGUI,MP. ANACO,PQ. ANACO,79557,154,1526,65846,31500,64320,15,525,41,155,80156,32,32207,65846
EDO. ANZOATEGUI,MP. FREITES,CM. CANTAURA,41165,82,636,34006,18295,33370,9,208,18,83,41715,6,14834,34006
EDO. ANZOATEGUI,MP. FREITES,PQ. URICA,4963,10,57,3954,2379,3897,3,14,3,10,4963,1,1497,3954
EDO. ANZOATEGUI,MP. FREITES,PQ. SANTA ROSA,4425,10,53,3650,2258,3597,0,15,2,10,4425,0,1322,3650
EDO. ANZOATEGUI,MP. FREITES,PQ. LIBERTADOR
EDO. ANZOATEGUI,MP. GUANTA,PQ. GUANTA,15499,31,297,13147,6373,12850,2,55,2,31,15499,1,6417,13147
EDO. ANZOATEGUI,MP. GUANTA,PQ. CHORRERON,8858,19,201,7226,4356,7025,1,50,2,19,8858,4,2612,7226
EDO. ANZOATEGUI,CE. BOLIVAR,PQ. CAIGUA,4074,8,90,3216,2010,3126,1,16,2,8,4074,2,1095,3216
EDO. ANZOATEGUI,CE. BOLIVAR,PQ. EL CARMEN,118878,226,1984,98080,48068,96096,39,582,48,229,120558,40,47319,98080
EDO. ANZOATEGUI,CE. BOLIVAR,PQ. SAN CRISTOBAL,122011,242,1998,98456,49917,96458,25,705,57,247,124779,38,45716,98456
EDO. ANZOATEGUI,CE. BOLIVAR,PQ. BERGANTIN,3450,6,49,2454,1526,2405,0,17,4,8,3662,0,858,2454
EDO. ANZOATEGUI,CE. BOLIVAR,PQ. NARICUAL,10487,24,232,7974,4595,7742,2,70,4,25,10880,2,3069,7974
EDO. ANZOATEGUI,CE. BOLIVAR,PQ. EL PILAR,2337,5,20,1673,999,1653,1,13,2,5,2337,1,637,1673
EDO. ANZOATEGUI,MP. L/DIEGO BAUTISTA,PQ. EL MORRO,5147,10,30,4268,771,4238,0,13,1,10,5147,1,3452,4268
EDO. ANZOATEGUI,MP. L/DIEGO BAUTISTA,PQ. LECHERIAS,26981,53,167,22541,3934,22374,3,44,1,53,26981,12,18380,22541
EDO. ANZOATEGUI,MP. PIRITU,PQ. SAN FRANCISCO,703,2,6,572,346,566,0,2,0,2,703,0,218,572
EDO. ANZOATEGUI,MP. PIRITU,PQ. PIRITU,16893,34,343,14117,7619,13774,1,69,9,35,17337,6,6070,14117
EDO. ANZOATEGUI,MP. GUANIPA,CM. SAN JOSE DE GUANIPA,50706,101,789,41800,22772,41011,6,298,14,103,51674,14,17907,41800
EDO. ANZOATEGUI,MP. MONAGAS,PQ. PIAR,1218,3,16,924,543,908,0,1,0,3,1218,0,364,924
EDO. ANZOATEGUI,MP. MONAGAS,PQ. UVERITO,1906,4,48,1490,805,1442,0,11,0,4,1906,2,624,1490
EDO. ANZOATEGUI,MP. MONAGAS,PQ. ZUATA,2414,5,58,1801,1197,1743,0,8,1,5,2414,0,537,1801
EDO. ANZOATEGUI,MP. MONAGAS,PQ. SANTA CLARA,2427,5,51,1879,1279,1828,0,9,4,5,2427,0,536,1879
EDO. ANZOATEGUI,MP. MONAGAS,CM. MAPIRE,2523,6,66,1988,1133,1922,1,17,3,8,3374,0,768,1988
EDO. ANZOATEGUI,MP. MONAGAS,PQ. SN DIEGO DE CABRUTICA,4091,9,75,3136,2284,3061,2,17,1,9,4091,0,757,3136
EDO. APURE,MP. PEDRO CAMEJO,PQ. CUNAVICHE,9132,23,76,6886,4386,6810,0,24,3,26,10420,1,2396,6886
EDO. APURE,MP. PEDRO CAMEJO,PQ. SAN JUAN DE PAYARA,7417,14,88,5780,3724,5692,2,16,1,14,7417,1,1948,5780
EDO. APURE,MP. PEDRO CAMEJO,PQ. CODAZZI,2852,8,108,1912,1407,1804,0,5,1,10,3440,0,391,1912
EDO. APURE,MP. MU#OZ,PQ. MANTECAL,9276,21,126,7242,5385,7116,1,44,3,21,9276,0,1683,7242
EDO. APURE,MP. MU#OZ,PQ. SAN VICENTE,1898,6,11,1420,1054,1409,0,7,0,6,1898,0,348,1420
EDO. APURE,MP. MU#OZ,PQ. BRUZUAL,4449,10,54,3502,2645,3448,1,20,3,10,4449,0,779,3502
EDO. APURE,MP. MU#OZ,PQ. RINCON HONDO,3781,11,57,2852,2119,2795,1,13,0,11,3781,1,661,2852
EDO. APURE,MP. MU#OZ,PQ. QUINTERO,847,2,5,599,390,594,0,2,0,3,1276,0,202,599
EDO. APURE,MP. ROMULO GALLEGOS,PQ. ELORZA,14459,31,211,10617,7310,10406,2,59,9,31,14459,0,3026,10617
EDO. APURE,MP. ROMULO GALLEGOS,PQ. LA TRINIDAD,3480,8,64,2585,1792,2521,1,8,2,8,3480,1,717,2585
EDO. APURE,CE. SAN FERNANDO,PQ. SAN FERNANDO,78408,157,1384,65149,38752,63765,11,364,45,159,79456,21,24572,65149
EDO. APURE,CE. SAN FERNANDO,PQ. EL RECREO,17319,39,262,14388,10343,14126,1,89,6,39,17319,6,3681,14388
EDO. APURE,CE. SAN FERNANDO,PQ. SN RAFAEL DE ATAMAICA,4761,10,29,3472,2301,3443,1,16,1,12,5267,0,1124,3472
EDO. APURE,CE. SAN FERNANDO,PQ. PE#ALVER,5173,13,39,3983,2972,3944,0,5,1,17,6559,2,964,3983
EDO. APURE,MP. PAEZ,PQ. SAN CAMILO,11063,22,168,8267,5064,8099,3,52,8,23,11600,0,2972,8267
EDO. APURE,MP. PAEZ,PQ. URDANETA,8360,22,107,6035,4624,5928,4,56,7,22,8360,2,1235,6035
EDO. APURE,MP. PAEZ,PQ. EL AMPARO,9332,20,205,5930,3574,5725,3,64,2,21,9793,3,2079,5930
EDO. APURE,MP. PAEZ,PQ. ARAMENDI,2680,8,23,1830,1184,1807,1,9,0,8,2680,0,613,1830
EDO. APURE,MP. PAEZ,PQ. GUASDUALITO,33061,70,647,25844,14016,25197,10,196,16,71,33653,11,10948,25844
EDO. APURE,MP. ACHAGUAS,PQ. QUESERAS DEL MEDIO,3586,9,35,2768,2127,2733,1,9,2,9,3586,0,594,2768
EDO. APURE,MP. ACHAGUAS,PQ. EL YAGUAL,3167,7,37,2300,1665,2263,0,6,2,8,3549,0,590,2300
EDO. APURE,MP. ACHAGUAS,PQ. GUACHARA,2941,8,18,2158,1525,2140,0,6,0,10,3532,0,609,2158
EDO. APURE,MP. ACHAGUAS,PQ. ACHAGUAS,20440,45,330,16494,11608,16164,5,131,15,49,21628,2,4403,16494
EDO. APURE,MP. ACHAGUAS,PQ. MUCURITAS,3671,9,57,2801,1972,2744,0,11,1,10,3887,1,759,2801
EDO. APURE,MP. ACHAGUAS,PQ. APURITO,3398,8,52,2514,1802,2462,1,19,3,8,3398,2,635,2514
EDO. APURE,MP. BIRUACA,PQ. BIRUACA,35884,82,630,29352,19146,28722,4,147,10,82,35884,7,9408,29352
EDO. ARAGUA,MP.OCUMARE D L COSTA,PQ. OCUMARE DE LA COSTA,8585,18,140,6661,4057,6521,2,26,2,18,8585,2,2432,6661
EDO. ARAGUA,MP. SANTOS MICHELENA,PQ. TIARA,2993,8,102,2364,1800,2262,0,9,1,8,2993,1,451,2364
EDO. ARAGUA,MP. SANTOS MICHELENA,CM. LAS TEJERIAS,21289,43,434,17368,13141,16934,8,51,9,43,21289,4,3721,17368
EDO. ARAGUA,MP. ZAMORA,PQ. VALLES DE TUCUTUNEMO,5991,12,156,4884,3955,4728,5,32,6,12,5991,3,727,4884
EDO. ARAGUA,MP. ZAMORA,PQ. PQ AUGUSTO MIJARES,4693,10,113,3718,2797,3605,0,22,1,10,4693,1,784,3718
EDO. ARAGUA,MP. ZAMORA,PQ. SAN FRANCISCO DE ASIS,13724,28,280,11417,7388,11137,3,60,5,28,13724,6,3675,11417
EDO. ARAGUA,MP. ZAMORA,PQ. MAGDALENO,12857,27,294,10306,7280,10012,3,59,10,27,12857,3,2657,10306
EDO. ARAGUA,MP. ZAMORA,CM. VILLA DE CURA,55981,109,921,46613,30692,45692,17,250,47,109,55981,25,14661,46613
EDO. ARAGUA,MP. JOSE ANGEL LAMAS,CM. SANTA CRUZ,22721,48,302,19354,11485,19052,4,94,15,48,22721,9,7445,19354
EDO. ARAGUA,MP. CAMATAGUA,CM. CAMATAGUA,8631,19,131,6860,4697,6729,1,47,3,19,8631,1,1980,6860
EDO. ARAGUA,MP. CAMATAGUA,PQ. CARMEN DE CURA,3195,7,77,2454,1456,2377,0,14,1,7,3195,0,906,2454
EDO. ARAGUA,MP.FRANCISCO LINARES,PQ. FRANCISCO DE MIRANDA,17704,34,332,14533,9291,14201,6,67,7,34,17704,12,4818,14533
EDO. ARAGUA,MP.FRANCISCO LINARES,CM. SANTA RITA,53578,106,997,44649,30587,43652,6,230,39,108,54711,30,12760,44649
EDO. ARAGUA,MP.FRANCISCO LINARES,PQ. MONS FELICIANO G,11007,21,142,9039,6875,8897,0,47,3,21,11007,5,1967,9039
EDO. ARAGUA,MP. JOSE R REVENGA,CM. EL CONSEJO,30956,63,528,26069,19022,25541,12,104,22,63,30956,12,6369,26069
EDO. ARAGUA,MP. SUCRE,CM. CAGUA,76296,146,1253,64533,33000,63280,17,311,23,146,76296,46,29883,64533
EDO. ARAGUA,MP. SUCRE,PQ. BELLA VISTA,6452,13,145,5211,3755,5066,2,17,6,13,6452,3,1283,5211
EDO. ARAGUA,MP. LIBERTADOR,CM. PALO NEGRO,24060,46,373,19917,12429,19544,3,96,7,46,24060,18,6991,19917
EDO. ARAGUA,MP. LIBERTADOR,PQ. SAN MARTIN DE PORRES,36081,72,624,30457,19970,29833,7,145,24,72,36081,21,9666,30457
EDO. ARAGUA,MP. TOVAR,CM. COLONIA TOVAR,12296,31,237,9552,4874,9315,7,40,9,32,12552,4,4381,9552
EDO. ARAGUA,MP. BOLIVAR,CM. SAN MATEO,28943,57,734,23271,16072,22537,4,101,13,58,29497,6,6341,23271
EDO. ARAGUA,MP. MARIO B IRAGORRY,CM. EL LIMON,29383,55,373,24705,9651,24332,5,77,21,56,29961,23,14555,24705
EDO. ARAGUA,MP. MARIO B IRAGORRY,PQ. CA A DE AZUCAR,47535,92,632,41124,21793,40492,10,162,27,93,48021,30,18470,41124
EDO. ARAGUA,MP. URDANETA,PQ. TAGUAY,3321,8,67,2756,1988,2689,1,19,1,8,3321,2,678,2756
EDO. ARAGUA,MP. URDANETA,PQ. SAN FRANCISCO DE CARA,1968,4,41,1610,1099,1569,0,4,0,4,1968,0,466,1610
EDO. ARAGUA,MP. URDANETA,CM. BARBACOAS,8621,18,231,7145,4826,6914,0,32,4,18,8621,4,2048,7145
EDO. ARAGUA,MP. URDANETA,PQ. LAS PE#ITAS,1697,4,47,1371,937,1324,1,5,1,4,1697,1,379,1371
EDO. ARAGUA,MP. JOSE FELIX RIVAS,PQ. CASTOR NIEVES RIOS,33499,63,536,29040,14035,28504,2,118,12,65,34508,23,14314,29040
EDO. ARAGUA,MP. JOSE FELIX RIVAS,PQ. ZUATA,18495,39,334,15214,11870,14880,3,72,8,39,18495,6,2921,15214
EDO. ARAGUA,MP. JOSE FELIX RIVAS,PQ. PAO DE ZARATE,2280,4,33,1840,1466,1807,1,6,3,4,2280,2,329,1840
EDO. ARAGUA,MP. JOSE FELIX RIVAS,PQ. LAS GUACAMAYAS,4472,10,96,3621,2430,3525,2,17,1,11,4978,1,1074,3621
EDO. ARAGUA,MP. JOSE FELIX RIVAS,CM. JUAN VICENTE BOLIVAR,42860,83,731,35362,19630,34631,13,178,27,84,43361,23,14760,35362
EDO. ARAGUA,MP. SAN SEBASTIAN,CM. SAN SEBASTIAN,16236,34,244,13213,8062,12969,3,39,11,34,16236,5,4849,13213
EDO. ARAGUA,MP. SAN CASIMIRO,CM. SAN CASIMIRO,14809,31,324,12135,7960,11811,4,42,8,31,14809,4,3793,12135
EDO. ARAGUA,MP. SAN CASIMIRO,PQ. VALLE MORIN,1197,3,21,972,670,951,1,10,0,3,1197,2,268,972
EDO. ARAGUA,MP. SAN CASIMIRO,PQ. OLLAS DE CARAMACATE,943,4,14,709,551,695,0,6,1,4,943,0,137,709
EDO. ARAGUA,MP. SAN CASIMIRO,PQ. GUIRIPA,1479,4,32,1235,869,1203,0,2,2,4,1479,0,330,1235
EDO. ARAGUA,MP. SANTIAGO MARI#O,PQ. ALFREDO PACHECO M,14469,28,230,11967,7899,11737,3,69,5,28,14469,11,3750,11967
EDO. ARAGUA,MP. SANTIAGO MARI#O,PQ. CHUAO,1129,3,10,900,769,890,0,3,1,3,1129,0,117,900
EDO. ARAGUA,MP. SANTIAGO MARI#O,PQ. AREVALO APONTE,24736,51,417,18983,13998,18566,5,91,11,53,25832,10,4451,18983
EDO. ARAGUA,MP. SANTIAGO MARI#O,PQ. SAMAN DE GUERE,48899,92,923,40749,24760,39826,7,199,25,93,49497,16,14819,40749
EDO. ARAGUA,MP. SANTIAGO MARI#O,CM. TURMERO,40607,77,419,33806,14192,33387,10,126,22,77,40607,26,19011,33806
EDO. ARAGUA,CE. GIRARDOT,PQ. LOS TACARIGUAS,56568,110,827,46365,29475,45538,21,219,20,110,56568,27,15776,46365
EDO. ARAGUA,CE. GIRARDOT,PQ. MADRE MA DE SAN JOSE,54497,105,525,45134,14489,44609,9,134,18,105,54497,25,29934,45134
EDO. ARAGUA,CE. GIRARDOT,PQ. PEDRO JOSE OVALLES,43530,84,628,36080,22062,35452,8,175,31,85,44017,25,13151,36080
EDO. ARAGUA,CE. GIRARDOT,PQ. JOAQUIN CRESPO,44273,86,559,36783,16151,36224,10,166,15,86,44273,28,19854,36783
EDO. ARAGUA,CE. GIRARDOT,PQ. LAS DELICIAS,42963,82,564,34865,15050,34301,8,146,25,82,42963,26,19046,34865
EDO. ARAGUA,CE. GIRARDOT,PQ. ANDRES ELOY BLANCO,45717,87,492,37210,17155,36718,11,153,20,87,45717,22,19357,37210
EDO. ARAGUA,CE. GIRARDOT,PQ. JOSE CASANOVA GODOY,49560,95,751,40961,19797,40210,3,169,24,95,49560,18,20199,40961
EDO. ARAGUA,CE. GIRARDOT,PQ. CHORONI,3734,7,51,2910,1980,2859,1,16,1,7,3734,0,861,2910
EDO. BARINAS,CE. BARINAS,PQ. SAN SILVESTRE,5482,15,95,4448,3030,4353,1,29,1,15,5482,1,1291,4448
EDO. BARINAS,CE. BARINAS,PQ. RAMON I MENDEZ,36889,72,797,30565,18423,29768,7,167,17,72,36889,5,11149,30565
EDO. BARINAS,CE. BARINAS,PQ. CORAZON DE JESUS,35432,76,612,29096,16834,28484,16,160,14,80,37390,16,11444,29096
EDO. BARINAS,CE. BARINAS,PQ. EL CARMEN,36738,67,635,30731,13955,30096,8,144,9,67,36738,10,15970,30731
EDO. BARINAS,CE. BARINAS,PQ. ALTO BARINAS,32453,63,485,28318,12515,27833,3,119,15,67,34293,14,15167,28318
EDO. BARINAS,CE. BARINAS,PQ. JUAN A RODRIGUEZ D,2580,5,78,2066,1217,1988,0,5,2,5,2580,0,764,2066
EDO. BARINAS,CE. BARINAS,PQ. MANUEL P FAJARDO,5614,13,128,4548,2618,4420,0,13,5,13,5614,0,1784,4548
EDO. BARINAS,CE. BARINAS,PQ. TORUNOS,2854,6,62,2399,1474,2337,0,4,0,7,3404,0,859,2399
EDO. BARINAS,CE. BARINAS,PQ. BARINAS,12370,25,195,9769,3825,9574,2,50,5,25,12370,3,5689,9769
EDO. BARINAS,CE. BARINAS,PQ. DOMINGA ORTIZ P,4679,10,102,3665,2273,3563,0,13,1,13,5076,0,1276,3665
EDO. BARINAS,CE. BARINAS,PQ. SANTA LUCIA,3879,9,96,2858,1674,2762,0,19,2,9,3879,0,1067,2858
EDO. BARINAS,CE. BARINAS,PQ. ROMULO BETANCOURT,29312,55,454,24143,13258,23689,2,144,11,55,29312,13,10261,24143
EDO. BARINAS,CE. BARINAS,PQ. ALFREDO A LARRIVA,5254,12,82,4267,2537,4185,0,17,3,12,5254,1,1627,4267
EDO. BARINAS,CE. BARINAS,PQ. SANTA INES,2317,5,32,1882,1262,1850,0,7,0,5,2317,0,581,1882
EDO. BARINAS,MP. CRUZ PAREDES,PQ. BARRANCAS,14536,36,229,11827,8614,11598,2,67,4,37,14590,1,2910,11827
EDO. BARINAS,MP. CRUZ PAREDES,PQ. EL SOCORRO,2916,10,55,2369,1544,2314,0,17,3,10,2916,0,750,2369
EDO. BARINAS,MP. CRUZ PAREDES,PQ. MASPARRITO
EDO. BARINAS,MP. PEDRAZA,PQ. JOSE FELIX RIBAS,5435,16,96,4284,2755,4188,2,14,1,17,5494,1,1415,4284
EDO. BARINAS,MP. PEDRAZA,PQ. IGNACIO BRICE#O,2686,7,33,1907,917,1874,0,7,1,7,2686,0,949,1907
EDO. BARINAS,MP. PEDRAZA,PQ. CIUDAD BOLIVIA,29238,63,500,23129,11879,22629,2,90,19,65,29723,1,10638,23129
EDO. BARINAS,MP. PEDRAZA,PQ. PAEZ,4821,12,103,3531,2100,3428,0,30,6,12,4821,0,1292,3531
EDO. BARINAS,MP. ROJAS,PQ. DOLORES,5260,12,89,4007,2583,3918,0,23,4,12,5260,0,1308,4007
EDO. BARINAS,MP. ROJAS,PQ. PALACIO FAJARDO,6663,14,72,5258,4266,5186,1,22,3,14,6663,0,894,5258
EDO. BARINAS,MP. ROJAS,PQ. LIBERTAD,7889,18,143,6259,4198,6116,1,47,0,18,7889,1,1869,6259
EDO. BARINAS,MP. ROJAS,PQ. SANTA ROSA,6732,17,87,5317,3867,5230,2,29,4,17,6732,1,1327,5317
EDO. BARINAS,MP. ARISMENDI,PQ. SAN ANTONIO,3103,8,46,2185,1405,2139,0,13,0,8,3103,2,719,2185
EDO. BARINAS,MP. ARISMENDI,PQ. ARISMENDI,6501,22,111,4605,3240,4494,2,32,6,25,7507,0,1214,4605
EDO. BARINAS,MP. ARISMENDI,PQ. GUADARRAMA,1661,9,27,1241,962,1214,0,7,1,9,1661,0,244,1241
EDO. BARINAS,MP. ARISMENDI,PQ. LA UNION,4617,13,49,2998,2069,2949,2,8,2,14,5188,0,868,2998
EDO. BARINAS,MP. ALBERTO ARVELO T,PQ. RODRIGUEZ DOMINGUEZ,5690,14,73,4775,3875,4702,1,22,4,14,5690,0,800,4775
EDO. BARINAS,MP. ALBERTO ARVELO T,PQ. SABANETA,21387,45,399,17679,14025,17280,1,81,3,46,21965,6,3164,17679
EDO. BARINAS,MP. ANDRES E. BLANCO,PQ. EL CANTON,5052,12,57,3947,2354,3890,1,14,1,13,5651,2,1518,3947
EDO. BARINAS,MP. ANDRES E. BLANCO,PQ. PUERTO VIVAS,2288,7,41,1831,1168,1790,0,9,0,8,2808,0,613,1831
EDO. BARINAS,MP. ANDRES E. BLANCO,PQ. SANTA CRUZ DE GUACAS,3382,8,48,2561,1446,2513,0,24,1,8,3382,0,1042,2561
EDO. BARINAS,MP. A JOSE DE SUCRE,PQ. ANDRES BELLO,4253,9,75,3364,1839,3289,2,14,2,9,4253,0,1432,3364
EDO. BARINAS,MP. A JOSE DE SUCRE,PQ. TICOPORO,36937,73,659,29190,15171,28531,7,145,20,74,37502,6,13182,29190
EDO. BARINAS,MP. A JOSE DE SUCRE,PQ. NICOLAS PULIDO,5259,12,82,4087,2611,4005,2,23,2,12,5259,0,1367,4087
EDO. BARINAS,MP. SOSA,PQ. SANTA CATALINA,1316,4,14,848,551,834,0,6,0,4,1316,0,277,848
EDO. BARINAS,MP. SOSA,PQ. EL REGALO,4106,9,51,3418,2156,3367,0,16,2,9,4106,0,1193,3418
EDO. BARINAS,MP. SOSA,PQ. PUERTO DE NUTRIAS,2089,5,30,1487,1026,1457,0,5,1,5,2089,1,424,1487
EDO. BARINAS,MP. SOSA,PQ. CIUDAD DE NUTRIAS,8537,20,145,6796,4266,6651,0,33,1,22,9472,1,2350,6796
EDO. BARINAS,MP. BOLIVAR,PQ. ALTAMIRA,2529,9,34,2078,1422,2044,1,11,1,9,2529,1,608,2078
EDO. BARINAS,MP. BOLIVAR,PQ. BARINITAS,28664,58,485,23661,13259,23176,5,114,10,58,28664,8,9780,23661
EDO. BARINAS,MP. BOLIVAR,PQ. CALDERAS,4640,20,53,3633,2435,3580,1,16,2,20,4640,0,1126,3633
EDO. BARINAS,MP. EZEQUIEL ZAMORA,PQ. PEDRO BRICE#O MENDEZ,3717,8,78,2933,1364,2855,0,12,2,9,4273,1,1476,2933
EDO. BARINAS,MP. EZEQUIEL ZAMORA,PQ. SANTA BARBARA,25511,57,438,20324,10467,19886,3,100,16,60,26805,1,9299,20324
EDO. BARINAS,MP. EZEQUIEL ZAMORA,PQ. RAMON IGNACIO MENDEZ,2597,5,44,2042,1015,1998,1,4,0,5,2597,1,977,2042
EDO. BARINAS,MP. EZEQUIEL ZAMORA,PQ.JOSE IGNACIO DEL PUMAR,2621,7,63,1964,994,1901,0,5,1,7,2621,1,900,1964
EDO. BARINAS,MP. OBISPOS,PQ. LOS GUASIMITOS,5945,12,104,4779,2979,4675,1,32,2,12,5945,3,1658,4779
EDO. BARINAS,MP. OBISPOS,PQ. OBISPOS,9643,22,157,7781,4911,7624,0,59,5,27,11306,1,2648,7781
EDO. BARINAS,MP. OBISPOS,PQ. EL REAL,2261,5,25,1915,1513,1890,1,8,1,5,2261,0,367,1915
EDO. BARINAS,MP. OBISPOS,PQ. LA LUZ,1391,5,8,1165,987,1157,0,8,1,15,4724,0,161,1165
EDO. BOLIVAR,MP. BLVNO ANGOSTURA,PQ. SAN FRANCISCO,5102,16,101,3733,2438,3632,1,22,5,16,5102,0,1166,3733
EDO. BOLIVAR,MP. BLVNO ANGOSTURA,PQ. BARCELONETA,5955,13,88,3860,1942,3772,2,30,5,23,8833,1,1792,3860
EDO. BOLIVAR,MP. BLVNO ANGOSTURA,PQ. SANTA BARBARA,2131,6,50,1505,844,1455,1,11,0,6,2131,1,598,1505
EDO. BOLIVAR,MP. BLVNO ANGOSTURA,CM. CIUDAD PIAR,11116,23,139,8448,4240,8309,1,54,5,24,11698,4,4005,8448
EDO. BOLIVAR,MP. GRAN SABANA,CM. SANTA ELENA DE UAIREN,16970,43,296,11441,6576,11145,17,98,20,49,19267,12,4422,11441
EDO. BOLIVAR,MP. GRAN SABANA,PQ. IKABARU,1322,3,13,619,343,606,0,0,1,4,1500,0,262,619
EDO. BOLIVAR,MP. ROSCIO,CM. GUASIPATI,15538,33,320,11985,5513,11665,2,75,7,33,15538,2,6066,11985
EDO. BOLIVAR,MP. ROSCIO,PQ. SALOM,1420,3,44,1100,515,1056,0,6,1,3,1420,0,534,1100
EDO. BOLIVAR,MP. CEDE#O,PQ. LA URBANA,1923,5,11,1324,976,1313,1,0,0,7,2468,0,336,1324
EDO. BOLIVAR,MP. CEDE#O,CM. CAICARA DEL ORINOCO,28182,61,425,20182,13732,19757,7,84,22,62,28695,4,5908,20182
EDO. BOLIVAR,MP. CEDE#O,PQ. GUANIAMO
EDO. BOLIVAR,MP. CEDE#O,PQ. PIJIGUAOS,4419,11,84,3373,2419,3289,1,18,3,18,5566,1,847,3373
EDO. BOLIVAR,MP. CEDE#O,PQ. ASCENSION FARRERAS,5219,15,85,3575,2390,3490,0,22,2,16,5638,1,1075,3575
EDO. BOLIVAR,MP. CEDE#O,PQ. ALTAGRACIA,1278,4,39,919,757,880,0,0,0,4,1278,0,123,919
EDO. BOLIVAR,MP. PIAR,CM. UPATA,59054,115,1084,47358,19720,46274,11,330,30,116,59543,6,26177,47358
EDO. BOLIVAR,MP. PIAR,PQ. ANDRES ELOY BLANCO,6284,15,104,4831,2955,4727,2,38,1,15,6284,2,1729,4831
EDO. BOLIVAR,MP. PIAR,PQ. PEDRO COVA,5195,12,100,3408,1425,3308,0,21,0,15,5866,1,1861,3408
EDO. BOLIVAR,MP. SIFONTES,PQ. DALLA COSTA,5366,11,59,3325,2280,3266,6,29,2,11,5366,0,949,3325
EDO. BOLIVAR,MP. SIFONTES,CM. TUMEREMO,18467,39,341,12626,5815,12285,6,112,9,40,18553,5,6338,12626
EDO. BOLIVAR,MP. SIFONTES,PQ. SAN ISIDRO,5994,11,114,3644,2513,3530,5,43,3,11,5994,2,964,3644
EDO. BOLIVAR,MP. EL CALLAO,CM. EL CALLAO,16364,34,375,12334,4664,11959,7,68,3,34,16364,3,7214,12334
EDO. BOLIVAR,MP. CARONI,PQ. YOCOIMA,4854,12,72,3723,2735,3651,1,30,6,19,8170,0,879,3723
EDO. BOLIVAR,MP. CARONI,PQ. SIMON BOLIVAR,58686,119,911,47989,24944,47078,18,344,25,126,62392,23,21724,47989
EDO. BOLIVAR,MP. CARONI,PQ. VISTA AL SOL,42758,83,809,33891,24264,33082,10,254,24,86,44049,10,8520,33891
EDO. BOLIVAR,MP. CARONI,PQ. CHIRICA,56692,114,914,45175,30920,44261,11,369,24,114,56692,15,12922,45175
EDO. BOLIVAR,MP. CARONI,PQ. CACHAMAY,37072,70,380,30882,9166,30502,3,112,12,75,39646,21,21188,30882
EDO. BOLIVAR,MP. CARONI,PQ. UNARE,90436,171,1088,77671,36937,76583,15,410,44,175,92511,55,39122,77671
EDO. BOLIVAR,MP. CARONI,PQ. DALLA COSTA,52401,103,816,43318,26642,42502,7,301,30,106,53888,16,15506,43318
EDO. BOLIVAR,MP. CARONI,PQ. UNIVERSIDAD,37525,71,325,32693,7349,32368,4,98,11,72,38053,12,24894,32693
EDO. BOLIVAR,MP. CARONI,PQ. ONCE DE ABRIL,51979,103,903,41206,28038,40303,12,338,28,109,54972,10,11877,41206
EDO. BOLIVAR,MP. CARONI,PQ. POZO VERDE,10793,25,216,8110,6072,7894,8,50,11,25,10793,3,1750,8110
EDO. BOLIVAR,MP. SUCRE,PQ. MOITACO,4784,15,80,3350,2207,3270,2,18,2,15,4784,0,1041,3350
EDO. BOLIVAR,MP. SUCRE,CM. MARIPA,3668,8,115,2319,1354,2204,0,25,5,9,4193,0,820,2319
EDO. BOLIVAR,MP. SUCRE,PQ. GUARATARO,5780,13,79,4056,3109,3977,1,20,3,13,5780,4,840,4056
EDO. BOLIVAR,MP. SUCRE,PQ. LAS MAJADAS,762,2,18,468,249,450,0,0,0,2,762,0,201,468
EDO. BOLIVAR,MP. SUCRE,PQ. ARIPAO,1312,4,29,741,492,712,0,4,2,7,1892,0,214,741
EDO. BOLIVAR,MP.PADRE PEDRO CHIEN,CM. EL PALMAR,8957,20,135,6974,3714,6839,0,39,6,26,11594,1,3079,6974
EDO. BOLIVAR,CE. HERES,PQ. CATEDRAL,48850,106,810,38993,17126,38183,8,265,10,107,49358,21,20753,38993
EDO. BOLIVAR,CE. HERES,PQ. MARHUANTA,15916,36,331,12571,7637,12240,7,98,5,36,15916,4,4489,12571
EDO. BOLIVAR,CE. HERES,PQ. VISTA HERMOSA,42366,85,576,34922,12557,34346,5,180,11,86,42916,27,21566,34922
EDO. BOLIVAR,CE. HERES,PQ. PANAPANA,1816,8,56,1478,1113,1422,2,9,2,8,1816,2,294,1478
EDO. BOLIVAR,CE. HERES,PQ. JOSE ANTONIO PAEZ,17542,41,358,13317,8462,12959,5,127,14,41,17542,1,4350,13317
EDO. BOLIVAR,CE. HERES,PQ. LA SABANITA,55315,125,921,43381,21902,42460,16,321,22,125,55315,15,20184,43381
EDO. BOLIVAR,CE. HERES,PQ. AGUA SALADA,37343,83,676,29906,15903,29230,8,206,11,83,37343,24,13078,29906
EDO. BOLIVAR,CE. HERES,PQ. ORINOCO,1464,5,21,1106,784,1085,1,6,1,5,1464,1,292,1106
EDO. BOLIVAR,CE. HERES,PQ. ZEA,1755,9,35,1155,716,1120,0,5,0,9,1755,1,398,1155
EDO. CARABOBO,MP. SAN DIEGO,PQ. URB SAN DIEGO,59286,110,555,51837,14289,51282,9,184,31,110,59286,30,36739,51837
EDO. CARABOBO,MP. LOS GUAYOS,PQ. U LOS GUAYOS,96651,184,1506,78243,48671,76737,19,428,36,184,96651,47,27536,78243
EDO. CARABOBO,MP. BEJUMA,PQ. CANOABO,5310,14,71,4179,2290,4108,2,11,5,14,5310,4,1796,4179
EDO. CARABOBO,MP. BEJUMA,PQ. SIMON BOLIVAR,5838,13,79,4850,2421,4771,2,14,1,13,5838,1,2332,4850
EDO. CARABOBO,MP. BEJUMA,PQ. BEJUMA,21679,42,253,17387,8765,17134,4,64,7,42,21679,7,8287,17387
EDO. CARABOBO,MP. NAGUANAGUA,PQ. NAGUANAGUA,98332,184,1173,81531,32100,80358,29,298,40,186,99406,42,47849,81531
EDO. CARABOBO,MP. CARLOS ARVELO,PQ. GUIGUE,47756,95,861,36775,24870,35914,11,235,22,96,48290,17,10759,36775
EDO. CARABOBO,MP. CARLOS ARVELO,PQ. BELEN,10115,21,123,7470,5444,7347,1,29,6,22,10284,2,1865,7470
EDO. CARABOBO,MP. CARLOS ARVELO,PQ. TACARIGUA,40343,82,693,31217,21941,30524,14,175,24,82,40343,15,8355,31217
EDO. CARABOBO,MP. LIBERTADOR,PQ. U INDEPENDENCIA,25590,53,370,20344,14448,19974,10,99,27,53,25590,10,5380,20344
EDO. CARABOBO,MP. LIBERTADOR,PQ. U TOCUYITO,82890,156,1193,64469,39261,63276,35,286,37,157,83416,36,23621,64469
EDO. CARABOBO,MP. MIRANDA,PQ. MIRANDA,19116,38,272,15188,9829,14916,2,64,5,38,19116,5,5011,15188
EDO. CARABOBO,MP. SAN JOAQUIN,PQ. SAN JOAQUIN,38296,74,573,31631,18013,31058,9,151,18,75,38795,23,12844,31631
EDO. CARABOBO,MP. DIEGO IBARRA,PQ. AGUAS CALIENTES,33896,65,624,27575,21002,26951,8,148,18,65,33896,11,5764,27575
EDO. CARABOBO,MP. DIEGO IBARRA,PQ. MARIARA,32772,61,560,26707,17288,26147,4,125,24,61,32772,13,8693,26707
EDO. CARABOBO,CE. VALENCIA,PQ. SANTA ROSA,52551,102,926,41242,23433,40316,17,256,18,106,54606,33,16559,41242
EDO. CARABOBO,CE. VALENCIA,PQ. CATEDRAL,4206,8,45,3119,1275,3074,1,17,4,8,4206,1,1776,3119
EDO. CARABOBO,CE. VALENCIA,PQ. NEGRO PRIMERO,517,3,6,410,376,404,0,2,1,20,6095,0,25,410
EDO. CARABOBO,CE. VALENCIA,PQ. SAN BLAS,21274,41,246,16737,5916,16491,5,64,4,41,21274,5,10497,16737
EDO. CARABOBO,CE. VALENCIA,PQ. EL SOCORRO,5197,10,64,3968,1240,3904,1,20,2,10,5197,2,2639,3968
EDO. CARABOBO,CE. VALENCIA,PQ. SAN JOSE,106363,196,632,86591,10250,85959,10,169,19,197,106895,48,75463,86591
EDO. CARABOBO,CE. VALENCIA,PQ. CANDELARIA,25645,49,328,20130,9489,19802,8,103,8,49,25645,18,10176,20130
EDO. CARABOBO,CE. VALENCIA,PQ. MIGUEL PE#A,223905,425,3425,175720,105770,172295,69,1062,93,428,225359,105,65196,175720
EDO. CARABOBO,CE. VALENCIA,PQ. RAFAEL URDANETA,124158,231,1565,101311,52652,99746,27,530,48,232,124714,37,46452,101311
EDO. CARABOBO,MP. JUAN JOSE MORA,PQ. URAMA,6236,15,81,4883,3745,4802,3,14,3,15,6236,1,1036,4883
EDO. CARABOBO,MP. JUAN JOSE MORA,PQ. MORON,42125,89,688,35120,25302,34432,25,143,20,90,42586,20,8922,35120
EDO. CARABOBO,MP. GUACARA,PQ. GUACARA,86559,165,1272,72008,42274,70736,18,409,42,167,87621,39,27954,72008
EDO. CARABOBO,MP. GUACARA,PQ. CIUDAD ALIANZA,14776,27,99,12200,2640,12101,1,24,2,27,14776,4,9430,12200
EDO. CARABOBO,MP. GUACARA,PQ. YAGUA,12758,24,155,10330,5899,10175,4,41,7,24,12758,1,4223,10330
EDO. CARABOBO,MP. MONTALBAN,PQ. MONTALBAN,16769,35,250,13660,7394,13410,2,46,5,35,16769,3,5960,13660
EDO. CARABOBO,MP. PUERTO CABELLO,PQ. FRATERNIDAD,8921,18,101,6960,3378,6859,4,29,2,18,8921,3,3443,6960
EDO. CARABOBO,MP. PUERTO CABELLO,PQ. PATANEMO,2874,6,54,2202,1340,2148,0,17,1,6,2874,0,790,2202
EDO. CARABOBO,MP. PUERTO CABELLO,PQ. JUAN JOSE FLORES,45099,87,647,37069,22366,36422,15,136,15,88,45395,17,13873,37069
EDO. CARABOBO,MP. PUERTO CABELLO,PQ. GOAIGOAZA,31237,61,450,25571,15901,25121,2,85,15,61,31237,15,9103,25571
EDO. CARABOBO,MP. PUERTO CABELLO,PQ. DEMOCRACIA,12187,24,201,9531,6914,9330,8,36,5,24,12187,5,2362,9531
EDO. CARABOBO,MP. PUERTO CABELLO,PQ. BORBURATA,6833,13,65,4818,3215,4753,1,26,2,13,6833,3,1506,4818
EDO. CARABOBO,MP. PUERTO CABELLO,PQ. UNION,4471,8,62,3293,1771,3231,3,16,2,8,4471,2,1437,3293
EDO. CARABOBO,MP. PUERTO CABELLO,PQ. BARTOLOME SALOM,28913,58,426,23704,13691,23278,9,81,4,58,28913,13,9480,23704
EDO. COJEDES,MP. GIRARDOT,PQ. EL BAUL,7507,16,132,5980,3910,5848,1,34,3,16,7507,4,1896,5980
EDO. COJEDES,MP. GIRARDOT,PQ. SUCRE,1705,5,15,1357,1032,1342,0,12,2,5,1705,0,296,1357
EDO. COJEDES,MP. TINACO,PQ. GRL/JEFE JOSE L SILVA,23109,50,471,18988,12204,18517,2,104,13,50,23109,6,6188,18988
EDO. COJEDES,CE. EZEQUIEL ZAMORA,PQ. MANUEL MANRIQUE,3023,7,61,2495,1538,2434,1,12,2,7,3023,2,879,2495
EDO. COJEDES,CE. EZEQUIEL ZAMORA,PQ. JUAN ANGEL BRAVO,1143,6,14,913,637,899,0,6,0,6,1143,0,256,913
EDO. COJEDES,CE. EZEQUIEL ZAMORA,PQ. SAN CARLOS DE AUSTRIA,65201,140,1281,54646,31182,53365,28,379,20,142,66305,24,21732,54646
EDO. COJEDES,MP. RICAURTE,PQ. LIBERTAD DE COJEDES,8864,20,158,7256,5617,7098,1,44,2,20,8864,2,1432,7256
EDO. COJEDES,MP. RICAURTE,PQ. EL AMPARO,1438,3,19,1128,927,1109,1,8,2,3,1438,0,171,1128
EDO. COJEDES,MP. ROMULO GALLEGOS,PQ. ROMULO GALLEGOS,13397,28,276,10908,7312,10632,2,87,6,29,13984,1,3224,10908
EDO. COJEDES,MP. PAO S J BAUTISTA,PQ. EL PAO,12105,41,268,9870,7543,9602,8,59,6,43,12439,3,1983,9870
EDO. COJEDES,MP. LIMA BLANCO,PQ. MACAPO,5516,10,101,4639,2972,4538,0,15,0,10,5516,2,1549,4639
EDO. COJEDES,MP. LIMA BLANCO,PQ. LA AGUADITA,3135,8,70,2602,1840,2532,1,11,3,8,3135,0,677,2602
EDO. COJEDES,MP. ANZOATEGUI,PQ. JUAN DE MATA SUAREZ,7221,17,192,5939,3927,5747,1,31,0,17,7221,2,1786,5939
EDO. COJEDES,MP. ANZOATEGUI,PQ. COJEDES,4612,11,90,3856,2810,3766,1,13,0,11,4612,1,941,3856
EDO. COJEDES,MP. TINAQUILLO,PQ. TINAQUILLO,62694,133,1348,51505,32437,50157,23,281,22,134,63027,22,17372,51505
EDO. DELTA AMAC,CE. TUCUPITA,PQ. JOSE VIDAL MARCANO,10558,27,207,8774,4608,8567,3,87,4,27,10558,3,3862,8774
EDO. DELTA AMAC,CE. TUCUPITA,PQ. SAN RAFAEL,8333,28,205,6557,4039,6352,7,56,4,30,8771,3,2243,6557
EDO. DELTA AMAC,CE. TUCUPITA,PQ. VIRGEN DEL VALLE,4499,18,96,3686,2487,3590,3,26,1,20,5166,0,1073,3686
EDO. DELTA AMAC,CE. TUCUPITA,PQ.MCL.ANTONIO J DE SUCRE,6208,15,170,4985,2830,4815,6,48,2,16,6696,6,1923,4985
EDO. DELTA AMAC,CE. TUCUPITA,PQ. JUAN MILLAN,5226,13,75,3940,2760,3865,5,37,8,19,6907,1,1054,3940
EDO. DELTA AMAC,CE. TUCUPITA,PQ. SAN JOSE,6255,15,113,4982,2174,4869,2,46,0,15,6255,4,2643,4982
EDO. DELTA AMAC,CE. TUCUPITA,PQ. MONS. ARGIMIRO GARCIA,10564,22,243,8859,4566,8616,2,80,6,22,10564,1,3961,8859
EDO. DELTA AMAC,CE. TUCUPITA,PQ. LEONARDO RUIZ PINEDA,7912,17,202,6600,3547,6398,1,73,7,17,7912,2,2768,6600
EDO. DELTA AMAC,MP. PEDERNALES,PQ. PEDERNALES,5168,10,51,3045,2306,2994,0,8,0,10,5168,1,679,3045
EDO. DELTA AMAC,MP. PEDERNALES,PQ. LUIS B PRIETO FIGUERO,3527,8,33,2313,1805,2280,0,13,1,8,3527,1,460,2313
EDO. DELTA AMAC,MP. ANTONIO DIAZ,PQ. SANTOS DE ABELGAS,388,2,1,290,267,289,0,2,0,5,1173,0,20,290
EDO. DELTA AMAC,MP. ANTONIO DIAZ,PQ. MANUEL RENAUD,1269,3,9,891,710,882,1,5,1,12,4400,0,165,891
EDO. DELTA AMAC,MP. ANTONIO DIAZ,PQ. ANICETO LUGO,1248,3,3,557,510,554,0,7,0,5,1808,0,37,557
EDO. DELTA AMAC,MP. ANTONIO DIAZ,PQ. ALMIRANTE LUIS BRION,194,1,0,131,125,131,0,0,0,6,1412,0,6,131
EDO. DELTA AMAC,MP. ANTONIO DIAZ,PQ. PADRE BARRAL,1560,4,2,1093,1073,1091,0,0,1,11,5020,0,17,1093
EDO. DELTA AMAC,MP. ANTONIO DIAZ,PQ. CURIAPO,6100,14,39,3446,2723,3407,1,12,2,14,6100,0,669,3446
EDO. DELTA AMAC,MP. CASACOIMA,PQ. ROMULO GALLEGOS,1991,9,23,1400,915,1377,1,11,2,9,1991,1,447,1400
EDO. DELTA AMAC,MP. CASACOIMA,PQ. IMATACA,3552,8,82,2556,1890,2474,2,20,9,9,4101,0,553,2556
EDO. DELTA AMAC,MP. CASACOIMA,PQ. JUAN BAUTISTA ARISMEN,3236,8,50,2388,1820,2338,2,7,1,8,3236,0,508,2388
EDO. DELTA AMAC,MP. CASACOIMA,PQ. MANUEL PIAR,10716,22,217,8484,6303,8267,2,50,6,22,10716,1,1905,8484
EDO. DELTA AMAC,MP. CASACOIMA,PQ. 5 DE JULIO,1765,5,36,1239,1031,1203,1,10,1,5,1765,1,159,1239
EDO. FALCON,MP. MAUROA,PQ. MENE DE MAUROA,10694,27,235,8700,4840,8465,4,51,9,28,11186,1,3560,8700
EDO. FALCON,MP. MAUROA,PQ. SAN FELIX,1385,4,9,1070,640,1061,1,12,0,4,1385,0,408,1070
EDO. FALCON,MP. MAUROA,PQ. CASIGUA,4427,14,98,3582,2463,3484,3,11,0,14,4427,0,1007,3582
EDO. FALCON,MP. SUCRE,PQ. PECAYA,1693,6,8,1230,1008,1222,0,2,1,6,1693,0,211,1230
EDO. FALCON,MP. SUCRE,PQ. SUCRE,3873,10,37,3053,2186,3016,1,16,2,11,4234,0,811,3053
EDO. FALCON,MP. FALCON,PQ. PUEBLO NUEVO,12037,26,174,9730,5931,9556,2,61,4,26,12037,1,3557,9730
EDO. FALCON,MP. FALCON,PQ. ADAURE,1637,4,25,1307,811,1282,1,9,0,4,1637,0,461,1307
EDO. FALCON,MP. FALCON,PQ. EL VINCULO,2558,6,55,2015,1230,1960,1,7,4,6,2558,0,718,2015
EDO. FALCON,MP. FALCON,PQ. EL HATO,1635,4,11,1306,948,1295,0,3,1,4,1635,0,343,1306
EDO. FALCON,MP. FALCON,PQ. MORUY,5317,13,107,4478,2975,4371,1,23,3,13,5317,1,1368,4478
EDO. FALCON,MP. FALCON,PQ. BARAIVED,2838,7,41,2372,1506,2331,0,17,2,7,2838,1,805,2372
EDO. FALCON,MP. FALCON,PQ. ADICORA,4356,11,78,3512,2214,3434,1,20,1,11,4356,1,1197,3512
EDO. FALCON,MP. FALCON,PQ. JADACAQUIVA,3210,11,43,2620,1551,2577,3,13,1,11,3210,1,1008,2620
EDO. FALCON,MP. FALCON,PQ. BUENA VISTA,3133,7,44,2625,1619,2581,0,10,0,8,3663,2,950,2625
EDO. FALCON,MP. MONS. ITURRIZA,PQ. BOCA DE TOCUYO,1421,3,18,1139,611,1121,0,5,0,3,1421,0,505,1139
EDO. FALCON,MP. MONS. ITURRIZA,PQ. CHICHIRIVICHE,6460,13,129,4822,2141,4693,3,24,1,13,6460,0,2524,4822
EDO. FALCON,MP. MONS. ITURRIZA,PQ. TOCUYO DE LA COSTA,6454,15,114,5005,3269,4891,0,15,1,15,6454,0,1606,5005
EDO. FALCON,MP. TOCOPERO,CM. TOCOPERO,5895,13,128,4723,3433,4595,1,16,0,13,5895,0,1145,4723
EDO. FALCON,MP. SILVA,PQ. BOCA DE AROA,4731,13,121,3224,1991,3103,2,15,3,14,5259,0,1092,3224
EDO. FALCON,MP. SILVA,PQ. TUCACAS,16696,36,323,11426,5589,11103,2,71,10,36,16696,3,5428,11426
EDO. FALCON,MP. COLINA,PQ. MACORUCA,1262,3,19,830,609,811,0,5,0,3,1262,0,197,830
EDO. FALCON,MP. COLINA,PQ. LAS CALDERAS,3836,7,40,3245,1586,3205,1,23,1,7,3836,2,1592,3245
EDO. FALCON,MP. COLINA,PQ. LA VELA DE CORO,19047,37,285,15497,9175,15212,1,85,2,38,19432,2,5947,15497
EDO. FALCON,MP. COLINA,PQ. ACURIGUA,1364,3,23,1089,680,1066,0,3,1,3,1364,0,382,1089
EDO. FALCON,MP. COLINA,PQ. GUAIBACOA,634,2,7,498,274,491,0,2,0,2,634,0,215,498
EDO. FALCON,MP. FEDERACION,PQ. MAPARARI,4652,14,118,3479,2320,3361,1,17,5,14,4652,0,1018,3479
EDO. FALCON,MP. FEDERACION,PQ. AGUA LARGA,2238,10,28,1693,1277,1665,1,12,0,10,2238,0,375,1693
EDO. FALCON,MP. FEDERACION,PQ. CHURUGUARA,10623,26,185,8368,4318,8183,6,39,7,26,10623,4,3809,8368
EDO. FALCON,MP. FEDERACION,PQ. EL PAUJI,2358,6,44,1796,1375,1752,0,7,2,6,2358,0,368,1796
EDO. FALCON,MP. FEDERACION,PQ. INDEPENDENCIA,734,4,9,566,366,557,0,5,1,4,734,0,185,566
EDO. FALCON,MP. LOS TAQUES,PQ. LOS TAQUES,16059,32,324,13394,8452,13070,3,79,4,32,16059,2,4530,13394
EDO. FALCON,MP. LOS TAQUES,PQ. JUDIBANA,16131,31,239,13563,7639,13324,2,66,2,32,16660,7,5608,13563
EDO. FALCON,MP. CARIRUBANA,PQ. NORTE,33744,65,476,28116,17430,27640,3,158,10,65,33744,8,10031,28116
EDO. FALCON,MP. CARIRUBANA,PQ. SANTA ANA,11018,25,189,9226,6531,9037,0,58,3,25,11018,3,2442,9226
EDO. FALCON,MP. CARIRUBANA,PQ. CARIRUBANA,67982,132,1116,55632,30739,54516,23,294,21,137,70605,28,23411,55632
EDO. FALCON,MP. CARIRUBANA,PQ. PUNTA CARDON,44420,84,761,37783,20938,37022,1,187,26,85,45000,27,15843,37783
EDO. FALCON,MP. DABAJURO,CM. DABAJURO,13825,30,244,11030,6020,10786,1,60,4,33,15197,3,4698,11030
EDO. FALCON,MP. CACIQUE MANAURE,CM. YARACAL,8049,16,244,6318,3577,6074,0,30,2,16,8049,1,2464,6318
EDO. FALCON,MP. JACURA,PQ. ARAURIMA,2509,7,38,1952,1274,1914,0,10,0,7,2509,1,629,1952
EDO. FALCON,MP. JACURA,PQ. JACURA,4565,11,54,3295,2206,3241,1,25,1,11,4565,2,1006,3295
EDO. FALCON,MP. JACURA,PQ. AGUA LINDA,1288,4,26,831,629,805,0,5,0,5,1387,0,171,831
EDO. FALCON,MP. PALMA SOLA,CM. PALMA SOLA,3754,13,46,3034,2482,2988,1,14,2,13,3754,1,488,3034
EDO. FALCON,MP. ACOSTA,PQ. LA PASTORA,2491,9,31,1865,1342,1834,2,11,2,9,2491,1,476,1865
EDO. FALCON,MP. ACOSTA,PQ. LIBERTADOR,759,2,19,570,285,551,0,2,0,2,759,0,264,570
EDO. FALCON,MP. ACOSTA,PQ. SAN JUAN DE LOS CAYOS,6318,14,109,4890,2523,4781,1,22,2,14,6318,1,2232,4890
EDO. FALCON,MP. ACOSTA,PQ. CAPADARE,4979,11,71,3694,2357,3623,1,11,1,11,4979,0,1253,3694
EDO. FALCON,MP. DEMOCRACIA,PQ. AVARIA,273,1,1,182,164,181,0,0,0,6,856,0,17,182
EDO. FALCON,MP. DEMOCRACIA,PQ. PURURECHE,851,4,9,698,473,689,0,1,0,6,1198,0,215,698
EDO. FALCON,MP. DEMOCRACIA,PQ. PIEDRA GRANDE,815,3,7,583,400,576,0,5,0,3,815,0,171,583
EDO. FALCON,MP. DEMOCRACIA,PQ. AGUA CLARA,288,1,3,214,112,211,0,2,0,1,288,0,97,214
EDO. FALCON,MP. DEMOCRACIA,PQ. PEDREGAL,5038,17,69,4054,2588,3985,2,21,1,19,5809,1,1372,4054
EDO. FALCON,MP. ZAMORA,PQ. ZAZARIDA,1028,5,7,702,627,695,1,0,0,5,1028,0,67,702
EDO. FALCON,MP. ZAMORA,PQ. PUERTO CUMAREBO,17140,39,211,13593,7794,13382,5,97,3,39,17140,5,5478,13593
EDO. FALCON,MP. ZAMORA,PQ. LA SOLEDAD,1508,6,24,1160,813,1136,0,5,0,6,1508,2,316,1160
EDO. FALCON,MP. ZAMORA,PQ. LA CIENAGA,1117,2,16,932,509,916,0,2,0,2,1117,0,405,932
EDO. FALCON,MP. ZAMORA,PQ. PUEBLO CUMAREBO,1956,8,12,1509,1099,1497,1,8,0,8,1956,0,389,1509
EDO. FALCON,MP. UNION,PQ. EL CHARAL,3432,12,29,2479,1857,2450,0,22,3,12,3432,1,567,2479
EDO. FALCON,MP. UNION,PQ. STA.CRUZ DE BUCARAL,5421,16,81,4100,2417,4019,1,23,3,17,5941,0,1575,4100
EDO. FALCON,MP. UNION,PQ. LAS VEGAS DEL TUY,2016,7,33,1589,1225,1556,0,6,1,7,2016,0,324,1589
EDO. FALCON,MP. URUMACO,PQ. URUMACO,4445,12,80,3716,2204,3636,1,11,0,13,4639,0,1420,3716
EDO. FALCON,MP. URUMACO,PQ. BRUZUAL,2032,9,16,1688,1163,1672,0,6,1,9,2032,0,502,1688
EDO. FALCON,MP. PETIT,PQ. COLINA,2446,8,41,1706,1382,1665,0,5,2,8,2446,0,276,1706
EDO. FALCON,MP. PETIT,PQ. CABURE,5673,16,85,4379,3049,4294,1,27,4,16,5673,1,1212,4379
EDO. FALCON,MP. PETIT,PQ. CURIMAGUA,2102,7,46,1561,1138,1515,0,7,1,8,2677,1,368,1561
EDO. FALCON,MP. PIRITU,PQ. PIRITU,6530,20,126,4790,3487,4664,2,38,3,20,6530,0,1134,4790
EDO. FALCON,MP. PIRITU,PQ. SAN JOSE DE LA COSTA,2592,9,50,1957,1435,1907,0,9,3,9,2592,2,458,1957
EDO. FALCON,MP. SAN FRANCISCO,CM. MIRIMIRE,9219,23,122,6961,4603,6839,3,26,2,23,9219,2,2203,6961
EDO. FALCON,MP. BOLIVAR,PQ. SAN LUIS,3696,15,62,3056,2024,2994,0,22,3,15,3696,4,941,3056
EDO. FALCON,MP. BOLIVAR,PQ. ARACUA,1734,4,23,1366,947,1343,1,4,0,5,2050,0,391,1366
EDO. FALCON,MP. BOLIVAR,PQ. LA PE#A,1532,4,29,1261,949,1232,0,6,1,4,1532,1,275,1261
EDO. FALCON,MP. BUCHIVACOA,PQ. ZAZARIDA,4039,12,58,3210,2533,3152,0,17,2,12,4039,1,599,3210
EDO. FALCON,MP. BUCHIVACOA,PQ. BOROJO,1649,5,15,1344,731,1329,0,6,0,5,1649,0,592,1344
EDO. FALCON,MP. BUCHIVACOA,PQ. GUAJIRO,1689,5,22,1274,714,1252,0,7,1,5,1689,3,527,1274
EDO. FALCON,MP. BUCHIVACOA,PQ. SEQUE,1992,7,33,1591,964,1558,1,8,1,7,1992,1,583,1591
EDO. FALCON,MP. BUCHIVACOA,PQ. CAPATARIDA,6085,13,100,5022,2872,4922,0,28,0,13,6085,3,2019,5022
EDO. FALCON,MP. BUCHIVACOA,PQ. BARIRO,2232,5,47,1682,793,1635,0,8,2,5,2232,0,832,1682
EDO. FALCON,CE. MIRANDA,PQ. RIO SECO,2069,5,37,1701,1244,1664,2,11,1,5,2069,0,406,1701
EDO. FALCON,CE. MIRANDA,PQ. SAN ANTONIO,69929,138,1212,57033,32577,55821,27,366,37,140,70890,27,22787,57033
EDO. FALCON,CE. MIRANDA,PQ. MITARE,1284,3,17,987,564,970,0,6,1,3,1284,0,399,987
EDO. FALCON,CE. MIRANDA,PQ. SABANETA,2839,7,51,2248,1475,2197,0,9,2,10,3296,1,710,2248
EDO. FALCON,CE. MIRANDA,PQ. GUZMAN GUILLERMO,4411,12,71,3365,2341,3294,3,27,3,14,4829,2,918,3365
EDO. FALCON,CE. MIRANDA,PQ. SANTA ANA,16810,34,292,13517,6450,13225,3,87,7,35,17355,5,6673,13517
EDO. FALCON,CE. MIRANDA,PQ. SAN GABRIEL,37297,73,573,30824,12760,30251,9,168,9,75,38427,12,17293,30824
EDO. GUARICO,MP. ZARAZA,PQ. SAN JOSE DE UNARE,2266,5,52,1674,1137,1622,1,10,1,5,2266,0,473,1674
EDO. GUARICO,MP. ZARAZA,PQ. ZARAZA,36171,76,456,27582,17737,27126,16,189,26,81,38646,10,9148,27582
EDO. GUARICO,MP. CHAGUARAMAS,PQ. CHAGUARAMAS,9737,23,220,7503,4746,7283,2,34,5,24,10270,2,2494,7503
EDO. GUARICO,CE. ROSCIO,PQ. CANTAGALLO,1681,4,12,1444,1011,1432,0,7,0,4,1681,0,414,1444
EDO. GUARICO,CE. ROSCIO,PQ. PARAPARA,2582,7,21,2075,1505,2054,1,6,2,7,2582,0,540,2075
EDO. GUARICO,CE. ROSCIO,PQ.SAN JUAN DE LOS MORROS,79488,160,1211,67010,37348,65799,17,372,24,163,81082,33,28005,67010
EDO. GUARICO,MP. MELLADO,PQ. EL SOMBRERO,17340,38,269,14062,9507,13793,3,72,9,38,17340,5,4197,14062
EDO. GUARICO,MP. MELLADO,PQ. SOSA,1157,3,13,962,598,949,0,3,0,3,1157,0,348,962
EDO. GUARICO,MP.SAN GERONIMO DE G,PQ. CAZORLA,4281,10,35,2902,1875,2867,0,10,1,11,4748,0,981,2902
EDO. GUARICO,MP.SAN GERONIMO DE G,PQ. GUAYABAL,9228,20,130,7042,4814,6912,0,41,6,20,9228,0,2051,7042
EDO. GUARICO,MP. INFANTE,PQ. VALLE DE LA PASCUA,73330,145,962,61053,34278,60091,17,335,30,152,75918,34,25397,61053
EDO. GUARICO,MP. INFANTE,PQ. ESPINO
EDO. GUARICO,MP. EL SOCORRO,PQ. EL SOCORRO,12240,27,202,9663,6517,9461,1,42,5,29,13306,4,2892,9663
EDO. GUARICO,MP. MIRANDA,PQ. EL CALVARIO,1127,2,30,844,577,814,0,3,1,2,1127,0,233,844
EDO. GUARICO,MP. MIRANDA,PQ. GUARDATINAJAS,2623,5,38,2041,1433,2003,2,6,0,7,3224,0,562,2041
EDO. GUARICO,MP. MIRANDA,PQ. CALABOZO,67419,134,963,55578,37045,54615,27,325,29,168,82758,28,17161,55578
EDO. GUARICO,MP. MIRANDA,PQ. EL RASTRO,2180,5,52,1688,1141,1636,1,11,0,5,2180,0,483,1688
EDO. GUARICO,MP. CAMAGUAN,PQ. CAMAGUAN,9763,21,195,7748,4802,7553,3,50,7,23,10927,0,2691,7748
EDO. GUARICO,MP. CAMAGUAN,PQ. PUERTO MIRANDA,2496,6,57,1980,1315,1923,1,9,1,6,2496,0,597,1980
EDO. GUARICO,MP. CAMAGUAN,PQ. UVERITO,1460,4,28,1119,780,1091,0,11,3,4,1460,1,296,1119
EDO. GUARICO,MP. ORTIZ,PQ. ORTIZ,7011,16,97,5671,3588,5574,0,47,7,16,7011,1,1931,5671
EDO. GUARICO,MP. ORTIZ,PQ. SAN FCO. DE TIZNADOS,2314,7,42,1787,1430,1745,1,8,1,7,2314,0,305,1787
EDO. GUARICO,MP. ORTIZ,PQ. SAN JOSE DE TIZNADOS,2859,7,46,2274,1640,2228,0,8,1,9,3803,1,578,2274
EDO. GUARICO,MP. ORTIZ,PQ. S LORENZO DE TIZNADOS,1954,6,17,1451,1152,1434,0,3,0,7,2306,0,279,1451
EDO. GUARICO,MP. S MARIA DE IPIRE,PQ. ALTAMIRA,847,2,15,630,555,615,0,1,3,2,847,0,56,630
EDO. GUARICO,MP. S MARIA DE IPIRE,PQ. SANTA MARIA DE IPIRE,9638,24,142,7214,4897,7072,5,52,12,24,9638,2,2104,7214
EDO. GUARICO,MP. LAS MERCEDES,PQ. LAS MERCEDES,12017,24,303,9082,5542,8779,0,51,8,29,14269,0,3178,9082
EDO. GUARICO,MP. LAS MERCEDES,PQ. CABRUTA,6331,14,98,4817,3865,4719,3,25,4,14,6331,0,822,4817
EDO. GUARICO,MP. LAS MERCEDES,PQ. STA RITA DE MANAPIRE,1435,3,20,1121,910,1101,1,2,0,3,1435,0,188,1121
EDO. GUARICO,MP.S JOSE DE GUARIBE,PQ. SAN JOSE DE GUARIBE,8052,20,146,6411,4240,6265,1,40,2,20,8052,1,1981,6411
EDO. GUARICO,MP. MONAGAS,PQ. LEZAMA,3356,8,59,2556,1647,2497,1,16,2,8,3356,1,830,2556
EDO. GUARICO,MP. MONAGAS,PQ. SOUBLETTE,2174,5,21,1646,1132,1625,1,7,0,5,2174,0,485,1646
EDO. GUARICO,MP. MONAGAS,PQ. SAN FCO DE MACAIRA,2074,4,21,1526,1189,1505,0,3,2,4,2074,0,311,1526
EDO. GUARICO,MP. MONAGAS,PQ. ALTAGRACIA DE ORITUCO,35886,75,623,29210,19092,28587,8,174,21,76,36205,11,9281,29210
EDO. GUARICO,MP. MONAGAS,PQ. LIBERTAD DE ORITUCO,670,2,11,491,375,480,0,1,0,2,670,0,104,491
EDO. GUARICO,MP. MONAGAS,PQ. SAN RAFAEL DE ORITUCO,3293,7,76,2676,1886,2600,0,11,0,7,3293,1,702,2676
EDO. GUARICO,MP. MONAGAS,PQ. PASO REAL DE MACAIRA,3294,7,48,2517,1743,2469,1,15,3,7,3294,0,707,2517
EDO. GUARICO,MP. RIBAS,PQ. TUCUPIDO,24896,59,352,19752,11941,19400,5,108,15,59,24896,8,7323,19752
EDO. GUARICO,MP. RIBAS,PQ. SAN RAFAEL DE LAYA,2553,6,30,1906,1352,1876,1,4,0,6,2553,0,519,1906
EDO. LARA,MP. ANDRES E BLANCO,PQ. PIO TAMAYO,20902,48,312,17395,9905,17083,8,100,7,48,20902,8,7055,17395
EDO. LARA,MP. ANDRES E BLANCO,PQ. YACAMBU,4449,16,67,3294,2355,3227,4,18,6,22,5816,1,843,3294
EDO. LARA,MP. ANDRES E BLANCO,PQ. QBDA. HONDA DE GUACHE,4165,13,24,3208,2871,3184,2,7,4,13,4165,2,298,3208
EDO. LARA,MP. MORAN,PQ. HILARIO LUNA Y LUNA,6883,21,99,5017,4200,4918,9,36,10,21,6883,1,662,5017
EDO. LARA,MP. MORAN,PQ. HUMOCARO BAJO,8040,21,162,6300,3820,6138,5,29,16,22,8166,1,2267,6300
EDO. LARA,MP. MORAN,PQ. HUMOCARO ALTO,6392,14,102,5044,3984,4942,2,31,9,14,6392,1,915,5044
EDO. LARA,MP. MORAN,PQ. MORAN,2843,8,62,2151,1539,2089,0,13,5,8,2843,2,530,2151
EDO. LARA,MP. MORAN,PQ. ANZOATEGUI,3962,13,68,3019,2145,2951,3,14,3,13,3962,0,786,3019
EDO. LARA,MP. MORAN,PQ. GUARICO,10726,28,163,8339,5852,8176,11,68,17,29,10963,3,2225,8339
EDO. LARA,MP. MORAN,PQ. BOLIVAR,45937,99,837,37445,21322,36608,12,228,27,101,46370,16,15003,37445
EDO. LARA,MP. MORAN,PQ. LA CANDELARIA,1505,4,28,1054,926,1026,0,1,1,4,1505,1,97,1054
EDO. LARA,MP. JIMENEZ,PQ. CRNEL. MARIANO PERAZA,9087,21,188,7712,4532,7524,5,62,9,21,9087,10,2906,7712
EDO. LARA,MP. JIMENEZ,PQ. JUAN B RODRIGUEZ,26839,53,411,22100,13000,21689,10,152,13,53,26839,14,8500,22100
EDO. LARA,MP. JIMENEZ,PQ. TINTORERO,8003,17,157,6660,4454,6503,3,41,8,17,8003,7,1990,6660
EDO. LARA,MP. JIMENEZ,PQ. SAN MIGUEL,2761,7,22,2178,1696,2156,1,21,2,7,2761,0,436,2178
EDO. LARA,MP. JIMENEZ,PQ. PARAISO DE SAN JOSE,867,2,13,707,603,694,0,1,1,3,1105,0,89,707
EDO. LARA,MP. JIMENEZ,PQ. CUARA,3316,8,48,2735,1810,2687,1,23,3,8,3316,0,850,2735
EDO. LARA,MP. JIMENEZ,PQ. DIEGO DE LOZADA,5383,12,114,4393,2792,4279,0,36,5,12,5383,0,1446,4393
EDO. LARA,MP. JIMENEZ,PQ. JOSE BERNARDO DORANTE,7879,17,163,6541,4379,6378,2,46,7,17,7879,3,1941,6541
EDO. LARA,MP. TORRES,PQ. EL BLANCO,4880,10,56,3786,2114,3730,1,16,1,17,6158,0,1598,3786
EDO. LARA,MP. TORRES,PQ. MANUEL MORILLO,2230,4,38,1735,1160,1697,0,6,0,6,2858,1,530,1735
EDO. LARA,MP. TORRES,PQ. LAS MERCEDES,4906,12,97,3870,2298,3773,3,18,2,14,5719,1,1451,3870
EDO. LARA,MP. TORRES,PQ. TORRES,1113,2,14,744,463,730,0,4,2,2,1113,0,261,744
EDO. LARA,MP. TORRES,PQ. ANTONIO DIAZ,2790,6,42,2066,1251,2024,0,9,1,9,3626,1,762,2066
EDO. LARA,MP. TORRES,PQ. CECILIO ZUBILLAGA,4137,9,68,3377,2476,3309,0,15,3,10,4595,1,814,3377
EDO. LARA,MP. TORRES,PQ. TRINIDAD SAMUEL,69893,142,1186,58493,28039,57307,24,294,31,149,73550,24,28895,58493
EDO. LARA,MP. TORRES,PQ. LARA,1027,2,13,829,491,816,0,4,1,3,1133,1,319,829
EDO. LARA,MP. TORRES,PQ. CHIQUINQUIRA,3476,7,44,2765,1635,2721,0,9,1,9,3767,1,1075,2765
EDO. LARA,MP. TORRES,PQ. MONTA A VERDE,5345,12,71,3959,2523,3888,1,38,10,19,7390,3,1313,3959
EDO. LARA,MP. TORRES,PQ. ESPINOZA LOS MONTEROS,4163,9,82,3361,2123,3279,1,16,2,9,4163,3,1134,3361
EDO. LARA,MP. TORRES,PQ. HERIBERTO ARROYO,293,1,2,217,154,215,2,0,0,1,293,0,59,217
EDO. LARA,MP. TORRES,PQ. CASTA#EDA,2072,4,31,1635,920,1604,2,15,0,7,2859,2,665,1635
EDO. LARA,MP. TORRES,PQ. MONTES DE OCA,1840,4,30,1387,797,1357,0,6,0,8,2951,1,553,1387
EDO. LARA,MP. TORRES,PQ. CAMACARO,4735,9,67,3974,2664,3907,1,5,5,15,6932,0,1232,3974
EDO. LARA,MP. TORRES,PQ. ALTAGRACIA,967,2,7,793,351,786,0,3,0,6,1426,2,430,793
EDO. LARA,MP. TORRES,PQ. REYES VARGAS
EDO. LARA,MP. SIMON PLANAS,PQ. SARARE,11545,24,198,9392,6756,9194,7,43,10,24,11545,6,2372,9392
EDO. LARA,MP. SIMON PLANAS,PQ. GUSTAVO VEGAS LEON,7946,17,128,6584,4819,6456,5,43,3,17,7946,1,1585,6584
EDO. LARA,MP. SIMON PLANAS,PQ. BURIA,5353,12,112,4218,3059,4106,2,27,5,12,5353,2,1011,4218
EDO. LARA,MP. CRESPO,PQ. JOSE MARIA BLANCO,11356,23,272,9414,5290,9142,1,61,18,23,11356,4,3768,9414
EDO. LARA,MP. CRESPO,PQ. FREITEZ,21884,48,414,17664,8675,17250,9,98,17,49,22372,14,8437,17664
EDO. LARA,MP. PALAVECINO,PQ. CABUDARE,41539,85,545,35486,14259,34941,7,238,22,85,41539,18,20397,35486
EDO. LARA,MP. PALAVECINO,PQ. AGUA VIVA,9681,18,188,8281,4055,8093,2,46,12,18,9681,4,3974,8281
EDO. LARA,MP. PALAVECINO,PQ. JOSE G. BASTIDAS,51077,99,601,44990,15268,44389,7,164,27,99,51077,17,28906,44990
EDO. LARA,CE. IRIBARREN,PQ. TAMACA,36178,75,657,29631,16868,28974,11,268,38,78,37542,12,11777,29631
EDO. LARA,CE. IRIBARREN,PQ. SANTA ROSA,57271,108,717,48992,15671,48275,14,217,27,108,57271,29,32317,48992
EDO. LARA,CE. IRIBARREN,PQ. CATEDRAL,98537,197,1308,82647,26765,81339,15,421,52,199,99534,37,54049,82647
EDO. LARA,CE. IRIBARREN,PQ. AGUEDO F. ALVARADO,7866,19,143,6345,3705,6202,3,49,7,36,14970,1,2437,6345
EDO. LARA,CE. IRIBARREN,PQ. EL CUJI,27422,56,431,22993,11873,22562,6,185,24,56,27422,21,10453,22993
EDO. LARA,CE. IRIBARREN,PQ. UNION,97254,191,1764,80715,44397,78951,28,566,39,194,98434,50,33871,80715
EDO. LARA,CE. IRIBARREN,PQ. LA CONCEPCION,117491,231,1512,99625,32832,98113,21,460,48,232,118079,68,64684,99625
EDO. LARA,CE. IRIBARREN,PQ. JUAREZ,9940,21,201,7799,4795,7598,2,51,11,22,10161,7,2732,7799
EDO. LARA,CE. IRIBARREN,PQ. JUAN DE VILLEGAS,208648,416,3700,173413,96880,169713,64,1269,157,422,211716,110,71233,173413
EDO. LARA,CE. IRIBARREN,PQ. BUENA VISTA,4791,13,55,3568,2688,3513,5,17,5,14,5270,2,796,3568
EDO. LARA,MP. URDANETA,PQ. MOROTURO,14397,37,196,11429,8198,11233,6,72,17,37,14397,3,2937,11429
EDO. LARA,MP. URDANETA,PQ. XAGUAS,2469,9,27,1892,831,1865,0,7,2,11,2805,0,1025,1892
EDO. LARA,MP. URDANETA,PQ. SAN MIGUEL,8986,29,90,7221,4794,7131,2,44,11,29,8986,2,2278,7221
EDO. LARA,MP. URDANETA,PQ. SIQUISIQUE,15851,47,217,12820,8164,12603,5,66,18,50,17130,2,4348,12820
EDO. MERIDA,CE. LIBERTADOR,PQ. ARIAS,12183,25,214,10356,4250,10142,3,39,3,25,12183,8,5839,10356
EDO. MERIDA,CE. LIBERTADOR,PQ. EL MORRO,1299,5,19,1043,673,1024,0,2,0,6,1402,0,349,1043
EDO. MERIDA,CE. LIBERTADOR,PQ. CARACCIOLO PARRA P,10957,21,101,9521,2002,9420,2,17,4,21,10957,7,7388,9521
EDO. MERIDA,CE. LIBERTADOR,PQ. LOS NEVADOS,619,2,15,476,350,461,0,0,0,2,619,0,111,476
EDO. MERIDA,CE. LIBERTADOR,PQ. GONZALO PICON FEBRES,4913,10,89,4182,1864,4093,4,14,2,10,4913,0,2209,4182
EDO. MERIDA,CE. LIBERTADOR,PQ. MILLA,17122,33,238,14386,4996,14148,10,60,3,34,17605,10,9069,14386
EDO. MERIDA,CE. LIBERTADOR,PQ. MARIANO PICON SALAS,9753,18,119,8436,2389,8317,6,25,1,20,10698,2,5894,8436
EDO. MERIDA,CE. LIBERTADOR,PQ. EL LLANO,11325,22,113,9498,2315,9385,1,30,4,22,11325,5,7030,9498
EDO. MERIDA,CE. LIBERTADOR,PQ. DOMINGO PE#A,19271,38,238,16720,5925,16482,5,56,4,38,19271,10,10482,16720
EDO. MERIDA,CE. LIBERTADOR,PQ. JACINTO PLAZA,17450,33,295,14613,7683,14318,6,65,11,34,18004,3,6550,14613
EDO. MERIDA,CE. LIBERTADOR,PQ. ANTONIO SPINETTI DINI,20205,37,253,17196,5929,16943,4,42,5,37,20205,11,10952,17196
EDO. MERIDA,CE. LIBERTADOR,PQ. JUAN RODRIGUEZ SUAREZ,13718,27,127,11933,2317,11806,4,25,5,27,13718,6,9449,11933
EDO. MERIDA,CE. LIBERTADOR,PQ. LASSO DE LA VEGA,8572,16,116,7364,2438,7248,1,22,2,16,8572,5,4780,7364
EDO. MERIDA,CE. LIBERTADOR,PQ. OSUNA RODRIGUEZ,11954,24,188,10248,4720,10060,2,30,6,24,11954,1,5301,10248
EDO. MERIDA,CE. LIBERTADOR,PQ. SAGRARIO,5211,10,73,4255,1215,4182,0,12,2,10,5211,5,2948,4255
EDO. MERIDA,MP. PUEBLO LLANO,CM. PUEBLO LLANO,7149,15,113,5962,3017,5849,1,13,1,15,7149,0,2817,5962
EDO. MERIDA,MP.OB. RAMOS DE LORA,PQ. PQ R DE ALCAZAR,3871,9,51,2996,1801,2945,0,7,1,9,3871,0,1136,2996
EDO. MERIDA,MP.OB. RAMOS DE LORA,CM. STA ELENA DE ARENALES,9459,22,117,7741,4453,7624,0,31,3,22,9459,3,3134,7741
EDO. MERIDA,MP.OB. RAMOS DE LORA,PQ. ELOY PAREDES,5174,14,49,4216,2522,4167,0,24,2,14,5174,1,1618,4216
EDO. MERIDA,MP. SUCRE,PQ. CHIGUARA,5790,14,120,4696,2510,4576,1,11,3,14,5790,1,2050,4696
EDO. MERIDA,MP. SUCRE,PQ. PUEBLO NUEVO DEL SUR,2114,7,18,1564,1023,1546,0,6,2,10,3093,2,513,1564
EDO. MERIDA,MP. SUCRE,CM. LAGUNILLAS,14013,30,225,11476,6364,11251,4,51,3,30,14013,5,4824,11476
EDO. MERIDA,MP. SUCRE,PQ. SAN JUAN,7407,16,138,6028,3434,5890,0,31,2,17,7945,1,2422,6028
EDO. MERIDA,MP. SUCRE,PQ. ESTANQUES,2700,8,38,2096,1268,2058,2,9,0,10,3137,0,779,2096
EDO. MERIDA,MP. SUCRE,PQ. LA TRAMPA,1720,6,25,1252,844,1227,0,7,4,6,1720,0,372,1252
EDO. MERIDA,MP. MIRANDA,PQ. PI#ANGO,1082,4,14,920,544,906,1,3,0,4,1082,1,357,920
EDO. MERIDA,MP. MIRANDA,PQ. LA VENTA,1257,3,25,1033,425,1008,0,8,0,3,1257,0,575,1033
EDO. MERIDA,MP. MIRANDA,PQ. ANDRES ELOY BLANCO,1594,3,33,1242,554,1209,0,10,1,3,1594,1,643,1242
EDO. MERIDA,MP. MIRANDA,CM. CHACHOPO,10950,25,238,9294,4626,9056,3,30,7,26,11454,3,4387,9294
EDO. MERIDA,MP.JULIO CESAR SALAS,PQ. PALMIRA,1919,5,12,1546,953,1534,0,5,0,5,1919,0,576,1546
EDO. MERIDA,MP.JULIO CESAR SALAS,CM. ARAPUEY,8025,21,138,6151,3969,6013,2,19,1,21,8025,0,2022,6151
EDO. MERIDA,MP. SANTOS MARQUINA,CM. TABAY,12001,25,219,10241,5205,10022,6,32,10,25,12001,6,4763,10241
EDO. MERIDA,MP. JUSTO BRICE#O,CM. TORONDOY,3701,11,49,2914,1840,2865,0,10,2,11,3701,1,1012,2914
EDO. MERIDA,MP. JUSTO BRICE#O,PQ. SAN CRISTOBAL DE T,1311,3,21,1082,645,1061,1,0,0,3,1311,0,415,1082
EDO. MERIDA,MP. CAMPO ELIAS,PQ. MONTALBAN,19786,38,272,16940,7320,16668,3,40,2,38,19786,4,9299,16940
EDO. MERIDA,MP. CAMPO ELIAS,PQ. JAJI,2505,7,34,2053,1086,2019,2,3,1,7,2505,0,927,2053
EDO. MERIDA,MP. CAMPO ELIAS,PQ. MATRIZ,28796,54,460,24203,11910,23743,9,104,10,55,29293,15,11695,24203
EDO. MERIDA,MP. CAMPO ELIAS,PQ. SAN JOSE,901,3,12,658,329,646,0,1,0,3,901,0,316,658
EDO. MERIDA,MP. CAMPO ELIAS,PQ. LA MESA,3431,7,61,2724,1529,2663,1,5,0,7,3431,0,1128,2724
EDO. MERIDA,MP. CAMPO ELIAS,PQ. FERNANDEZ PE#A,8182,17,173,7033,3050,6860,1,20,4,18,8727,8,3777,7033
EDO. MERIDA,MP. CAMPO ELIAS,PQ. ACEQUIAS,640,2,6,446,292,440,0,4,0,2,640,0,144,446
EDO. MERIDA,MP. ARICAGUA,PQ. SAN ANTONIO,922,2,7,671,335,664,0,1,1,2,922,0,327,671
EDO. MERIDA,MP. ARICAGUA,CM. ARICAGUA,2902,7,37,2320,950,2283,0,6,1,7,2902,0,1326,2320
EDO. MERIDA,MP. ARZOBISPO CHACON,PQ. CAPURI,596,2,5,443,290,438,0,0,0,2,596,0,148,443
EDO. MERIDA,MP. ARZOBISPO CHACON,PQ. EL MOLINO,1264,3,21,1004,486,983,0,3,0,3,1264,0,494,1004
EDO. MERIDA,MP. ARZOBISPO CHACON,CM. CANAGUA,2555,6,44,2108,1106,2064,2,5,1,6,2555,0,950,2108
EDO. MERIDA,MP. ARZOBISPO CHACON,PQ. CHACANTA,1404,5,7,1070,721,1063,0,5,1,5,1404,1,335,1070
EDO. MERIDA,MP. ARZOBISPO CHACON,PQ. GUAIMARAL,335,1,1,228,105,227,0,1,0,3,662,0,121,228
EDO. MERIDA,MP. ARZOBISPO CHACON,PQ. MUCUTUY,2017,7,56,1479,722,1423,0,5,1,7,2017,1,694,1479
EDO. MERIDA,MP. ARZOBISPO CHACON,PQ. MUCUCHACHI,1155,3,10,873,529,863,0,2,0,7,1503,0,332,873
EDO. MERIDA,MP. RANGEL,CM. MUCUCHIES,5240,10,104,4601,2131,4497,3,10,0,10,5240,0,2353,4601
EDO. MERIDA,MP. RANGEL,PQ. SAN RAFAEL,2704,6,79,2278,1104,2199,0,17,3,6,2704,0,1075,2278
EDO. MERIDA,MP. RANGEL,PQ. LA TOMA,1346,3,56,1156,635,1100,0,2,0,3,1346,1,462,1156
EDO. MERIDA,MP. RANGEL,PQ. CACUTE,1044,2,37,879,482,842,0,3,0,2,1044,0,357,879
EDO. MERIDA,MP. RANGEL,PQ. MUCURUBA,2510,6,46,2127,1052,2081,1,10,1,6,2510,1,1016,2127
EDO. MERIDA,MP. PADRE NOGUERA,CM. STA MARIA DE CAPARO,2531,5,32,2106,1054,2074,0,15,1,5,2531,0,1004,2106
EDO. MERIDA,MP. GUARAQUE,PQ. MESA DE QUINTERO,890,2,8,691,438,683,0,0,0,2,890,0,245,691
EDO. MERIDA,MP. GUARAQUE,CM. GUARAQUE,2907,6,42,2196,1382,2154,1,2,0,8,3805,0,769,2196
EDO. MERIDA,MP. GUARAQUE,PQ. RIO NEGRO,2682,6,30,2136,1018,2106,0,0,1,6,2682,0,1087,2136
EDO. MERIDA,MP. TULIO F CORDERO,CM. NUEVA BOLIVIA,10082,21,164,8372,4908,8208,4,41,4,21,10082,3,3248,8372
EDO. MERIDA,MP. TULIO F CORDERO,PQ. SANTA APOLONIA,2233,6,28,1738,1002,1710,0,4,1,6,2233,1,702,1738
EDO. MERIDA,MP. TULIO F CORDERO,PQ. MARIA C PALACIOS,2864,10,72,2284,1658,2212,0,7,1,10,2864,0,546,2284
EDO. MERIDA,MP. TULIO F CORDERO,PQ. INDEPENDENCIA,5484,13,108,4437,3163,4329,0,19,2,13,5484,0,1145,4437
EDO. MERIDA,MP. ANTONIO PINTO S.,PQ. MESA DE LAS PALMAS,1847,6,32,1567,974,1535,0,0,0,6,1847,1,560,1567
EDO. MERIDA,MP. ANTONIO PINTO S.,PQ. MESA BOLIVAR,3538,8,64,2859,1665,2795,0,10,0,8,3538,1,1119,2859
EDO. MERIDA,MP. ANTONIO PINTO S.,CM. STA CRUZ DE MORA,12742,26,180,10630,5270,10450,1,38,3,27,13242,0,5138,10630
EDO. MERIDA,MP. ANDRES BELLO,CM. LA AZULITA,9652,26,145,7973,4785,7828,0,26,0,27,9909,3,3014,7973
EDO. MERIDA,MP. TOVAR,PQ. EL LLANO,6387,12,66,5462,2133,5396,3,15,1,14,7417,1,3243,5462
EDO. MERIDA,MP. TOVAR,PQ. SAN FRANCISCO,1833,5,13,1562,866,1549,0,2,0,5,1833,1,680,1562
EDO. MERIDA,MP. TOVAR,PQ. EL AMPARO,1600,4,29,1295,749,1266,0,3,0,4,1600,0,514,1295
EDO. MERIDA,MP. TOVAR,PQ. TOVAR,16512,33,240,13758,6313,13518,0,44,6,33,16512,3,7152,13758
EDO. MERIDA,MP. CARACCIOLO PARRA,CM. TUCANI,11866,27,272,9380,5122,9108,3,33,7,27,11866,1,3942,9380
EDO. MERIDA,MP. CARACCIOLO PARRA,PQ. FLORENCIO RAMIREZ,4123,8,58,3236,2143,3178,0,10,1,8,4123,1,1023,3236
EDO. MERIDA,MP. ZEA,CM. ZEA,5849,14,56,4942,2133,4886,1,16,3,14,5849,3,2730,4942
EDO. MERIDA,MP. ZEA,PQ. CA#O EL TIGRE,1574,3,22,1314,780,1292,0,6,1,4,2152,0,505,1314
EDO. MERIDA,MP.CARDENAL QUINTERO,CM. SANTO DOMINGO,3839,8,102,3245,1789,3143,0,9,1,8,3839,0,1344,3245
EDO. MERIDA,MP.CARDENAL QUINTERO,PQ. LAS PIEDRAS,3112,9,50,2540,1713,2490,0,11,1,9,3112,1,764,2540
EDO. MERIDA,MP. RIVAS DAVILA,CM. BAILADORES,11006,25,181,9176,4606,8995,2,35,2,25,11006,5,4345,9176
EDO. MERIDA,MP. RIVAS DAVILA,PQ. GERONIMO MALDONADO,2665,5,28,2257,1042,2229,0,9,0,5,2665,1,1177,2257
EDO. MERIDA,MP. ALBERTO ADRIANI,PQ. PRESIDENTE PAEZ,23796,51,381,19530,9869,19149,8,87,10,51,23796,4,9171,19530
EDO. MERIDA,MP. ALBERTO ADRIANI,PQ. PTE. ROMULO GALLEGOS,17316,34,257,14402,7277,14145,6,52,7,34,17316,2,6801,14402
EDO. MERIDA,MP. ALBERTO ADRIANI,PQ. HECTOR AMABLE MORA,6589,16,109,5269,3186,5160,1,17,4,16,6589,3,1949,5269
EDO. MERIDA,MP. ALBERTO ADRIANI,PQ. JOSE NUCETE SARDI,1548,4,25,1206,968,1181,0,4,0,4,1548,0,209,1206
EDO. MERIDA,MP. ALBERTO ADRIANI,PQ. PULIDO MENDEZ,15119,32,289,12622,7133,12333,4,46,0,32,15119,1,5149,12622
EDO. MERIDA,MP. ALBERTO ADRIANI,PQ. PRESIDENTE BETANCOURT,15918,32,294,12987,6237,12693,4,55,8,32,15918,5,6384,12987
EDO. MERIDA,MP. ALBERTO ADRIANI,PQ. GABRIEL PICON G.,3219,9,55,2494,1399,2439,2,12,1,9,3219,0,1025,2494
EDO. MIRANDA,MP. INDEPENDENCIA,PQ. STA TERESA DEL TUY,45714,89,758,37142,25695,36384,14,139,29,91,46683,15,10492,37142
EDO. MIRANDA,MP. INDEPENDENCIA,PQ. EL CARTANAL,42703,82,776,35447,25810,34671,7,180,20,85,44327,30,8624,35447
EDO. MIRANDA,MP. BARUTA,PQ. BARUTA,147569,279,1150,115139,24046,113989,24,210,32,281,148683,76,89601,115139
EDO. MIRANDA,MP. BARUTA,PQ. EL CAFETAL,43168,82,171,33001,2504,32830,6,37,4,83,43708,17,30262,33001
EDO. MIRANDA,MP. BARUTA,PQ. LAS MINAS DE BARUTA,35976,68,398,28637,9793,28239,4,71,13,68,35976,12,18346,28637
EDO. MIRANDA,MP. SIMON BOLIVAR,PQ. S ANTONIO DE YARE,6552,16,124,5364,4326,5240,0,25,4,16,6552,7,878,5364
EDO. MIRANDA,MP. SIMON BOLIVAR,PQ. SAN FCO DE YARE,19204,40,360,16113,10830,15753,4,57,8,40,19204,9,4845,16113
EDO. MIRANDA,MP. PLAZA,PQ. GUARENAS,134220,257,2234,114141,66334,111907,24,454,48,262,136683,94,44953,114141
EDO. MIRANDA,MP. SUCRE,PQ. PETARE,319672,615,4174,254434,115481,250260,69,918,127,619,321644,181,133484,254434
EDO. MIRANDA,MP. SUCRE,PQ. CAUCAGUITA,32234,61,644,25751,15770,25107,8,106,12,62,32802,20,9191,25751
EDO. MIRANDA,MP. SUCRE,PQ. LEONCIO MARTINEZ,60629,116,572,46268,9889,45696,10,89,12,116,60629,37,35659,46268
EDO. MIRANDA,MP. SUCRE,PQ. LA DOLORITA,21413,42,461,17334,11755,16873,10,99,17,42,21413,13,4979,17334
EDO. MIRANDA,MP. SUCRE,PQ. FILAS DE MARICHES,21642,42,360,17074,12149,16714,9,75,14,42,21642,4,4463,17074
EDO. MIRANDA,MP. BUROZ,PQ. MAMPORAL,16109,35,326,12846,8728,12520,1,51,5,35,16109,4,3731,12846
EDO. MIRANDA,MP. EL HATILLO,PQ. EL HATILLO,50654,95,407,40806,7329,40399,4,82,16,96,51215,18,32950,40806
EDO. MIRANDA,MP. LOS SALIAS,PQ. SAN ANTONIO LOS ALTOS,55106,104,474,46222,10862,45748,9,74,21,104,55106,42,34740,46222
EDO. MIRANDA,MP. ANDRES BELLO,PQ. CUMBO,863,2,23,622,345,599,1,2,0,3,1297,0,251,622
EDO. MIRANDA,MP. ANDRES BELLO,PQ.SAN JOSE DE BARLOVENTO,14153,35,292,11341,7603,11049,4,41,6,36,14607,4,3391,11341
EDO. MIRANDA,MP. PEDRO GUAL,PQ. CUPIRA,12735,30,282,9774,5936,9492,5,62,4,31,12836,4,3481,9774
EDO. MIRANDA,MP. PEDRO GUAL,PQ. MACHURUCUTO,944,2,15,741,380,726,0,3,0,2,944,0,343,741
EDO. MIRANDA,MP. PAZ CASTILLO,PQ. SANTA LUCIA,63099,127,1078,51717,38237,50639,13,234,29,127,63099,33,12093,51717
EDO. MIRANDA,MP. CRISTOBAL ROJAS,PQ. CHARALLAVE,67818,135,1313,57124,35542,55811,17,262,25,136,68385,48,19917,57124
EDO. MIRANDA,MP. CRISTOBAL ROJAS,PQ. LAS BRISAS,10668,22,247,8490,5861,8243,5,41,6,22,10668,10,2320,8490
EDO. MIRANDA,MP. CARRIZAL,PQ. CARRIZAL,35876,70,529,29982,12818,29453,8,101,21,71,36403,39,16466,29982
EDO. MIRANDA,MP. CHACAO,PQ. CHACAO,81580,156,698,60077,10910,59379,13,128,26,157,82111,40,48262,60077
EDO. MIRANDA,MP. ZAMORA,PQ. BOLIVAR,13885,34,221,11143,7729,10922,2,34,7,35,14434,10,3140,11143
EDO. MIRANDA,MP. ZAMORA,PQ. GUATIRE,103091,199,1801,88027,45310,86226,11,318,40,201,104206,72,40475,88027
EDO. MIRANDA,MP. BRION,PQ. HIGUEROTE,21096,40,503,17091,9638,16588,4,74,12,40,21096,11,6849,17091
EDO. MIRANDA,MP. BRION,PQ. CURIEPE,8285,19,175,6593,4515,6418,2,27,6,19,8285,3,1865,6593
EDO. MIRANDA,MP. BRION,PQ. TACARIGUA,9427,21,188,7668,4683,7480,0,42,2,21,9427,8,2745,7668
EDO. MIRANDA,MP. URDANETA,PQ. NUEVA CUA,25674,56,502,20900,15710,20398,14,102,13,56,25674,12,4547,20900
EDO. MIRANDA,MP. URDANETA,PQ. CUA,55581,111,1101,46752,28101,45651,14,198,28,112,56115,49,17261,46752
EDO. MIRANDA,MP. LANDER,PQ. LA DEMOCRACIA,1285,4,20,919,706,899,0,2,0,4,1285,0,191,919
EDO. MIRANDA,MP. LANDER,PQ. SANTA BARBARA,7867,15,154,6669,5231,6515,2,18,5,15,7867,5,1254,6669
EDO. MIRANDA,MP. LANDER,PQ. OCUMARE DEL TUY,79613,156,1469,65518,47028,64049,18,309,38,157,80142,44,16612,65518
EDO. MIRANDA,MP. ACEVEDO,PQ. AREVALO GONZALEZ,4193,13,89,3155,2311,3066,1,13,4,13,4193,0,737,3155
EDO. MIRANDA,MP. ACEVEDO,PQ. PANAQUIRE,4827,14,112,3784,2649,3672,1,13,3,14,4827,1,1005,3784
EDO. MIRANDA,MP. ACEVEDO,PQ. ARAGUITA,4896,12,90,3688,2741,3598,1,13,3,12,4896,0,840,3688
EDO. MIRANDA,MP. ACEVEDO,PQ. MARIZAPA,5649,12,199,4636,3180,4437,1,22,2,12,5649,2,1230,4636
EDO. MIRANDA,MP. ACEVEDO,PQ. CAUCAGUA,19049,40,381,14730,9272,14349,6,82,12,40,19049,14,4963,14730
EDO. MIRANDA,MP. ACEVEDO,PQ. RIBAS,4926,18,64,3646,2622,3582,0,12,2,21,5403,3,943,3646
EDO. MIRANDA,MP. ACEVEDO,PQ. EL CAFE,3984,11,56,3029,2200,2973,0,14,2,11,3984,0,757,3029
EDO. MIRANDA,MP. ACEVEDO,PQ. CAPAYA,7680,20,215,5978,3882,5763,0,23,5,21,7850,4,1849,5978
EDO. MIRANDA,CE. GUAICAIPURO,PQ. SAN PEDRO,7559,15,160,6177,2915,6017,2,29,5,15,7559,5,3061,6177
EDO. MIRANDA,CE. GUAICAIPURO,PQ. EL JARILLO,2320,4,61,1744,814,1683,2,6,0,4,2320,1,860,1744
EDO. MIRANDA,CE. GUAICAIPURO,PQ. LOS TEQUES,150804,290,2367,125095,61846,122728,51,511,69,292,151901,108,60143,125095
EDO. MIRANDA,CE. GUAICAIPURO,PQ. ALTAGRACIA DE LA M,2609,6,74,2017,1181,1943,1,11,2,6,2609,0,748,2017
EDO. MIRANDA,CE. GUAICAIPURO,PQ. TACATA,3028,6,44,2507,1653,2463,0,10,2,6,3028,3,795,2507
EDO. MIRANDA,CE. GUAICAIPURO,PQ. CECILIO ACOSTA,11695,23,153,9374,4585,9221,1,36,6,23,11695,6,4587,9374
EDO. MIRANDA,CE. GUAICAIPURO,PQ. PARACOTOS,8482,20,160,6915,4127,6755,0,20,10,20,8482,4,2594,6915
EDO. MIRANDA,MP. PAEZ,PQ. RIO CHICO,13964,28,328,11276,6579,10948,4,37,5,28,13964,2,4321,11276
EDO. MIRANDA,MP. PAEZ,PQ. EL GUAPO,5406,14,80,4261,3139,4181,0,14,3,14,5406,2,1023,4261
EDO. MIRANDA,MP. PAEZ,PQ. SN FERNANDO DEL GUAPO,2332,5,57,1837,1202,1780,1,14,1,5,2332,0,562,1837
EDO. MIRANDA,MP. PAEZ,PQ.TACARIGUA DE LA LAGUNA,3224,6,63,2665,1459,2602,0,12,1,6,3224,2,1128,2665
EDO. MIRANDA,MP. PAEZ,PQ. PAPARO,1029,2,17,866,532,849,0,5,0,2,1029,0,312,866
EDO. MONAGAS,MP. SOTILLO,LOS BARRANCOS DE FAJARDO,4760,12,72,3704,2991,3632,1,30,5,12,4760,0,605,3704
EDO. MONAGAS,MP. SOTILLO,CM. BARRANCAS,10110,21,162,7409,4608,7247,0,55,5,24,11142,2,2577,7409
EDO. MONAGAS,MP. PUNCERES,CM. QUIRIQUIRE,11318,26,205,8836,5703,8631,4,74,3,26,11318,3,2844,8836
EDO. MONAGAS,MP. PUNCERES,PQ. CACHIPO,9919,20,154,7865,4751,7711,2,42,0,20,9919,4,2912,7865
EDO. MONAGAS,MP. CEDE#O,PQ. SAN FELIX,3550,9,33,2824,1300,2791,0,9,0,9,3550,0,1482,2824
EDO. MONAGAS,MP. CEDE#O,PQ. AREO,3971,11,60,3087,2258,3027,0,22,1,13,4264,0,746,3087
EDO. MONAGAS,MP. CEDE#O,CM. CAICARA,13399,27,169,10866,4358,10697,1,58,14,30,14928,4,6262,10866
EDO. MONAGAS,MP. CEDE#O,PQ. VIENTO FRESCO,2622,5,50,2065,1129,2015,0,14,1,5,2622,1,870,2065
EDO. MONAGAS,MP. PIAR,PQ. GUANAGUANA,3870,10,79,3007,1816,2928,0,8,4,10,3870,1,1099,3007
EDO. MONAGAS,MP. PIAR,PQ. APARICIO,2819,8,38,2292,1352,2254,0,7,2,8,2819,0,893,2292
EDO. MONAGAS,MP. PIAR,PQ. LA TOSCANA,7158,16,105,5585,3590,5480,2,27,0,16,7158,2,1859,5585
EDO. MONAGAS,MP. PIAR,CM. ARAGUA,7112,14,112,5713,3566,5601,0,26,4,14,7112,0,2005,5713
EDO. MONAGAS,MP. PIAR,PQ. EL PINTO,1549,4,17,1141,852,1124,3,12,1,6,2302,0,256,1141
EDO. MONAGAS,MP. PIAR,PQ. CHAGUARAMAL,5898,14,90,4517,2786,4427,2,22,0,14,5898,3,1614,4517
EDO. MONAGAS,MP. PIAR,PQ. TAGUAYA,2376,6,26,1929,1140,1903,0,8,1,6,2376,0,754,1929
EDO. MONAGAS,MP. ACOSTA,PQ. SAN FRANCISCO,5333,12,102,3926,2281,3824,1,6,2,12,5333,3,1531,3926
EDO. MONAGAS,MP. ACOSTA,CM. SAN ANTONIO,9888,23,163,7803,3807,7640,0,27,2,23,9888,4,3800,7803
EDO. MONAGAS,MP. LIBERTADOR,PQ. CHAGUARAMAS,3681,7,78,2814,2230,2736,1,14,2,7,3681,1,488,2814
EDO. MONAGAS,MP. LIBERTADOR,CM. TEMBLADOR,20803,40,371,16832,11669,16461,6,132,6,41,21323,4,4644,16832
EDO. MONAGAS,MP. LIBERTADOR,PQ. TABASCA,2715,8,49,2023,1401,1974,0,16,3,8,2715,2,552,2023
EDO. MONAGAS,MP. LIBERTADOR,PQ. LAS ALHUACAS
EDO. MONAGAS,MP. SANTA BARBARA,CM. SANTA BARBARA,7182,16,151,5845,3522,5694,0,28,1,17,7580,5,2138,5845
EDO. MONAGAS,MP. BOLIVAR,CM. CARIPITO,26627,63,438,20659,12845,20221,6,101,4,64,27194,5,7260,20659
EDO. MONAGAS,MP. CARIPE,PQ. LA GUANOTA,2118,6,16,1477,918,1461,0,12,4,6,2118,2,525,1477
EDO. MONAGAS,MP. CARIPE,PQ. SAN AGUSTIN,2794,6,48,2128,1335,2080,2,8,3,6,2794,0,732,2128
EDO. MONAGAS,MP. CARIPE,CM. CARIPE,8346,17,143,6592,3295,6449,2,19,6,18,8850,1,3126,6592
EDO. MONAGAS,MP. CARIPE,PQ. TERESEN,5603,14,95,4150,2900,4055,2,9,4,14,5603,0,1140,4150
EDO. MONAGAS,MP. CARIPE,PQ. SABANA DE PIEDRA,1764,4,38,1242,607,1204,0,2,1,4,1764,0,594,1242
EDO. MONAGAS,MP. CARIPE,PQ. EL GUACHARO,3030,7,29,2291,1344,2262,1,8,1,8,3489,1,907,2291
EDO. MONAGAS,MP. URACOA,CM. URACOA,7404,17,171,5889,2757,5718,1,24,4,17,7404,1,2931,5889
EDO. MONAGAS,CE. MATURIN,PQ. SAN SIMON,90388,185,1143,73938,34894,72795,15,425,40,202,97879,30,37391,73938
EDO. MONAGAS,CE. MATURIN,PQ. EL COROZO,4027,8,98,3252,2048,3154,0,18,2,8,4027,3,1083,3252
EDO. MONAGAS,CE. MATURIN,PQ. SANTA CRUZ,23669,45,357,20125,10349,19768,4,112,11,45,23669,6,9286,20125
EDO. MONAGAS,CE. MATURIN,PQ. SAN VICENTE,6371,12,89,4981,3293,4892,1,31,2,13,6893,1,1564,4981
EDO. MONAGAS,CE. MATURIN,PQ. ALTO DE LOS GODOS,85841,169,1111,72077,40861,70966,10,448,26,170,86322,21,29600,72077
EDO. MONAGAS,CE. MATURIN,PQ. BOQUERON,32787,66,548,26793,14782,26245,6,170,16,73,36282,8,11263,26793
EDO. MONAGAS,CE. MATURIN,PQ. JUSEPIN,8445,17,129,7054,5107,6925,2,42,1,17,8445,1,1772,7054
EDO. MONAGAS,CE. MATURIN,PQ. LA PICA,9914,22,197,7482,4725,7285,4,45,3,22,9914,4,2504,7482
EDO. MONAGAS,CE. MATURIN,PQ. EL FURRIAL,6750,13,128,5542,3516,5414,0,34,4,13,6750,4,1856,5542
EDO. MONAGAS,CE. MATURIN,PQ. LAS COCUIZAS,56064,114,895,45599,25859,44704,7,311,25,117,57415,21,18481,45599
EDO. MONAGAS,MP. EZEQUIEL ZAMORA,CM. PUNTA DE MATA,32960,66,651,27294,16716,26643,8,157,12,69,34530,8,9742,27294
EDO. MONAGAS,MP. EZEQUIEL ZAMORA,PQ. EL TEJERO,7517,15,184,6160,3871,5976,2,24,2,15,7517,1,2076,6160
EDO. MONAGAS,MP. AGUASAY,CM. AGUASAY,10684,23,212,8517,5276,8305,1,59,4,23,10684,0,2965,8517
EDO. PORTUGUESA,MP. GUANARITO,PQ. DIVINA PASTORA,3600,10,107,2941,2029,2834,2,25,1,11,3820,0,777,2941
EDO. PORTUGUESA,MP. GUANARITO,CM. GUANARITO,19134,42,370,15538,10274,15168,6,56,29,42,19134,1,4802,15538
EDO. PORTUGUESA,MP. GUANARITO,PQ.TRINIDAD DE LA CAPILLA,1913,6,23,1451,1229,1428,1,4,4,8,2534,2,188,1451
EDO. PORTUGUESA,MP. OSPINO,PQ. APARICION,6424,18,112,5179,4007,5067,2,29,6,18,6424,1,1022,5179
EDO. PORTUGUESA,MP. OSPINO,CM. OSPINO,18245,44,320,14849,10100,14529,6,104,13,44,18245,5,4301,14849
EDO. PORTUGUESA,MP. OSPINO,PQ. LA ESTACION,7094,29,118,5171,4252,5053,2,41,7,29,7094,0,751,5171
EDO. PORTUGUESA,MP.GENARO BOCONOITO,PQ. ANTOLIN TOVAR AQUINO,5964,16,115,4993,4134,4878,3,22,5,16,5964,0,714,4993
EDO. PORTUGUESA,MP.GENARO BOCONOITO,CM. BOCONOITO,10366,20,172,8504,6805,8332,1,53,4,20,10366,1,1468,8504
EDO. PORTUGUESA,MP.S RAFAEL DE ONOTO,CM. SAN RAFAEL DE ONOTO,9679,21,185,8067,5627,7882,1,56,3,21,9679,2,2193,8067
EDO. PORTUGUESA,MP.S RAFAEL DE ONOTO,PQ. SANTA FE,966,2,12,849,652,837,1,1,2,2,966,0,181,849
EDO. PORTUGUESA,MP.S RAFAEL DE ONOTO,PQ. THERMO MORLES,1624,4,26,1296,975,1270,0,12,0,4,1624,0,283,1296
EDO. PORTUGUESA,CE. GUANARE,CM. GUANARE,102759,216,2065,85596,53748,83531,40,545,61,220,104179,26,29111,85596
EDO. PORTUGUESA,CE. GUANARE,PQ. CORDOBA,387,2,4,292,262,288,0,2,0,7,1963,0,24,292
EDO. PORTUGUESA,CE. GUANARE,PQ. VIRGEN DE LA COROMOTO,6329,15,168,5240,4005,5072,1,39,5,16,6387,1,1021,5240
EDO. PORTUGUESA,CE. GUANARE,PQ.SAN JOSE DE LA MONTA#A,371,1,4,237,182,233,0,1,0,4,1414,0,50,237
EDO. PORTUGUESA,CE. GUANARE,PQ.SAN JUAN GUANAGUANARE,9330,23,162,7772,5274,7610,3,51,11,23,9330,3,2268,7772
EDO. PORTUGUESA,MP. ESTELLER,PQ. UVERAL,4494,15,73,3612,3005,3539,4,29,6,16,4698,1,494,3612
EDO. PORTUGUESA,MP. ESTELLER,CM. PIRITU,24354,55,435,20157,15170,19722,10,138,16,55,24354,6,4382,20157
EDO. PORTUGUESA,MP. SANTA ROSALIA,PQ. FLORIDA,1413,3,19,1088,888,1069,1,9,0,7,2669,0,171,1088
EDO. PORTUGUESA,MP. SANTA ROSALIA,CM. EL PLAYON,6919,17,93,5672,4459,5579,4,26,2,23,9463,0,1088,5672
EDO. PORTUGUESA,MP. TUREN,PQ. SAN ISIDRO LABRADOR,3735,9,35,2948,2143,2913,0,18,2,9,3735,2,748,2948
EDO. PORTUGUESA,MP. TUREN,CM. VILLA BRUZUAL,29083,60,422,23744,16507,23322,5,157,13,61,29626,8,6632,23744
EDO. PORTUGUESA,MP. TUREN,PQ. CANELONES,5668,13,97,4773,3942,4676,1,26,5,13,5668,0,702,4773
EDO. PORTUGUESA,MP. TUREN,PQ. SANTA CRUZ,3351,9,69,2562,2100,2493,2,19,10,9,3351,1,361,2562
EDO. PORTUGUESA,MP. PAPELON,CM. PAPELON,4542,9,83,3687,1958,3604,2,21,3,10,4841,0,1620,3687
EDO. PORTUGUESA,MP. PAPELON,PQ. CA#O DELGADITO,5266,16,97,4210,3435,4113,4,23,7,20,6561,1,643,4210
EDO. PORTUGUESA,MP. AGUA BLANCA,CM. AGUA BLANCA,14214,32,285,12205,9578,11920,6,53,11,32,14214,5,2267,12205
EDO. PORTUGUESA,MP. ARAURE,CM. ARAURE,79570,167,1335,67678,45209,66343,28,330,40,167,79570,37,20699,67678
EDO. PORTUGUESA,MP. ARAURE,PQ. RIO ACARIGUA,7679,17,104,6231,5270,6127,4,28,10,18,8220,1,814,6231
EDO. PORTUGUESA,MP. SUCRE,PQ. SAN JOSE DE SAGUAZ,1441,5,29,1175,865,1146,0,7,2,5,1441,0,272,1175
EDO. PORTUGUESA,MP. SUCRE,PQ.SAN RAFAEL PALO ALZADO,2456,7,40,1949,1374,1909,0,6,2,7,2456,0,527,1949
EDO. PORTUGUESA,MP. SUCRE,CM. BISCUCUY,14027,31,345,11616,6731,11271,4,64,6,35,16185,3,4463,11616
EDO. PORTUGUESA,MP. SUCRE,PQ. UVENCIO A VELASQUEZ,4550,11,67,3535,2403,3468,1,16,4,11,4550,0,1044,3535
EDO. PORTUGUESA,MP. SUCRE,PQ. CONCEPCION,2901,8,53,2214,1688,2161,1,8,1,8,2901,0,463,2214
EDO. PORTUGUESA,MP. SUCRE,PQ. VILLA ROSA,4320,12,54,3506,2499,3452,1,18,6,12,4320,3,925,3506
EDO. PORTUGUESA,MP. M.JOSE V DE UNDA,PQ. PE#A BLANCA,2104,6,32,1616,1271,1584,1,14,1,7,2527,0,297,1616
EDO. PORTUGUESA,MP. M.JOSE V DE UNDA,CM. CHABASQUEN,11459,31,224,8749,6353,8525,3,62,6,38,14266,2,2099,8749
EDO. PORTUGUESA,MP. PAEZ,PQ. PIMPINELA,3670,9,61,3009,2645,2948,3,13,5,9,3670,1,281,3009
EDO. PORTUGUESA,MP. PAEZ,CM. ACARIGUA,108025,211,1884,89694,59290,87810,32,542,44,212,108550,55,27847,89694
EDO. PORTUGUESA,MP. PAEZ,PQ. PAYARA,6874,15,89,5470,4769,5381,5,26,3,15,6874,3,575,5470
EDO. PORTUGUESA,MP. PAEZ,PQ. RAMON PERAZA,3756,9,100,3099,2435,2999,0,20,3,9,3756,0,541,3099
EDO. SUCRE,MP. ANDRES E BLANCO,PQ. ROMULO GALLEGOS,5336,13,65,3685,2151,3620,2,12,2,15,5972,1,1452,3685
EDO. SUCRE,MP. ANDRES E BLANCO,PQ. MARI#O,12925,28,163,9643,5238,9480,5,53,5,29,13230,2,4177,9643
EDO. SUCRE,MP. LIBERTADOR,PQ. TUNAPUY,7128,17,125,5476,3434,5351,2,16,2,17,7128,3,1894,5476
EDO. SUCRE,MP. LIBERTADOR,PQ. CAMPO ELIAS,1037,4,10,711,546,701,0,3,0,4,1037,0,152,711
EDO. SUCRE,MP. MARI#O,PQ. CAMPO CLARO,3160,8,61,2168,1398,2107,0,4,1,8,3160,1,703,2168
EDO. SUCRE,MP. MARI#O,PQ. MARABAL,1703,4,15,1212,889,1197,0,6,3,4,1703,0,299,1212
EDO. SUCRE,MP. MARI#O,PQ. SORO,1501,3,12,984,668,972,0,3,0,3,1501,0,301,984
EDO. SUCRE,MP. MARI#O,PQ. IRAPA,8429,19,95,5920,3516,5825,1,18,0,19,8429,1,2289,5920
EDO. SUCRE,MP. MARI#O,PQ. SAN ANTONIO DE IRAPA,1758,4,20,1143,736,1123,0,3,0,4,1758,0,384,1143
EDO. SUCRE,MP. ARISMENDI,PQ. ANTONIO JOSE DE SUCRE,2046,7,30,1279,864,1249,0,5,1,10,2178,0,379,1279
EDO. SUCRE,MP. ARISMENDI,PQ. EL MORRO DE PTO SANTO,5653,11,57,4282,2873,4225,2,10,1,11,5653,3,1336,4282
EDO. SUCRE,MP. ARISMENDI,PQ. PUERTO SANTO,4183,10,53,3112,1898,3059,1,9,0,10,4183,0,1151,3112
EDO. SUCRE,MP. ARISMENDI,PQ. SAN JUAN GALDONAS,3015,9,36,2065,1448,2029,1,11,1,11,3370,0,568,2065
EDO. SUCRE,MP. ARISMENDI,PQ. RIO CARIBE,17846,47,182,13288,8475,13106,2,41,3,49,18521,1,4584,13288
EDO. SUCRE,MP. ANDRES MATA,PQ. TAVERA ACOSTA,6508,20,57,4641,3203,4584,1,18,2,21,7070,1,1359,4641
EDO. SUCRE,MP. ANDRES MATA,PQ. SAN JOSE DE AREOCUAR,9502,29,141,7394,4564,7253,0,11,2,29,9502,4,2672,7394
EDO. SUCRE,MP. BERMUDEZ,PQ. SANTA CATALINA,43853,86,550,34647,20260,34097,7,162,27,87,44328,15,13626,34647
EDO. SUCRE,MP. BERMUDEZ,PQ. SANTA ROSA,21004,45,277,16640,9061,16363,4,58,10,47,22126,7,7223,16640
EDO. SUCRE,MP. BERMUDEZ,PQ. MACARAPANA,4288,10,55,3404,1972,3349,0,15,0,10,4288,0,1362,3404
EDO. SUCRE,MP. BERMUDEZ,PQ. SANTA TERESA,4021,8,34,3271,1656,3237,0,13,2,8,4021,0,1566,3271
EDO. SUCRE,MP. BERMUDEZ,PQ. BOLIVAR,21336,45,287,16938,11163,16651,3,76,10,46,21862,2,5397,16938
EDO. SUCRE,MP. CAJIGAL,PQ. PAUJIL,2756,9,42,1950,1313,1908,0,7,0,9,2756,0,588,1950
EDO. SUCRE,MP. CAJIGAL,PQ. LIBERTAD,3978,14,57,2744,2047,2687,0,15,1,15,4167,1,623,2744
EDO. SUCRE,MP. CAJIGAL,PQ. YAGUARAPARO,8225,23,117,6097,4255,5980,1,17,0,23,8225,1,1706,6097
EDO. SUCRE,MP. CRUZ S ACOSTA,PQ. ARAYA,13685,28,199,10589,6782,10390,2,44,8,28,13685,1,3553,10589
EDO. SUCRE,MP. CRUZ S ACOSTA,PQ. MANICUARE,5591,14,65,4553,2994,4488,1,21,0,14,5591,1,1471,4553
EDO. SUCRE,MP. CRUZ S ACOSTA,PQ. CHACOPATA,5397,11,65,4170,2750,4105,0,13,4,11,5397,0,1338,4170
EDO. SUCRE,MP. BOLIVAR,CM. MARIGUITAR,15272,36,221,11874,6355,11653,1,57,4,36,15272,1,5235,11874
EDO. SUCRE,MP. BENITEZ,PQ. EL RINCON,2651,5,30,1971,1162,1941,0,12,2,5,2651,0,765,1971
EDO. SUCRE,MP. BENITEZ,PQ. UNION,1569,5,11,1075,795,1064,0,1,0,6,2105,0,268,1075
EDO. SUCRE,MP. BENITEZ,PQ. GRAL FCO. A VASQUEZ,1569,3,17,1192,722,1175,0,2,0,3,1569,0,451,1192
EDO. SUCRE,MP. BENITEZ,PQ. GUARAUNOS,987,2,11,743,403,732,0,3,0,3,1458,0,326,743
EDO. SUCRE,MP. BENITEZ,PQ. TUNAPUICITO,1932,7,21,1442,1115,1421,1,1,2,7,1932,0,302,1442
EDO. SUCRE,MP. BENITEZ,PQ. EL PILAR,13130,38,127,9676,6538,9549,3,35,5,39,13573,2,2966,9676
EDO. SUCRE,MP. RIBERO,PQ. RENDON,3803,11,34,2531,1675,2497,0,14,2,11,3803,0,806,2531
EDO. SUCRE,MP. RIBERO,PQ. SANTA CRUZ,1738,5,29,1153,820,1124,0,2,1,5,1738,0,301,1153
EDO. SUCRE,MP. RIBERO,PQ. CARIACO,21781,47,269,16396,10744,16127,3,66,7,47,21781,1,5306,16396
EDO. SUCRE,MP. RIBERO,PQ. SANTA MARIA,5037,14,58,3280,2315,3222,1,17,3,14,5037,2,884,3280
EDO. SUCRE,MP. RIBERO,PQ. CATUARO,6292,17,65,4016,2707,3951,1,10,3,18,6430,2,1228,4016
EDO. SUCRE,CE. SUCRE,PQ.GRAN MARISCAL,5770,14,90,4350,2523,4260,2,19,5,14,5770,5,1706,4350
EDO. SUCRE,CE. SUCRE,PQ. SANTA INES,49811,97,706,38656,19997,37950,9,216,14,101,52040,12,17702,38656
EDO. SUCRE,CE. SUCRE,PQ. RAUL LEONI,9922,21,147,6861,4307,6714,2,45,4,21,9922,3,2353,6861
EDO. SUCRE,CE. SUCRE,PQ. SAN JUAN,9508,22,125,6882,4588,6757,3,42,6,23,9844,4,2114,6882
EDO. SUCRE,CE. SUCRE,PQ. VALENTIN VALIENTE,38184,75,500,31204,14421,30704,10,134,9,75,38184,11,16119,31204
EDO. SUCRE,CE. SUCRE,PQ. AYACUCHO,35243,72,430,27354,14423,26924,14,134,12,72,35243,10,12331,27354
EDO. SUCRE,CE. SUCRE,PQ. ALTAGRACIA,88659,171,1090,70800,38915,69710,21,376,44,173,89753,28,30326,70800
EDO. SUCRE,MP. MONTES,PQ. ARENAS,4819,11,54,3570,2510,3516,2,23,0,11,4819,0,981,3570
EDO. SUCRE,MP. MONTES,PQ. COCOLLAR,3423,10,27,2402,1356,2375,2,2,1,12,4457,0,1014,2402
EDO. SUCRE,MP. MONTES,PQ. SAN LORENZO,4687,11,58,3182,1861,3124,2,12,1,11,4687,0,1248,3182
EDO. SUCRE,MP. MONTES,PQ. SAN FERNANDO,4961,12,44,3512,2577,3468,1,5,3,12,4961,0,882,3512
EDO. SUCRE,MP. MONTES,PQ. CUMANACOA,15397,32,166,11581,7536,11415,3,48,6,33,15440,4,3818,11581
EDO. SUCRE,MP. MONTES,PQ. ARICAGUA,5653,14,62,3933,2369,3871,1,21,5,14,5653,1,1474,3933
EDO. SUCRE,MP. MEJIA,CM. SAN ANT DEL GOLFO,11394,28,132,8646,5120,8514,2,31,5,29,11813,1,3355,8646
EDO. SUCRE,MP. VALDEZ,PQ. CRISTOBAL COLON,1246,4,15,827,692,812,0,4,0,4,1246,0,116,827
EDO. SUCRE,MP. VALDEZ,PQ. PUNTA DE PIEDRA,3481,10,32,2454,1623,2422,0,3,2,10,3481,0,794,2454
EDO. SUCRE,MP. VALDEZ,PQ. BIDEAU,1669,5,19,1127,930,1108,0,6,0,5,1669,0,172,1127
EDO. SUCRE,MP. VALDEZ,PQ. GUIRIA,20450,42,277,14799,10639,14522,2,47,7,42,20450,5,3822,14799
EDO. TACHIRA,MP. INDEPENDENCIA,PQ. ROMAN CARDENAS,2067,4,35,1768,799,1733,0,7,1,4,2067,1,925,1768
EDO. TACHIRA,MP. INDEPENDENCIA,CM. CAPACHO NUEVO,16033,33,282,13538,5733,13256,2,64,3,33,16033,4,7450,13538
EDO. TACHIRA,MP. INDEPENDENCIA,PQ. JUAN GERMAN ROSCIO,6190,12,126,5298,2528,5172,3,32,0,12,6190,1,2608,5298
EDO. TACHIRA,MP. SAN JUDAS TADEO,CM. UMUQUENA,6821,16,139,5523,3332,5384,0,24,2,17,7314,1,2025,5523
EDO. TACHIRA,CE. SAN CRISTOBAL,PQ. SN JUAN BAUTISTA,66369,127,862,56384,16212,55522,5,168,13,129,67456,26,39098,56384
EDO. TACHIRA,CE. SAN CRISTOBAL,PQ. SAN SEBASTIAN,13043,28,224,10637,4685,10413,4,51,5,28,13043,3,5665,10637
EDO. TACHIRA,CE. SAN CRISTOBAL,PQ. PEDRO MARIA MORANTES,50176,98,469,42477,9666,42008,4,104,7,98,50176,21,32206,42477
EDO. TACHIRA,CE. SAN CRISTOBAL,PQ. LA CONCORDIA,70855,135,1006,58846,21637,57840,11,208,28,138,72226,22,35934,58846
EDO. TACHIRA,CE. SAN CRISTOBAL,PQ. DR. FCO. ROMERO LOBO,798,2,13,650,293,637,0,1,0,3,1051,0,343,650
EDO. TACHIRA,MP. ANTONIO ROMULO C,CM. LAS MESAS,7473,17,169,6186,3823,6017,2,27,0,17,7473,2,2163,6186
EDO. TACHIRA,MP. SUCRE,PQ. SAN PABLO,1858,8,16,1475,957,1459,0,2,0,8,1858,0,500,1475
EDO. TACHIRA,MP. SUCRE,PQ.ELEAZAR LOPEZ CONTRERA,440,1,4,361,156,357,0,0,0,1,440,0,201,361
EDO. TACHIRA,MP. SUCRE,CM. QUENIQUEA,3802,12,45,3122,1766,3077,0,5,0,13,3933,1,1305,3122
EDO. TACHIRA,MP. LIBERTADOR,CM. ABEJALES,6088,14,109,5144,2547,5035,0,12,1,14,6088,1,2474,5144
EDO. TACHIRA,MP. LIBERTADOR,PQ. DORADAS,2889,6,18,2369,1253,2351,2,13,3,6,2889,0,1080,2369
EDO. TACHIRA,MP. LIBERTADOR,PQ. SAN JOAQUIN DE NAVAY,2149,6,32,1691,782,1659,0,10,1,6,2149,1,865,1691
EDO. TACHIRA,MP. LIBERTADOR,PQ. EMETERIO OCHOA,3413,8,36,2867,1379,2831,2,4,0,8,3413,3,1443,2867
EDO. TACHIRA,MP. PANAMERICANO,PQ. LA PALMITA,4050,11,67,3172,1981,3105,1,21,0,11,4050,1,1101,3172
EDO. TACHIRA,MP. PANAMERICANO,CM. COLONCITO,14870,31,261,11920,5908,11659,3,51,3,31,14870,1,5693,11920
EDO. TACHIRA,MP. SIMON RODRIGUEZ,CM. SAN SIMON,2520,5,41,2108,953,2067,0,7,4,5,2520,0,1103,2108
EDO. TACHIRA,MP. ANDRES BELLO,CM. CORDERO,16661,35,310,14205,5740,13895,2,42,6,35,16661,9,8096,14205
EDO. TACHIRA,MP. LIBERTAD,CM. CAPACHO VIEJO,9030,21,196,7479,3844,7283,3,29,2,21,9030,3,3402,7479
EDO. TACHIRA,MP. LIBERTAD,PQ. MANUEL FELIPE RUGELES,6408,14,147,5396,2606,5249,1,22,1,14,6408,1,2618,5396
EDO. TACHIRA,MP. LIBERTAD,PQ. CIPRIANO CASTRO,2597,8,25,2081,1095,2056,0,8,1,8,2597,0,952,2081
EDO. TACHIRA,MP. SAMUEL MALDONADO,CM. LA TENDIDA,5623,13,123,4700,2488,4577,0,14,0,14,6159,2,2073,4700
EDO. TACHIRA,MP. SAMUEL MALDONADO,PQ. HERNANDEZ,2513,8,39,2150,1208,2111,0,4,0,8,2513,1,898,2150
EDO. TACHIRA,MP. SAMUEL MALDONADO,PQ. BOCONO,2818,7,51,2244,1370,2193,2,2,2,7,2818,1,816,2244
EDO. TACHIRA,MP. TORBES,CM. SAN JOSECITO,26756,51,687,21919,11054,21232,5,83,9,52,27311,10,10071,21919
EDO. TACHIRA,MP. JOSE MARIA VARGA,CM. EL COBRE,7536,20,135,6322,3311,6187,0,24,2,20,7536,0,2850,6322
EDO. TACHIRA,MP. LOBATERA,CM. LOBATERA,5562,13,87,4629,2617,4542,0,17,1,13,5562,3,1904,4629
EDO. TACHIRA,MP. LOBATERA,PQ. CONSTITUCION,4073,11,58,3452,1947,3394,0,12,0,11,4073,1,1434,3452
EDO. TACHIRA,MP. MICHELENA,CM. MICHELENA,13253,30,202,11195,5546,10993,2,40,5,30,13253,9,5391,11195
EDO. TACHIRA,MP. GUASIMOS,CM. PALMIRA,27640,56,598,24139,9454,23541,8,71,10,57,28127,13,13985,24139
EDO. TACHIRA,MP. URIBANTE,CM. PREGONERO,8434,27,140,6850,3322,6710,1,14,1,28,8901,1,3371,6850
EDO. TACHIRA,MP. URIBANTE,PQ. CARDENAS,2166,9,14,1735,919,1721,0,3,1,10,2392,0,798,1735
EDO. TACHIRA,MP. URIBANTE,PQ. POTOSI,1638,8,24,1045,469,1021,1,1,0,8,1638,0,550,1045
EDO. TACHIRA,MP. URIBANTE,PQ. JUAN PABLO PE#ALOZA,1630,5,26,1249,727,1223,0,2,0,6,1748,1,493,1249
EDO. TACHIRA,MP. GARCIA DE HEVIA,CM. LA FRIA,27469,57,394,22122,12902,21728,4,108,4,57,27469,3,8707,22122
EDO. TACHIRA,MP. GARCIA DE HEVIA,PQ. BOCA DE GRITA,1790,4,39,1245,623,1206,0,4,0,6,2687,0,579,1245
EDO. TACHIRA,MP. GARCIA DE HEVIA,PQ. JOSE ANTONIO PAEZ,3068,9,59,2386,1481,2327,0,2,1,9,3068,0,843,2386
EDO. TACHIRA,MP. CORDOBA,CM. STA. ANA  DEL TACHIRA,20108,41,499,16490,7670,15991,1,62,1,41,20108,10,8247,16490
EDO. TACHIRA,MP. JUNIN,PQ. BRAMON,16794,33,359,14329,7444,13970,2,65,9,33,16794,8,6442,14329
EDO. TACHIRA,MP. JUNIN,CM. RUBIO,35995,73,578,30524,12434,29946,7,131,8,73,35995,20,17346,30524
EDO. TACHIRA,MP. JUNIN,PQ. LA PETROLEA,1385,3,29,1127,625,1098,0,7,0,3,1385,0,466,1127
EDO. TACHIRA,MP. JUNIN,PQ. QUINIMARI,1171,2,14,961,471,947,1,2,0,2,1171,0,473,961
EDO. TACHIRA,MP. FERNANDEZ FEO,CM.SAN RAFAEL DEL PINAL,11175,25,184,9046,4457,8862,1,56,4,25,11175,1,4343,9046
EDO. TACHIRA,MP. FERNANDEZ FEO,PQ. SANTO DOMINGO,6470,18,127,5485,3051,5358,1,34,2,18,6470,4,2266,5485
EDO. TACHIRA,MP. FERNANDEZ FEO,PQ. ALBERTO ADRIANI,8886,22,172,7268,4322,7096,3,30,4,22,8886,1,2736,7268
EDO. TACHIRA,MP. AYACUCHO,CM. COLON,30636,62,553,25820,10952,25267,5,85,3,62,30636,7,14215,25820
EDO. TACHIRA,MP. AYACUCHO,PQ. RIVAS BERTI,2719,8,51,2173,1298,2122,0,11,1,9,3230,0,812,2173
EDO. TACHIRA,MP. AYACUCHO,PQ. SAN PEDRO DEL RIO,2130,6,35,1664,771,1629,0,7,2,6,2130,0,849,1664
EDO. TACHIRA,MP. JAUREGUI,PQ. MONS. MIGUEL A SALAS,1849,5,50,1535,870,1485,0,11,2,5,1849,0,602,1535
EDO. TACHIRA,MP. JAUREGUI,CM. LA GRITA,23680,56,417,19730,8580,19313,7,79,13,56,23680,5,10629,19730
EDO. TACHIRA,MP. JAUREGUI,PQ. EMILIO C. GUERRERO,1528,6,29,1265,653,1236,0,3,0,6,1528,0,580,1265
EDO. TACHIRA,MP. FCO DE MIRANDA,CM. SAN JOSE DE BOLIVAR,3684,9,37,3119,1059,3082,0,10,2,10,3978,0,2011,3119
EDO. TACHIRA,MP. BOLIVAR,PQ. ISAIAS MEDINA ANGARIT,1294,5,27,1006,577,979,0,6,1,5,1294,0,395,1006
EDO. TACHIRA,MP. BOLIVAR,PQ. JUAN VICENTE GOMEZ,1092,2,25,882,410,857,0,3,0,2,1092,0,444,882
EDO. TACHIRA,MP. BOLIVAR,CM. SAN ANT DEL TACHIRA,42345,83,575,24450,9085,23875,5,114,3,83,42345,7,14661,24450
EDO. TACHIRA,MP. BOLIVAR,PQ. PALOTAL,4506,9,68,3426,1518,3358,1,15,1,9,4506,0,1823,3426
EDO. TACHIRA,MP. SEBORUCO,CM. SEBORUCO,6140,17,113,5067,2534,4954,0,14,1,20,7510,0,2405,5067
EDO. TACHIRA,MP. RAFAEL URDANETA,CM. DELICIAS,4188,12,90,3422,1915,3332,1,17,3,14,5006,3,1393,3422
EDO. TACHIRA,MP.PEDRO MARIA URE#A,CM. URE#A,26279,52,400,16657,7290,16257,1,78,9,52,26279,4,8875,16657
EDO. TACHIRA,MP.PEDRO MARIA URE#A,PQ. NUEVA ARCADIA,7446,15,98,4669,2078,4571,0,30,1,16,7833,1,2461,4669
EDO. TACHIRA,MP. CARDENAS,PQ. AMENODORO RANGEL LAMU,11906,22,189,10467,3900,10278,2,29,1,22,11906,8,6338,10467
EDO. TACHIRA,MP. CARDENAS,CM. TARIBA,53915,103,932,46185,17358,45253,3,172,13,106,55529,15,27692,46185
EDO. TACHIRA,MP. CARDENAS,PQ. LA FLORIDA,1179,7,15,951,601,936,1,0,0,9,1581,0,334,951
EDO. TRUJILLO,MP. PAMPANITO,PQ. LA CONCEPCION,3250,8,51,2781,1654,2730,0,10,1,8,3250,2,1063,2781
EDO. TRUJILLO,MP. PAMPANITO,PQ. PAMPANITO,7941,19,125,6726,3997,6601,2,25,1,19,7941,2,2574,6726
EDO. TRUJILLO,MP. PAMPANITO,PQ. PAMPANITO II,6095,14,95,5066,3458,4971,2,21,2,14,6095,0,1488,5066
EDO. TRUJILLO,MP. MOTATAN,PQ. MOTATAN,8417,18,182,7034,4689,6852,1,29,0,18,8417,2,2131,7034
EDO. TRUJILLO,MP. MOTATAN,PQ. EL BA#O,1443,3,27,1281,880,1254,0,2,1,3,1443,0,371,1281
EDO. TRUJILLO,MP. MOTATAN,PQ. JALISCO,3184,8,79,2763,2095,2684,1,6,3,8,3184,0,579,2763
EDO. TRUJILLO,MP. ANDRES BELLO,PQ. EL JAGUITO,2707,6,67,2041,1374,1974,0,2,1,6,2707,0,597,2041
EDO. TRUJILLO,MP. ANDRES BELLO,PQ. SANTA ISABEL,4812,10,99,3657,2419,3558,0,10,3,10,4812,1,1125,3657
EDO. TRUJILLO,MP. ANDRES BELLO,PQ. ARAGUANEY,1558,4,22,1162,738,1140,0,2,0,4,1558,0,400,1162
EDO. TRUJILLO,MP. ANDRES BELLO,PQ. LA ESPERANZA,2645,5,62,1995,1452,1933,0,3,0,5,2645,0,478,1995
EDO. TRUJILLO,MP. BOCONO,PQ. MOSQUEY,3706,8,41,2948,2262,2907,0,23,1,8,3706,1,620,2948
EDO. TRUJILLO,MP. BOCONO,PQ. EL CARMEN,19063,41,325,15342,9329,15017,4,101,10,41,19063,7,5566,15342
EDO. TRUJILLO,MP. BOCONO,PQ. GENERAL RIVAS,3507,13,65,2376,1545,2311,3,10,6,13,3507,1,746,2376
EDO. TRUJILLO,MP. BOCONO,PQ. BURBUSAY,3326,9,44,2480,1945,2436,0,11,0,9,3326,0,480,2480
EDO. TRUJILLO,MP. BOCONO,PQ. SAN JOSE,4008,15,53,2928,2381,2875,0,11,5,15,4008,1,477,2928
EDO. TRUJILLO,MP. BOCONO,PQ. GUARAMACAL,897,3,6,682,636,676,1,0,0,4,1147,0,39,682
EDO. TRUJILLO,MP. BOCONO,PQ. LA VEGA DE GUARAMACAL,1178,4,31,890,793,859,0,2,1,4,1178,0,63,890
EDO. TRUJILLO,MP. BOCONO,PQ. RAFAEL RANGEL,3385,13,46,2508,1929,2462,1,14,3,13,3385,1,514,2508
EDO. TRUJILLO,MP. BOCONO,PQ. SAN MIGUEL,3145,10,24,2328,2052,2304,1,5,2,10,3145,1,243,2328
EDO. TRUJILLO,MP. BOCONO,PQ. MONSE#OR JAUREGUI,3307,13,58,2364,1760,2306,2,13,1,15,4009,2,528,2364
EDO. TRUJILLO,MP. BOCONO,PQ. BOCONO,17491,43,304,13532,8069,13228,7,66,15,43,17491,9,5062,13532
EDO. TRUJILLO,MP. BOCONO,PQ. AYACUCHO,2348,8,25,1680,1312,1655,0,4,3,9,2871,1,335,1680
EDO. TRUJILLO,MP. RAFAEL RANGEL,PQ. JOSE G HERNANDEZ,4238,9,54,3479,2055,3425,1,20,1,9,4238,4,1344,3479
EDO. TRUJILLO,MP. RAFAEL RANGEL,PQ. EL CEDRO,3365,7,68,2683,1563,2615,0,11,0,7,3365,2,1039,2683
EDO. TRUJILLO,MP. RAFAEL RANGEL,PQ. BETIJOQUE,3943,8,72,3209,1593,3137,1,9,0,8,3943,0,1534,3209
EDO. TRUJILLO,MP. RAFAEL RANGEL,PQ. LA PUEBLITA,3876,8,75,3351,1830,3276,0,15,3,8,3876,0,1428,3351
EDO. TRUJILLO,MP. BOLIVAR,PQ. GRANADOS,2124,5,34,1692,1226,1658,0,6,2,5,2124,0,424,1692
EDO. TRUJILLO,MP. BOLIVAR,PQ. CHEREGUE,3247,8,37,2504,1974,2467,0,13,0,8,3247,1,479,2504
EDO. TRUJILLO,MP. BOLIVAR,PQ. SABANA GRANDE,5242,11,83,4181,2943,4098,0,8,0,11,5242,1,1146,4181
EDO. TRUJILLO,CE. TRUJILLO,PQ. TRES ESQUINAS,3639,8,61,3056,1869,2995,0,11,4,8,3639,0,1111,3056
EDO. TRUJILLO,CE. TRUJILLO,PQ. ANDRES LINARES,2917,10,48,2124,1354,2076,0,3,5,10,2917,0,714,2124
EDO. TRUJILLO,CE. TRUJILLO,PQ. MATRIZ,6663,14,106,5763,2908,5657,1,20,6,14,6663,5,2717,5763
EDO. TRUJILLO,CE. TRUJILLO,PQ. MONSE#OR CARRILLO,7434,18,111,5942,3898,5831,0,34,5,18,7434,1,1893,5942
EDO. TRUJILLO,CE. TRUJILLO,PQ. CHIQUINQUIRA,7437,15,94,6094,3423,6000,0,29,3,15,7437,2,2543,6094
EDO. TRUJILLO,CE. TRUJILLO,PQ. CRISTOBAL MENDOZA,11262,25,140,8995,5395,8855,0,39,1,25,11262,9,3411,8995
EDO. TRUJILLO,CE. TRUJILLO,PQ. CRUZ CARRILLO,3356,9,41,2737,1550,2696,0,10,1,10,3437,3,1132,2737
EDO. TRUJILLO,MP. CARACHE,PQ. CUICAS,5062,20,41,3702,2829,3661,0,14,4,20,5062,1,813,3702
EDO. TRUJILLO,MP. CARACHE,PQ. SANTA CRUZ,1774,6,41,1388,1026,1347,0,8,0,6,1774,1,312,1388
EDO. TRUJILLO,MP. CARACHE,PQ. PANAMERICANA,1917,7,20,1584,1364,1564,0,8,1,7,1917,0,191,1584
EDO. TRUJILLO,MP. CARACHE,PQ. LA CONCEPCION,3903,16,36,3086,2523,3050,1,7,2,16,3903,1,516,3086
EDO. TRUJILLO,MP. CARACHE,PQ. CARACHE,9162,29,150,7076,4407,6926,2,32,4,29,9162,0,2481,7076
EDO. TRUJILLO,MP. CANDELARIA,PQ. MANUEL SALVADOR ULLOA,1613,3,33,1187,956,1154,0,4,0,3,1613,0,194,1187
EDO. TRUJILLO,MP. CANDELARIA,PQ. CARRILLO,1779,6,13,1302,1003,1289,0,1,0,6,1779,0,285,1302
EDO. TRUJILLO,MP. CANDELARIA,PQ. ARNOLDO GABALDON,2023,6,18,1606,1333,1588,1,5,0,7,2489,0,249,1606
EDO. TRUJILLO,MP. CANDELARIA,PQ. CEGARRA,871,3,8,642,483,634,0,2,0,3,871,0,149,642
EDO. TRUJILLO,MP. CANDELARIA,PQ. SAN JOSE,2503,5,22,1958,1650,1936,0,9,2,5,2503,0,275,1958
EDO. TRUJILLO,MP. CANDELARIA,PQ. BOLIVIA,2429,11,21,1839,1498,1818,0,9,2,11,2429,0,309,1839
EDO. TRUJILLO,MP. CANDELARIA,PQ. CHEJENDE,8142,24,123,6171,4559,6048,1,27,2,26,9048,1,1458,6171
EDO. TRUJILLO,MP. SUCRE,PQ. EL PARAISO,1331,3,20,941,632,921,0,0,0,3,1331,0,289,941
EDO. TRUJILLO,MP. SUCRE,PQ. SABANA DE MENDOZA,7517,15,106,6128,3541,6022,3,25,0,15,7517,2,2451,6128
EDO. TRUJILLO,MP. SUCRE,PQ. JUNIN,2702,5,22,2134,1452,2112,0,3,0,5,2702,0,657,2134
EDO. TRUJILLO,MP. SUCRE,PQ. VALMORE RODRIGUEZ,7841,17,108,6306,4331,6198,4,22,5,17,7841,0,1836,6306
EDO. TRUJILLO,MP. PAMPAN,PQ. SANTA ANA,5834,17,62,4519,3535,4457,1,11,2,17,5834,1,907,4519
EDO. TRUJILLO,MP. PAMPAN,PQ. FLOR DE PATRIA,9168,21,163,7573,4815,7410,2,24,1,22,9429,1,2567,7573
EDO. TRUJILLO,MP. PAMPAN,PQ. LA PAZ,11486,26,202,9069,6717,8867,2,41,6,27,12027,1,2100,9069
EDO. TRUJILLO,MP. PAMPAN,PQ. PAMPAN,6416,15,112,5271,2832,5159,1,28,0,15,6416,2,2296,5271
EDO. TRUJILLO,MP. JUAN V CAMPO ELI,PQ. ARNOLDO GABALDON,1810,6,22,1382,1125,1360,1,3,1,6,1810,0,230,1382
EDO. TRUJILLO,MP. JUAN V CAMPO ELI,PQ. CAMPO ELIAS,3632,8,48,2984,2161,2936,1,8,2,8,3632,2,762,2984
EDO. TRUJILLO,MP. ESCUQUE,PQ. ESCUQUE,10104,26,146,8452,5176,8306,0,38,3,27,10625,3,3086,8452
EDO. TRUJILLO,MP. ESCUQUE,PQ. SANTA RITA,2202,6,39,1893,1272,1854,0,11,1,6,2202,1,569,1893
EDO. TRUJILLO,MP. ESCUQUE,PQ. SABANA LIBRE,4769,11,77,3983,2210,3906,0,14,2,11,4769,0,1680,3983
EDO. TRUJILLO,MP. ESCUQUE,PQ. LA UNION,2246,5,32,1892,1079,1860,1,10,0,5,2246,0,770,1892
EDO. TRUJILLO,MP. VALERA,PQ. LA PUERTA,6902,15,98,5550,3207,5452,0,18,2,15,6902,3,2222,5550
EDO. TRUJILLO,MP. VALERA,PQ. SAN LUIS,10208,23,206,8683,5491,8477,1,46,6,23,10208,4,2929,8683
EDO. TRUJILLO,MP. VALERA,PQ. MERCEDES DIAZ,39957,80,595,33293,18803,32698,14,127,17,83,41482,17,13720,33293
EDO. TRUJILLO,MP. VALERA,PQ. MENDOZA,6501,15,82,5261,2939,5179,3,20,2,15,6501,3,2212,5261
EDO. TRUJILLO,MP. VALERA,PQ. LA BEATRIZ,8224,16,92,7364,3278,7272,1,24,3,16,8224,3,3963,7364
EDO. TRUJILLO,MP. VALERA,PQ. JUAN IGNACIO MONTILLA,25740,52,298,21719,8953,21421,2,67,9,53,26223,7,12383,21719
EDO. TRUJILLO,MP. MONTE CARMELO,PQ. STA MARIA DEL HORCON,1095,4,21,867,666,846,0,1,0,4,1095,1,178,867
EDO. TRUJILLO,MP. MONTE CARMELO,PQ. MONTE CARMELO,5330,15,69,4035,2748,3966,0,20,2,15,5330,0,1196,4035
EDO. TRUJILLO,MP. MONTE CARMELO,PQ. BUENA VISTA,4495,12,71,3529,2587,3458,1,7,0,12,4495,0,863,3529
EDO. TRUJILLO,MP. URDANETA,PQ. CABIMBU,1941,5,7,1537,830,1530,1,1,3,5,1941,0,695,1537
EDO. TRUJILLO,MP. URDANETA,PQ. TU#AME,3307,7,49,2314,1670,2265,2,15,10,7,3307,0,568,2314
EDO. TRUJILLO,MP. URDANETA,PQ. JAJO,4866,14,68,3840,2277,3772,1,8,1,14,4866,0,1485,3840
EDO. TRUJILLO,MP. URDANETA,PQ. LA QUEBRADA,5499,15,103,4174,2366,4071,1,10,2,15,5499,1,1691,4174
EDO. TRUJILLO,MP. URDANETA,PQ. LA MESA,5476,12,95,4175,2707,4080,0,22,2,12,5476,1,1348,4175
EDO. TRUJILLO,MP. URDANETA,PQ. SANTIAGO,3319,10,29,2523,1933,2494,0,8,1,10,3319,1,551,2523
EDO. TRUJILLO,MP. LA CEIBA,PQ. SANTA APOLONIA,3567,8,35,2709,2115,2674,0,4,0,8,3567,0,555,2709
EDO. TRUJILLO,MP. LA CEIBA,PQ. TRES DE FEBRERO,4786,10,52,3562,2871,3510,1,11,1,10,4786,0,626,3562
EDO. TRUJILLO,MP. LA CEIBA,PQ. EL PROGRESO,3588,7,37,2737,2039,2700,1,5,0,7,3588,0,655,2737
EDO. TRUJILLO,MP. LA CEIBA,PQ. LA CEIBA,835,2,15,657,544,642,1,0,0,2,835,0,97,657
EDO. TRUJILLO,MP. JOSE F M CA#IZAL,PQ. ANTONIO JOSE DE SUCRE,950,2,9,662,357,653,0,1,0,2,950,0,295,662
EDO. TRUJILLO,MP. JOSE F M CA#IZAL,PQ. EL SOCORRO,3032,6,43,2344,1490,2301,1,6,2,6,3032,0,802,2344
EDO. TRUJILLO,MP. JOSE F M CA#IZAL,PQ. LOS CAPRICHOS,413,1,2,279,183,277,0,4,0,1,413,0,90,279
EDO. TRUJILLO,MP. MIRANDA,PQ. EL CENIZO,1897,4,27,1428,1157,1401,0,8,2,4,1897,0,234,1428
EDO. TRUJILLO,MP. MIRANDA,PQ. VALERITA,596,1,7,436,363,429,0,7,0,1,596,0,59,436
EDO. TRUJILLO,MP. MIRANDA,PQ. AGUA CALIENTE,1146,3,14,841,657,827,0,4,0,3,1146,0,166,841
EDO. TRUJILLO,MP. MIRANDA,PQ. AGUA SANTA,3564,8,65,2792,2057,2727,1,10,1,8,3564,1,657,2792
EDO. TRUJILLO,MP. MIRANDA,PQ. EL DIVIDIVE,7622,17,154,6214,3819,6060,0,18,0,17,7622,0,2223,6214
EDO. TRUJILLO,MP.S RAFAEL CARVAJAL,PQ. CARVAJAL,8850,18,144,7475,3763,7331,1,16,2,18,8850,3,3546,7475
EDO. TRUJILLO,MP.S RAFAEL CARVAJAL,PQ. ANTONIO N BRICE#O,7307,15,109,6144,3554,6035,1,15,4,15,7307,2,2459,6144
EDO. TRUJILLO,MP.S RAFAEL CARVAJAL,PQ. JOSE LEONARDO SUAREZ,6126,13,112,5047,3296,4935,0,20,1,13,6126,1,1617,5047
EDO. TRUJILLO,MP.S RAFAEL CARVAJAL,PQ. CAMPO ALEGRE,13726,27,208,11370,6497,11162,1,33,3,27,13726,1,4627,11370
EDO. VARGAS,CE. VARGAS,PQ. CARABALLEDA,29271,59,415,23404,11200,22989,5,95,9,59,29271,14,11666,23404
EDO. VARGAS,CE. VARGAS,PQ. MAIQUETIA,29967,59,472,23533,13985,23061,8,106,13,59,29967,24,8925,23533
EDO. VARGAS,CE. VARGAS,PQ. CARLOS SOUBLETTE,33647,67,560,26695,16759,26135,5,145,13,67,33647,25,9188,26695
EDO. VARGAS,CE. VARGAS,PQ. CARAYACA,23555,63,342,18436,13480,18094,9,87,21,66,24298,11,4486,18436
EDO. VARGAS,CE. VARGAS,PQ. NAIGUATA,13771,29,209,11115,7481,10906,3,47,5,29,13771,8,3362,11115
EDO. VARGAS,CE. VARGAS,PQ. MACUTO,14757,30,163,11703,5419,11540,2,51,3,30,14757,9,6056,11703
EDO. VARGAS,CE. VARGAS,PQ. CARUAO,4824,12,87,3829,2587,3742,2,16,5,12,4824,3,1129,3829
EDO. VARGAS,CE. VARGAS,PQ. URIMARE,24359,49,337,20130,11516,19793,15,95,13,50,24895,12,8142,20130
EDO. VARGAS,CE. VARGAS,PQ. CATIA LA MAR,63843,125,967,50804,32487,49837,12,244,34,127,64819,38,17022,50804
EDO. VARGAS,CE. VARGAS,PQ. EL JUNKO,7133,17,151,5588,3113,5437,4,32,10,17,7133,3,2275,5588
EDO. VARGAS,CE. VARGAS,PQ. LA GUAIRA,18529,37,402,14537,8338,14135,3,89,7,37,18529,10,5688,14537
EDO. YARACUY,MP. INDEPENDENCIA,CM. INDEPENDENCIA,38154,81,893,31915,14004,31022,6,178,20,81,38154,15,16799,31915
EDO. YARACUY,MP.JOSE ANTONIO PAEZ,CM. SABANA DE PARRA,12713,27,257,10678,7305,10421,2,77,7,27,12713,2,3028,10678
EDO. YARACUY,MP. NIRGUA,CM. NIRGUA,29194,80,557,23485,14187,22928,13,118,17,81,29687,14,8579,23485
EDO. YARACUY,MP. NIRGUA,PQ. SALOM,9434,22,146,7555,4981,7409,1,39,7,23,9888,5,2376,7555
EDO. YARACUY,MP. NIRGUA,PQ. TEMERLA,2048,9,39,1614,1240,1575,0,7,0,9,2048,1,327,1614
EDO. YARACUY,MP. LA TRINIDAD,CM. BORAURE,11118,25,253,9432,5253,9179,2,46,3,26,11486,3,3872,9432
EDO. YARACUY,MP. VEROES,CM. FARRIAR,8809,22,184,7179,5777,6995,1,27,3,23,9231,1,1186,7179
EDO. YARACUY,MP. VEROES,PQ. EL GUAYABO,9109,26,205,7404,5491,7199,2,27,5,27,9194,2,1672,7404
EDO. YARACUY,MP. ARISTIDES BASTID,CM. SAN PABLO,13828,35,273,11313,7386,11040,4,66,6,35,13828,2,3576,11313
EDO. YARACUY,MP. PE#A,PQ. SAN ANDRES,5626,14,109,4492,2759,4383,1,34,6,14,5626,3,1580,4492
EDO. YARACUY,MP. PE#A,CM. YARITAGUA,57830,124,1080,47652,29677,46572,14,250,38,125,58267,17,16576,47652
EDO. YARACUY,MP. SUCRE,CM. GUAMA,14178,32,287,12163,6746,11876,4,68,4,32,14178,3,5051,12163
EDO. YARACUY,MP. URACHICHE,CM. URACHICHE,14404,34,318,11819,8220,11501,6,61,5,35,15001,2,3207,11819
EDO. YARACUY,MP. BOLIVAR,CM. AROA,20744,54,388,16932,10898,16544,7,78,6,55,21269,3,5552,16932
EDO. YARACUY,MP. BRUZUAL,PQ. CAMPO ELIAS,8787,21,161,7118,5261,6957,5,29,6,21,8787,2,1654,7118
EDO. YARACUY,MP. BRUZUAL,CM. CHIVACOA,36618,76,643,30172,18426,29529,16,160,23,78,37767,17,10887,30172
EDO. YARACUY,CE. SAN FELIPE,CM. SAN FELIPE,40844,84,706,34284,13804,33578,6,155,23,84,40844,16,19574,34284
EDO. YARACUY,CE. SAN FELIPE,PQ. SAN JAVIER,9140,21,179,7474,4823,7295,3,44,4,22,9686,2,2419,7474
EDO. YARACUY,CE. SAN FELIPE,PQ. ALBARICO,18774,42,373,14913,9298,14540,5,99,9,42,18774,9,5120,14913
EDO. YARACUY,MP. MANUEL MONGE,CM. YUMARE,11493,27,212,9395,6708,9183,7,33,5,28,12072,3,2427,9395
EDO. YARACUY,MP. COCOROTE,CM. COCOROTE,26885,55,660,22210,10455,21550,7,106,11,55,26885,14,10957,22210
EDO. ZULIA,MP. LA CA#ADA DE U.,PQ. ANDRES BELLO (KM 48),6193,13,52,4617,3035,4565,0,9,0,13,6193,2,1519,4617
EDO. ZULIA,MP. LA CA#ADA DE U.,PQ. EL CARMELO,5680,10,34,4818,2466,4784,0,5,1,11,6160,0,2312,4818
EDO. ZULIA,MP. LA CA#ADA DE U.,PQ. CHIQUINQUIRA,8046,15,59,6390,3887,6331,1,12,1,15,8046,0,2430,6390
EDO. ZULIA,MP. LA CA#ADA DE U.,PQ. POTRERITOS,4604,8,23,3785,2263,3762,0,3,0,8,4604,0,1496,3785
EDO. ZULIA,MP. LA CA#ADA DE U.,PQ. CONCEPCION,21793,42,168,17683,8164,17515,0,32,3,42,21793,3,9313,17683
EDO. ZULIA,MP. COLON,PQ. SAN CARLOS DEL ZULIA,10952,21,159,9116,4585,8957,0,34,3,21,10952,2,4333,9116
EDO. ZULIA,MP. COLON,PQ. SANTA CRUZ DEL ZULIA,5684,11,58,4499,2200,4441,1,4,1,11,5684,0,2235,4499
EDO. ZULIA,MP. COLON,PQ. URRIBARRI,7714,17,64,5916,3659,5852,2,23,3,17,7714,1,2164,5916
EDO. ZULIA,MP. COLON,PQ. SANTA BARBARA,31736,61,429,25980,13923,25551,6,77,4,61,31736,6,11535,25980
EDO. ZULIA,MP. COLON,PQ. MORALITO,11809,28,161,9218,5740,9057,1,22,5,30,12690,0,3289,9218
EDO. ZULIA,MP. JESUS E LOSSADA,PQ. SAN JOSE,8422,18,90,6469,4371,6379,1,14,4,18,8422,1,1988,6469
EDO. ZULIA,MP. JESUS E LOSSADA,PQ. LA CONCEPCION,38542,75,621,30124,16495,29503,7,97,16,76,39042,12,12876,30124
EDO. ZULIA,MP. JESUS E LOSSADA,PQ. MARIANO PARRA LEON,4746,9,60,3680,2179,3620,0,4,1,9,4746,0,1436,3680
EDO. ZULIA,MP. JESUS E LOSSADA,PQ. JOSE RAMON YEPEZ,12198,25,165,9278,5838,9113,0,13,5,25,12198,0,3257,9278
EDO. ZULIA,MP. SIMON BOLIVAR,PQ. RAFAEL MARIA BARALT,11251,22,195,9392,5675,9197,5,23,8,22,11251,4,3482,9392
EDO. ZULIA,MP. SIMON BOLIVAR,PQ. MANUEL MANRIQUE,17577,33,287,14524,6828,14237,5,51,3,33,17577,4,7346,14524
EDO. ZULIA,MP. SIMON BOLIVAR,PQ. RAFAEL URDANETA,3420,7,69,2705,1728,2636,2,11,2,7,3420,2,891,2705
EDO. ZULIA,MP. SUCRE,PQ. ROMULO GALLEGOS,14285,27,238,11255,6575,11017,2,46,6,28,14843,3,4385,11255
EDO. ZULIA,MP. SUCRE,PQ. EL BATEY,4547,9,62,3559,2470,3497,3,11,1,9,4547,1,1011,3559
EDO. ZULIA,MP. SUCRE,PQ. GIBRALTAR,7026,17,103,5375,3604,5272,1,8,2,17,7026,0,1657,5375
EDO. ZULIA,MP. SUCRE,PQ. BOBURES,4189,10,66,3239,2051,3173,1,3,0,10,4189,2,1116,3239
EDO. ZULIA,MP. SUCRE,PQ. HERAS,4142,11,67,3034,1944,2967,2,7,0,11,4142,1,1013,3034
EDO. ZULIA,MP. SUCRE,PQ. M.ARTURO CELESTINO A,4854,10,69,3793,2287,3724,2,6,2,10,4854,1,1426,3793
EDO. ZULIA,MP. MIRANDA,PQ. SAN ANTONIO,6175,16,103,4986,2957,4883,2,17,4,16,6175,2,1901,4986
EDO. ZULIA,MP. MIRANDA,PQ. ANA MARIA CAMPOS,5345,13,71,4365,2608,4294,1,24,2,13,5345,1,1658,4365
EDO. ZULIA,MP. MIRANDA,PQ. SAN JOSE,12947,26,131,10767,7802,10636,1,20,1,27,13445,3,2809,10767
EDO. ZULIA,MP. MIRANDA,PQ. FARIA,4002,10,61,3419,2219,3358,0,4,1,11,4296,1,1133,3419
EDO. ZULIA,MP. MIRANDA,PQ. ALTAGRACIA,35262,74,465,30179,19586,29714,4,87,10,76,36131,6,10021,30179
EDO. ZULIA,MP. LAGUNILLAS,PQ. LIBERTAD,24746,46,381,20367,9757,19986,3,90,8,46,24746,6,10122,20367
EDO. ZULIA,MP. LAGUNILLAS,PQ. ELEAZAR LOPEZ C,2199,4,42,1791,1130,1749,1,3,0,4,2199,0,615,1791
EDO. ZULIA,MP. LAGUNILLAS,PQ. ALONSO DE OJEDA,68616,129,1156,57047,25818,55891,19,196,38,131,69767,27,29793,57047
EDO. ZULIA,MP. LAGUNILLAS,PQ. VENEZUELA,22897,43,334,18957,8438,18623,7,67,9,43,22897,6,10096,18957
EDO. ZULIA,MP. LAGUNILLAS,PQ. CAMPO LARA,3776,7,65,3087,1737,3022,0,7,0,7,3776,1,1277,3087
EDO. ZULIA,MP. CATATUMBO,PQ. UDON PEREZ,8061,17,81,5996,3004,5915,1,17,1,17,8061,2,2890,5996
EDO. ZULIA,MP. CATATUMBO,PQ. ENCONTRADOS,9945,21,105,7631,3979,7526,0,18,3,27,11991,0,3526,7631
EDO. ZULIA,MP. MACHIQUES DE P,PQ. SAN JOSE DE PERIJA,12787,24,102,8987,4055,8885,1,24,3,24,12787,1,4801,8987
EDO. ZULIA,MP. MACHIQUES DE P,PQ. RIO NEGRO,4266,10,57,2850,2035,2793,0,8,4,10,4266,0,746,2850
EDO. ZULIA,MP. MACHIQUES DE P,PQ. LIBERTAD,48119,99,621,35661,19148,35040,12,132,20,100,48618,2,15726,35661
EDO. ZULIA,MP. MACHIQUES DE P,PQ.BARTOLOME DE LAS CASAS,9748,18,116,7043,3468,6927,0,19,3,18,9748,0,3437,7043
EDO. ZULIA,MP. CABIMAS,PQ. ARISTIDES CALVANI,2452,8,34,2006,1251,1972,0,6,1,13,4065,0,714,2006
EDO. ZULIA,MP. CABIMAS,PQ. JORGE HERNANDEZ,29999,59,486,25482,16041,24996,5,75,13,59,29999,8,8854,25482
EDO. ZULIA,MP. CABIMAS,PQ. AMBROSIO,35676,69,388,29614,13592,29226,6,125,15,70,36217,12,15476,29614
EDO. ZULIA,MP. CABIMAS,PQ. LA ROSA,22456,44,299,18948,9895,18649,3,71,5,45,22983,8,8667,18948
EDO. ZULIA,MP. CABIMAS,PQ. GERMAN RIOS LINARES,26529,52,373,22539,14073,22166,4,75,9,53,27037,9,7996,22539
EDO. ZULIA,MP. CABIMAS,PQ. CARMEN HERRERA,24306,47,300,20562,8959,20262,3,62,9,47,24306,7,11222,20562
EDO. ZULIA,MP. CABIMAS,PQ. PUNTA GORDA,6419,13,80,5365,3492,5285,1,25,0,14,6574,3,1764,5365
EDO. ZULIA,MP. CABIMAS,PQ. SAN BENITO,14873,29,215,12602,8000,12387,2,50,7,29,14873,6,4322,12602
EDO. ZULIA,MP. CABIMAS,PQ. ROMULO BETANCOURT,16553,33,196,13993,9041,13797,3,52,4,33,16553,4,4693,13993
EDO. ZULIA,MP. BLVNO GUAJIRA,PQ. ELIAS SANCHEZ RUBIO,7150,16,72,4720,3130,4648,0,19,2,16,7150,0,1497,4720
EDO. ZULIA,MP. BLVNO GUAJIRA,PQ. ALTA GUAJIRA,6672,16,58,2812,2138,2754,1,8,1,16,6672,0,606,2812
EDO. ZULIA,MP. BLVNO GUAJIRA,PQ. SINAMAICA,11309,25,125,8032,5292,7907,2,40,6,25,11309,0,2567,8032
EDO. ZULIA,MP. BLVNO GUAJIRA,PQ. GUAJIRA,37268,78,366,20486,14564,20120,9,90,18,79,37750,3,5436,20486
EDO. ZULIA,MP. JESUS M SEMPRUN,PQ. JESUS M SEMPRUN,11805,28,150,9426,6045,9276,0,40,2,28,11805,1,3188,9426
EDO. ZULIA,MP. JESUS M SEMPRUN,PQ. BARI,3544,8,32,2607,2116,2575,1,14,0,11,4087,0,444,2607
EDO. ZULIA,CE. MARACAIBO,PQ. CHIQUINQUIRA,45743,88,536,36268,11103,35732,8,105,11,88,45743,18,24487,36268
EDO. ZULIA,CE. MARACAIBO,PQ. CRISTO DE ARANZA,78722,149,917,64203,29194,63286,8,144,24,149,78722,19,33897,64203
EDO. ZULIA,CE. MARACAIBO,PQ. JUANA DE AVILA,53750,102,458,44306,13455,43848,2,100,19,103,54308,15,30257,44306
EDO. ZULIA,CE. MARACAIBO,PQ. ANTONIO BORJAS ROMERO,44647,87,664,33977,21547,33313,11,111,9,87,44647,13,11622,33977
EDO. ZULIA,CE. MARACAIBO,PQ. RAUL LEONI,44558,82,350,37186,11392,36836,4,62,9,82,44558,19,25350,37186
EDO. ZULIA,CE. MARACAIBO,PQ. IDELFONZO VASQUEZ,68941,132,949,48189,29462,47240,18,149,28,132,68941,12,17571,48189
EDO. ZULIA,CE. MARACAIBO,PQ. CACIQUE MARA,48761,90,563,39316,18282,38753,0,98,17,90,48761,21,20335,39316
EDO. ZULIA,CE. MARACAIBO,PQ. LUIS HURTADO HIGUERA,37636,72,457,30354,19336,29897,4,82,7,72,37636,7,10461,30354
EDO. ZULIA,CE. MARACAIBO,PQ. MANUEL DAGNINO,52825,103,649,43376,22115,42727,4,128,18,103,52825,25,20437,43376
EDO. ZULIA,CE. MARACAIBO,PQ. VENANCIO PULGAR,59233,116,858,45218,27920,44360,18,105,31,117,59722,18,16268,45218
EDO. ZULIA,CE. MARACAIBO,PQ. OLEGARIO VILLALOBOS,65123,122,512,51148,11209,50636,2,97,15,122,65123,25,39288,51148
EDO. ZULIA,CE. MARACAIBO,PQ.CARACCIOLO PARRA PEREZ,47632,92,498,37243,13299,36745,4,88,7,92,47632,24,23323,37243
EDO. ZULIA,CE. MARACAIBO,PQ. SAN ISIDRO,18598,36,218,13627,9422,13409,2,38,11,36,18598,5,3931,13627
EDO. ZULIA,CE. MARACAIBO,PQ. FRANCISCO EUGENIO B,99774,192,1286,81866,44601,80580,15,204,53,194,100937,40,35667,81866
EDO. ZULIA,CE. MARACAIBO,PQ. SANTA LUCIA,29995,57,306,23948,7887,23642,3,49,7,58,30516,12,15684,23948
EDO. ZULIA,CE. MARACAIBO,PQ. COQUIVACOA,65957,127,728,53504,22832,52776,2,119,13,127,65957,23,29787,53504
EDO. ZULIA,CE. MARACAIBO,PQ. BOLIVAR,19734,38,160,15574,5149,15414,2,29,6,39,20244,5,10223,15574
EDO. ZULIA,CE. MARACAIBO,PQ. CECILIO ACOSTA,41614,77,433,34451,13090,34018,2,86,14,77,41614,15,20811,34451
EDO. ZULIA,MP. ALMIRANTE P,PQ. ISLA DE TOAS,6986,14,43,5504,3899,5461,0,15,0,14,6986,0,1547,5504
EDO. ZULIA,MP. ALMIRANTE P,PQ. MONAGAS,2649,5,30,2115,1746,2085,0,0,0,5,2649,0,339,2115
EDO. ZULIA,MP.ROSARIO DE PERIJA,PQ. EL ROSARIO,44665,84,572,34137,17849,33565,7,86,17,84,44665,4,15602,34137
EDO. ZULIA,MP.ROSARIO DE PERIJA,PQ. SIXTO ZAMBRANO,6348,13,51,4081,2467,4030,0,3,0,15,7426,0,1560,4081
EDO. ZULIA,MP.ROSARIO DE PERIJA,PQ. DONALDO GARCIA,3044,6,8,2217,1902,2209,0,1,0,7,3601,0,306,2217
EDO. ZULIA,MP. SAN FRANCISCO,PQ. LOS CORTIJOS,28556,56,394,22492,15084,22098,4,70,9,56,28556,9,6922,22492
EDO. ZULIA,MP. SAN FRANCISCO,PQ. DOMITILA FLORES,84877,166,1127,67990,41385,66863,6,263,34,169,86554,15,25160,67990
EDO. ZULIA,MP. SAN FRANCISCO,PQ. MARCIAL HERNANDEZ,16408,31,188,13156,8624,12968,2,28,6,31,16408,2,4306,13156
EDO. ZULIA,MP. SAN FRANCISCO,PQ. SAN FRANCISCO,79371,149,774,66599,32456,65825,6,185,16,149,79371,26,33136,66599
EDO. ZULIA,MP. SAN FRANCISCO,PQ. EL BAJO,11713,23,128,9798,5998,9670,2,27,7,23,11713,2,3634,9798
EDO. ZULIA,MP. SAN FRANCISCO,PQ. FRANCISCO OCHOA,50605,97,582,41362,20282,40780,5,122,24,97,50605,15,20332,41362
EDO. ZULIA,MP. SANTA RITA,PQ. PEDRO LUCAS URRIBARRI,3438,8,55,2732,1657,2677,0,5,0,8,3438,0,1015,2732
EDO. ZULIA,MP. SANTA RITA,PQ. JOSE CENOVIO URRIBARR,10805,21,131,8898,4920,8767,5,28,2,21,10805,2,3810,8898
EDO. ZULIA,MP. SANTA RITA,PQ. EL MENE,4099,8,42,3398,1932,3356,1,16,1,8,4099,3,1403,3398
EDO. ZULIA,MP. SANTA RITA,PQ. SANTA RITA,20725,42,268,17177,9913,16909,4,60,5,42,20725,5,6922,17177
EDO. ZULIA,MP. BARALT,PQ. GENERAL URDANETA,8085,19,73,6380,4740,6307,0,23,2,19,8085,1,1541,6380
EDO. ZULIA,MP. BARALT,PQ. MARCELINO BRICE#O,3604,8,30,2624,1814,2594,1,3,0,8,3604,0,776,2624
EDO. ZULIA,MP. BARALT,PQ. PUEBLO NUEVO,17174,36,256,13817,8094,13561,2,82,8,36,17174,2,5373,13817
EDO. ZULIA,MP. BARALT,PQ. MANUEL GUANIPA MATOS,7759,16,92,6331,3607,6239,1,16,1,16,7759,1,2613,6331
EDO. ZULIA,MP. BARALT,PQ. SAN TIMOTEO,5368,11,47,4527,2952,4480,0,20,0,11,5368,1,1507,4527
EDO. ZULIA,MP. BARALT,PQ. LIBERTADOR,13578,28,179,10853,6197,10674,1,42,6,28,13578,1,4427,10853
EDO. ZULIA,MP.VALMORE RODRIGUEZ,PQ. LA VICTORIA,19448,37,352,15830,7847,15478,4,74,11,37,19448,4,7538,15830
EDO. ZULIA,MP.VALMORE RODRIGUEZ,PQ. RAFAEL URDANETA,7606,16,158,6059,3061,5901,1,32,2,16,7606,2,2803,6059
EDO. ZULIA,MP.VALMORE RODRIGUEZ,PQ. RAUL CUENCA,9772,20,170,8089,5135,7919,1,30,10,20,9772,1,2742,8089
EDO. ZULIA,MP. FRANCISCO J PULG,PQ. SIMON RODRIGUEZ,10324,23,197,8015,4288,7818,1,14,3,24,10621,1,3511,8015
EDO. ZULIA,MP. FRANCISCO J PULG,PQ. CARLOS QUEVEDO,5767,11,99,4484,2599,4385,2,8,4,11,5767,1,1771,4484
EDO. ZULIA,MP. FRANCISCO J PULG,PQ. FRANCISCO J PULGAR,2522,5,35,2023,1018,1988,0,4,0,5,2522,0,966,2023
EDO. ZULIA,MP. MARA,PQ. LAS PARCELAS,9621,19,81,7743,6007,7662,2,16,8,19,9621,1,1628,7743
EDO. ZULIA,MP. MARA,PQ. MONS.MARCOS SERGIO G,2924,6,18,2047,1638,2029,0,1,0,6,2924,0,390,2047
EDO. ZULIA,MP. MARA,PQ. LA SIERRITA,26644,55,307,19985,14122,19678,3,62,11,55,26644,4,5476,19985
EDO. ZULIA,MP. MARA,PQ. SAN RAFAEL,30246,57,220,24679,17586,24459,5,46,7,57,30246,6,6809,24679
EDO. ZULIA,MP. MARA,PQ. LUIS DE VICENTE,11513,25,106,9011,5627,8905,0,26,8,25,11513,0,3244,9011
EDO. ZULIA,MP. MARA,PQ. RICAURTE,30593,58,485,23781,15529,23296,9,86,13,58,30593,6,7653,23781
EDO. ZULIA,MP. MARA,PQ. TAMARE,10142,20,98,7861,5482,7763,1,24,4,20,10142,1,2251,7861
EDO.NVA.ESPARTA,MP.VILLALBA(I.COCHE),PQ. VICENTE FUENTES,3173,6,40,2700,1476,2660,0,7,4,6,3173,0,1173,2700
EDO.NVA.ESPARTA,MP.VILLALBA(I.COCHE),CM. SAN PEDRO DE COCHE,4059,8,57,3235,1770,3178,0,15,10,8,4059,1,1382,3235
EDO.NVA.ESPARTA,CE. ARISMENDI,CM. LA ASUNCION,20288,41,294,16942,6839,16648,3,58,6,42,20813,10,9732,16942
EDO.NVA.ESPARTA,MP. MANEIRO,PQ. AGUIRRE,18577,37,148,15272,3751,15124,1,37,1,37,18577,3,11331,15272
EDO.NVA.ESPARTA,MP. MANEIRO,CM. PAMPATAR,15909,33,202,13050,5415,12848,0,29,1,33,15909,6,7397,13050
EDO.NVA.ESPARTA,MP. GOMEZ,PQ. MATASIETE,3747,8,41,3148,1683,3107,0,18,0,8,3747,0,1406,3148
EDO.NVA.ESPARTA,MP. GOMEZ,PQ. GUEVARA,3982,8,45,3301,1628,3256,0,17,1,8,3982,0,1610,3301
EDO.NVA.ESPARTA,MP. GOMEZ,CM. SANTA ANA,9975,20,102,8275,4871,8173,0,37,1,20,9975,4,3260,8275
EDO.NVA.ESPARTA,MP. GOMEZ,PQ. BOLIVAR,1705,3,14,1474,799,1460,0,11,1,3,1705,0,649,1474
EDO.NVA.ESPARTA,MP. GOMEZ,PQ. SUCRE,7047,14,93,5624,3007,5531,0,31,0,14,7047,1,2492,5624
EDO.NVA.ESPARTA,MP. GARCIA,CM. VALLE ESP SANTO,8052,15,131,6481,2819,6350,1,26,2,15,8052,4,3498,6481
EDO.NVA.ESPARTA,MP. GARCIA,PQ. FRANCISCO FAJARDO,29973,59,511,24212,13777,23701,1,131,6,59,29973,9,9777,24212
EDO.NVA.ESPARTA,MP. MARCANO,CM. JUAN GRIEGO,14764,30,194,12074,6662,11880,4,63,8,30,14764,2,5141,12074
EDO.NVA.ESPARTA,MP. MARCANO,PQ. ADRIAN,10537,22,159,8725,5023,8566,0,53,5,22,10537,2,3483,8725
EDO.NVA.ESPARTA,MP. DIAZ,PQ. ZABALA,12517,25,286,9986,6196,9700,4,46,3,25,12517,5,3446,9986
EDO.NVA.ESPARTA,MP. DIAZ,CM. SAN JUAN BAUTISTA,27717,57,633,23280,12616,22647,5,106,2,57,27717,8,9910,23280
EDO.NVA.ESPARTA,MP. TUBORES,CM. PUNTA DE PIEDRAS,16858,35,262,13716,7640,13454,2,54,5,36,17280,2,5751,13716
EDO.NVA.ESPARTA,MP. TUBORES,PQ. LOS BARALES,5967,13,92,4816,2950,4724,0,19,1,13,5967,1,1753,4816
EDO.NVA.ESPARTA,MP.PENIN. DE MACANAO,PQ. SAN FRANCISCO,9787,25,102,7164,4408,7062,0,25,4,25,9787,4,2621,7164
EDO.NVA.ESPARTA,MP.PENIN. DE MACANAO,CM. BOCA DEL RIO,7609,15,74,6071,3146,5997,1,31,0,16,7965,3,2816,6071
EDO.NVA.ESPARTA,MP. MARI#O,CM. PORLAMAR,71928,142,1104,56475,26683,55371,9,247,18,150,75992,16,28398,56475
EDO.NVA.ESPARTA,MP.ANTOLIN DEL CAMPO,CM.LA PLAZA DE PARAGUACHI,20006,42,250,16817,8423,16567,3,80,1,42,20006,8,8052,16817
